UID,Name,NationID,Born,Age,IntCaps,IntGoals,U21Caps,U21Goals,Height,Weight,AerialAbility,CommandOfArea,Communication,Eccentricity,Handling,Kicking,OneOnOnes,Reflexes,RushingOut,TendencyToPunch,Throwing,Corners,Crossing,Dribbling,Finishing,FirstTouch,Freekicks,Heading,LongShots,Longthrows,Marking,Passing,PenaltyTaking,Tackling,Technique,Aggression,Anticipation,Bravery,Composure,Concentration,Vision,Decisions,Determination,Flair,Leadership,OffTheBall,Positioning,Teamwork,Workrate,Acceleration,Agility,Balance,Jumping,LeftFoot,NaturalFitness,Pace,RightFoot,Stamina,Strength,Consistency,Dirtiness,ImportantMatches,InjuryProness,Versatility,Adaptability,Ambition,Loyalty,Pressure,Professional,Sportsmanship,Temperament,Controversy,PositionsDesc,Goalkeeper,Sweeper,Striker,AttackingMidCentral,AttackingMidLeft,AttackingMidRight,DefenderCentral,DefenderLeft,DefenderRight,DefensiveMidfielder,MidfielderCentral,MidfielderLeft,MidfielderRight,WingBackLeft,WingBackRight
1025389,Wádson,1651,22/07/1990,25,0,0,0,0,183,77,10,10,13,3,11,11,3,10,1,3,3,9,6,2,1,10,5,15,7,1,13,9,9,16,9,6,8,8,7,9,7,9,12,2,5,9,12,9,10,7,11,11,12,9,11,9,20,10,12,9,4,1,9,9,20,12,9,13,11,8,9,6,D C,1,1,1,1,1,1,20,1,1,1,1,1,1,1,1
1033176,António Carlos,1651,12/06/1979,37,0,0,0,0,188,72,4,2,3,3,1,1,1,1,1,2,3,7,7,8,14,14,7,13,8,4,4,8,7,5,10,9,11,8,9,6,6,12,9,10,10,10,7,6,8,14,11,8,14,9,14,12,20,9,8,9,9,1,9,9,15,11,10,11,11,9,15,3,S ,1,1,20,1,1,1,1,1,1,1,1,1,1,1,1
1033189,Ricardo Andrade,1651,22/06/1977,39,0,0,0,0,187,82,12,9,11,13,11,8,10,12,11,12,7,4,3,1,3,7,7,6,1,2,3,8,1,1,7,9,11,12,8,9,7,8,12,1,6,2,11,12,12,8,11,12,13,5,9,9,20,7,10,9,6,4,5,9,12,12,11,10,12,8,10,10,GK ,20,1,1,1,1,1,1,1,1,1,1,1,1,1,1
104342,Zé Roberto,1651,06/07/1974,41,84,6,0,0,172,71,2,1,1,1,1,3,1,4,3,2,2,12,13,13,10,15,14,8,9,11,10,15,13,13,17,13,13,12,15,15,13,16,16,16,15,13,12,15,13,11,10,14,6,20,14,10,7,10,8,14,6,17,6,14,18,15,13,14,19,16,17,6,D/WB/M/AM LC,1,1,1,15,18,1,1,16,1,14,19,20,1,16,1
107254,Álvaro,1651,01/11/1977,38,0,0,0,0,182,83,2,2,3,3,1,1,2,3,2,3,2,7,8,9,11,9,10,16,10,9,10,11,10,10,10,12,12,13,11,11,10,11,12,12,10,10,10,12,13,7,11,11,12,7,17,7,20,10,13,15,11,14,4,5,14,15,16,15,7,11,9,10,D C,1,9,1,1,1,1,20,1,1,1,1,1,1,1,1
107476,Rafael,1651,01/08/1978,37,0,0,0,0,185,83,1,1,2,1,3,2,3,1,1,3,1,6,8,9,12,10,8,13,9,4,5,10,14,4,11,11,10,11,13,12,12,13,15,14,12,11,7,12,8,7,7,12,12,11,11,7,20,8,14,12,8,13,9,12,12,12,19,14,15,14,8,8,S ,1,1,20,14,12,12,1,1,1,1,1,1,1,1,1
11008319,Marcos dos Santos,1651,18/05/1981,35,0,0,0,0,169,62,1,1,1,3,3,2,2,3,1,3,2,8,10,10,7,9,8,7,8,8,6,9,10,7,10,8,8,6,7,7,9,7,12,8,6,7,5,6,8,13,14,10,6,10,12,14,20,9,6,8,10,10,7,10,10,12,11,10,7,8,10,9,M/AM RL,1,1,14,10,17,20,1,1,1,1,8,14,16,1,1
11010640,Denis Viana,1651,03/09/1986,29,0,0,0,0,187,84,1,1,3,1,2,3,2,3,1,2,2,7,5,6,3,12,7,9,9,4,8,9,2,13,9,6,9,8,9,7,9,14,2,9,8,9,11,8,9,14,14,8,11,10,6,14,20,14,8,10,5,9,9,9,8,10,11,11,8,1,16,5,D/M C,1,1,1,1,1,1,18,1,1,10,20,1,1,1,1
11024622,Mauricio,1651,08/02/1993,23,0,0,0,0,182,76,2,2,1,1,3,2,2,1,1,3,1,8,10,12,7,11,9,6,11,5,7,10,12,6,11,3,6,10,11,11,10,10,13,14,5,12,5,11,7,12,14,9,9,20,12,11,6,9,9,12,8,5,6,12,16,11,12,11,12,14,7,7,M/AM LC,1,1,14,20,20,13,1,1,1,1,15,17,10,1,1
11027761,Serginho,1651,06/05/1995,21,0,0,0,0,179,0,3,3,2,2,1,1,2,4,3,3,3,6,9,13,15,14,9,14,11,3,9,11,8,7,12,9,13,8,11,11,11,11,3,10,13,9,10,9,10,15,12,6,9,10,11,14,20,7,8,10,5,10,8,10,20,12,10,8,11,3,19,4,S ,1,1,20,14,13,12,1,1,1,1,1,1,1,1,1
115919,Leonardo,1651,09/03/1983,33,0,0,2,0,171,69,1,2,3,3,3,1,1,3,3,2,3,9,11,15,11,14,11,5,14,6,4,13,14,4,15,7,11,10,11,8,13,11,7,18,4,11,4,8,6,13,13,8,5,20,9,11,7,9,8,8,4,12,14,14,14,8,7,12,9,6,18,18,M/AM RLC,1,1,14,20,15,15,1,1,1,1,18,15,15,1,1
12029353,Jeferson,1651,22/06/1987,29,0,0,0,0,182,77,3,1,1,2,3,2,1,2,1,3,1,7,7,13,13,13,7,13,7,1,7,8,5,3,12,10,11,2,10,8,9,9,8,12,11,13,8,7,9,13,13,8,8,10,15,13,20,13,10,10,10,10,14,10,10,10,11,10,11,9,5,6,S ,1,1,20,1,1,13,1,1,1,1,1,1,1,1,1
12029409,Régis de Souza,1651,25/01/1982,34,0,0,0,0,188,0,2,1,3,1,1,3,1,2,3,3,2,9,7,10,11,10,13,13,12,1,6,9,5,1,11,13,13,4,13,6,6,12,3,9,9,13,8,7,8,13,12,11,13,20,11,11,10,11,11,10,4,9,8,10,17,8,13,10,13,8,1,7,S ,1,1,20,1,1,1,1,1,1,1,1,1,1,1,1
12037888,Guto,1651,20/01/1990,26,0,0,0,0,179,77,1,1,3,3,1,2,3,1,3,2,2,10,9,13,8,13,13,7,11,4,3,12,11,3,15,7,10,6,5,6,12,7,7,13,7,13,4,11,5,12,14,7,5,20,6,11,8,6,6,8,4,8,12,9,7,10,11,9,11,1,3,1,AM RLC,1,1,1,20,18,15,1,1,1,1,10,10,10,1,1
12053864,Orlando,1651,07/08/1985,30,0,0,0,0,175,75,3,2,3,1,1,3,3,1,2,1,2,10,13,8,7,9,8,8,7,4,3,6,5,6,11,9,10,4,7,7,7,9,7,11,9,8,6,7,8,13,13,5,8,20,13,13,6,6,8,9,6,4,9,9,17,13,10,12,9,1,11,7,AM L,1,1,15,1,20,13,1,1,1,1,1,13,6,1,1
120919,Juliano Vicentini,1651,26/08/1981,34,0,0,0,0,179,70,3,2,1,1,1,1,4,4,3,2,1,11,12,10,8,10,11,11,12,5,8,12,11,9,10,12,10,13,12,10,13,10,11,12,10,11,10,11,10,12,12,12,8,7,12,11,20,13,11,16,10,14,10,11,8,14,14,12,14,13,10,6,M/AM C,1,1,1,20,1,1,1,1,1,13,20,1,1,1,1
121098,Lima,1651,17/04/1971,45,0,0,0,0,176,79,1,1,1,1,1,1,1,1,1,1,1,5,10,9,5,14,5,10,8,12,15,15,5,14,12,15,14,16,8,12,11,14,18,5,9,10,13,12,11,6,9,10,9,20,8,7,4,6,9,9,14,10,2,11,17,15,15,14,9,11,10,12,DM C,1,1,1,1,1,1,2,14,3,20,15,13,7,14,5
121163,Matuzalém,1651,10/06/1980,36,0,0,4,0,175,70,1,2,2,1,3,2,4,1,1,3,2,14,8,10,5,12,12,4,12,3,6,13,11,11,14,16,10,13,12,12,11,10,14,14,14,11,10,12,13,8,9,10,7,20,7,9,12,9,14,12,17,15,17,8,15,15,8,12,14,9,16,11,M/AM C,1,1,1,16,1,1,1,1,1,15,20,9,4,1,1
127913,Léo Moura,1651,23/10/1978,37,1,0,0,0,178,66,3,2,2,1,1,3,1,4,2,1,1,12,12,15,13,13,14,10,12,12,8,14,15,11,15,16,13,13,12,12,15,14,14,13,15,14,11,15,14,11,9,12,9,10,14,11,20,9,11,11,14,14,13,14,12,9,12,11,12,8,12,12,D/WB/M R,1,1,1,10,1,10,7,1,19,5,10,1,16,1,20
13110751,Sidney,1651,09/02/1987,29,0,0,0,0,170,72,1,2,3,2,2,1,1,2,1,3,2,7,10,7,8,9,6,3,3,4,7,10,3,10,8,5,10,9,10,9,6,14,8,10,13,9,10,6,7,14,14,9,3,8,12,14,20,10,7,10,10,9,10,10,9,12,11,11,11,2,8,8,D/WB R,1,1,1,1,1,15,1,1,19,1,1,1,15,1,20
13132727,Jorginho,1651,03/05/1988,28,0,0,0,0,181,75,2,1,3,3,2,1,2,1,1,4,3,5,11,12,13,11,8,10,8,8,7,11,12,7,12,10,11,11,12,13,12,12,10,12,11,12,13,13,14,11,12,11,10,9,12,12,20,12,12,11,9,12,9,12,11,11,12,9,11,9,8,5,S ,1,1,20,1,13,13,1,1,1,1,1,1,1,1,1
13150999,Paulo Sérgio,1651,06/11/1983,32,0,0,0,0,177,0,1,1,2,2,2,4,2,1,2,3,2,6,8,8,3,11,5,11,6,4,15,8,2,14,11,8,14,11,10,11,10,15,2,5,12,8,13,10,10,12,12,5,5,13,12,9,20,15,8,5,6,9,10,10,16,11,10,11,10,11,11,8,D/WB RC,1,1,1,1,1,1,15,1,20,1,1,1,1,1,18
13173991,Judicael,1651,09/09/1994,21,0,0,0,0,178,0,4,3,2,3,2,2,1,2,4,3,1,5,5,12,13,14,7,14,8,1,6,8,9,3,12,9,5,8,9,8,6,11,4,11,13,13,8,7,8,14,14,5,5,9,10,14,20,9,7,9,5,7,9,9,10,11,12,11,11,5,16,3,S ,1,1,20,1,1,1,1,1,1,1,1,1,1,1,1
13173992,Felipe Tiago,1651,04/05/1990,26,0,0,0,0,190,0,3,2,3,3,1,1,1,2,3,1,1,4,4,3,5,7,1,14,1,4,14,6,4,14,3,7,10,9,7,8,7,14,9,1,12,4,9,7,8,12,11,8,16,4,14,11,20,11,9,9,7,1,8,9,7,9,10,12,13,1,16,6,D C,1,1,1,1,1,1,20,1,1,1,1,1,1,1,1
1348,Glaysson,1651,01/03/1979,37,0,0,0,0,183,94,12,12,10,6,14,12,12,10,12,5,10,5,1,2,2,7,7,1,1,1,1,4,2,2,7,10,10,14,8,8,8,13,5,3,11,1,14,10,9,11,12,10,12,20,9,13,11,8,17,10,7,14,6,10,17,12,13,13,10,14,8,4,GK ,20,1,1,1,1,1,1,1,1,1,1,1,1,1,1
1394630981,Marconi,1651,22/06/1988,28,0,0,0,0,172,75,1,1,2,3,2,3,1,2,1,3,2,1,7,10,9,10,8,9,10,6,12,11,9,11,10,12,10,14,9,11,9,10,12,9,11,7,14,13,13,11,11,12,7,8,14,11,20,13,10,12,10,10,7,10,11,12,8,11,11,9,12,10,DM/M C,1,1,1,7,1,1,1,1,1,18,20,1,1,1,1
1394630982,Jean,1651,23/08/1987,28,0,0,0,0,189,0,1,4,2,3,3,3,1,1,1,2,2,5,6,7,12,12,5,12,7,1,4,7,6,3,12,8,5,6,7,7,7,11,7,13,7,12,7,5,7,12,12,7,12,8,10,12,20,11,9,9,9,9,4,9,14,11,13,10,10,4,11,5,AM/S C,1,1,20,17,1,1,1,1,1,1,1,1,1,1,1
1394630987,Araújo,1651,12/05/1988,28,0,0,0,0,188,77,2,1,3,2,1,1,1,1,2,2,2,2,4,6,7,8,7,13,9,5,12,10,9,12,8,13,10,13,8,11,7,9,12,3,8,9,12,13,13,12,10,13,15,10,14,11,20,13,13,12,11,10,8,8,12,11,10,11,13,8,11,7,D C,1,11,1,1,1,1,20,1,1,1,1,1,1,1,1
1394630993,Itacaré,1651,21/08/1987,28,0,0,0,0,181,81,3,2,2,1,3,2,3,3,3,1,3,2,6,8,12,8,3,12,10,1,3,8,12,2,9,12,12,13,11,8,7,10,13,16,3,12,5,9,10,11,11,12,12,12,15,11,20,12,14,12,8,15,8,10,15,13,14,12,14,7,12,8,S ,1,1,20,10,1,1,1,1,1,1,1,1,1,1,1
1394630999,Marcelo,1651,24/01/1989,27,0,0,0,0,184,81,1,1,1,3,3,2,2,2,1,2,3,8,6,8,12,10,8,12,9,1,3,8,14,4,9,4,11,12,11,8,8,11,10,9,8,11,9,8,11,10,8,13,13,9,13,9,20,12,13,13,9,2,9,9,15,10,12,10,11,6,4,6,S ,1,1,20,1,1,1,1,1,1,1,1,1,1,1,1
1394662743,Luiz Fernando,1651,12/05/2000,16,0,0,0,0,177,0,1,2,3,3,2,2,2,1,2,3,1,3,5,1,2,6,1,4,4,1,6,5,1,6,9,10,6,11,4,5,3,7,2,13,3,2,6,8,4,12,12,13,6,20,13,10,12,6,4,8,13,9,5,6,13,11,8,10,11,12,10,7,D L,1,1,1,1,1,1,1,20,7,1,1,1,1,6,1
1394662744,Lídio,1651,03/12/2000,15,0,0,0,0,166,0,2,1,1,4,2,1,2,2,3,2,3,5,6,5,3,5,1,2,5,5,7,4,2,6,5,6,7,8,4,7,2,10,5,10,9,5,7,12,7,13,7,14,6,8,9,11,20,6,6,5,6,7,8,14,5,7,7,7,10,3,2,5,D R,1,1,1,1,1,1,1,5,20,1,1,1,1,1,8
1394662745,Alexandre,1651,08/09/2000,15,0,0,0,0,178,0,3,2,1,1,2,1,2,1,1,2,2,4,2,3,4,6,4,6,5,4,6,5,5,12,3,7,6,16,6,5,5,7,7,9,8,6,10,13,9,10,7,7,7,9,14,9,20,8,5,7,15,7,14,9,12,11,8,11,10,9,11,8,D RC,1,1,1,1,1,1,20,6,19,1,1,1,1,1,7
1394662746,Ygor,1651,09/06/2000,16,0,0,0,0,174,0,1,1,3,1,3,2,3,3,3,2,1,3,4,3,1,6,1,6,3,3,11,4,3,15,3,10,9,5,3,7,3,6,3,2,8,3,9,12,7,9,6,2,8,8,11,8,20,8,5,5,8,12,15,4,12,6,5,9,16,6,12,10,D RLC,1,1,1,1,1,1,20,15,15,1,1,1,1,5,7
1394662747,Carlos Antônio,1651,30/12/2000,15,0,0,0,0,189,0,2,2,2,2,2,1,2,3,1,1,1,3,2,1,1,3,1,4,1,2,9,4,2,6,7,11,5,4,1,6,2,10,5,6,4,1,5,1,4,10,10,12,12,8,6,8,20,7,5,4,9,14,7,10,8,7,14,11,5,10,6,6,D RLC,1,1,1,1,1,1,20,17,17,1,1,1,1,6,6
1394662748,Diogo Jaime,1651,25/04/2000,16,0,0,0,0,186,0,2,7,3,10,14,5,5,10,7,7,3,1,2,1,3,3,5,1,2,3,1,1,1,1,1,10,4,10,4,6,4,5,9,3,4,1,4,9,11,13,4,10,7,16,17,9,20,6,5,4,11,14,4,6,3,8,12,7,16,9,8,8,GK ,20,1,1,1,1,1,1,1,1,1,1,1,1,1,1
1394662749,Cassiano,1651,01/02/2001,15,0,0,0,0,188,0,2,2,1,3,3,1,3,2,3,2,2,3,4,3,4,5,1,6,4,2,7,5,2,6,5,7,8,6,5,6,1,10,4,7,13,2,7,8,12,9,6,14,13,9,11,6,20,7,10,4,9,11,5,8,3,13,6,12,3,5,10,19,D C,1,1,1,1,1,1,20,1,1,1,1,1,1,1,1
1394662750,André Luís,1651,19/01/2001,15,0,0,0,0,186,0,4,1,1,4,3,2,1,2,2,1,3,1,1,2,2,4,3,7,3,3,7,4,3,6,3,11,8,15,4,7,4,13,6,7,4,1,11,4,4,6,7,4,13,8,15,5,20,4,8,3,11,3,6,7,5,12,8,13,10,14,10,1,D C,1,1,1,1,1,1,20,1,1,1,1,1,1,1,1
1394662751,Alex,1651,31/01/2001,15,0,0,0,0,180,0,1,3,3,1,1,2,3,1,3,1,2,1,2,1,3,2,1,11,1,2,10,3,4,7,2,12,4,10,3,6,5,9,6,5,10,1,9,7,10,5,6,9,5,20,15,5,13,5,7,5,5,11,5,5,6,13,5,9,3,5,7,11,D LC,1,1,1,1,1,1,20,16,1,1,1,1,1,5,1
1394662752,Ziquinha,1651,23/09/2000,15,0,0,0,0,191,0,6,3,3,1,9,5,6,13,11,10,4,3,3,2,2,2,5,1,2,1,2,1,2,2,1,9,5,17,1,6,8,7,10,1,2,3,4,4,4,7,11,2,11,11,15,7,20,2,5,6,5,9,12,5,9,16,12,8,5,15,10,9,GK ,20,1,1,1,1,1,1,1,1,1,1,1,1,1,1
1394662753,Leandro Xavier,1651,26/01/2001,15,0,0,0,0,181,0,6,11,8,2,5,5,6,12,9,11,11,5,3,3,1,2,7,1,2,2,3,1,2,2,1,11,6,6,3,6,7,9,7,1,2,3,9,12,6,11,15,9,11,9,13,9,20,2,4,6,8,17,8,6,7,16,8,11,4,11,9,12,GK ,20,1,1,1,1,1,1,1,1,1,1,1,1,1,1
1394662754,Roberto Carlos,1651,28/08/2000,15,0,0,0,0,184,0,1,3,2,3,1,1,2,3,2,2,2,1,1,1,1,3,1,10,1,1,13,2,1,10,4,14,6,6,2,4,1,8,17,5,4,2,5,18,13,6,7,11,12,8,10,7,20,9,10,13,7,5,10,5,11,5,7,12,5,7,8,12,D C,1,1,1,1,1,1,20,1,1,1,1,1,1,1,1
1394662755,Luiz Eduardo,1651,03/09/2000,15,0,0,0,0,189,0,3,4,1,2,1,3,2,3,2,1,2,2,3,1,2,4,4,7,2,3,12,7,2,7,2,14,4,14,3,8,3,7,18,4,14,3,5,15,10,7,7,3,14,8,12,7,20,7,6,3,6,16,5,4,8,11,7,10,6,5,7,14,D C,1,1,1,1,1,1,20,1,1,1,1,1,1,1,1
1394662756,Luís Henrique,1651,01/05/2000,16,0,0,0,0,179,0,2,1,3,1,3,2,1,3,2,2,3,5,10,4,4,8,2,3,5,13,4,4,4,3,9,10,6,6,5,4,5,5,8,3,3,5,3,13,9,9,6,10,9,20,12,7,16,10,6,8,12,16,7,13,10,9,12,12,12,12,13,9,M RL,1,1,1,1,11,1,1,1,1,1,1,20,15,1,1
1394662757,Paulinho,1651,05/09/2000,15,0,0,0,0,175,0,2,1,1,1,2,2,3,3,3,1,2,6,9,7,4,9,8,2,6,2,5,4,5,5,13,5,6,6,5,6,5,6,5,11,6,7,3,9,13,8,8,10,9,20,6,9,9,8,4,4,15,9,9,7,6,4,7,5,14,9,9,7,M/AM L,1,1,1,1,19,1,1,1,1,1,1,20,1,1,1
1394662758,George,1651,29/10/2000,15,0,0,0,0,185,0,6,6,4,1,13,7,8,13,7,15,5,6,2,2,3,1,8,1,1,3,2,1,3,1,1,8,3,8,3,6,6,10,3,3,12,1,10,11,6,7,5,12,8,20,12,3,7,1,4,16,10,3,11,6,12,18,8,13,7,15,10,8,GK ,20,1,1,1,1,1,1,1,1,1,1,1,1,1,1
1394662759,Ronald,1651,02/12/2000,15,0,0,0,0,168,0,2,1,3,3,1,4,2,2,1,1,1,6,5,4,6,8,4,5,6,5,7,4,2,6,8,11,8,9,7,7,7,12,4,9,3,2,6,5,9,8,12,12,7,20,13,10,9,8,7,4,8,14,12,7,9,8,8,5,8,8,9,8,D L,1,1,1,1,1,1,1,20,6,1,1,1,1,7,1
1394662760,Edimário,1651,22/01/2001,15,0,0,0,0,172,0,2,1,1,1,3,1,1,3,3,1,2,5,5,3,2,10,3,4,1,4,6,5,2,5,7,11,6,6,5,9,4,7,9,6,5,5,7,16,13,8,8,5,6,8,10,7,20,13,8,5,8,9,6,13,9,7,9,12,7,5,10,14,D RL,1,1,1,1,1,1,1,15,20,1,1,1,1,7,9
1394662761,Diego Amorim,1651,17/04/2000,16,0,0,0,0,183,0,2,2,1,2,3,3,2,2,1,1,2,1,3,5,2,4,2,6,2,4,10,3,3,10,1,10,10,6,3,5,2,13,2,1,7,2,12,14,9,7,6,4,10,20,11,6,7,6,5,13,5,5,8,9,14,5,13,6,4,5,9,6,D C,1,1,1,1,1,1,20,1,1,1,1,1,1,1,1
1394662762,Tiago,1651,04/12/2000,15,0,0,0,0,178,0,4,2,3,1,1,1,3,3,1,1,1,3,3,1,1,5,5,4,3,2,6,3,1,10,5,7,6,13,2,7,3,7,15,3,7,2,9,7,10,7,10,12,10,15,9,8,20,6,8,5,3,5,1,4,4,2,7,9,7,12,15,1,D RC,1,1,1,1,1,1,20,11,19,1,1,1,1,1,7
1394662763,Tiago,1651,02/08/2000,15,0,0,0,0,194,0,1,1,1,1,1,1,1,2,3,1,3,11,15,5,3,8,9,2,3,3,6,5,1,2,13,8,4,3,5,2,4,5,7,11,13,6,2,13,9,11,9,3,13,20,12,13,9,11,7,6,9,7,9,10,3,7,7,14,9,10,18,6,M L,1,1,1,1,11,1,1,1,1,1,1,20,1,1,1
1394662764,Diego Simão,1651,08/10/2000,15,0,0,0,0,187,0,12,9,7,2,8,11,4,7,9,9,6,1,1,2,1,2,6,1,2,2,3,1,2,1,4,8,5,11,3,8,2,7,2,2,8,2,7,4,4,7,5,3,13,20,12,4,10,2,5,6,9,7,7,8,11,11,7,7,6,9,11,1,GK ,20,1,1,1,1,1,1,1,1,1,1,1,1,1,1
1394662765,Gilmar Napolitano,1651,10/12/2000,15,0,0,0,0,194,0,7,10,5,11,14,7,4,5,6,9,4,1,1,1,1,2,3,1,2,3,1,2,1,1,1,10,4,7,2,5,13,8,2,2,4,2,7,4,2,7,9,8,11,10,14,5,20,3,4,11,10,3,5,8,11,12,10,10,18,11,14,10,GK ,20,1,1,1,1,1,1,1,1,1,1,1,1,1,1
1394662766,Gilmar,1651,18/04/2000,16,0,0,0,0,172,0,1,3,2,2,2,1,3,3,1,3,1,1,2,3,1,5,1,1,2,2,3,3,3,4,3,10,5,11,3,5,2,11,4,2,5,1,5,7,9,12,13,4,6,20,14,14,7,6,2,11,14,10,10,8,12,13,8,10,10,5,6,6,D L,1,1,1,1,1,1,1,20,6,1,1,1,1,8,1
1394662767,Heitor Pena,1651,10/02/2000,16,0,0,0,0,179,0,3,1,3,2,1,1,1,2,3,1,1,1,1,1,3,3,1,6,1,1,7,2,2,8,6,9,5,11,4,4,2,12,9,4,9,1,6,4,2,8,8,13,7,8,12,7,20,7,7,5,8,5,4,6,4,18,9,5,4,9,10,3,D RLC,1,1,1,1,1,1,20,15,15,1,1,1,1,6,7
1394662768,José Roberto,1651,24/02/2000,16,0,0,0,0,177,0,3,1,2,3,2,2,4,1,3,2,1,1,1,2,1,4,1,8,2,1,9,3,1,4,2,9,9,6,1,4,1,7,3,2,11,1,11,11,6,7,4,13,9,9,14,6,20,4,9,6,10,12,5,7,8,16,4,14,1,5,10,19,D C,1,1,1,1,1,1,20,1,1,1,1,1,1,1,1
1394662769,Edmundo Marcelo,1651,22/03/2000,16,0,0,0,0,192,0,4,9,3,2,11,9,4,11,13,14,3,3,2,1,1,2,6,1,3,2,1,1,1,3,1,13,4,8,3,7,7,7,2,1,9,3,3,12,7,11,3,1,12,11,8,8,20,3,5,10,11,12,6,6,8,12,11,11,12,7,2,10,GK ,20,1,1,1,1,1,1,1,1,1,1,1,1,1,1
1394662770,Haroldo,1651,25/06/2000,16,0,0,0,0,177,0,2,2,1,1,3,1,1,2,2,3,3,2,5,4,5,5,4,5,4,4,6,4,7,6,4,14,6,11,5,6,4,11,15,3,1,1,8,10,14,9,5,7,10,20,12,5,16,9,6,14,5,13,7,9,3,16,10,4,9,14,2,5,D RL,1,1,1,1,1,1,1,20,19,1,1,1,1,6,8
1394662771,Jonatan,1651,02/01/2001,15,0,0,0,0,176,0,3,2,3,3,3,2,3,1,2,4,2,3,3,2,1,4,1,4,1,2,6,3,2,5,4,9,6,6,4,6,5,4,7,3,7,4,6,6,11,10,10,6,9,14,8,12,20,11,5,3,17,3,2,4,9,18,15,5,4,8,11,7,D R,1,1,1,1,1,1,1,6,20,1,1,1,1,1,6
1394662772,Fulgêncio,1651,29/01/2001,15,0,0,0,0,181,0,1,3,3,2,2,2,1,3,3,3,1,1,1,3,2,4,3,7,1,2,5,5,3,8,4,13,6,6,5,5,3,5,14,5,8,1,6,13,9,12,9,13,8,8,12,9,20,5,13,7,7,8,6,5,9,16,5,9,8,6,12,4,D C,1,1,1,1,1,1,20,1,1,1,1,1,1,1,1
1394662773,Weverton Santos,1651,28/09/2000,15,0,0,0,0,179,0,2,2,4,1,1,2,1,1,3,1,3,3,1,3,3,3,2,7,3,2,10,5,2,10,2,17,5,7,5,4,3,6,9,9,1,1,8,14,10,6,8,10,8,8,12,7,20,5,9,8,12,7,4,5,9,9,9,7,9,11,10,11,D C,1,1,1,1,1,1,20,1,1,1,1,1,1,1,1
1394662774,Bruno César,1651,23/03/2000,16,0,0,0,0,188,0,3,1,1,2,2,3,1,2,3,1,2,1,2,1,2,7,1,4,1,1,6,2,1,9,3,6,2,12,3,4,2,9,5,8,1,1,11,10,10,7,7,12,11,20,7,11,7,6,3,4,8,5,12,4,19,10,17,12,10,5,9,6,D LC,1,1,1,1,1,1,20,15,1,1,1,1,1,9,1
1394662775,Arlan,1651,06/03/2000,16,0,0,0,0,168,0,2,3,2,2,3,2,3,3,2,3,1,7,4,6,4,5,12,2,2,2,2,7,4,3,10,8,4,7,2,1,6,5,4,10,11,5,2,8,10,13,7,7,3,20,14,8,7,7,3,3,7,11,5,16,10,11,3,11,4,10,9,1,M/AM L,1,1,1,1,16,1,1,1,1,1,1,20,1,1,1
1394662776,José Wellington,1651,14/06/2000,16,0,0,0,0,189,0,3,3,1,1,2,3,1,1,1,1,2,4,4,10,5,9,3,3,2,2,2,5,3,3,6,15,6,8,6,2,5,4,7,10,5,3,1,15,12,13,10,6,12,20,8,9,7,7,4,4,12,3,9,2,5,7,13,7,7,11,7,5,AM RL,1,1,12,1,20,16,1,1,1,1,1,1,1,1,1
1394662777,José Alberto,1651,06/11/2000,15,0,0,0,0,183,0,2,3,2,3,4,1,2,1,2,1,1,5,7,6,3,8,9,1,4,1,2,8,4,2,6,8,4,4,5,2,6,6,6,8,10,4,2,12,7,9,9,4,10,15,12,9,20,5,5,8,11,10,2,10,8,14,13,11,9,9,5,6,M R,1,1,1,1,1,10,1,1,1,1,1,1,20,1,1
1394662778,Allan Reuber Tabosa,1651,14/02/2000,16,0,0,0,0,176,0,1,3,2,1,3,2,1,1,2,2,4,3,6,6,4,4,2,1,4,2,2,3,2,2,9,7,7,8,5,5,4,6,4,11,13,2,1,8,11,11,10,9,7,9,5,11,20,6,3,5,10,5,4,6,14,11,10,10,18,5,10,1,AM R,1,1,1,1,1,20,1,1,1,1,1,1,13,1,1
1394663835,Wágner,1651,10/03/2000,16,0,0,0,0,164,0,1,1,3,2,1,1,3,1,2,2,1,5,5,6,5,5,1,4,3,5,6,4,5,8,3,14,7,8,4,6,1,11,5,8,12,2,9,11,7,10,6,4,2,11,6,8,20,10,5,6,9,9,7,9,10,7,8,11,1,7,20,7,D R,1,1,1,1,1,1,1,7,20,1,1,1,1,1,9
1394665686,Marlon Henrique,1651,21/11/2000,15,0,0,0,0,179,0,3,2,1,2,3,3,2,2,3,1,1,4,4,1,3,4,1,3,3,4,5,3,2,4,3,12,5,5,3,6,4,8,7,7,12,4,6,17,14,12,8,3,10,8,10,11,20,11,3,5,7,14,7,12,4,9,11,8,11,6,10,10,D R,1,1,1,1,1,1,1,6,20,1,1,1,1,1,9
1394665687,Douglas,1651,24/09/2000,15,0,0,0,0,178,0,2,1,1,2,2,2,1,3,3,2,1,4,3,3,5,4,3,8,3,6,6,5,5,12,4,15,7,9,7,9,7,6,7,7,8,5,7,14,10,7,7,14,9,14,7,6,20,7,10,9,12,3,6,12,7,12,13,8,10,11,11,8,D RLC,1,1,1,1,1,1,20,19,19,1,1,1,1,6,5
1394665688,Leomir,1651,10/10/2000,15,0,0,0,0,180,0,3,2,2,3,3,3,3,1,1,1,3,4,1,3,3,3,1,6,3,3,6,3,2,12,3,9,4,4,2,5,2,10,6,7,5,2,11,11,13,6,6,3,7,20,12,5,9,8,6,6,10,10,2,8,10,11,8,12,13,10,9,8,D LC,1,1,1,1,1,1,20,15,1,1,1,1,1,7,1
1394665689,Filipe Gasperin,1651,23/05/2000,16,0,0,0,0,174,0,1,4,2,2,4,1,1,3,2,3,2,5,8,5,5,6,3,1,5,1,3,4,1,3,8,8,3,8,4,3,8,4,4,8,1,5,3,6,4,14,10,3,7,20,13,10,8,3,3,3,14,4,5,6,9,6,7,7,12,13,8,8,M/AM L,1,1,1,1,17,1,1,1,1,1,1,20,1,1,1
1394665690,Luís Fernando,1651,23/10/2000,15,0,0,0,0,170,0,3,3,2,1,2,1,3,2,2,2,2,4,5,6,2,5,2,2,4,2,4,6,3,3,6,12,6,6,4,2,5,6,5,7,2,3,3,13,9,12,11,12,8,20,14,12,8,5,4,12,8,6,6,6,2,5,15,4,12,11,7,4,M L,1,1,1,1,11,1,1,1,1,1,1,20,1,1,1
1394665837,Fábio Souza Ramos,1651,07/03/2000,16,0,0,0,0,180,0,5,8,3,2,7,3,4,6,11,13,4,1,3,1,3,2,3,1,2,1,3,1,1,3,4,13,4,13,2,5,4,8,5,2,14,3,6,13,7,12,9,11,10,7,7,7,20,2,6,8,7,8,10,2,12,18,5,10,10,11,10,5,GK ,20,1,1,1,1,1,1,1,1,1,1,1,1,1,1
1394665838,José Augusto,1651,07/12/2000,15,0,0,0,0,180,0,2,2,2,2,2,2,1,2,3,1,3,4,6,5,2,7,5,4,4,5,6,4,5,8,10,10,4,6,6,10,5,6,4,8,5,3,5,4,3,7,6,6,10,15,10,8,20,6,7,8,10,3,6,9,7,5,6,8,3,6,13,3,D R,1,1,1,1,1,1,1,12,20,1,1,1,1,1,7
1394665839,Cleyton,1651,13/12/2000,15,0,0,0,0,185,0,1,1,2,1,1,3,2,2,2,1,3,2,1,1,1,3,1,4,2,2,9,3,1,4,2,7,5,11,3,8,1,9,3,7,10,1,9,3,2,6,7,3,10,13,11,6,20,3,10,12,7,16,7,7,5,5,7,9,5,6,10,6,D C,1,1,1,1,1,1,20,1,1,1,1,1,1,1,1
1394665840,Romeu,1651,01/08/2000,15,0,0,0,0,177,0,3,2,3,3,2,1,3,1,3,2,1,1,2,3,2,4,1,5,3,1,9,3,1,9,5,11,4,15,2,5,3,6,7,2,7,1,7,14,9,8,10,10,10,11,13,8,20,4,9,5,7,8,3,6,13,7,6,8,7,9,15,10,D C,1,1,1,1,1,1,20,1,1,1,1,1,1,1,1
1394665841,Sidney,1651,25/11/2000,15,0,0,0,0,177,0,3,1,3,4,1,2,2,3,3,1,2,8,8,5,3,6,11,5,6,4,4,6,2,5,7,17,7,4,5,4,6,6,6,5,3,4,2,13,9,9,11,13,6,20,10,12,9,8,5,8,8,14,8,11,12,7,5,11,18,7,13,9,M L,1,1,1,1,11,1,1,1,1,1,1,20,1,1,1
1394665842,Marcus Vinícius,1651,22/03/2000,16,0,0,0,0,182,0,2,3,1,3,2,2,2,1,3,3,2,1,5,5,3,5,2,2,3,1,1,3,1,2,3,9,5,5,4,1,5,5,7,14,8,4,1,7,9,13,10,4,9,20,11,13,11,4,4,7,7,5,5,6,20,13,10,9,8,4,7,2,M/AM L,1,1,1,1,20,1,1,1,1,1,1,19,1,1,1
1394665843,Paulo Sérgio,1651,11/12/2000,15,0,0,0,0,180,0,3,3,2,3,3,1,2,2,3,1,1,12,15,4,4,10,8,7,3,4,3,6,3,5,7,9,7,5,6,5,6,7,5,8,4,5,4,16,12,8,9,6,7,11,15,9,20,9,5,14,7,15,9,6,18,16,3,13,16,9,8,7,M/AM R,1,1,1,1,1,16,1,1,1,1,1,1,20,1,1
1394665844,John,1651,29/11/2000,15,0,0,0,0,172,0,3,1,3,3,1,3,3,3,1,3,3,3,3,4,2,8,6,1,1,1,1,3,1,1,4,7,2,16,2,2,5,6,8,14,6,1,1,11,7,11,9,2,5,11,12,11,20,9,2,11,7,11,5,7,8,13,6,5,5,1,9,18,AM R,1,1,1,1,1,20,1,1,1,1,1,1,14,1,1
1394665845,Wallace Luís,1651,11/04/2000,16,0,0,0,0,181,0,1,1,1,1,1,3,2,1,3,1,1,3,2,2,2,5,2,14,3,5,4,8,3,5,3,5,2,7,6,5,5,11,14,6,6,3,8,13,8,10,7,5,10,8,11,9,20,3,6,8,10,8,10,5,2,15,17,9,5,9,10,13,DM ,1,1,1,1,1,1,14,1,1,20,6,1,1,1,1
1394665846,José Roberto,1651,07/09/2000,15,0,0,0,0,174,0,1,4,4,2,3,1,3,3,2,1,2,7,5,3,5,6,12,3,5,1,1,3,2,3,8,9,5,17,7,2,4,9,8,10,4,4,2,11,7,11,8,11,7,20,7,7,8,8,5,7,7,12,5,2,6,6,11,13,3,11,7,6,AM C,1,1,15,20,1,1,1,1,1,1,1,1,1,1,1
1394665847,Lucas,1651,19/05/2000,16,0,0,0,0,173,0,3,1,1,1,2,1,4,1,2,3,1,1,1,4,4,5,4,4,4,1,5,6,5,8,9,10,6,6,3,5,4,10,7,8,8,3,11,13,9,7,5,14,4,20,6,5,8,6,9,5,7,8,5,7,6,11,7,10,18,19,15,9,DM ,1,1,1,1,1,1,13,1,1,20,7,1,1,1,1
1394665848,João Aluino,1651,27/11/2000,15,0,0,0,0,184,0,7,7,3,5,13,4,6,13,9,6,2,1,3,1,1,3,4,1,2,3,2,1,3,3,1,6,6,10,1,3,1,10,7,1,7,1,9,7,8,5,8,11,10,8,13,3,20,4,5,3,8,11,10,6,8,16,3,6,3,11,10,14,GK ,20,1,1,1,1,1,1,1,1,1,1,1,1,1,1
1394665849,Caio,1651,27/02/2000,16,0,0,0,0,173,0,2,2,3,2,3,3,1,3,1,1,3,3,4,3,4,6,1,4,3,5,7,4,5,4,4,11,7,6,5,8,4,9,12,8,5,5,6,12,8,8,11,6,8,20,14,11,9,9,4,3,9,8,1,6,5,6,10,11,16,17,9,3,D RL,1,1,1,1,1,1,1,20,18,1,1,1,1,7,9
1394665850,Marivaldo de Santana,1651,16/06/2000,16,0,0,0,0,197,0,3,3,4,2,3,1,2,3,1,2,1,1,1,2,2,2,1,6,2,2,5,5,2,10,4,13,8,5,4,7,4,11,5,3,9,2,5,9,11,5,6,3,12,13,11,6,20,6,7,7,13,9,3,6,9,13,10,11,7,7,8,14,D C,1,1,1,1,1,1,20,1,1,1,1,1,1,1,1
1394665851,Paulo André,1651,24/12/2000,15,0,0,0,0,178,0,3,1,4,3,4,1,2,1,3,1,3,1,1,3,2,4,1,6,3,1,12,4,4,6,5,10,6,8,6,7,4,11,8,6,14,1,11,9,11,7,10,5,9,7,14,10,20,7,4,6,8,9,5,7,5,12,8,13,9,7,6,3,D RC,1,1,1,1,1,1,20,1,15,1,1,1,1,1,9
1394665852,Jadelson,1651,07/10/2000,15,0,0,0,0,191,0,3,2,3,2,3,3,1,3,1,1,2,4,1,2,5,2,1,6,3,2,7,7,1,11,5,18,8,9,3,4,3,9,9,8,10,2,5,3,4,5,4,4,13,11,14,4,20,4,8,6,11,17,13,8,9,10,9,8,11,6,12,3,D C,1,1,1,1,1,1,20,1,1,1,1,1,1,1,1
1394665853,Wescley,1651,17/04/2000,16,0,0,0,0,172,0,3,1,3,3,3,3,1,4,1,2,2,5,7,6,5,6,5,3,3,2,5,5,3,4,6,13,6,2,3,3,2,6,8,6,9,6,4,5,9,11,7,9,9,20,13,11,12,5,5,5,11,10,7,8,11,16,7,7,13,1,1,6,M L,1,1,1,1,12,1,1,1,1,1,1,20,1,1,1
1394665854,Arthur,1651,29/01/2001,15,0,0,0,0,173,0,4,2,2,3,2,2,1,1,1,1,2,5,8,8,3,3,4,4,3,2,2,5,6,3,7,6,5,4,3,3,7,7,6,4,2,5,2,9,12,11,10,11,8,20,13,11,8,7,4,7,15,3,6,3,10,12,7,13,7,11,12,1,M L,1,1,1,1,12,1,1,1,1,1,1,20,1,1,1
1394665855,Cícero Flávio,1651,23/09/2000,15,0,0,0,0,168,0,2,1,2,1,3,2,1,2,1,2,3,5,8,4,5,4,4,3,3,4,6,6,2,3,8,6,5,6,3,4,6,10,5,4,8,5,2,5,4,15,10,5,6,8,17,14,20,5,4,7,12,15,8,12,2,3,6,12,17,10,9,7,M R,1,1,1,1,1,12,1,1,1,1,1,1,20,1,1
1394665856,Marcos,1651,24/07/2000,15,0,0,0,0,180,0,4,1,1,2,3,3,3,1,3,2,2,5,7,6,5,4,4,1,1,1,1,5,2,1,8,7,3,1,2,2,5,3,4,9,5,1,1,8,10,13,10,2,10,9,12,9,20,6,2,5,14,15,9,9,9,1,12,9,1,14,9,19,AM R,1,1,1,1,1,20,1,1,1,1,1,1,12,1,1
1394665857,Flaysmar,1651,01/12/2000,15,0,0,0,0,180,0,2,2,1,1,3,1,1,1,2,3,3,1,2,5,4,7,1,4,5,1,6,4,4,4,7,7,7,3,8,5,9,8,8,1,4,5,9,13,14,4,7,11,8,20,12,5,8,9,5,6,4,9,4,9,13,10,9,9,3,15,11,3,DM ,1,1,1,1,1,1,1,1,1,20,12,1,1,1,1
1394665858,Luiz Miller,1651,12/05/2000,16,0,0,0,0,169,0,3,1,2,2,3,1,3,3,2,2,4,9,5,11,4,5,11,2,5,2,2,6,1,4,8,9,6,3,5,3,5,8,4,13,14,5,2,8,11,9,10,11,5,20,7,10,9,8,3,12,9,6,8,4,8,11,11,10,9,9,6,6,AM LC,1,1,1,20,17,1,1,1,1,1,14,1,1,1,1
1394665859,Guilherme,1651,26/03/2000,16,0,0,0,0,180,0,2,3,2,2,4,3,4,4,2,1,4,9,3,4,3,9,12,3,10,1,5,3,4,7,6,20,4,2,5,4,10,14,4,8,14,4,4,14,9,10,8,3,6,20,13,9,11,4,6,14,13,8,7,5,12,20,3,12,17,6,10,6,DM ,1,1,1,1,1,1,1,1,1,20,14,1,1,1,1
1394667735,Thiago José,1651,21/05/2000,16,0,0,0,0,170,0,3,3,2,3,3,3,1,3,2,1,2,4,5,3,1,8,1,2,1,5,5,4,4,7,8,3,4,5,4,8,1,11,7,7,5,2,5,9,13,9,7,6,5,20,14,6,11,11,4,12,10,7,10,4,8,3,8,12,13,9,6,6,D L,1,1,1,1,1,1,1,20,6,1,1,1,1,9,1
1394667736,Thiago José,1651,27/06/2000,16,0,0,0,0,187,0,3,2,1,2,1,3,2,1,3,1,3,1,3,1,1,3,1,11,3,2,12,4,2,7,1,13,5,3,3,5,2,4,5,2,8,3,4,18,12,6,6,3,12,16,12,6,20,9,7,15,6,17,7,5,9,9,8,10,6,14,11,2,D C,1,1,1,1,1,1,20,1,1,1,1,1,1,1,1
1394667737,Pedro,1651,06/09/2000,15,0,0,0,0,191,0,3,2,2,2,1,1,1,2,3,4,3,1,3,2,2,3,1,6,1,1,4,3,1,8,3,11,9,5,3,5,3,11,7,7,10,1,4,12,12,6,6,3,10,9,15,6,20,8,10,4,7,8,2,11,7,16,19,8,9,5,7,12,D C,1,1,1,1,1,1,20,1,1,1,1,1,1,1,1
1394667790,José Luís,1651,04/01/2000,16,0,0,0,0,180,0,12,7,4,1,9,4,4,6,7,10,5,2,3,3,1,4,6,1,1,1,1,1,3,1,1,10,6,14,3,9,2,9,9,3,14,2,5,16,11,11,9,3,7,20,11,13,7,6,5,8,11,6,7,6,10,7,4,9,12,8,7,8,GK ,20,1,1,1,1,1,1,1,1,1,1,1,1,1,1
14021312,Gustavo Maccarone,1651,17/03/1987,29,0,0,0,0,174,62,3,4,3,1,3,1,3,3,2,1,3,7,13,14,10,12,7,11,7,6,5,11,9,5,13,9,10,9,11,10,9,8,5,13,6,13,7,14,12,13,12,7,8,8,14,11,20,13,7,10,7,9,8,14,15,9,10,11,11,3,14,7,M/AM R,1,1,1,12,1,20,1,1,1,1,1,1,18,1,1
1403409,Emerson,1651,16/08/1980,35,0,0,0,0,187,81,3,4,3,1,3,2,3,2,4,2,3,8,9,13,10,12,14,14,15,6,12,11,10,13,14,11,13,13,7,11,13,10,14,15,15,8,11,10,11,10,11,13,12,20,12,12,11,12,12,13,15,11,4,15,15,12,18,15,15,14,14,5,D/DM/M C,1,1,1,1,1,1,20,1,1,19,16,1,1,1,1
14091251,Francisco De Souza,1651,20/04/1991,25,0,0,0,0,173,0,1,1,3,2,1,3,2,2,3,3,3,11,12,15,8,9,11,5,7,2,4,9,11,4,12,10,14,11,13,8,11,6,10,10,10,12,9,11,12,12,10,14,7,11,10,13,20,12,7,6,6,9,6,10,14,10,14,13,12,12,8,8,AM RL,1,1,12,8,20,19,1,1,1,1,1,15,15,1,1
14124629,Junior Neto,1651,06/06/1995,21,0,0,0,0,183,72,2,2,1,1,1,2,2,2,3,1,3,4,3,12,13,10,5,10,6,1,4,4,5,4,13,8,6,7,13,6,6,10,7,13,6,12,6,5,7,13,8,6,10,8,13,10,20,5,8,6,5,1,4,8,9,10,11,11,10,4,15,2,S C,1,1,20,15,1,1,1,1,1,1,1,1,1,1,1
1413233,Diego Oliveira,1651,11/02/1987,29,0,0,0,0,174,70,1,1,1,1,1,1,1,1,1,1,1,10,10,8,7,6,10,4,7,6,3,11,10,3,10,7,7,6,5,6,9,9,12,15,8,12,6,9,10,12,10,5,6,10,14,11,20,9,7,11,12,8,8,9,14,12,12,10,8,13,13,10,M/AM RL,1,1,1,1,15,20,1,1,1,1,1,15,19,1,1
14135118,Walter De Souza,1651,26/06/1996,20,0,0,0,0,175,73,3,2,1,1,2,1,2,2,1,3,4,7,11,12,12,11,10,4,10,7,5,13,4,6,11,8,8,6,8,11,11,14,10,8,5,11,9,11,14,12,12,6,9,20,14,12,8,10,8,10,8,6,6,10,9,12,11,10,10,3,12,2,AM RLC,1,1,1,20,15,15,1,1,1,1,1,1,1,1,1
1414561,Cassiano Bodini,1651,06/09/1983,32,0,0,0,0,171,67,2,2,2,1,2,3,1,2,1,4,1,6,7,12,9,12,6,6,7,7,6,10,6,3,11,8,12,11,10,11,9,10,16,13,8,14,7,10,11,12,14,9,4,10,11,12,20,10,9,11,6,12,16,10,5,15,13,2,16,8,10,1,AM/S R,1,1,16,1,1,20,1,1,1,1,1,1,1,1,1
141835,Arthuro,1651,27/08/1982,33,0,0,0,0,192,85,1,3,1,3,2,1,2,3,2,3,1,3,2,14,13,12,9,17,5,4,3,14,15,7,14,3,13,12,12,15,10,13,15,11,3,12,8,14,12,7,11,17,17,20,17,6,11,14,17,14,3,15,5,2,14,13,10,14,16,16,16,8,S ,1,1,20,10,1,1,1,1,1,1,1,1,1,1,1
141933,Juan,1651,06/02/1982,34,2,0,0,0,168,66,1,3,2,2,1,3,4,1,4,1,1,13,13,14,12,15,12,7,13,11,10,15,13,9,15,12,13,12,13,10,14,13,11,14,11,13,8,13,10,13,13,15,4,20,15,12,7,12,7,12,13,14,4,12,9,14,9,14,5,10,8,7,D/WB/M/AM LC,1,1,1,19,1,1,1,19,1,1,20,19,1,19,1
142332,Halisson,1651,28/06/1985,31,0,0,0,0,188,81,1,2,1,3,3,3,1,3,1,2,1,6,7,8,9,9,7,15,7,12,12,13,10,14,14,12,12,14,10,13,7,9,15,9,10,7,12,14,15,11,13,15,16,7,16,12,20,16,15,11,11,12,7,6,11,8,12,11,11,10,10,7,D C,1,1,1,1,1,1,20,1,1,1,1,1,1,1,1
142361,Júnior César,1651,09/04/1982,34,0,0,0,0,166,60,3,1,3,3,4,3,2,2,1,3,2,10,12,13,9,12,14,6,11,4,8,11,12,8,12,8,12,10,11,10,12,11,14,14,14,11,8,11,10,16,15,9,3,20,14,15,9,16,6,12,13,12,3,12,11,13,11,13,8,10,10,7,D/WB L,1,1,1,1,1,1,1,20,1,1,1,13,1,17,1
142362,Fernando Henrique,1651,25/11/1983,32,1,0,0,0,189,82,14,13,13,14,14,15,13,14,11,17,14,1,3,1,1,12,5,6,1,3,1,11,3,3,11,10,5,6,9,13,7,5,9,3,15,2,13,15,13,12,16,15,15,10,16,13,20,15,15,13,5,18,6,10,9,15,12,6,12,13,13,5,GK ,20,1,1,1,1,1,1,1,1,1,1,1,1,1,1
142363,Carlos Alberto,1651,11/12/1984,31,1,0,0,0,175,73,3,4,4,3,3,3,1,3,3,4,2,13,13,14,13,13,13,8,12,7,2,13,15,6,15,15,13,12,11,9,13,12,5,14,14,13,8,11,11,12,13,14,7,12,11,12,20,11,12,11,12,12,17,12,2,6,8,8,4,7,5,17,AM/S RLC,1,1,18,20,15,15,1,1,1,1,15,1,1,1,1
142364,Marcelo Macedo,1651,01/02/1983,33,0,0,0,0,177,72,1,2,2,2,1,1,2,2,1,3,1,7,8,11,10,10,6,11,8,4,5,8,12,7,11,13,11,9,10,11,9,8,14,12,12,11,5,11,8,11,11,11,7,10,15,11,20,11,8,11,13,10,11,9,7,12,11,12,9,13,14,11,S C,1,1,20,15,1,1,1,1,1,1,1,1,1,1,1
142365,Rodrigo Alvim,1651,25/11/1983,32,0,0,0,0,182,72,2,3,1,2,3,2,3,2,2,3,3,11,11,10,9,11,11,11,11,12,10,10,12,10,10,11,9,12,11,11,10,11,13,10,10,11,11,11,12,12,11,12,10,20,15,11,5,13,11,10,10,12,8,10,7,12,14,10,15,12,12,7,D L,1,2,1,1,1,1,10,20,1,1,1,1,1,15,1
14525,Adrianinho,1651,11/07/1980,35,0,0,0,0,176,69,2,3,1,2,2,2,1,1,3,4,2,14,12,13,12,12,15,6,12,4,4,13,15,4,13,10,9,14,13,11,14,14,11,11,5,13,11,13,10,11,13,8,7,20,14,10,7,11,6,13,7,12,13,1,8,11,13,11,10,11,14,10,M/AM LC,1,1,11,20,18,7,1,1,1,1,17,17,7,1,1
15052646,Igor Sao Jose,1651,16/11/1988,27,0,0,0,0,165,0,2,1,3,2,3,4,3,2,2,1,3,6,6,6,3,13,6,1,8,2,11,13,1,10,13,9,9,3,6,4,11,9,9,9,16,6,7,7,12,13,13,7,3,1,9,13,20,13,6,9,4,9,6,9,9,11,11,10,12,8,4,7,M C,1,1,1,1,1,1,1,1,1,1,20,1,1,1,1
150533,Adriano Louzada,1651,03/01/1979,37,0,0,0,0,181,73,1,1,1,3,1,2,2,1,3,1,3,4,8,9,11,10,11,14,11,4,4,9,14,5,10,11,13,12,11,10,9,10,11,12,10,12,6,9,11,12,10,12,9,11,14,12,20,12,12,14,9,14,9,7,11,9,15,13,8,8,11,12,S ,1,1,20,1,1,1,1,1,1,1,1,1,1,1,1
15054756,Gustavo Catarcione,1651,28/09/1984,31,0,0,0,0,182,0,1,3,1,2,3,2,3,2,1,4,2,4,4,12,13,12,6,13,7,2,3,6,6,2,11,6,11,5,11,6,6,12,8,11,4,12,7,6,7,13,11,5,5,8,12,12,20,10,8,9,8,5,4,9,17,11,10,10,11,7,13,4,S ,1,1,20,1,1,1,1,1,1,1,1,1,1,1,1
15065618,Walyson Pinheiro,1651,11/05/1997,19,0,0,0,0,171,0,2,4,4,2,3,1,1,1,4,1,2,2,2,4,1,6,1,5,4,4,6,3,4,8,5,7,6,7,5,9,3,4,4,4,5,3,6,5,5,13,13,4,1,12,14,13,20,7,3,6,7,7,7,7,20,10,12,12,9,5,9,1,D R,1,1,1,1,1,1,1,1,20,1,1,1,1,1,1
15075259,Adilson De Melo,1651,20/03/1981,35,0,0,0,0,185,0,2,2,1,2,1,3,2,2,2,2,3,9,11,14,10,13,12,11,12,3,5,11,10,5,12,8,8,8,13,9,9,9,12,14,11,6,11,7,2,8,4,13,13,20,12,6,11,4,12,9,4,12,13,8,5,11,8,10,12,12,6,14,M/AM/S LC,1,1,16,20,16,1,1,1,1,1,16,1,1,1,1
1507766,Fernando de Abreu,1651,03/10/1984,31,0,0,0,0,187,82,1,1,3,3,1,1,2,3,1,3,3,5,9,8,5,11,7,13,6,6,12,11,8,10,10,10,11,10,10,14,9,14,12,5,7,8,15,11,13,10,12,11,12,5,11,11,20,12,9,8,8,10,14,8,14,8,15,11,18,12,13,3,D C,1,10,1,1,1,1,20,1,1,5,1,1,1,1,1
15080067,Rurik Pereira,1651,22/04/1994,22,0,0,0,0,170,0,2,1,1,2,4,3,2,2,2,2,2,5,5,7,6,11,2,3,6,3,4,9,4,4,12,6,6,1,8,6,7,8,4,12,11,8,7,6,11,13,11,6,1,9,11,13,20,13,3,8,8,2,8,8,15,11,10,12,12,3,7,1,M/AM C,1,1,1,20,1,1,1,1,1,1,16,1,1,1,1
151208,Bruno Barbosa,1651,07/06/1981,35,0,0,0,0,185,75,1,1,2,3,2,2,1,3,2,2,2,6,3,3,1,6,2,13,2,1,13,7,1,13,5,6,9,9,4,7,5,12,9,2,10,3,13,6,7,10,11,7,13,20,15,8,10,4,8,9,6,7,6,9,19,12,13,14,13,1,14,5,D C,1,1,1,1,1,1,20,1,1,1,1,1,1,1,1
156820,Caihame,1651,11/02/1987,29,0,0,0,0,185,81,3,1,3,3,1,2,2,3,2,3,1,8,12,11,12,10,3,10,2,1,5,2,8,3,12,9,8,12,8,6,7,11,5,11,11,11,5,11,11,14,12,6,7,10,5,14,20,4,12,9,9,8,6,9,7,10,10,13,11,5,12,6,S R,1,1,20,1,10,15,1,1,1,1,1,1,1,1,1
16005140,Jailson,1651,11/10/1984,31,0,0,0,0,179,77,1,3,1,3,1,3,3,2,1,2,3,8,9,12,13,12,6,10,8,3,5,11,9,5,13,6,11,10,12,8,9,11,6,12,11,12,12,8,11,11,13,12,11,5,8,11,20,10,12,10,6,10,8,10,16,10,12,10,9,3,1,7,AM/S R,1,1,18,1,14,20,1,1,1,1,1,1,1,1,1
16018576,Denilson,1651,12/05/1989,27,0,0,0,0,178,68,2,2,2,3,3,1,1,4,3,2,3,7,7,8,6,14,7,7,7,1,9,11,1,14,13,9,10,8,8,9,9,10,6,5,10,9,8,8,12,12,13,6,7,10,11,14,20,7,6,9,9,9,9,9,19,12,12,9,13,8,2,2,M C,1,1,1,12,1,1,1,1,1,15,20,1,1,1,1
16047583,Jonathan,1651,15/09/1991,24,0,0,0,0,174,69,3,2,2,2,1,3,2,2,2,1,2,6,9,11,11,10,8,6,8,8,6,11,13,6,11,8,11,9,10,11,11,9,6,7,8,12,8,10,11,14,13,13,7,20,12,13,15,12,7,10,8,9,10,10,13,10,12,10,13,7,13,6,S ,1,1,20,1,13,13,1,1,1,1,1,1,1,1,1
16063849,Danilo Soares,1651,29/10/1991,24,0,0,0,0,170,72,1,1,3,1,2,2,1,2,1,1,1,10,15,12,7,13,7,10,8,13,10,12,8,12,14,15,13,10,13,10,12,12,13,13,8,14,9,12,16,15,16,10,7,20,12,13,8,14,7,15,14,14,9,9,13,15,10,11,11,8,10,10,D/WB L,1,1,1,1,15,1,1,20,1,1,1,15,1,20,1
16097159,André Ramalho,1651,16/02/1992,24,0,0,0,0,182,75,3,3,2,2,2,3,3,3,3,3,1,6,9,11,7,12,10,14,9,10,15,12,8,17,13,14,16,16,14,10,10,11,12,9,9,8,14,13,12,9,11,14,13,10,16,11,20,15,13,12,12,13,4,12,13,16,9,16,14,13,8,8,D/DM/M C,1,1,1,1,1,1,20,12,1,17,17,1,1,8,1
16101870,Carlos Eduardo,1651,15/01/1992,24,0,0,0,0,185,74,3,2,1,3,2,3,1,1,2,3,2,4,5,12,4,11,3,12,5,7,10,11,4,13,13,4,8,12,11,9,6,8,9,6,2,7,13,8,10,11,11,12,11,20,10,12,5,12,11,8,5,5,9,8,10,13,12,13,12,7,14,8,D C,1,1,1,1,1,1,20,1,1,5,1,1,1,1,1
16132844,Rafinha,1651,18/02/1993,23,0,0,0,0,182,0,3,2,2,3,2,1,1,3,2,2,2,8,11,12,5,11,6,8,6,6,11,11,8,11,12,9,11,11,8,9,10,8,6,7,9,13,10,9,11,12,12,10,11,20,11,12,5,11,9,7,9,4,6,9,10,14,9,11,11,1,5,6,D/WB/M RL,1,1,1,1,14,1,1,20,16,1,1,16,1,18,1
16162056,Luis Filipe Couto da Silva,1651,15/09/1992,23,0,0,0,0,187,0,2,2,4,2,3,1,1,1,3,2,3,5,4,10,9,12,5,6,6,4,4,10,7,5,11,8,5,3,12,5,10,8,3,12,1,6,6,5,7,13,13,6,8,5,11,12,20,8,9,8,8,6,8,8,19,10,13,11,12,6,7,5,AM C,1,1,13,20,1,1,1,1,1,1,1,1,1,1,1
16162880,Venuto,1651,14/01/1995,21,0,0,0,0,164,63,2,4,1,2,2,3,2,3,2,2,2,11,12,12,9,12,11,4,10,5,4,11,12,5,12,9,12,8,10,9,10,9,8,11,7,13,9,10,12,16,14,10,4,10,11,16,20,11,10,11,11,9,10,11,13,13,11,9,10,1,14,5,AM RC,1,1,14,20,10,18,1,1,1,1,1,1,1,1,1
16162881,Felipe Pires,1651,18/04/1995,21,0,0,0,0,178,68,3,3,3,2,3,4,1,4,1,1,3,9,10,13,12,12,10,7,11,6,5,10,14,6,12,15,11,10,8,10,10,8,14,14,6,13,8,12,15,16,14,12,9,8,14,15,20,13,8,11,5,11,5,15,12,16,8,10,13,8,10,10,M/AM RL,1,1,14,12,20,18,1,1,1,1,8,20,18,1,1
16183023,Bruno,1651,26/05/1994,22,0,0,0,0,179,72,3,1,3,2,3,3,2,2,3,2,2,4,7,12,13,13,6,8,8,6,6,8,5,2,11,9,8,8,11,8,6,6,9,11,8,8,6,7,8,14,13,8,6,20,12,15,10,11,7,9,9,9,9,9,17,12,13,10,8,3,14,4,AM/S L,1,1,17,10,20,13,1,1,1,1,1,13,13,1,1
16190703,Victor Alves,1651,02/01/1994,22,0,0,0,0,160,0,1,1,1,3,2,3,2,3,1,2,2,3,5,9,9,13,2,1,11,2,5,13,5,6,13,8,4,5,7,6,9,12,8,13,5,8,1,6,9,13,11,2,1,9,11,13,20,6,3,8,8,8,8,8,15,11,13,11,11,9,5,1,AM C,1,1,1,20,1,1,1,1,1,1,1,1,1,1,1
16199713,Igor,1651,07/02/1998,18,0,0,0,0,190,80,3,3,2,3,2,3,1,2,3,2,1,7,5,2,7,4,2,12,3,7,12,8,5,13,7,10,13,10,7,7,6,13,17,1,9,7,8,7,3,13,11,8,15,9,17,12,20,5,10,8,10,10,6,10,14,11,11,10,12,1,17,5,D C,1,1,1,1,1,1,20,1,1,1,1,1,1,1,1
16228804,Lucas Xavier,1651,20/02/1998,18,0,0,0,0,172,68,1,2,2,2,3,3,1,2,2,1,1,7,6,7,5,13,4,10,5,9,11,10,6,13,11,9,7,10,8,7,10,14,9,8,10,7,8,10,10,7,13,6,8,8,10,10,20,7,8,9,9,9,9,9,9,10,11,10,12,4,2,8,D R,1,1,1,1,1,1,1,1,20,1,1,1,1,1,13
16232467,Victor Jatobá,1651,17/12/1997,18,0,0,0,0,189,79,1,2,3,3,3,3,1,1,3,2,2,4,7,3,5,9,5,13,3,4,9,9,5,15,8,6,7,8,9,11,6,15,3,1,10,7,9,7,9,9,12,8,12,1,15,10,20,7,10,8,8,8,8,8,14,11,10,10,10,8,6,2,D/DM C,1,1,1,1,1,1,20,1,1,17,1,1,1,1,1
17002078,Vagner,1651,01/06/1987,29,0,0,0,0,186,86,2,2,3,2,2,3,4,3,2,1,2,9,10,14,8,9,10,9,10,11,7,9,13,7,14,11,8,12,8,10,6,7,9,11,11,10,9,7,10,12,9,12,12,20,17,11,8,10,12,9,4,2,6,8,11,8,10,9,7,11,18,6,M/AM RLC,1,1,13,20,20,15,1,1,1,1,1,16,10,10,1
1700588,Gilberto,1651,01/04/1984,32,0,0,0,0,173,71,3,3,2,4,2,1,3,2,2,4,3,8,10,13,12,14,7,8,8,5,5,12,8,5,14,13,14,11,13,11,11,13,11,15,6,14,5,10,14,15,15,11,8,10,12,14,20,9,11,12,2,10,3,10,14,12,13,13,13,14,14,7,S LC,1,1,20,15,15,14,1,1,1,1,1,1,1,1,1
17012710,Leo,1651,09/06/1992,24,0,0,0,0,186,77,4,3,3,2,1,3,2,1,1,2,3,9,10,12,10,14,10,8,7,11,7,11,14,7,12,12,7,9,8,8,7,7,1,13,11,8,7,9,9,10,12,9,11,8,8,11,20,11,10,11,4,12,9,8,10,10,10,10,10,12,9,5,AM/S RLC,1,1,17,15,17,20,1,1,1,1,10,10,13,1,1
17013678,Lucas Sotero,1651,21/05/1991,25,0,0,0,0,179,73,1,2,3,3,3,1,1,3,2,3,3,10,10,14,9,12,10,7,11,8,7,12,5,7,12,12,8,9,8,8,8,8,2,10,11,8,7,11,12,13,14,8,7,20,14,13,9,12,8,10,9,10,8,10,16,11,10,13,14,4,5,1,M/AM RLC,1,1,10,20,19,18,1,1,1,1,11,17,15,1,1
1800324,Monga,1651,25/09/1983,32,0,0,0,0,190,91,2,2,2,1,1,3,3,3,1,1,2,9,10,8,8,14,9,12,8,7,4,9,6,5,9,11,10,9,16,8,10,7,11,8,7,10,8,7,10,8,5,12,15,20,9,7,12,9,14,9,13,8,9,6,16,12,14,12,13,7,14,3,S ,1,1,20,1,1,1,1,1,1,1,1,1,1,1,1
18017495,Daniel,1651,14/09/1985,30,0,0,0,0,180,76,3,3,1,3,3,1,2,2,1,3,3,14,10,12,12,12,9,8,9,8,5,10,14,8,12,7,12,14,13,10,5,12,14,14,8,13,6,10,10,13,12,11,12,10,8,13,20,11,11,14,5,10,13,12,11,12,10,11,12,8,11,1,S ,1,1,20,1,1,1,1,1,1,1,1,1,1,1,1
18017686,Leandrinho,1651,06/06/1986,30,0,0,0,0,180,76,3,3,2,3,1,3,1,2,3,1,2,12,12,15,12,15,14,10,10,3,2,12,13,5,15,7,12,8,13,10,13,15,11,14,8,14,8,11,7,13,14,9,7,16,11,13,20,8,10,13,5,15,11,12,15,10,10,10,12,15,10,5,AM RLC,1,1,14,16,17,20,1,1,1,1,1,8,8,1,1
18032150,Edmilson Junior,1651,19/08/1994,21,0,0,0,0,183,71,1,2,1,1,4,2,1,2,1,3,3,8,10,13,10,14,11,6,12,7,5,11,4,5,14,15,9,15,12,8,12,9,11,14,10,12,6,11,12,14,14,8,10,14,9,14,20,12,9,10,10,13,10,11,12,18,11,10,7,8,9,9,M/AM RL,1,1,14,14,18,20,1,1,1,1,12,18,17,1,1
18045296,Liliu,1651,30/03/1990,26,0,0,0,0,180,75,3,2,2,3,2,1,3,1,3,3,3,10,10,12,7,13,9,10,8,7,7,9,6,4,11,12,11,14,9,9,7,9,12,9,11,11,4,9,9,14,14,6,11,7,8,14,20,6,6,13,4,10,15,10,10,8,10,8,11,11,5,6,M/AM/S R,1,1,16,14,14,19,1,1,1,1,1,14,20,1,1
18045992,Jean Acosta,1651,27/01/1992,24,0,0,0,0,173,72,2,2,3,3,2,1,2,1,2,3,1,9,9,14,10,14,8,11,11,4,5,14,5,5,14,10,8,10,12,10,16,10,1,11,5,5,5,10,10,13,8,6,10,7,6,14,20,10,6,11,9,6,8,9,18,13,12,11,10,12,7,1,AM RC,1,1,1,20,1,15,1,1,1,1,15,1,15,1,1
18046334,Fernando Canesin Matos,1651,27/02/1992,24,0,0,0,0,176,68,1,2,2,2,2,2,1,2,2,4,3,13,13,16,7,14,10,5,10,5,5,14,9,5,15,7,8,16,14,14,14,8,14,12,5,13,8,11,14,15,11,9,7,10,5,14,20,10,9,14,3,12,3,11,10,14,9,14,12,11,5,5,AM/S RC,1,1,18,19,13,20,1,1,1,1,14,13,13,1,1
18073840,Wanderson,1651,07/10/1994,21,0,0,0,0,175,66,1,3,3,4,3,2,1,1,1,4,2,11,9,15,9,13,12,3,11,11,5,9,7,11,15,9,11,9,11,11,9,11,7,14,1,13,5,11,9,17,15,9,8,20,14,15,12,13,7,11,8,11,8,11,11,15,12,12,8,5,4,1,M/AM RL,1,1,8,1,18,20,1,1,1,1,1,18,15,1,1
18080565,Berg,1651,14/09/1992,23,0,0,0,0,174,67,2,1,2,3,2,2,2,1,2,4,1,9,9,12,12,12,9,5,6,2,5,10,9,11,12,9,9,13,10,11,5,13,4,9,13,12,7,7,10,13,12,12,7,7,15,14,20,5,5,10,7,5,9,9,7,11,11,7,8,2,1,4,M C,1,1,14,14,1,1,1,1,1,14,20,1,1,1,1
18085775,Wigor,1651,07/01/1995,21,0,0,0,0,182,80,2,2,3,4,3,1,1,1,1,1,3,11,8,9,12,13,9,11,11,3,13,8,9,13,8,12,12,13,11,12,8,12,9,9,9,9,13,12,13,13,11,14,8,7,12,12,20,14,14,10,11,10,7,10,14,9,11,11,13,5,11,8,DM ,1,1,1,1,1,1,1,1,1,20,1,1,1,1,1
18093398,Pedro Ferrari,1651,03/11/1994,21,0,0,0,0,179,0,3,2,2,2,2,3,1,1,3,3,2,8,4,11,15,11,8,5,9,1,8,9,11,6,12,4,12,7,11,7,7,13,12,9,8,10,9,8,9,13,11,9,5,5,12,13,20,7,11,9,9,9,9,9,18,11,10,12,8,11,7,2,S ,1,1,20,1,1,1,1,1,1,1,1,1,1,1,1
18096960,Ivan Paulino Rosario,1651,05/04/1998,18,0,0,0,0,179,0,1,3,2,1,2,2,1,3,4,2,1,5,4,7,13,11,6,13,5,2,3,7,9,1,9,9,7,7,12,7,3,9,6,9,1,13,5,6,7,13,12,3,9,8,13,13,20,7,7,9,9,9,7,9,7,11,9,11,12,10,3,6,S ,1,1,20,1,1,1,1,1,1,1,1,1,1,1,1
18096961,Gerson Santos Correia,1651,09/01/1999,17,0,0,0,0,187,0,1,2,2,1,1,2,3,4,3,3,3,6,3,13,13,11,6,13,7,1,6,5,10,1,11,9,11,5,11,2,5,4,4,11,11,11,4,6,7,12,8,7,10,8,11,10,20,9,8,9,9,9,9,8,12,10,13,11,10,8,3,5,S ,1,1,20,1,1,1,1,1,1,1,1,1,1,1,1
18100727,Matheus,1651,08/02/1999,17,0,0,0,0,163,59,2,3,3,1,2,3,3,1,2,3,3,8,12,13,7,13,7,5,7,7,7,12,5,8,12,9,12,16,10,8,7,10,11,14,7,12,8,7,7,14,11,4,4,20,10,14,6,6,4,8,4,9,9,9,16,7,11,9,8,2,10,10,AM RLC,1,1,15,20,18,16,1,1,1,1,1,1,1,1,1
19000030,Renan Ribeiro,1651,23/03/1990,26,0,0,8,0,193,87,12,12,12,7,13,11,14,15,12,9,11,4,1,2,1,11,8,8,2,2,1,10,3,1,13,8,11,11,12,11,10,12,11,1,11,3,13,12,12,13,14,13,17,8,14,13,20,11,12,10,9,11,11,11,6,16,11,13,15,14,18,8,GK ,20,1,1,1,1,1,1,1,1,1,1,1,1,1,1
19000033,Wendel,1651,31/08/1991,24,0,0,0,0,184,77,4,4,3,1,3,1,3,3,3,1,2,11,10,13,11,12,10,7,12,6,5,11,11,6,13,11,12,10,10,12,12,12,14,14,9,12,5,13,12,14,11,9,10,8,12,14,20,13,8,11,10,10,13,13,8,13,12,13,12,8,12,6,M/AM/S C,1,1,20,18,1,1,1,1,1,1,17,1,1,1,1
19000062,Kasado,1651,17/02/1989,27,0,0,0,0,188,75,4,1,2,3,1,2,1,1,3,3,1,1,8,8,6,9,10,12,11,11,12,9,5,12,8,13,10,13,9,10,8,10,11,9,14,11,11,13,11,11,11,15,12,7,14,11,20,14,13,11,13,9,7,10,10,11,8,10,10,9,11,11,DM/M C,1,1,1,1,1,1,1,1,1,20,18,1,1,1,1
19000064,Vinícius,1651,02/02/1990,26,0,0,0,0,190,74,1,1,3,1,1,3,2,2,1,1,2,7,5,4,5,9,8,9,3,8,9,8,3,8,5,13,9,9,7,8,11,15,8,6,4,5,11,12,12,8,8,11,13,10,13,9,20,11,12,9,13,4,8,9,12,13,10,10,10,11,13,8,D C,1,1,1,1,1,1,20,1,1,1,1,1,1,1,1
19000072,Marcinho,1651,08/06/1987,29,0,0,0,0,168,70,2,1,2,3,4,2,1,2,1,2,1,6,6,9,5,10,7,7,6,4,14,11,3,13,9,14,11,15,11,12,8,10,12,7,11,5,10,12,13,10,12,7,2,12,14,13,20,13,7,12,15,9,9,9,14,12,13,14,12,6,17,5,DM/M C,1,1,1,1,1,1,1,1,1,20,16,1,1,1,1
19000073,Thiago Silvy,1651,12/06/1986,30,0,0,0,0,175,69,1,2,2,2,3,4,3,4,3,2,3,8,10,11,12,11,4,8,9,4,3,11,10,4,12,13,12,12,11,12,11,12,13,10,2,14,8,12,11,13,13,9,7,8,15,13,20,12,8,12,4,10,5,12,14,11,6,8,11,11,11,13,S ,1,1,20,10,12,12,1,1,5,1,1,1,11,1,13
19000145,Fabiano,1651,19/09/1977,38,0,0,0,0,186,86,11,12,13,6,13,12,13,12,11,14,14,3,2,2,1,1,5,1,3,3,3,5,2,1,6,10,11,11,12,12,4,11,12,2,17,6,11,8,10,9,12,12,13,3,12,11,20,12,13,13,6,12,7,10,11,11,11,12,15,14,14,10,GK ,20,1,1,1,1,1,1,1,1,1,1,1,1,1,1
19000197,Anderson Paim,1651,07/11/1982,33,0,0,0,0,168,68,3,3,1,1,2,1,1,1,1,2,1,12,12,11,8,9,14,5,10,10,10,9,13,8,11,14,7,11,10,8,10,10,14,10,6,10,6,10,10,14,11,8,4,20,10,14,7,11,9,12,5,12,6,5,12,12,10,13,11,11,14,11,D/WB L,1,1,1,1,6,1,1,18,1,1,1,12,1,20,1
19000199,Bruninho,1651,01/04/1986,30,0,0,0,0,171,75,4,3,3,3,2,1,3,3,2,1,1,12,8,6,7,10,6,6,7,4,8,7,1,11,12,9,6,8,8,7,8,9,6,12,8,8,7,7,8,13,13,13,4,20,16,13,10,13,5,9,5,9,7,9,7,11,11,10,11,4,15,7,D/WB/DM/M/AM LC,1,1,1,20,18,1,1,19,1,17,18,14,1,16,1
19000283,Márcio Carioca,1651,02/05/1983,33,0,0,0,0,179,78,1,3,2,2,3,1,2,2,2,1,2,6,7,8,11,9,8,10,11,2,4,8,14,4,9,8,10,12,10,6,7,9,11,13,12,11,8,9,10,12,9,11,8,12,13,11,20,12,12,9,9,5,9,9,13,12,10,9,11,2,8,7,S ,1,1,20,1,1,1,1,1,1,1,1,1,1,1,1
19000289,Bruno Meneghel,1651,03/06/1987,29,0,0,0,0,170,64,1,1,2,3,2,2,3,2,1,3,2,10,12,13,12,13,10,10,12,2,4,12,16,6,13,10,12,11,12,10,11,12,13,14,3,13,8,10,13,14,15,12,6,9,13,14,20,12,10,13,7,12,9,12,11,13,11,12,13,7,14,10,S ,1,1,20,10,12,13,1,1,1,1,3,5,6,1,1
19000410,Bruno Martins,1651,21/07/1986,29,0,0,0,0,178,72,2,3,1,3,2,1,1,2,1,2,1,9,12,10,10,10,13,12,12,10,12,11,7,10,10,13,10,11,9,11,9,11,12,10,13,11,12,11,12,11,12,12,10,5,10,11,20,12,10,12,14,10,9,10,10,12,9,11,12,10,12,6,DM/M C,1,1,1,1,1,1,1,1,13,20,17,1,14,1,13
19000472,Douglas Marques,1651,18/05/1985,31,0,0,0,0,185,74,4,2,3,2,3,1,1,3,3,3,4,5,5,6,5,7,6,13,5,6,12,7,6,13,7,12,11,12,10,12,10,10,12,12,13,6,12,13,13,12,12,11,14,10,13,13,20,12,14,10,14,11,8,5,12,13,12,11,13,13,12,8,D C,1,1,1,1,1,1,20,1,1,1,1,1,1,1,1
19000542,Anderson,1651,10/01/1988,28,0,0,0,0,188,80,3,3,3,1,1,3,1,1,1,3,1,3,8,10,6,11,5,15,4,8,13,11,6,13,12,14,12,15,13,11,9,13,12,6,10,8,12,10,14,12,10,13,16,10,13,14,20,12,15,13,7,12,16,10,14,15,7,12,11,9,10,8,D C,1,1,1,1,1,1,20,1,10,12,11,1,1,1,8
19000582,William Amendoim,1651,06/05/1987,29,0,0,0,0,170,58,4,2,2,1,3,2,3,3,2,1,3,6,5,13,8,13,5,5,10,5,7,13,3,13,12,9,11,3,8,3,11,13,14,11,5,10,6,7,12,11,11,7,4,20,11,13,8,9,8,9,9,1,9,9,18,11,11,12,11,6,1,3,M C,1,1,1,15,1,1,1,1,1,13,20,1,1,1,1
19000626,Kayke,1651,01/04/1988,28,0,0,0,0,182,78,2,2,2,1,1,3,3,1,3,3,2,13,13,14,14,13,14,12,10,6,7,12,15,7,14,7,13,12,14,13,11,14,9,16,7,14,7,12,14,13,13,13,11,9,12,14,20,13,13,14,8,13,10,9,6,13,14,8,9,12,11,10,S ,1,1,20,1,13,14,1,1,1,1,1,1,14,1,1
19000641,Marabá,1651,07/08/1986,29,0,0,0,0,178,75,1,3,1,1,3,1,3,2,2,2,2,6,10,8,8,7,7,11,14,6,14,8,7,12,8,10,8,14,7,11,7,9,10,10,1,7,10,10,12,13,12,15,13,8,14,13,20,15,14,12,17,10,6,10,10,12,10,9,10,6,9,6,DM/M C,1,1,1,1,1,1,1,1,1,20,18,1,1,1,1
19000686,Dudu,1651,29/11/1986,29,0,0,0,0,182,82,13,13,12,2,9,11,7,13,3,9,9,1,2,3,1,3,4,1,3,3,1,2,2,3,2,6,9,8,7,12,6,13,4,1,9,1,10,7,3,11,14,7,8,9,14,12,20,4,8,9,9,9,9,9,10,11,11,11,9,10,3,7,GK ,20,1,1,1,1,1,1,1,1,1,1,1,1,1,1
19000695,Tiago,1651,22/09/1987,28,0,0,0,0,170,72,1,3,2,2,1,1,1,3,3,2,1,3,10,8,4,12,1,6,5,1,9,4,5,13,7,2,11,8,9,6,6,8,4,7,13,8,9,8,9,10,14,8,5,20,6,14,9,14,6,9,8,7,9,9,12,7,10,10,13,6,7,7,D/WB L,1,1,1,1,10,1,1,18,1,1,1,12,1,20,1
19000707,Fernando Oliveira,1651,11/05/1984,32,0,0,0,0,183,81,2,3,3,2,1,1,1,1,1,1,3,9,11,12,11,11,9,14,11,12,5,12,12,5,11,14,12,12,12,12,11,9,8,7,9,12,9,10,10,12,8,13,13,15,5,12,20,11,14,9,14,9,13,5,8,12,11,11,8,10,13,1,S ,1,1,20,1,1,1,1,1,1,1,1,1,1,1,1
19000735,Giliardi,1651,06/10/1983,32,0,0,0,0,175,72,2,1,3,4,3,1,3,3,3,2,2,8,8,13,14,15,8,10,10,7,8,9,3,5,15,9,9,9,8,8,12,15,3,13,6,11,10,9,10,7,8,9,6,8,10,8,20,8,9,9,9,9,9,9,14,10,13,11,12,8,10,8,M/AM/S C,1,1,18,20,1,1,1,1,1,1,18,1,1,1,1
19000762,Elicarlos,1651,08/06/1985,31,0,0,0,0,176,73,2,1,3,1,3,3,2,1,1,2,3,8,10,11,11,11,10,11,10,7,14,9,9,12,11,13,13,16,11,11,9,12,12,10,8,12,13,16,15,11,15,15,8,10,16,12,20,16,9,11,13,12,6,14,12,16,13,11,13,12,14,10,DM/M RC,1,1,1,5,1,8,7,1,11,20,15,1,16,1,15
19000770,Sueliton,1651,19/08/1986,29,0,0,0,0,177,67,3,3,2,2,1,3,4,1,2,3,3,12,12,12,11,12,10,9,10,12,10,12,11,10,12,12,13,12,12,12,12,12,10,14,9,12,11,13,12,14,13,10,8,20,12,14,9,13,9,11,13,11,13,12,5,12,14,7,9,7,1,3,D/WB R,1,1,1,1,1,1,1,14,18,1,1,1,1,14,20
19000781,Joelson,1651,29/05/1988,28,0,0,0,0,172,68,1,2,2,2,2,2,1,1,2,2,2,13,9,13,10,11,12,8,9,2,5,10,13,6,13,11,9,11,10,8,11,10,12,13,7,13,9,10,10,16,17,6,7,7,13,16,20,11,5,12,5,11,10,12,10,12,10,10,15,10,15,10,S ,1,1,20,10,11,13,1,1,1,1,1,1,1,1,1
19001035,Dalton,1651,08/09/1986,29,0,0,0,0,198,0,11,12,9,10,12,11,12,11,6,10,8,7,1,1,1,7,10,1,1,1,1,1,1,3,4,10,11,13,7,11,12,13,13,3,4,3,11,11,12,11,11,8,17,10,10,12,20,5,14,12,5,13,9,10,20,11,12,12,9,6,8,2,GK ,20,1,1,1,1,1,1,1,1,1,1,1,1,1,1
19001041,Ari,1651,18/04/1986,30,0,0,0,0,188,77,13,11,7,5,11,13,10,13,10,10,9,1,2,1,3,2,6,1,1,2,2,1,5,2,2,4,9,13,8,6,7,13,13,3,11,1,9,8,7,12,16,8,16,8,15,12,20,2,8,12,6,8,10,10,8,11,15,13,9,12,13,8,GK ,20,1,1,1,1,1,1,1,1,1,1,1,1,1,1
19001171,Thyago Fernandes,1651,05/12/1985,30,0,0,0,0,175,67,3,4,1,1,3,3,2,1,3,1,2,8,13,13,10,11,6,6,11,11,10,12,12,10,13,10,9,11,8,8,10,9,12,10,14,9,9,9,10,14,13,8,6,20,14,14,7,10,6,10,6,2,5,10,10,11,11,10,12,13,14,11,D/WB L,1,1,1,1,6,1,1,20,1,1,1,12,1,18,1
19001302,Jonathas,1651,10/04/1985,31,0,0,0,0,188,82,2,2,2,3,3,1,4,1,1,2,1,8,8,8,6,10,8,12,8,8,10,9,8,9,10,10,9,9,8,7,6,7,7,8,9,8,10,9,8,12,11,13,14,20,15,12,5,12,14,10,9,10,8,11,9,11,11,11,13,11,12,4,D LC,1,10,1,1,1,1,20,17,1,1,1,1,1,7,1
19001337,Élson Júnior,1651,14/07/1986,29,0,0,0,0,182,70,2,2,1,3,3,1,1,4,2,3,2,5,7,8,2,8,2,10,5,6,10,10,3,14,9,3,9,10,8,12,4,14,8,4,8,8,8,9,7,14,14,9,10,10,8,14,20,9,14,10,6,4,8,10,10,11,14,8,8,3,5,3,D RC,1,1,1,1,1,1,20,1,19,1,1,1,1,1,15
19001353,Pirão,1651,31/12/1985,30,0,0,0,0,185,71,1,1,3,3,3,2,2,3,3,1,1,8,11,10,7,10,5,10,9,7,13,11,2,11,10,13,11,12,10,11,12,10,12,9,10,10,11,14,10,11,11,12,10,20,12,11,9,12,11,12,12,11,9,14,17,13,15,13,8,6,12,8,D/DM/M LC,1,1,1,10,11,1,1,19,1,18,20,13,1,15,1
19001406,Tiago Amaral,1651,06/02/1985,31,0,0,0,0,178,84,1,1,3,2,4,1,3,1,4,1,3,3,3,13,13,13,7,13,8,2,7,7,9,4,13,10,13,8,12,8,7,13,6,13,11,10,8,7,8,13,11,4,8,10,12,12,20,7,12,10,10,10,6,10,7,9,12,11,11,5,11,4,S ,1,1,20,1,1,1,1,1,1,1,1,1,1,1,1
19001654,Márcio Gabriel,1651,18/08/1982,33,0,0,0,0,169,63,1,4,2,2,1,2,1,1,4,1,4,7,6,9,7,9,8,5,8,7,7,9,3,8,11,12,9,11,9,10,9,10,13,13,10,14,9,11,10,13,12,6,5,9,12,11,20,12,6,12,8,11,12,9,14,10,11,12,11,1,5,5,D/WB R,1,1,1,1,1,1,1,1,17,1,1,1,1,1,20
19001667,Adriano Junio,1651,21/01/1986,30,0,0,0,0,172,0,2,4,1,2,1,3,4,1,4,3,3,7,7,8,1,11,2,7,5,6,9,9,3,12,6,9,9,8,8,7,6,13,9,6,13,8,8,8,9,14,14,8,7,20,11,14,10,13,7,9,9,5,5,9,7,12,12,12,11,3,12,7,WB L,1,1,1,1,1,1,1,15,1,1,1,1,1,20,1
19001668,Bruno Fuso,1651,30/01/1988,28,0,0,0,0,194,83,15,15,8,7,15,15,12,15,9,7,11,6,2,3,1,3,9,1,2,2,1,4,4,2,5,6,10,15,10,10,9,9,11,3,11,2,13,10,9,12,12,13,15,1,14,15,20,9,13,10,10,10,10,10,11,10,11,10,11,9,11,1,GK ,20,1,1,1,1,1,1,1,1,1,1,1,1,1,1
19001674,Hendrich,1651,07/05/1986,30,0,0,0,0,174,69,3,2,1,2,2,2,1,1,3,1,3,9,9,13,10,12,9,7,15,5,6,13,4,8,13,10,9,6,10,8,14,10,3,10,9,11,11,10,12,13,14,9,6,2,10,13,20,12,8,10,7,10,10,10,7,10,11,11,9,1,16,5,AM C,1,1,1,20,1,1,1,1,1,13,15,1,1,1,1
19001679,Max,1651,07/08/1987,28,0,0,0,0,188,86,2,2,3,1,4,3,1,3,3,1,1,9,6,5,9,9,7,15,8,3,14,9,6,15,4,10,10,11,10,12,6,9,10,1,7,8,10,9,10,15,11,10,14,20,13,11,11,12,13,11,8,7,8,10,19,10,14,12,12,6,11,6,D C,1,1,1,1,1,1,20,1,1,1,1,1,1,1,1
19001680,Nícolas,1651,12/04/1988,28,0,0,0,0,190,85,14,13,10,4,14,11,13,14,13,9,11,8,1,2,1,7,11,5,3,3,3,7,2,2,7,12,11,12,12,11,4,12,13,6,12,4,13,10,12,11,14,12,14,8,13,11,20,10,12,15,4,13,3,11,13,11,14,11,14,15,14,8,GK ,20,1,1,1,1,1,1,1,1,1,1,1,1,1,1
19001681,Paulo Henrique,1651,13/03/1989,27,0,0,0,0,181,88,3,1,2,3,3,3,2,2,2,3,2,9,11,13,12,13,8,12,8,6,6,9,13,6,13,11,11,13,12,9,10,10,12,14,6,11,7,10,13,13,13,13,13,12,6,13,20,7,14,11,11,10,12,8,14,15,12,7,8,13,13,6,AM/S RL,1,1,20,7,16,15,1,1,1,1,1,7,1,1,1
19001682,Paulinho,1651,10/02/1988,28,0,0,0,0,181,77,1,2,2,1,1,2,3,1,1,3,2,6,6,3,7,9,6,6,5,4,9,12,4,13,7,9,10,8,8,8,5,10,4,4,12,7,11,7,11,13,12,9,10,9,9,12,20,13,7,6,9,4,8,9,13,9,11,13,13,3,8,3,DM C,1,1,1,1,1,1,12,1,1,20,15,1,1,1,1
19001685,Raphael Aguiar,1651,12/02/1988,28,0,0,0,0,179,74,2,1,2,2,2,2,1,2,1,3,1,9,7,9,7,11,8,7,9,6,8,10,9,9,11,11,9,11,6,10,11,10,16,13,11,11,7,11,10,10,10,10,6,16,12,13,20,11,10,13,6,11,11,13,7,13,14,15,14,13,12,11,AM/S C,1,1,20,18,1,1,1,1,1,1,15,1,1,1,1
19001686,Rodrigo Vítor,1651,03/02/1988,28,0,0,0,0,183,76,2,3,1,1,1,2,2,1,1,1,1,4,4,2,7,10,4,8,3,5,10,12,3,13,8,9,9,8,4,7,8,13,6,4,14,6,13,7,11,13,13,7,11,10,14,13,20,6,8,8,7,9,7,9,17,8,12,13,12,3,2,1,DM C,1,1,1,1,1,1,15,1,8,20,7,1,1,1,6
19001690,Sheslon,1651,04/01/1987,29,0,0,0,0,186,77,3,3,2,2,1,3,2,2,3,1,3,11,11,11,8,10,7,10,10,5,10,10,8,9,12,13,11,11,11,11,10,12,15,12,10,10,9,11,13,11,11,11,14,9,13,13,20,11,10,17,11,12,7,10,19,13,15,13,13,12,12,11,D/WB RC,1,1,1,1,1,1,17,1,18,1,1,1,1,1,20
19001692,Welton Felipe,1651,15/06/1986,30,0,0,0,0,194,90,2,3,1,3,2,2,2,3,3,2,2,1,2,4,5,5,3,13,5,5,11,7,8,12,6,15,11,13,11,10,5,10,13,8,11,7,10,13,11,11,5,14,16,7,14,9,20,12,15,12,14,13,5,6,13,14,12,12,13,8,12,8,D C,1,11,1,1,1,1,20,1,1,1,1,1,1,1,1
19001693,Werley,1651,05/09/1988,27,0,0,0,0,184,81,1,3,1,1,3,1,1,4,3,1,2,7,8,10,9,9,9,12,7,8,12,10,8,13,10,13,12,13,12,13,9,13,12,9,12,10,12,12,13,13,12,11,12,8,13,12,20,14,15,11,14,10,6,8,7,11,13,12,12,8,10,10,D C,1,1,1,1,1,1,20,1,1,1,1,1,1,1,1
19001694,Zotti,1651,23/05/1985,31,0,0,0,0,186,80,3,1,2,2,1,3,1,2,2,2,4,8,6,10,6,13,8,6,8,6,11,15,2,13,9,8,8,9,10,10,10,8,9,8,5,9,15,10,13,15,10,9,11,6,14,11,20,9,10,9,6,4,5,9,10,11,9,12,11,1,17,7,DM C,1,1,1,15,1,1,1,1,1,20,12,1,1,1,1
19001770,Sílvio,1651,11/10/1988,27,0,0,0,0,197,83,12,11,11,1,9,10,11,11,13,14,10,1,2,3,2,4,5,7,3,1,2,5,3,2,4,8,10,10,10,11,9,11,7,9,6,6,11,12,12,8,10,6,17,5,13,8,20,13,14,11,5,10,9,9,7,13,11,9,12,1,1,4,GK ,20,1,1,1,1,1,1,1,1,1,1,1,1,1,1
19001913,Fábio Fidélis,1651,16/04/1986,30,0,0,0,0,180,79,1,1,1,3,3,3,3,2,2,3,3,6,4,2,6,8,2,13,6,7,13,8,2,12,7,5,13,10,6,10,3,10,12,3,12,7,13,7,8,13,13,8,9,10,15,12,20,11,12,10,10,5,10,10,13,12,12,11,9,4,4,1,D C,1,1,1,1,1,1,20,1,1,8,2,1,1,1,1
19001918,João Paulo,1651,01/07/1986,30,0,0,0,0,173,71,3,1,2,3,2,3,1,1,3,3,1,12,12,12,11,13,11,11,12,12,10,13,12,10,13,11,13,12,12,10,11,12,13,12,11,11,13,13,12,14,14,9,6,20,12,13,8,13,7,12,8,12,12,12,12,10,10,13,11,11,12,7,D/WB L,1,1,1,1,11,1,1,20,1,1,1,12,1,17,1
19001935,Gustavo,1651,21/01/1987,29,0,0,0,0,173,74,3,1,1,2,3,2,3,2,2,1,1,6,6,9,9,9,7,6,6,7,7,9,9,7,10,11,10,5,10,6,8,15,2,10,3,9,7,8,10,12,12,13,6,8,11,12,20,12,9,10,11,9,9,16,20,3,13,13,10,3,7,7,D/WB R,1,1,12,13,1,10,1,1,18,11,12,1,10,1,20
19001937,Jandson,1651,16/09/1986,29,0,0,0,0,189,89,1,1,3,4,1,2,1,3,2,3,1,11,9,12,11,12,10,14,12,10,5,6,6,6,9,11,10,8,12,13,11,11,11,12,6,12,5,11,12,13,11,16,14,10,15,13,20,15,16,13,10,2,7,11,11,11,10,10,10,9,10,9,S ,1,1,20,1,1,1,1,1,1,1,1,1,1,1,1
19002233,Nem,1651,12/10/1987,28,0,0,0,0,184,82,1,1,1,2,2,2,1,2,4,3,3,5,9,9,11,15,9,9,11,6,12,13,8,15,12,9,11,10,11,11,13,15,3,7,11,11,11,8,11,13,15,10,11,1,6,13,20,12,9,12,5,10,10,10,16,11,10,10,10,8,12,7,DM/M C,1,1,1,10,1,1,1,1,1,19,20,1,1,1,1
19002235,Raul,1651,31/10/1986,29,0,0,0,0,177,67,1,2,1,2,3,1,3,3,4,1,1,11,12,10,8,12,11,12,13,10,9,11,7,9,11,10,15,9,12,15,9,9,4,10,13,11,11,11,10,12,13,12,11,11,10,10,20,12,11,10,6,6,10,8,7,10,13,13,11,8,7,8,AM/S RL,1,1,20,1,18,17,1,1,1,1,1,1,1,1,1
19002477,Thomaz,1651,02/05/1986,30,0,0,0,0,177,74,3,2,2,1,2,3,1,2,2,3,1,10,12,13,8,12,8,7,5,8,7,9,3,8,11,7,12,7,11,9,10,13,10,10,9,9,5,9,6,14,14,7,7,20,14,14,8,9,10,10,7,10,3,10,11,9,12,14,10,8,14,7,M L,1,1,1,5,15,1,1,1,1,1,1,20,1,1,1
19002495,Arthur Henrique,1651,14/01/1987,29,0,0,0,0,175,68,2,2,1,3,1,1,3,1,1,2,2,12,14,12,11,12,11,9,11,11,9,12,9,9,13,9,8,10,12,10,12,11,9,13,10,12,10,13,13,13,13,11,9,20,10,13,9,12,10,11,10,10,11,12,14,10,12,12,14,13,12,5,D/WB L,1,1,1,1,10,1,1,20,1,1,1,14,1,20,1
19002497,Cesinha,1651,08/10/1986,29,0,0,0,0,185,78,2,2,3,3,2,1,3,3,3,1,3,2,7,6,5,7,2,14,3,4,12,8,8,12,8,14,12,12,9,12,6,10,12,5,10,8,12,11,13,12,10,13,12,7,13,11,20,13,13,12,9,13,8,6,18,10,14,11,15,11,10,10,D C,1,1,1,1,1,1,20,1,1,1,1,1,1,1,1
19002787,Fernandinho,1651,31/08/1985,30,0,0,0,0,180,65,3,2,3,1,2,1,4,4,1,1,1,10,11,12,7,11,10,6,7,7,7,9,9,8,11,10,10,10,12,9,11,9,5,12,8,12,12,9,11,14,14,8,9,20,12,13,9,12,8,11,7,11,8,12,11,10,10,12,10,4,3,1,D/WB/M/AM LC,1,1,1,16,15,1,1,18,1,1,15,18,1,20,1
19002901,Camilo,1651,09/03/1986,30,0,0,0,0,174,72,2,3,1,2,2,3,2,2,3,2,4,13,13,13,14,13,15,8,16,9,9,14,12,10,14,10,12,11,14,12,15,12,12,14,10,12,10,13,13,14,13,13,7,12,12,14,20,12,13,12,10,13,10,15,12,15,15,11,14,7,14,8,M/AM C,1,1,1,20,1,1,1,1,12,12,18,1,10,1,11
19002912,Luiz Henrique,1651,06/11/1979,36,0,0,0,0,187,90,5,13,11,3,9,11,11,12,9,9,11,4,3,2,2,1,8,1,3,3,3,1,3,1,3,9,9,8,7,9,6,13,6,2,9,1,8,7,6,13,12,5,14,9,16,10,20,6,15,9,7,3,6,9,12,11,11,12,10,8,10,5,GK ,20,1,1,1,1,1,1,1,1,1,1,1,1,1,1
19002913,Wanderson,1651,09/01/1980,36,0,0,0,0,191,90,12,10,13,2,7,15,9,7,8,9,9,4,2,3,1,6,9,1,2,3,3,2,3,1,5,9,10,12,9,8,8,12,4,2,10,3,14,9,8,10,9,6,16,10,14,5,20,14,16,12,6,6,9,9,9,14,14,10,13,5,3,8,GK ,20,1,1,1,1,1,1,1,1,1,1,1,1,1,1
19002921,Andrezinho,1651,06/11/1983,32,0,0,0,0,169,64,3,2,2,1,3,3,2,2,3,2,4,11,12,12,9,11,11,7,9,11,9,12,10,9,12,11,10,11,11,11,11,11,12,12,6,13,10,10,12,13,14,7,4,8,14,14,20,12,6,11,8,11,6,12,11,11,12,10,17,14,13,9,D/WB R,1,1,1,1,1,5,1,1,20,1,1,1,10,1,19
19002936,Lacerda,1651,12/06/1984,32,0,0,0,0,184,79,4,2,3,1,1,2,1,3,1,2,3,5,2,4,7,10,2,15,7,2,14,8,1,11,6,10,13,11,10,12,6,12,10,4,11,6,15,9,10,11,12,10,13,11,15,10,20,7,14,12,8,10,5,10,17,13,9,12,15,7,8,3,D C,1,1,1,1,1,1,20,1,7,1,1,1,1,1,1
19002942,Edson,1651,24/09/1985,30,0,0,0,0,189,85,13,12,13,5,13,10,11,12,12,16,13,1,3,3,3,7,4,2,1,1,1,5,2,2,12,10,9,15,12,11,10,11,11,3,8,3,13,11,11,12,11,14,14,6,14,13,20,12,15,12,10,2,5,10,13,15,12,13,12,14,15,11,GK ,20,1,1,1,1,1,1,1,1,1,1,1,1,1,1
19003041,André Freitas,1651,03/08/1987,28,0,0,0,0,188,79,1,1,1,2,2,1,1,2,2,2,4,3,1,1,3,5,1,12,1,1,12,5,1,8,1,8,9,7,5,6,1,9,8,1,6,3,12,4,5,12,12,5,15,8,11,12,20,2,8,8,7,8,8,8,9,11,12,10,10,4,13,2,D C,1,1,1,1,1,1,20,1,1,1,1,1,1,1,1
19003046,Rafael Pereira,1651,18/11/1984,31,0,0,0,0,183,73,2,2,1,4,3,1,1,3,1,1,3,9,10,7,7,11,10,13,9,6,14,10,9,13,9,10,10,11,12,14,12,12,2,10,12,10,13,12,11,9,11,12,12,11,17,9,20,12,13,10,10,6,6,10,20,12,11,10,11,8,12,3,D/DM C,1,1,1,1,1,1,20,1,1,19,1,1,1,1,1
19003063,Sabiá,1651,02/11/1982,33,0,0,0,0,175,75,2,1,2,1,1,3,1,2,2,1,1,6,8,12,9,10,6,11,11,5,6,8,8,6,11,13,11,9,8,12,9,9,2,8,6,13,6,13,7,11,12,12,8,12,8,13,20,12,9,11,9,8,6,8,12,8,12,13,10,5,9,2,S ,1,1,20,1,12,12,1,1,1,1,1,1,1,1,1
19003074,Leandro Mineiro,1651,09/01/1986,30,0,0,0,0,179,66,2,3,1,2,3,2,3,4,4,3,1,5,2,10,11,9,5,10,13,12,10,10,4,4,11,9,10,2,6,5,7,13,3,9,6,10,7,8,10,13,13,8,8,10,12,13,20,13,6,9,9,9,5,9,13,12,10,13,9,9,9,2,M/AM C,1,1,1,20,1,1,1,1,1,1,17,1,1,1,1
19003075,Ayrton,1651,19/04/1985,31,0,0,0,0,175,69,3,1,2,3,2,3,3,1,3,1,1,12,12,12,12,13,15,8,13,13,11,12,12,10,13,12,12,13,13,11,12,12,12,13,11,13,12,13,13,13,13,15,7,6,11,13,20,13,8,11,12,13,8,12,17,12,9,13,8,8,10,11,D/WB R,1,1,1,1,1,8,5,1,20,1,1,1,12,1,19
19003128,Everton,1651,15/06/1984,32,0,0,0,0,183,78,1,1,3,1,1,3,2,2,2,2,3,13,12,11,7,15,16,9,7,10,12,9,4,16,11,4,11,11,11,12,11,15,10,6,13,9,12,12,8,8,11,12,12,20,17,10,5,8,12,10,3,8,8,10,9,14,13,13,11,10,9,7,D L,1,1,1,1,8,1,1,20,1,1,1,12,1,15,1
19003159,Gueba,1651,25/12/1982,33,0,0,0,0,181,74,3,1,1,2,3,1,3,1,2,2,2,6,8,8,5,8,5,10,7,8,12,12,9,12,9,13,12,13,11,12,10,12,13,10,8,10,11,13,13,13,11,14,13,2,11,13,20,13,13,9,10,9,8,11,17,10,10,8,13,2,5,1,DM/M C,1,1,1,1,1,1,1,1,1,20,18,1,1,1,1
19003288,Ricardo Bueno,1651,15/08/1987,28,0,0,0,0,182,70,3,2,2,4,3,2,2,2,3,3,2,7,9,12,12,12,9,14,10,7,7,11,13,8,11,12,11,11,11,11,10,11,12,10,8,11,6,12,12,12,12,10,12,10,12,13,20,13,8,10,10,6,14,6,11,12,7,13,12,8,11,13,S ,1,1,20,1,1,1,1,1,1,1,1,1,1,1,1
19003323,Maxsuel,1651,01/08/1981,34,0,0,0,0,177,66,2,1,3,2,2,1,1,2,2,3,3,6,8,7,8,14,8,8,12,7,13,14,2,14,9,15,12,9,8,9,13,14,9,7,9,9,12,10,13,6,9,5,6,5,16,9,20,13,7,13,16,10,8,10,12,12,12,11,11,2,10,7,DM/M C,1,1,1,1,1,1,1,1,1,20,17,1,1,1,1
19003327,Welington Simião,1651,23/02/1987,29,0,0,0,0,178,69,2,2,1,2,1,2,4,1,1,2,1,8,8,10,10,13,8,12,11,8,9,11,14,14,12,6,8,9,9,13,11,13,13,3,11,12,9,12,12,13,14,9,8,20,13,13,10,6,9,12,10,10,5,10,10,12,13,13,14,12,7,12,DM/M C,1,1,1,5,1,1,1,1,1,18,20,1,1,1,1
19003335,Magrão,1651,21/10/1984,31,0,0,0,0,192,88,2,1,1,1,3,1,2,2,2,2,3,8,4,14,12,12,8,15,8,1,8,12,15,4,10,4,12,13,11,6,12,10,5,7,1,14,11,13,9,10,11,8,16,20,14,10,11,10,15,10,6,5,8,10,16,11,10,11,9,8,9,4,S ,1,1,20,1,1,1,1,1,1,1,1,1,1,1,1
19003337,Rafael Aidar,1651,28/12/1982,33,0,0,0,0,169,68,1,1,2,3,4,1,3,1,1,1,2,7,3,11,13,13,7,13,8,5,6,8,4,6,13,4,12,5,9,8,5,12,7,13,11,13,7,7,8,15,11,6,5,8,11,15,20,10,6,10,8,10,12,10,15,13,10,9,12,6,14,5,S ,1,1,20,1,1,1,1,1,1,1,1,1,1,1,1
19003422,Diego Ângelo,1651,17/02/1986,30,0,0,0,0,192,89,3,3,2,3,1,2,2,1,1,4,1,6,13,9,9,13,13,15,14,5,13,14,10,12,13,10,13,12,15,10,14,14,11,12,12,10,16,13,7,7,7,15,16,20,8,11,8,9,15,11,10,11,8,6,13,16,16,10,11,10,12,5,D C,1,1,1,1,1,1,20,1,1,10,1,1,1,1,1
19003586,Wanderley,1651,11/10/1988,27,0,0,0,0,182,80,2,3,3,2,2,1,2,1,3,1,1,1,9,14,14,13,8,13,14,7,5,13,13,8,12,14,11,15,12,12,12,12,13,16,11,13,8,12,16,14,14,13,11,9,14,14,20,15,14,13,9,13,9,8,11,8,14,12,14,9,12,8,S ,1,1,20,13,10,10,1,1,1,1,1,1,1,1,1
19003589,Dênis,1651,14/04/1987,29,0,0,0,0,188,86,14,13,13,6,15,13,13,13,12,13,14,3,2,3,1,10,5,8,1,3,2,8,2,3,11,4,13,14,13,13,12,14,10,3,10,3,13,11,15,11,13,13,15,7,13,10,20,10,10,11,3,16,2,12,10,12,12,12,9,12,13,14,GK ,20,1,1,1,1,1,1,1,1,1,1,1,1,1,1
19003703,Paulinho,1651,25/07/1988,27,32,5,0,0,180,71,2,3,2,3,4,1,2,1,3,2,1,11,12,12,10,13,12,13,11,11,14,13,12,15,13,10,15,8,12,14,14,15,13,14,12,16,12,14,14,14,16,14,11,11,13,13,20,15,13,15,13,9,9,12,7,13,15,12,13,9,11,12,M C,1,1,1,15,1,1,1,1,1,15,20,1,1,1,1
19003704,Paulo Roberto,1651,26/03/1987,29,0,0,0,0,175,77,3,2,2,1,3,3,1,1,3,3,2,7,10,9,9,12,7,9,9,13,14,11,10,13,11,13,10,13,11,12,8,12,13,8,11,12,13,14,13,14,12,14,8,10,14,13,20,14,14,13,13,7,10,10,10,13,12,14,12,13,13,6,DM/M C,1,1,1,1,1,1,1,1,1,20,18,1,1,1,1
19003706,Rafael Martins,1651,17/03/1989,27,0,0,0,0,177,74,1,3,3,2,2,3,2,1,3,3,3,3,8,12,14,12,8,13,12,4,5,12,14,6,13,13,13,14,12,12,11,13,12,14,8,14,7,12,11,14,12,14,11,15,13,13,20,13,14,12,11,12,7,9,10,12,9,10,10,10,11,9,S ,1,1,20,9,13,10,1,1,1,1,1,1,3,1,1
19003707,Rodnei,1651,11/09/1985,30,0,0,0,0,190,90,4,2,1,1,1,2,3,2,2,3,3,4,5,8,6,10,4,15,6,7,13,9,5,13,11,14,10,16,8,12,7,8,15,11,10,7,12,10,14,11,9,16,16,20,13,12,8,12,17,12,11,14,18,6,15,16,13,13,13,14,9,8,D LC,1,1,1,1,1,1,20,15,1,1,1,1,1,11,1
19003815,Giovanni,1651,05/02/1987,29,0,0,0,0,191,83,12,11,13,6,14,13,13,15,10,17,13,6,1,2,3,11,8,2,3,2,1,8,4,6,13,6,14,13,10,11,12,13,15,1,11,3,13,13,12,11,13,13,16,11,13,13,20,7,13,12,8,13,7,11,19,12,10,13,15,10,7,7,GK ,20,1,1,1,1,1,1,1,1,1,1,1,1,1,1
19003816,Gum,1651,04/01/1986,30,0,0,0,0,189,85,2,2,3,2,2,1,2,2,3,2,2,6,12,10,11,9,10,16,9,5,13,10,9,15,11,14,11,14,13,10,10,12,11,7,17,10,14,13,15,11,12,14,15,10,13,12,20,14,13,12,5,17,12,10,13,13,8,13,13,10,11,10,D C,1,1,1,1,1,1,20,1,1,1,1,1,1,1,1
19004294,Eraldo,1651,01/04/1982,34,0,0,0,0,185,82,2,1,3,1,2,1,3,1,2,2,1,4,7,8,11,10,9,13,11,4,4,9,14,6,9,11,11,12,11,11,9,11,11,11,13,12,9,13,12,10,9,7,13,11,14,9,20,12,13,12,8,11,8,5,10,10,10,10,12,13,14,10,S ,1,1,20,1,1,1,1,1,1,1,1,1,1,1,1
19004295,Fred,1651,27/04/1984,32,0,0,0,0,184,84,14,12,11,3,13,14,10,12,6,10,8,1,2,3,2,4,6,1,1,1,1,3,2,3,8,10,10,13,8,10,8,11,12,1,12,2,13,9,8,11,17,9,14,9,15,11,20,7,10,15,9,6,6,10,18,13,11,12,15,13,11,9,GK ,20,1,1,1,1,1,1,1,1,1,1,1,1,1,1
19004299,Teco,1651,11/08/1982,33,0,0,0,0,188,82,2,1,1,1,1,2,1,4,3,2,3,6,9,7,10,9,5,14,6,13,13,9,13,12,10,12,11,14,11,11,6,10,13,9,13,8,12,14,13,13,11,14,15,20,12,12,7,14,14,13,11,14,15,13,13,12,12,10,12,8,12,10,D C,1,12,1,1,1,1,20,13,1,1,1,1,1,1,1
19004486,Juliano,1651,14/02/1986,30,0,0,0,0,173,73,3,1,3,2,1,3,3,2,2,3,1,13,13,13,11,13,13,8,11,12,7,13,13,6,13,7,10,12,12,11,12,13,16,9,8,11,9,11,12,13,11,10,7,20,11,13,8,13,10,10,5,11,11,9,12,10,19,12,12,12,16,5,M/AM LC,1,1,13,20,18,10,1,1,1,1,17,16,5,1,1
19004547,Dick,1651,13/02/1984,32,0,0,0,0,187,79,3,3,2,2,2,1,3,3,1,1,1,8,10,9,6,14,8,8,4,8,10,10,6,12,10,7,10,9,8,11,10,14,7,10,13,8,14,7,10,14,10,9,11,10,13,11,20,8,9,10,5,9,6,10,20,9,13,13,11,2,8,7,D/WB/DM RL,1,1,1,1,1,1,1,16,18,18,10,1,1,10,20
19004553,Lincom,1651,17/02/1984,32,0,0,0,0,192,95,3,1,3,4,3,1,2,2,1,2,1,4,7,11,14,12,9,15,11,4,5,11,12,5,12,14,12,12,12,12,10,10,14,11,6,13,8,12,12,11,10,14,16,20,14,12,9,12,16,11,10,11,6,4,5,10,7,9,11,12,13,10,S ,1,1,20,1,1,1,1,1,1,1,1,1,1,1,1
19004564,Léo Mineiro,1651,28/07/1983,32,0,0,0,0,178,70,2,1,2,1,1,2,4,1,3,2,3,7,7,14,10,14,7,14,9,2,7,9,9,4,14,4,12,8,13,8,7,13,6,13,12,13,8,7,9,13,10,5,4,10,10,12,20,14,6,9,9,9,9,9,12,10,11,11,9,8,14,4,AM/S C,1,1,20,18,1,1,1,1,1,1,1,1,1,1,1
19004652,Pedro Oldoni,1651,26/09/1985,30,0,0,0,0,191,85,2,3,1,1,1,3,3,2,1,3,2,3,4,8,10,12,6,14,11,4,6,10,12,6,11,14,11,15,10,11,9,10,9,8,10,11,5,12,9,9,9,14,16,10,13,10,20,13,15,8,8,15,5,7,8,11,9,12,13,13,14,7,S ,1,1,20,10,1,1,1,1,1,1,1,1,1,1,1
19004664,Jota,1651,14/12/1982,33,0,0,0,0,181,73,1,1,2,1,2,1,2,3,1,1,1,6,6,6,8,9,8,9,7,8,12,10,8,12,8,12,11,12,11,10,8,11,12,9,12,9,12,12,12,11,11,12,11,8,12,11,20,11,10,10,8,10,5,11,10,10,14,12,14,9,12,7,DM C,1,1,1,1,1,1,10,1,1,20,15,1,1,1,1
19004954,Tozin,1651,10/11/1984,31,0,0,0,0,180,78,1,3,1,3,3,1,2,3,1,2,1,7,7,10,12,11,9,14,9,3,5,10,5,5,14,8,9,9,9,9,9,10,11,9,7,11,12,9,12,13,13,7,10,12,10,13,20,13,13,10,7,10,7,11,17,13,11,13,13,7,10,6,S ,1,1,20,1,1,1,1,1,1,1,1,1,1,1,1
19004958,Lisa,1651,25/06/1984,32,0,0,0,0,174,69,1,1,3,1,2,1,2,1,3,1,2,8,13,12,9,11,10,9,10,11,10,12,6,12,13,13,10,15,12,6,9,8,17,15,12,12,7,11,14,12,13,11,6,8,12,13,20,10,6,11,4,12,7,12,16,15,13,11,12,10,10,5,D/WB R,1,1,1,1,1,1,1,1,20,1,14,1,10,1,19
19004961,Diogo,1651,26/05/1987,29,0,0,0,0,181,80,2,2,2,3,3,1,3,3,2,3,3,8,12,14,13,14,10,13,9,4,10,13,13,10,14,10,13,12,13,12,14,12,6,13,7,12,9,12,12,13,12,10,12,11,12,13,20,12,13,12,12,10,14,13,8,13,8,7,7,6,8,14,AM/S R,1,1,20,13,12,17,1,1,1,1,6,7,9,1,2
19004966,Ozéia,1651,02/01/1982,34,0,0,0,0,190,86,1,1,4,2,1,3,1,2,4,3,1,7,7,9,9,12,12,13,10,5,12,11,10,12,11,15,10,13,11,11,10,9,12,7,11,11,13,12,13,12,9,13,15,9,15,11,20,12,16,8,12,10,8,6,12,12,10,10,12,7,6,2,D C,1,1,1,1,1,1,20,1,1,1,1,1,1,1,1
19004979,Élton,1651,25/08/1985,30,0,0,0,0,184,79,2,2,2,3,1,3,2,1,2,3,4,9,12,8,9,15,8,7,9,2,7,11,5,9,14,9,10,11,11,12,12,9,12,12,3,12,8,12,11,10,10,8,12,10,8,10,20,9,13,12,8,12,9,9,7,9,13,13,9,1,15,2,M/AM C,1,1,1,20,1,1,1,1,1,1,16,1,1,1,1
19004980,Jefferson,1651,06/01/1988,28,0,0,0,0,189,74,3,1,3,4,3,1,2,1,1,1,3,7,8,12,12,9,10,13,7,4,5,12,13,4,12,9,12,10,11,9,12,12,11,9,11,13,11,12,13,10,11,12,15,9,15,11,20,13,13,12,7,9,8,6,5,14,9,12,13,12,12,8,AM/S L,1,1,20,1,19,1,1,1,1,1,1,1,1,1,1
19004992,Thiago Marin,1651,03/11/1984,31,0,0,0,0,170,68,1,1,3,2,3,3,2,3,1,1,2,12,11,12,9,10,11,5,9,7,6,11,11,5,12,12,10,11,9,8,10,8,12,12,7,11,8,9,11,12,11,7,5,14,12,12,20,11,7,10,8,12,10,16,12,12,12,13,12,9,12,6,M/AM LC,1,1,10,20,18,10,1,12,1,1,18,14,1,10,1
19004998,Marlos,1651,07/06/1988,28,0,0,0,0,174,69,2,3,3,2,2,1,3,1,1,1,2,13,14,17,10,15,14,8,14,5,5,13,14,6,17,8,10,13,11,10,14,12,13,17,5,14,5,12,11,16,16,15,8,20,15,14,14,13,11,12,8,12,8,14,12,11,16,13,15,10,12,9,AM RLC,1,1,10,15,15,20,1,1,1,1,1,10,13,1,1
19005004,Charles Vágner,1651,19/05/1982,34,0,0,0,0,182,0,2,2,3,2,3,2,3,1,1,3,3,4,8,7,7,10,7,9,9,9,11,10,9,12,10,11,9,12,7,9,9,10,12,10,11,10,12,12,11,12,13,11,10,10,12,12,20,12,11,11,9,8,10,10,12,12,12,11,15,10,10,11,DM C,1,1,1,1,1,1,1,1,1,20,15,1,1,1,1
19005016,Renna,1651,14/05/1987,29,0,0,0,0,173,70,2,1,2,3,1,3,3,3,2,2,1,5,10,15,9,12,7,7,10,7,6,11,12,6,13,12,11,11,9,12,9,11,14,16,8,14,6,9,12,14,14,7,11,15,13,11,20,12,7,11,11,10,8,11,15,14,14,13,15,12,13,7,AM RLC,1,1,10,19,17,20,1,1,1,1,1,1,1,1,1
19005103,Totó,1651,31/03/1985,31,0,0,0,0,168,65,3,2,3,1,4,4,3,2,2,3,3,7,4,11,14,14,6,13,8,5,10,5,11,4,12,7,13,5,13,7,7,12,9,9,4,14,8,7,8,13,12,8,10,1,11,13,20,13,6,9,9,2,9,9,12,10,12,9,7,6,18,3,S ,1,1,20,1,1,1,1,1,1,1,1,1,1,1,1
19005127,Mondragon,1651,20/07/1982,33,0,0,0,0,184,77,14,9,9,4,10,14,12,12,7,7,10,4,1,3,2,5,9,1,1,2,2,2,1,3,6,4,10,10,6,7,7,14,7,1,10,2,10,8,7,12,7,6,6,10,10,10,20,7,10,9,9,1,9,9,19,10,14,11,10,1,6,7,GK ,20,1,1,1,1,1,1,1,1,1,1,1,1,1,1
19005137,Luciano,1651,08/07/1983,32,0,0,0,0,190,80,12,10,11,1,12,16,12,10,10,10,9,3,1,3,2,8,8,1,1,1,1,3,1,2,5,10,10,16,8,10,5,10,7,1,10,1,12,11,10,10,12,12,15,9,13,10,20,10,13,7,10,10,5,10,13,8,13,11,9,5,5,2,GK ,20,1,1,1,1,1,1,1,1,1,1,1,1,1,1
19005152,Elielton,1651,25/07/1985,30,0,0,0,0,172,72,4,1,2,3,3,2,1,2,1,1,2,5,7,10,8,8,8,8,10,7,13,10,6,12,10,14,12,13,10,12,9,10,13,10,12,11,12,15,14,13,13,13,6,8,14,12,20,14,10,13,13,10,8,10,10,11,8,11,12,5,7,11,DM/M C,1,1,1,1,1,1,1,1,1,20,18,1,1,1,1
19005161,Wanderley,1651,12/10/1982,33,0,0,0,0,171,65,3,3,3,2,1,1,3,2,1,3,1,10,10,12,12,11,10,9,12,5,3,11,14,3,12,11,10,11,11,9,10,11,12,13,11,12,8,10,9,12,11,11,6,20,13,12,10,12,6,13,6,13,8,10,12,11,6,11,14,15,14,10,AM/S C,1,1,20,18,13,10,1,1,1,1,15,5,1,1,1
19005185,Cascata,1651,02/06/1982,34,0,0,0,0,170,76,2,1,2,3,1,3,2,3,3,2,3,12,12,12,12,12,12,11,11,2,5,12,14,6,12,13,12,11,12,12,12,12,11,15,8,13,8,12,12,12,14,15,5,7,13,13,20,12,11,12,6,10,10,10,10,10,11,10,12,14,13,10,M/AM/S C,1,1,19,20,14,13,1,1,1,1,18,1,1,1,1
19005236,César Gaúcho,1651,28/06/1978,38,0,0,0,0,188,79,1,2,1,1,1,2,2,3,2,2,2,10,8,11,12,12,10,12,10,7,12,12,8,12,9,10,15,10,10,13,10,10,6,8,4,6,9,8,11,10,10,12,15,7,11,11,20,10,15,12,6,9,10,10,17,14,10,10,13,6,8,8,D/DM C,1,1,1,1,1,1,17,1,1,20,1,1,1,1,1
19005246,Adriano,1651,21/01/1982,34,0,0,0,0,178,76,1,1,3,4,1,2,3,1,3,2,2,3,6,12,12,11,5,9,7,5,7,12,8,6,12,11,11,17,10,10,9,11,11,13,7,11,12,11,11,11,13,10,9,8,16,13,20,13,10,14,11,12,5,10,17,13,12,11,7,12,12,11,S ,1,1,20,1,1,1,1,1,1,1,1,1,1,1,1
19005257,Ronaldo Tres,1651,13/02/1987,29,0,0,0,0,175,75,2,2,1,1,1,3,1,1,1,3,3,6,7,7,2,12,6,6,6,4,11,9,5,11,8,9,11,8,7,9,4,13,1,9,13,5,9,8,4,13,12,8,3,10,6,11,20,11,12,9,13,5,5,9,9,14,14,9,11,8,12,1,D/WB/DM/M RC,1,1,1,1,1,1,1,1,19,20,18,1,1,1,19
19005259,Rafael Lima,1651,08/03/1986,30,0,0,0,0,188,87,3,2,2,1,4,1,2,2,1,2,1,6,7,11,7,11,9,12,8,13,12,11,7,12,11,11,12,15,11,12,9,11,11,8,12,10,12,14,12,11,10,7,14,12,15,12,20,15,16,13,12,14,9,8,19,12,12,11,13,12,12,8,D C,1,10,1,1,1,1,20,1,1,1,1,1,1,1,1
19005267,Henrique,1651,09/03/1981,35,0,0,0,0,184,83,3,2,3,3,2,3,2,2,1,1,1,4,4,6,6,7,1,12,8,4,11,8,2,10,7,14,9,12,8,11,6,9,13,1,11,6,10,13,11,9,7,13,11,8,14,9,20,12,14,5,8,8,8,8,9,10,12,9,12,3,15,7,D C,1,11,1,1,1,1,20,1,1,1,1,1,1,1,1
19005389,Lucas Piasentin,1651,17/03/1986,30,0,0,0,0,194,87,2,1,3,3,2,3,3,4,1,2,2,2,4,4,6,9,10,14,12,4,12,9,9,12,7,12,10,12,10,11,4,11,11,8,12,6,12,9,11,9,9,14,16,8,12,10,20,13,14,11,11,12,8,10,14,6,8,12,12,13,12,8,D C,1,18,1,1,1,1,20,1,1,1,1,1,1,1,1
19005462,Thiago Silva,1651,14/06/1985,31,0,0,0,0,171,65,1,3,1,3,2,2,3,1,2,2,3,8,9,11,7,5,6,5,6,7,14,14,6,14,13,14,12,13,12,11,11,12,12,11,7,12,12,12,10,15,15,7,9,9,12,14,20,12,13,11,13,11,9,10,15,14,12,11,14,13,12,7,DM/M C,1,1,1,1,1,1,1,1,1,20,16,1,1,1,1
19005480,Max,1651,23/09/1986,29,0,0,0,0,189,85,14,10,8,1,11,11,9,14,13,12,9,2,2,3,1,1,6,1,1,2,3,2,3,3,2,9,9,10,8,14,7,8,2,3,12,2,11,8,7,10,14,7,14,4,13,8,20,13,13,8,9,6,9,9,8,9,12,9,12,8,9,7,GK ,20,1,1,1,1,1,1,1,1,1,1,1,1,1,1
19005538,Sandro Costa,1651,13/02/1987,29,0,0,0,0,182,77,2,3,3,2,3,2,1,1,2,3,2,8,6,9,7,14,8,8,14,3,7,8,5,8,12,10,12,9,8,7,7,14,4,11,5,11,10,9,12,14,14,9,11,9,15,14,20,14,6,10,8,10,18,10,9,8,10,9,11,1,10,4,M/AM C,1,1,1,20,1,1,1,1,1,1,18,1,1,1,1
19005892,Paulo Henrique,1651,27/03/1983,33,0,0,0,0,186,80,2,2,1,4,2,3,1,1,2,3,1,5,6,7,7,10,9,13,8,5,11,11,7,10,9,13,11,13,11,13,8,13,11,10,14,9,12,12,12,10,11,13,12,8,14,9,20,13,12,12,11,12,7,10,12,15,11,12,11,14,13,11,D C,1,12,1,1,1,1,20,1,1,1,1,1,1,1,1
19005972,Márcio Rozário,1651,21/11/1983,32,0,0,0,0,184,78,1,2,2,2,2,1,2,1,2,3,1,11,12,12,10,11,9,14,10,10,14,12,9,13,11,12,14,12,11,13,10,12,11,11,5,13,13,13,14,12,13,13,14,20,14,11,7,13,13,12,12,12,10,15,12,12,7,11,9,12,13,13,D LC,1,1,1,1,1,1,20,18,1,1,1,1,1,1,1
19006123,Michel,1651,08/06/1981,35,0,0,0,0,178,78,1,2,3,2,1,2,2,3,3,1,4,6,10,10,9,11,9,11,11,9,12,11,9,12,11,13,12,14,13,12,10,10,14,8,14,11,13,15,11,11,10,13,9,10,14,11,20,12,12,12,16,12,7,17,10,12,14,14,14,7,16,10,DM/M C,1,5,1,4,1,1,7,13,11,20,18,8,10,14,12
19006126,Capela,1651,02/05/1985,31,0,0,0,0,182,0,1,2,3,1,3,3,1,3,4,1,3,9,6,9,8,14,9,7,16,2,10,10,7,10,9,9,8,6,11,6,9,8,10,9,13,11,11,10,15,8,12,9,8,5,12,12,20,13,11,9,8,1,3,9,8,13,11,12,11,11,12,7,M C,1,1,1,11,1,1,1,1,1,14,20,1,1,1,1
19006131,Nenê,1651,28/07/1983,32,0,0,0,0,183,78,3,1,3,1,2,3,1,3,2,1,2,8,9,10,14,13,10,14,13,6,6,8,12,8,12,13,14,13,14,13,9,13,10,12,10,12,9,14,13,9,9,15,11,13,16,10,20,13,15,12,11,13,6,7,12,13,14,11,13,14,13,6,S ,1,1,20,5,1,1,1,1,1,1,1,1,1,1,1
19006183,Fernando Gabriel,1651,11/05/1988,28,0,0,0,0,179,72,2,2,2,3,2,2,1,3,3,3,1,12,11,11,11,10,15,8,10,9,6,12,11,4,11,10,10,10,12,10,11,10,10,13,11,11,9,11,14,13,12,9,10,20,12,13,9,11,9,12,6,11,10,11,16,8,6,6,9,6,4,3,M/AM LC,1,1,1,15,17,13,1,1,1,1,20,17,1,1,1
19006194,Marcos Neves,1651,22/05/1988,28,0,0,0,0,175,67,2,3,3,2,2,1,2,2,3,3,3,13,13,13,12,13,12,12,9,7,7,12,13,5,14,8,10,9,11,8,10,10,10,13,9,13,7,9,9,14,12,8,7,13,13,11,20,11,8,8,10,9,8,12,6,6,10,10,12,8,8,7,S C,1,1,20,15,12,1,1,1,1,1,4,1,1,1,1
19006212,Eydison,1651,30/05/1988,28,0,0,0,0,179,74,3,2,4,1,1,1,1,1,3,3,2,6,6,13,10,12,6,11,6,1,6,7,7,1,9,9,8,8,13,6,7,13,9,9,11,13,6,6,8,13,12,7,8,20,13,13,10,12,8,9,4,9,9,9,20,10,11,11,11,1,6,1,S ,1,1,20,1,1,1,1,1,1,1,1,1,1,1,1
19006214,Magno,1651,21/09/1985,30,0,0,0,0,177,0,1,3,3,2,3,3,2,3,2,3,1,9,12,12,9,11,11,8,9,3,3,11,13,3,11,10,7,9,14,7,10,14,9,10,5,17,11,11,13,13,14,8,9,1,10,14,20,10,8,10,10,10,5,10,10,11,11,8,12,2,4,8,AM/S R,1,1,20,1,1,17,1,1,1,1,1,1,1,1,1
19006265,Rodrigues,1651,16/12/1977,38,0,0,0,0,184,86,15,11,9,2,10,15,12,10,7,9,10,3,2,2,1,5,4,2,3,1,2,4,3,2,5,3,12,12,7,9,8,10,10,3,12,2,11,9,8,9,8,9,14,2,13,11,20,5,11,9,8,9,9,8,14,12,12,11,12,12,14,7,GK ,20,1,1,1,1,1,1,1,1,1,1,1,1,1,1
19006307,Mayaro,1651,11/04/1989,27,0,0,0,0,176,0,3,4,1,1,1,1,1,2,3,3,4,7,3,3,9,9,7,7,9,5,10,10,2,13,7,10,13,9,9,8,12,13,2,8,13,8,9,9,11,13,13,9,7,20,15,13,12,6,10,10,7,10,10,10,15,13,11,11,13,1,4,6,DM/M C,1,1,1,10,1,1,1,1,1,20,19,1,1,1,1
19006308,Noel,1651,18/08/1988,27,0,0,0,0,185,0,1,1,3,1,3,3,2,3,2,2,2,5,8,13,6,9,4,10,4,8,11,12,8,12,13,11,11,13,10,12,7,11,3,15,12,6,9,13,14,12,12,6,12,20,14,11,9,9,7,8,13,1,5,9,9,11,12,13,14,3,8,4,D L,1,1,1,6,8,1,1,20,1,12,10,14,1,15,1
19006313,Nílton,1651,12/11/1983,32,0,0,0,0,174,0,2,2,1,3,1,1,2,3,2,1,1,6,6,7,4,12,2,6,3,7,9,9,4,13,7,8,9,9,8,10,8,11,8,1,13,5,7,8,8,14,9,5,8,20,13,11,9,7,8,8,8,1,8,8,15,11,13,14,13,1,4,2,D/WB L,1,1,1,1,1,1,1,20,1,1,1,1,1,18,1
19006317,Paulinho,1651,09/04/1986,30,0,0,0,0,173,76,1,1,4,1,3,3,3,2,1,2,3,15,13,14,15,15,15,8,16,10,5,13,13,4,15,9,11,9,14,12,13,12,10,15,7,13,9,12,11,13,12,13,6,7,10,13,20,12,12,13,10,11,13,9,12,8,6,10,10,10,10,13,AM/S LC,1,1,20,19,18,14,1,1,1,1,10,10,10,1,1
19006386,Leandro Lima,1651,09/11/1985,30,0,0,12,4,167,64,2,1,3,1,2,1,1,3,2,3,2,9,10,13,8,12,11,7,11,6,6,11,11,4,12,6,10,9,9,8,11,9,14,12,7,10,6,8,9,13,13,15,4,15,10,13,20,9,5,9,7,10,7,12,11,19,9,13,14,12,12,5,AM C,1,1,11,20,13,14,1,1,1,1,10,5,6,1,1
19006474,Evandro Gigante,1651,17/11/1985,30,0,0,0,0,194,84,9,9,6,4,12,13,11,13,1,10,11,6,2,3,3,1,10,1,1,1,1,1,2,2,3,6,10,15,7,9,7,13,10,2,12,1,12,8,7,10,11,8,16,8,12,11,20,7,9,8,8,10,5,10,10,9,9,10,11,5,7,6,GK ,20,1,1,1,1,1,1,1,1,1,1,1,1,1,1
19006489,Daniel,1651,21/08/1988,27,0,0,0,0,174,61,2,3,3,2,3,3,3,3,3,3,2,3,6,6,6,13,6,6,12,6,8,12,3,12,13,7,10,8,7,8,11,11,5,4,7,7,7,7,12,13,12,7,8,20,15,10,10,13,6,9,6,3,8,9,9,11,13,13,10,11,14,7,DM/M C,1,1,1,1,1,1,1,1,1,20,18,1,1,1,1
19006505,Leandro,1651,31/01/1982,34,0,0,0,0,187,79,1,3,1,2,3,1,2,2,2,1,1,5,3,8,13,9,8,8,8,1,7,9,9,4,9,9,6,5,9,7,7,12,10,12,13,10,8,4,7,13,10,6,13,9,13,11,20,5,11,9,7,5,9,8,8,12,11,10,10,4,14,3,M/AM/S C,1,1,20,20,1,1,1,1,1,1,18,1,1,1,1
19006517,Marcelo Marciel,1651,14/08/1986,29,0,0,0,0,166,65,3,2,1,3,2,3,3,3,2,3,1,8,9,12,8,11,8,4,8,3,3,8,3,3,12,9,10,10,10,10,10,10,9,15,7,12,3,7,10,12,12,6,3,9,12,14,20,10,8,13,9,9,9,12,10,12,9,13,10,6,17,2,S R,1,1,20,1,1,15,1,1,1,1,1,1,1,1,1
19006762,Felipe Guedes,1651,23/04/1985,31,0,0,0,0,186,0,14,9,7,1,14,14,7,14,9,9,10,5,2,2,2,4,8,1,3,3,1,3,4,1,4,4,8,13,8,13,7,11,4,2,9,3,9,8,7,9,8,8,11,20,12,10,10,4,9,9,6,7,9,9,12,11,11,12,11,5,5,3,GK ,20,1,1,1,1,1,1,1,1,1,1,1,1,1,1
19006772,Thiago Ferreira,1651,12/07/1987,28,0,0,0,0,178,65,3,1,2,2,1,2,2,2,2,3,3,12,14,11,10,10,9,7,7,8,5,9,2,5,10,10,10,7,11,9,6,10,6,10,11,10,8,9,8,14,14,9,9,5,11,14,20,12,6,11,10,10,9,10,15,10,8,12,11,1,15,6,AM RL,1,1,10,12,17,20,1,1,1,1,8,14,15,1,1
19006935,João Paulo,1651,13/05/1985,31,0,0,0,0,184,78,4,1,1,3,1,3,1,3,1,3,2,9,12,11,13,12,8,11,10,5,7,11,12,8,10,10,11,8,11,12,11,12,11,13,10,9,9,9,12,13,15,9,12,7,12,14,20,12,12,14,6,10,8,6,13,13,11,11,12,12,12,6,S ,1,1,20,1,1,1,1,1,1,1,1,1,1,1,1
19006972,Antônio Alex,1651,21/02/1986,30,0,0,0,0,174,70,3,1,3,2,2,1,3,1,1,1,2,4,6,2,7,13,6,6,9,1,9,13,6,9,11,9,9,4,9,7,10,9,5,6,3,9,8,7,12,13,13,7,8,3,12,13,20,13,11,5,7,2,8,9,10,10,10,13,10,1,13,8,M C,1,1,1,1,1,1,1,1,1,1,20,1,1,1,1
19007063,Evandro,1651,24/09/1984,31,0,0,0,0,192,0,2,2,3,2,2,2,1,2,2,2,3,3,6,3,4,8,6,14,7,1,14,8,1,11,5,6,11,9,8,9,6,10,7,3,11,7,14,7,8,7,8,8,15,1,9,9,20,6,11,9,9,6,6,8,20,11,11,9,13,5,8,3,D C,1,1,1,1,1,1,20,1,1,1,1,1,1,1,1
19007104,Juninho,1651,29/04/1977,39,0,0,0,0,185,79,2,3,1,1,4,3,2,1,3,1,2,8,10,10,8,8,8,7,10,8,11,12,13,10,11,10,10,9,8,8,11,14,8,6,6,8,14,10,13,7,13,8,10,20,11,13,10,12,10,11,5,11,10,10,13,11,12,12,11,4,15,8,DM/M C,1,1,1,12,1,1,5,10,1,19,20,1,1,10,1
19007518,Leandro,1651,05/01/1984,32,0,0,0,0,187,0,1,2,3,2,1,3,2,2,3,3,2,6,3,1,3,7,4,10,4,4,14,6,1,10,5,9,11,9,8,12,1,14,6,8,13,7,9,7,8,12,11,8,8,9,5,10,20,9,11,9,3,4,9,9,14,13,14,10,9,7,12,6,D C,1,1,1,1,1,1,20,1,1,1,1,1,1,1,1
19007537,Rodrigo Antônio,1651,27/07/1987,28,0,0,0,0,179,73,1,3,3,1,2,1,1,3,2,3,1,7,6,11,11,8,6,12,12,4,12,9,11,13,12,12,13,12,13,13,10,12,12,9,8,10,13,13,13,13,12,13,12,12,12,12,20,13,12,11,15,11,8,15,12,12,15,11,12,11,12,6,M C,1,1,1,14,1,1,10,1,13,10,20,10,10,1,1
19007555,Fabinho,1651,16/03/1985,31,0,0,6,0,174,80,1,1,1,1,1,5,1,1,1,1,1,14,12,11,7,12,13,9,7,10,11,11,10,10,12,11,11,11,10,6,10,9,12,12,12,10,12,12,14,12,15,10,9,20,12,12,7,12,9,9,10,12,7,9,11,14,9,7,14,8,9,9,D/WB L,1,1,1,1,1,1,1,19,1,1,1,15,1,20,1
19007586,Danilo Rios,1651,09/06/1988,28,0,0,2,0,175,72,2,2,2,1,2,1,1,3,3,2,1,11,10,11,10,11,11,6,11,4,5,11,13,5,12,13,9,12,10,9,11,10,16,12,3,11,7,9,9,12,12,8,6,20,12,12,7,11,7,8,13,11,7,12,5,14,12,14,13,10,7,14,M/AM LC,1,1,8,20,19,10,1,6,1,1,16,17,5,13,1
19007587,Ramazotti,1651,09/08/1988,27,0,0,0,0,193,82,1,3,1,2,1,1,2,2,3,1,2,4,5,8,12,9,6,16,11,2,4,8,3,5,9,7,11,13,11,12,6,11,15,7,5,13,8,12,15,13,9,13,17,7,12,12,20,11,14,12,7,13,8,5,19,14,12,10,14,10,10,6,S ,1,1,20,1,1,1,1,1,1,1,1,1,1,1,1
19007646,Apodi,1651,13/12/1986,29,0,0,0,0,173,67,3,2,1,4,2,1,4,1,4,1,2,9,10,12,9,11,9,8,11,13,10,11,10,10,12,11,9,13,9,12,10,9,15,15,5,15,8,10,12,17,16,15,6,8,14,17,20,14,6,11,10,13,8,17,10,13,12,10,14,13,12,13,D/WB/M/AM R,1,1,1,7,13,16,1,1,20,1,10,10,17,1,19
19007651,Índio,1651,21/11/1981,34,0,0,0,0,177,70,2,2,1,1,3,1,4,3,3,2,1,11,10,10,12,10,12,10,11,9,5,10,15,4,11,10,11,10,10,9,10,11,14,14,2,11,6,8,10,11,12,7,7,8,12,12,20,10,5,11,5,17,8,14,15,13,8,16,14,14,15,14,M/AM/S RC,1,1,20,18,9,19,1,3,10,1,14,6,17,5,12
19007707,Walmer,1651,01/01/1986,30,0,0,0,0,179,0,2,1,3,1,3,2,3,2,3,3,2,5,3,12,10,13,2,13,6,2,5,6,1,1,10,5,8,7,6,6,5,12,1,10,11,12,6,5,6,13,12,6,7,9,14,13,20,8,5,12,7,5,8,8,16,12,10,12,11,4,10,6,S ,1,1,20,1,1,1,1,1,1,1,1,1,1,1,1
19007714,Yuri,1651,26/05/1988,28,0,0,0,0,184,77,14,7,11,3,10,13,13,14,9,9,12,7,1,2,1,3,9,1,1,3,3,1,2,2,5,9,7,11,4,14,8,14,13,2,5,2,11,9,8,11,16,9,15,10,14,11,20,8,11,10,5,5,10,10,19,13,11,12,14,1,4,7,GK ,20,1,1,1,1,1,1,1,1,1,1,1,1,1,1
19007725,Chico,1651,02/02/1987,29,0,0,5,0,186,86,1,1,1,3,2,4,2,2,3,3,2,7,8,9,11,12,8,14,10,8,13,14,8,14,12,13,12,14,14,13,12,13,15,12,14,9,13,14,10,8,8,13,14,20,13,10,14,12,14,13,12,15,6,12,8,11,16,14,12,10,13,10,D/DM/M C,1,10,1,1,1,1,20,1,1,19,17,1,1,1,1
19007727,Marcelo Carné,1651,06/02/1990,26,0,0,11,0,189,83,9,9,8,4,12,13,13,13,10,10,13,1,3,3,1,6,3,3,2,1,2,12,3,1,10,7,9,10,8,10,12,9,12,2,9,1,10,10,8,11,12,11,14,8,17,12,20,10,10,9,10,10,10,10,14,13,13,9,13,11,12,6,GK ,20,1,1,1,1,1,1,1,1,1,1,1,1,1,1
19007728,Bruno Collaço,1651,08/03/1990,26,0,0,4,0,174,73,2,1,1,2,3,1,3,3,3,3,2,14,13,13,8,13,12,6,11,12,7,12,8,10,12,8,10,12,8,12,12,9,10,14,7,12,8,12,13,15,13,12,10,20,12,14,5,13,12,10,11,10,13,11,10,12,11,10,8,12,12,6,D/WB L,1,1,1,1,1,1,1,20,1,1,1,13,1,16,1
19007730,Alex Teixeira,1651,06/01/1990,26,0,0,7,3,173,69,2,3,1,3,2,3,1,3,1,1,2,12,10,17,16,16,10,8,12,5,5,15,17,5,16,13,15,13,16,12,15,16,16,15,13,16,10,15,13,16,16,16,7,15,15,14,20,14,10,15,15,12,10,14,16,14,10,10,12,7,14,10,AM C,1,1,15,20,14,14,1,1,7,14,14,7,7,1,7
19007740,Hélder,1651,20/06/1984,32,0,0,0,0,182,82,2,1,2,3,3,3,2,3,1,2,1,7,12,12,11,14,6,11,15,12,13,13,8,13,14,15,12,15,11,12,12,12,14,13,10,11,13,13,14,12,12,13,11,20,14,12,9,13,12,10,14,13,7,13,13,11,12,14,12,9,11,7,DM/M LC,1,1,5,14,14,1,1,13,1,19,20,17,6,14,1
19007805,Marcão,1651,02/04/1986,30,0,0,0,0,180,78,4,1,3,1,4,3,1,2,1,3,2,4,7,7,11,8,8,12,9,4,5,8,9,6,9,14,16,14,10,8,7,9,7,6,10,13,7,13,11,10,7,14,12,7,11,9,20,16,15,10,10,10,9,9,9,11,12,13,13,4,13,2,S ,1,1,20,1,1,1,1,1,1,1,1,1,1,1,1
19007856,Anderson Luiz,1651,18/04/1982,34,0,0,0,0,188,84,2,1,2,4,2,3,3,3,2,1,2,3,5,4,6,7,1,14,8,5,12,6,6,13,4,8,11,10,9,7,6,14,10,2,11,7,14,8,9,8,10,9,10,10,13,8,20,8,11,10,9,8,9,10,14,14,8,12,11,8,3,5,D C,1,1,1,1,1,1,20,1,1,1,1,1,1,1,1
19007860,Amarildo,1651,20/03/1985,31,0,0,0,0,186,83,3,2,1,2,1,3,1,3,3,2,2,9,7,6,10,13,10,9,10,6,8,11,5,13,12,10,11,12,10,12,8,13,7,2,12,9,11,14,9,7,9,15,14,20,17,8,8,8,14,10,7,10,3,10,13,13,10,12,11,5,12,4,DM/M C,1,1,1,1,1,1,1,1,1,20,16,1,1,1,1
19007890,Douglas Assis,1651,05/05/1985,31,0,0,0,0,186,80,1,3,3,2,3,3,1,3,2,2,3,8,6,6,4,10,3,15,9,3,10,8,5,10,6,7,12,11,10,13,6,15,10,1,12,9,15,9,10,9,10,10,10,1,10,10,20,15,9,10,10,2,10,10,10,11,11,12,12,4,8,3,D C,1,1,1,1,1,1,20,1,1,1,1,1,1,1,1
19007899,Álisson,1651,19/12/1986,29,0,0,0,0,179,75,1,1,2,1,4,3,1,3,1,2,2,7,7,6,7,13,5,9,13,3,12,10,4,10,10,7,10,9,11,11,11,11,13,6,9,9,11,10,12,12,10,12,8,10,16,11,20,10,12,12,9,10,10,10,9,10,10,11,10,11,10,9,DM/M C,1,1,1,1,1,1,1,1,1,20,18,1,1,1,1
19007957,Betinho,1651,21/04/1986,30,0,0,0,0,174,0,3,4,3,2,3,2,2,2,1,1,2,7,5,9,9,13,7,7,12,5,6,13,5,9,11,4,8,9,7,8,11,13,5,11,3,10,8,8,7,13,13,8,4,9,8,13,20,12,6,10,6,10,10,10,12,12,10,13,11,7,6,3,M/AM C,1,1,1,20,1,1,1,1,1,1,18,1,1,1,1
19007961,Douglas,1651,13/10/1987,28,0,0,0,0,188,92,13,12,12,8,13,12,13,13,13,13,12,2,4,4,2,11,8,6,4,3,4,11,5,6,10,11,13,10,10,7,7,12,13,12,9,5,13,13,13,11,13,13,15,6,14,10,20,13,14,11,8,13,4,2,12,9,15,9,15,14,14,5,GK ,20,1,1,1,1,1,1,1,1,1,1,1,1,1,1
19007962,Rogério,1651,09/05/1986,30,0,0,0,0,175,72,2,2,3,2,2,4,2,3,2,2,4,2,8,8,9,11,4,10,12,4,12,11,8,12,10,13,12,15,10,11,9,11,13,7,13,9,13,13,13,11,12,13,7,7,13,10,20,13,10,14,9,12,7,11,11,12,14,12,15,12,13,8,DM/M C,1,1,1,1,1,1,11,1,1,20,18,1,1,1,1
19007965,Weverton,1651,02/09/1987,28,0,0,0,0,190,78,14,14,12,2,9,13,7,10,10,8,9,3,3,2,2,1,7,1,3,1,2,1,2,3,5,10,12,13,8,12,8,14,4,3,9,2,14,9,8,12,10,6,15,20,13,11,5,5,11,11,9,10,10,9,19,12,10,14,11,3,12,6,GK ,20,1,1,1,1,1,1,1,1,1,1,1,1,1,1
19007968,Wellyson,1651,24/11/1988,27,0,0,0,0,162,0,2,2,3,2,1,1,3,1,2,2,1,6,6,3,3,13,6,2,9,3,9,13,2,12,13,6,9,5,8,5,8,12,9,3,8,7,8,7,12,13,13,7,1,8,3,13,20,7,6,9,9,8,6,9,15,13,12,10,12,6,7,2,M C,1,1,1,1,1,1,1,1,1,10,20,1,1,1,1
19008065,Wallace Sergipano,1651,15/01/1987,29,0,0,0,0,183,0,2,3,1,1,1,1,4,3,2,2,2,6,5,3,5,10,6,8,5,6,9,13,3,13,8,9,8,8,8,6,6,13,4,8,13,6,13,7,10,13,13,8,7,9,4,12,20,10,6,9,4,9,9,9,17,14,10,10,10,1,6,7,D/DM C,1,1,1,1,1,1,19,1,1,20,1,1,1,1,1
19008069,Henrique,1651,16/05/1985,31,0,0,0,0,180,72,1,3,1,1,1,3,2,3,1,1,2,11,12,13,12,13,12,14,14,5,15,13,12,15,13,13,13,14,13,13,12,14,14,8,14,13,13,15,13,14,13,10,12,5,12,13,20,12,11,11,8,13,11,15,11,12,11,13,13,13,12,8,DM/M C,1,11,1,12,4,7,14,7,10,20,19,9,12,8,11
19008106,Júnior Negão,1651,30/12/1986,29,0,0,0,0,187,84,3,1,1,1,3,3,3,3,1,1,2,8,8,10,13,11,8,13,11,4,4,9,14,7,10,13,12,13,13,11,9,13,12,14,5,12,8,10,11,11,13,13,14,10,17,11,20,12,13,12,11,11,5,7,13,11,14,13,10,14,14,8,S ,1,1,20,1,1,1,1,1,1,1,1,1,1,1,1
19008110,Rafinha,1651,01/04/1987,29,0,0,0,0,173,73,2,3,3,4,4,2,4,3,2,3,3,13,14,12,9,8,14,5,9,13,11,12,10,11,12,10,12,12,11,12,13,11,12,9,10,13,12,11,12,13,12,13,8,20,12,14,11,13,9,12,8,11,8,12,11,12,11,11,13,12,10,9,D L,1,1,1,1,1,1,1,20,1,1,1,13,1,15,1
19008134,Wanderson,1651,02/01/1988,28,0,0,0,0,167,61,3,3,1,1,1,3,2,1,2,3,1,11,13,15,14,13,14,8,13,3,4,13,10,6,14,8,11,9,14,11,13,11,13,15,5,15,4,11,13,14,17,11,7,9,13,14,20,13,8,17,8,17,8,13,12,12,14,14,13,9,9,9,AM RLC,1,1,9,18,20,17,1,1,1,1,12,15,12,1,1
19008137,Edson Ratinho,1651,31/05/1986,30,0,0,0,0,170,64,1,1,3,2,3,1,1,2,2,1,1,5,10,11,5,12,5,6,5,9,10,10,5,10,12,12,10,12,9,9,10,9,10,13,5,12,9,10,12,14,15,9,5,10,12,14,20,14,6,13,13,13,5,13,8,10,9,12,7,12,12,12,D/WB/M R,1,1,1,1,1,11,1,1,17,1,1,1,17,1,20
19008141,Fernandes,1651,24/04/1985,31,0,0,0,0,175,71,2,2,2,2,2,2,1,2,2,3,3,10,11,12,10,11,10,6,11,12,8,11,10,9,10,13,9,12,11,9,9,9,12,10,7,11,11,10,10,14,14,5,6,20,11,11,7,10,5,10,11,12,12,16,11,12,3,11,10,8,10,15,D/WB/DM/M/AM LC,1,1,1,18,18,1,1,17,1,19,20,16,1,18,1
19008149,Paulão,1651,16/10/1985,30,0,0,0,0,186,75,2,2,4,1,2,1,2,3,3,1,2,5,7,7,5,11,1,13,7,1,13,8,4,10,7,4,13,11,10,10,6,11,7,3,8,9,11,9,10,15,12,7,14,20,7,15,11,14,10,6,7,2,5,10,20,13,9,12,12,1,6,1,D LC,1,10,1,1,1,1,20,16,1,1,1,1,1,1,1
19008202,Tony,1651,10/04/1981,35,0,0,0,0,172,73,2,2,2,1,3,3,2,2,3,2,1,8,8,7,10,9,8,7,11,4,12,10,5,11,10,14,10,12,11,10,9,10,3,9,10,10,13,11,12,10,10,11,6,12,12,9,20,9,8,11,6,5,9,8,19,13,11,11,12,1,10,8,DM/M C,1,1,1,1,1,1,1,1,1,20,17,1,1,1,1
19008293,Kaio,1651,06/07/1987,28,0,0,0,0,187,77,1,1,1,2,1,1,4,2,3,3,1,10,11,12,10,13,11,13,11,4,6,13,14,7,13,9,11,11,9,7,14,9,13,11,8,14,6,13,14,12,13,11,13,20,11,13,11,14,11,6,11,10,4,12,15,9,15,9,12,14,13,10,AM/S C,1,1,20,16,1,1,1,1,1,1,13,1,1,1,1
19008354,Caiuby,1651,14/07/1988,27,0,0,0,0,184,85,1,2,3,1,1,1,3,2,3,3,1,10,13,12,10,10,11,14,12,8,6,9,13,8,11,17,10,15,9,11,10,8,14,14,8,12,9,13,17,12,11,16,13,20,16,17,11,15,14,12,13,11,4,15,16,12,13,11,11,10,12,10,M/AM/S L,1,1,16,12,20,14,1,1,1,1,1,20,14,1,1
19008357,Max Carrasco,1651,03/05/1984,32,0,0,0,0,179,75,1,1,3,2,2,2,2,3,1,3,2,3,4,5,5,3,5,4,14,5,14,13,3,14,8,12,12,13,11,12,8,13,12,12,12,6,12,13,12,13,12,11,10,9,11,13,20,13,14,11,13,10,5,7,11,11,12,12,12,12,14,10,DM C,1,1,1,1,1,1,1,1,12,20,15,1,1,1,10
19008363,Leandro Donizete,1651,18/05/1982,34,0,0,0,0,175,70,1,3,3,3,2,2,3,1,3,1,2,9,12,5,11,14,11,13,12,4,15,13,10,14,13,16,12,16,12,14,13,13,16,12,13,13,14,16,16,13,11,13,7,11,16,12,20,14,13,14,14,17,8,14,7,13,13,13,12,13,15,11,DM/M C,1,1,1,1,1,1,1,1,1,20,17,1,13,1,1
19008463,Alex Maranhão,1651,30/04/1985,31,0,0,0,0,172,62,1,1,1,3,2,2,3,2,1,3,2,11,11,12,10,11,11,6,12,5,6,12,12,7,11,12,11,11,11,11,11,12,12,13,5,12,8,9,12,14,15,14,6,20,12,13,9,13,5,11,12,12,7,14,11,15,2,12,18,12,18,11,AM LC,1,1,1,20,17,1,1,10,1,1,10,14,1,13,1
19008499,Huanderson,1651,03/08/1983,32,0,0,0,0,189,83,10,11,12,13,12,13,14,15,12,15,13,2,2,2,2,8,4,2,2,2,1,8,7,3,8,12,11,11,13,8,6,9,14,8,13,3,15,10,10,9,12,13,14,5,8,9,20,12,15,10,6,12,3,10,13,10,16,14,13,6,8,10,GK ,20,1,1,1,1,1,1,1,1,1,1,1,1,1,1
19008535,Róbson,1651,22/06/1985,31,0,0,0,0,182,0,2,1,1,1,3,2,1,2,3,2,3,2,6,2,7,7,1,12,4,8,12,8,6,12,7,6,16,11,11,11,10,8,9,2,7,8,13,10,11,11,11,11,12,20,10,9,16,12,12,10,8,10,6,10,9,12,12,12,8,8,11,1,D C,1,11,1,1,1,1,20,1,1,1,1,1,1,1,1
19008536,Éder Sciola,1651,25/09/1985,30,0,0,0,0,181,80,2,3,1,4,1,3,2,3,1,2,1,9,10,10,8,9,8,8,8,14,11,9,9,11,10,15,10,14,12,12,11,11,13,10,11,11,10,11,9,12,11,12,8,9,11,12,20,12,12,11,11,12,6,12,20,11,12,11,3,8,12,12,D/WB/DM R,1,1,1,1,1,1,1,1,20,16,13,1,15,1,19
19008540,Rodrigo Thiesen,1651,01/12/1986,29,0,0,0,0,180,80,3,4,2,3,3,1,1,2,3,3,1,8,8,5,10,14,8,8,8,2,13,10,2,13,12,10,12,12,10,8,9,14,10,6,8,9,12,14,13,12,12,11,10,9,17,13,20,12,11,12,15,10,10,10,15,10,10,11,11,1,5,5,DM C,1,1,1,12,1,1,1,1,1,20,15,1,1,1,1
19008591,Ricardo Baiano,1651,04/06/1980,36,0,0,0,0,172,72,3,4,3,3,2,3,2,2,2,2,3,7,7,8,7,12,7,7,5,1,11,10,6,12,9,9,9,8,8,10,8,9,9,7,10,8,12,12,12,14,10,14,5,10,15,13,20,12,7,11,5,6,5,9,20,7,12,11,11,1,3,7,DM/M C,1,1,1,1,1,1,1,1,1,20,16,1,1,1,1
19008619,Miro Bahia,1651,22/12/1979,36,0,0,0,0,179,74,3,3,2,2,4,3,2,1,1,3,3,2,8,9,11,9,4,11,10,4,4,9,10,4,10,14,10,15,12,7,7,9,14,13,6,10,11,9,11,13,11,11,9,10,15,12,20,13,12,14,10,11,7,10,13,14,12,14,15,5,19,8,AM C,1,1,15,20,1,1,1,1,1,1,10,1,1,1,1
19008789,Danúbio,1651,31/05/1987,29,0,0,0,0,180,0,1,4,1,1,2,3,3,4,2,1,2,6,6,13,13,13,6,13,7,3,5,7,8,3,12,9,9,8,11,6,5,11,6,12,10,11,6,6,8,13,13,7,9,3,11,13,20,12,6,9,4,9,4,9,20,10,13,10,9,2,17,3,S ,1,1,20,1,1,1,1,1,1,1,1,1,1,1,1
19008790,Cristiano,1651,25/07/1987,28,0,0,0,0,178,75,3,2,2,1,1,4,1,1,1,1,2,7,7,11,10,9,7,10,3,1,1,10,8,1,13,11,7,5,12,8,8,13,8,13,8,12,8,7,8,13,13,8,8,16,11,13,20,8,11,10,11,5,8,10,10,13,12,9,10,1,14,1,S ,1,1,20,1,1,1,1,1,1,1,1,1,1,1,1
19008797,Guto,1651,18/09/1987,28,0,0,0,0,168,65,2,2,2,4,11,11,1,11,12,2,3,3,8,10,9,10,9,6,10,7,14,10,9,13,10,14,11,14,11,11,9,11,13,6,10,10,12,14,14,15,13,16,4,20,13,14,10,14,8,11,14,10,7,10,7,12,10,11,12,6,10,7,DM C,1,1,1,1,1,1,1,1,1,20,15,1,1,1,1
19008825,Ernandes,1651,11/11/1987,28,0,0,0,0,174,70,1,1,1,1,2,3,2,3,3,2,3,14,11,12,13,10,11,10,13,11,9,11,14,12,11,12,11,12,12,12,10,11,14,11,5,12,8,12,13,14,15,14,8,20,13,13,8,14,8,13,10,11,7,15,12,12,11,12,13,7,13,11,D/WB L,1,5,1,5,10,1,7,19,1,14,13,15,1,20,1
19008827,Leo Jaime,1651,28/03/1986,30,0,0,0,0,165,59,3,1,2,1,3,1,2,2,3,1,1,9,12,14,11,12,6,7,10,8,7,12,10,7,13,11,10,12,13,11,11,11,12,16,5,15,7,10,12,15,15,7,6,20,12,15,10,12,5,13,7,8,13,14,10,11,12,11,9,7,4,4,WB/AM/S RC,1,1,20,18,12,12,1,1,10,1,1,1,13,1,17
19008856,Dedé,1651,31/05/1987,29,0,0,0,0,175,73,1,1,3,1,1,3,1,3,1,3,2,10,10,11,9,8,10,7,9,12,12,10,9,11,10,13,9,14,8,10,8,9,14,11,5,12,12,13,12,12,12,11,7,7,14,13,20,13,9,13,11,11,7,16,14,13,11,12,13,7,14,10,D/WB/DM/M RC,1,1,1,1,1,1,1,1,18,20,17,1,13,1,19
19008952,Ícaro,1651,30/06/1985,31,0,0,0,0,187,85,3,1,1,2,2,1,4,1,3,4,3,4,1,1,4,6,1,9,2,1,12,7,1,10,6,9,13,9,7,8,5,13,6,1,9,6,9,6,7,12,9,6,13,10,9,7,20,7,14,9,8,2,4,9,18,12,13,11,12,11,8,1,D C,1,1,1,1,1,1,20,1,1,1,1,1,1,1,1
19009038,Joãozinho,1651,11/12/1986,29,0,0,0,0,189,0,1,3,1,1,3,2,1,1,3,1,2,7,5,8,13,13,7,13,8,3,7,8,7,2,8,6,12,6,7,3,5,12,11,8,10,13,5,7,8,13,11,8,11,9,15,13,20,13,11,10,10,2,10,10,18,13,11,9,12,7,4,5,S ,1,1,20,1,1,1,1,1,1,1,1,1,1,1,1
19009059,Ricardo Ahlf,1651,23/12/1986,29,0,0,0,0,186,86,11,11,9,5,11,10,12,12,12,14,6,4,1,1,3,5,7,1,2,1,3,3,3,2,1,9,11,15,6,11,8,9,11,1,14,3,14,13,13,7,11,8,13,10,14,7,20,12,12,12,13,10,10,10,20,12,12,11,12,7,14,8,GK ,20,1,1,1,1,1,1,1,1,1,1,1,1,1,1
19009073,Paulo Santos,1651,09/03/1986,30,0,0,0,0,173,67,4,2,3,2,3,1,1,1,3,2,2,3,6,7,5,11,1,8,6,5,9,9,3,11,9,9,12,9,8,8,6,14,9,4,3,5,8,8,5,14,14,8,6,20,14,14,10,9,6,9,12,6,9,13,19,10,11,11,13,1,7,4,D L,1,1,1,1,1,1,1,20,1,1,1,1,1,15,1
19009122,Eraldo,1651,07/02/1982,34,0,0,0,0,181,81,3,2,3,3,3,3,3,2,1,2,1,4,5,9,11,9,5,10,8,3,4,8,12,5,9,12,11,11,11,10,10,10,11,13,11,11,5,8,9,12,11,9,8,9,7,11,20,12,10,11,7,11,11,5,19,10,13,12,12,8,9,11,S ,1,1,20,1,1,1,1,1,1,1,1,1,1,1,1
19009219,Everton,1651,07/10/1986,29,0,0,0,0,174,73,2,3,2,4,3,2,1,3,1,2,3,11,13,13,10,12,11,10,8,7,4,13,13,4,12,10,7,8,8,9,11,8,5,10,4,13,8,9,10,13,14,8,6,20,10,14,8,14,6,10,10,9,10,10,12,10,11,11,10,1,8,5,M/AM LC,1,1,1,20,18,1,1,1,1,1,16,16,1,1,1
19009326,Tiago Alves,1651,29/05/1984,32,0,0,0,0,185,81,1,3,3,3,2,1,3,2,1,1,1,4,8,7,7,7,8,13,9,7,13,8,9,13,8,13,13,12,11,14,7,11,13,8,12,8,13,13,13,12,10,14,14,10,14,12,20,13,14,13,13,10,6,7,18,11,12,11,12,9,13,9,D C,1,11,1,1,1,1,20,1,1,1,1,1,1,1,1
19009330,Diego Neves,1651,13/06/1986,30,0,0,0,0,180,84,3,4,2,2,4,1,1,3,2,1,3,8,10,11,12,11,10,10,12,5,4,11,12,5,12,12,9,10,11,10,10,10,12,13,5,16,7,10,9,14,14,9,10,3,12,13,20,11,11,12,10,9,10,13,12,14,9,8,11,7,6,4,S ,1,1,20,1,1,1,1,1,1,1,1,1,1,1,1
19009389,Renan Marques,1651,06/03/1983,33,0,0,0,0,189,95,1,2,3,3,3,1,2,2,2,3,1,2,7,11,12,11,11,14,11,8,7,11,9,7,11,12,12,7,16,11,10,10,8,11,11,11,11,14,12,11,9,15,14,20,15,10,7,12,15,9,12,10,10,10,16,8,8,6,6,6,16,16,S ,1,1,20,1,1,1,1,1,1,1,1,1,1,1,1
19009390,João Paulo,1651,28/01/1982,34,0,0,0,0,164,60,1,1,3,3,4,3,2,1,1,1,4,4,9,9,1,14,1,8,4,8,10,10,2,14,10,9,12,9,8,10,6,13,5,4,9,9,10,9,9,16,15,7,9,20,14,16,10,11,6,10,10,10,10,10,11,8,13,12,11,7,8,6,D/WB L,1,1,1,1,1,1,1,18,1,1,1,1,1,20,1
19009397,Éric Botteghin,1651,31/08/1987,28,0,0,0,0,193,86,1,3,1,3,1,3,3,1,2,1,3,6,5,7,6,12,8,16,7,7,15,8,2,16,10,11,15,11,13,14,12,12,5,9,13,9,12,11,14,10,10,16,14,5,12,10,20,14,15,12,12,15,8,11,13,10,16,14,14,8,9,4,D C,1,1,1,1,1,1,20,5,10,8,1,1,1,1,8
19009471,Conrado,1651,15/04/1985,31,0,0,0,0,173,0,3,3,3,2,3,2,1,1,3,3,1,4,4,8,5,10,4,5,9,1,6,12,1,7,14,8,6,4,9,7,13,14,6,13,6,7,6,7,7,13,11,7,3,8,15,12,20,8,6,7,8,8,8,8,14,9,11,12,10,1,6,2,M/AM C,1,1,1,20,1,1,1,1,1,1,18,1,1,1,1
19009480,Filipi Souza,1651,27/07/1987,28,0,0,0,0,174,68,1,1,3,2,2,1,3,3,3,1,1,8,12,12,7,12,7,6,10,8,11,10,5,10,11,15,11,15,10,11,11,10,15,13,5,10,10,13,12,13,12,11,7,8,11,14,20,11,12,11,10,12,6,10,9,14,13,12,13,14,12,11,D/WB R,1,1,1,1,1,1,1,14,20,1,1,1,1,10,17
19009635,Clebinho,1651,14/01/1988,28,0,0,0,0,179,66,1,1,1,3,1,2,2,2,2,3,4,10,12,12,11,9,10,7,13,4,7,12,10,7,11,8,12,11,10,9,12,10,10,9,8,12,10,11,11,13,12,11,8,7,11,12,20,13,9,11,8,11,8,12,20,12,11,9,13,1,12,3,M/AM RC,1,1,1,18,1,20,1,1,1,1,15,1,18,1,1
19009665,Marielson,1651,30/03/1985,31,0,0,0,0,168,69,2,4,1,2,3,1,4,2,1,3,2,9,11,10,9,9,12,7,13,8,10,12,10,10,10,12,11,13,10,10,11,12,7,10,13,10,10,12,10,9,11,9,6,10,11,9,20,10,9,12,10,12,13,10,12,12,12,12,11,8,6,6,DM/M C,1,1,1,15,1,1,1,1,1,20,17,1,1,1,1
19009709,Fernando Londrina,1651,13/09/1982,33,0,0,0,0,186,0,3,3,3,2,2,1,3,1,2,1,1,8,6,12,14,15,6,9,9,4,7,6,6,1,15,7,10,4,12,8,6,13,9,13,8,15,6,8,9,13,11,9,9,2,12,10,20,10,15,9,9,9,8,9,10,13,9,10,14,9,7,8,S ,1,1,20,1,1,1,1,1,1,1,1,1,1,1,1
19009930,Dalton,1651,05/02/1990,26,0,0,10,0,186,79,2,1,3,4,1,2,4,1,3,1,1,4,4,11,7,11,10,14,8,6,15,11,9,14,13,13,10,12,10,11,11,11,13,12,9,7,12,13,12,11,12,11,12,10,13,11,20,13,11,12,5,11,14,12,16,13,5,9,18,14,16,4,D C,1,14,1,1,1,1,20,1,1,1,1,1,1,1,1
19010155,Alan,1651,10/07/1989,26,0,0,5,1,184,75,3,1,2,1,1,3,2,4,3,2,1,6,10,15,16,16,9,14,12,6,5,13,12,7,16,14,13,11,12,12,12,13,13,16,9,13,2,11,12,14,16,12,11,12,14,14,20,13,10,12,6,10,12,4,5,10,10,12,11,8,18,11,S ,1,1,20,12,1,1,1,1,1,1,1,1,1,1,1
19010201,Plínio,1651,31/08/1984,31,0,0,0,0,185,82,1,2,2,2,3,2,3,1,3,1,1,2,7,8,10,10,12,15,10,6,13,9,13,12,9,12,13,14,11,12,8,10,14,14,9,10,13,14,13,12,12,13,14,7,13,13,20,12,13,15,10,12,4,11,14,14,11,14,16,8,12,10,D C,1,11,1,1,1,1,20,1,1,1,1,1,1,1,1
19010255,Giuliano,1651,31/05/1990,26,8,0,14,3,172,70,3,3,1,3,1,3,1,2,3,2,1,9,12,13,15,13,10,5,12,8,12,16,12,9,14,8,16,14,13,13,14,15,15,14,10,15,10,15,14,14,14,14,7,15,16,13,20,13,9,11,2,15,10,12,9,15,9,16,14,12,14,10,M/AM RC,1,1,10,20,13,18,1,1,1,1,19,7,13,1,1
19010256,Eltinho,1651,07/07/1987,28,0,0,0,0,180,77,4,2,2,3,2,2,3,2,2,1,3,10,10,11,11,11,11,9,11,7,10,11,9,9,12,13,12,14,11,12,12,11,12,11,8,11,10,12,12,14,12,10,9,20,13,13,8,12,10,12,12,11,12,11,12,13,8,10,10,13,12,11,D L,1,1,1,1,1,1,1,20,1,1,1,12,1,15,1
19010271,Rodrigo Café,1651,16/05/1985,31,0,0,0,0,188,88,13,11,10,6,12,10,11,12,11,11,9,8,3,1,1,2,10,2,1,3,2,4,3,3,6,11,8,9,7,10,1,10,10,2,5,2,14,10,11,12,11,10,15,10,12,9,20,7,13,11,10,11,11,10,9,10,11,5,12,11,12,2,GK ,20,1,1,1,1,1,1,1,1,1,1,1,1,1,1
19010273,Dirceu,1651,05/01/1988,28,0,0,0,0,191,87,3,2,1,1,1,2,3,2,2,2,2,4,6,5,7,11,11,11,10,7,13,10,12,12,11,9,12,13,7,12,13,10,10,11,12,10,13,14,14,10,10,14,16,11,13,11,20,14,15,12,12,15,8,12,15,11,15,11,13,12,14,10,D/DM C,1,1,1,1,1,1,20,1,1,18,15,1,1,1,1
19010338,Diego Jardel,1651,26/12/1989,26,0,0,0,0,180,73,2,4,4,1,3,3,3,1,3,1,1,12,12,12,11,13,12,11,13,5,5,13,11,11,13,6,7,7,13,9,13,13,3,13,8,12,11,10,12,13,13,9,10,20,12,12,7,12,10,10,8,11,8,10,9,10,14,11,7,11,8,13,M/AM C,1,1,1,20,1,1,1,1,1,1,18,1,1,1,1
19010340,Diogo Oliveira,1651,29/10/1986,29,0,0,0,0,181,80,1,3,2,1,1,3,3,2,1,1,3,3,11,10,3,10,3,10,10,11,12,10,9,10,10,15,11,14,11,12,8,9,13,7,6,10,11,14,14,10,10,9,8,10,13,8,20,13,13,12,14,10,15,17,7,14,13,12,13,9,11,10,DM/M RC,1,1,1,1,1,1,7,1,15,20,16,1,13,1,15
19010341,Edson,1651,06/07/1987,28,0,0,2,0,184,83,1,1,4,3,2,2,3,3,3,1,3,5,10,11,7,10,10,13,10,11,13,12,5,13,12,14,11,12,11,12,11,12,14,10,9,5,12,13,13,13,12,10,13,20,15,14,4,12,14,11,4,10,7,10,15,10,8,12,7,8,15,9,D C,1,10,1,1,1,1,20,14,1,1,1,1,1,1,1
19010342,Edson Galvão,1651,08/02/1989,27,0,0,0,0,176,73,1,1,2,4,1,1,1,1,1,3,2,5,6,7,5,9,15,9,12,9,11,10,1,10,14,11,9,11,9,12,12,7,12,10,15,11,10,14,14,10,12,11,8,10,10,11,20,13,10,11,10,11,7,9,15,13,14,9,13,2,1,8,DM/M C,1,1,1,1,1,1,1,1,1,20,18,14,1,1,1
19010353,Leo Cipriano,1651,09/04/1988,28,0,0,0,0,178,66,1,1,1,3,3,1,2,3,3,3,4,7,12,11,12,12,5,5,6,1,5,7,4,1,7,4,8,1,9,6,4,11,9,8,5,7,5,6,7,12,12,6,7,9,12,12,20,12,5,8,8,9,6,9,9,12,14,12,13,1,16,5,M/AM R,1,1,15,1,1,20,1,1,1,1,1,1,18,1,1
19010354,Luan,1651,11/02/1991,25,0,0,0,0,179,76,3,2,1,4,2,3,1,3,1,3,1,10,10,11,7,10,11,10,10,9,11,11,1,11,12,12,11,11,11,11,10,10,13,9,10,10,12,12,11,12,12,12,9,12,9,12,20,12,10,11,12,8,15,11,13,10,12,12,11,1,16,3,D/DM L,1,1,1,1,1,1,1,16,12,20,8,1,1,13,7
19010360,Rafael Coelho,1651,20/05/1988,28,0,0,1,0,174,78,2,2,3,3,1,3,3,2,3,3,3,5,11,14,13,12,13,12,13,6,7,12,13,5,12,13,12,13,12,12,10,13,14,13,12,13,5,12,13,16,11,13,9,8,12,14,20,12,13,12,14,11,13,9,13,15,12,9,10,9,12,11,AM/S R,1,1,20,1,1,17,1,1,1,1,1,1,1,1,1
19010362,Reinaldo Lobo,1651,05/04/1988,28,0,0,0,0,186,80,3,1,3,2,1,3,2,1,3,3,1,7,7,1,7,8,7,9,7,2,7,7,2,13,6,7,12,9,8,11,5,10,1,6,7,7,14,7,9,14,12,8,14,2,8,14,20,8,8,9,14,4,9,9,14,10,10,11,12,6,13,3,D/DM C,1,19,1,1,1,1,20,1,1,16,1,1,1,1,1
19010368,Washington,1651,20/01/1989,27,0,0,0,0,183,79,2,2,2,2,1,2,3,2,4,2,4,11,11,12,8,13,10,9,8,8,11,14,10,11,14,8,10,9,13,12,13,13,13,6,11,12,11,11,9,11,11,14,11,12,14,11,20,13,12,13,3,12,6,7,11,11,10,10,13,1,10,4,DM/M C,1,1,1,8,1,1,1,1,13,19,20,1,1,1,7
19010369,Massari,1651,25/07/1990,25,0,0,0,0,176,69,1,4,1,3,2,2,2,2,4,2,3,10,13,12,11,12,6,5,10,6,9,11,7,9,12,12,11,11,11,12,11,11,9,13,2,12,8,12,13,13,14,10,7,20,15,15,7,11,9,13,10,9,10,10,13,10,14,10,9,1,19,1,D/WB L,1,1,1,1,1,1,11,20,1,1,1,12,1,18,1
19010481,Taison,1651,13/01/1988,28,0,0,0,0,172,67,2,1,3,3,2,1,1,3,3,2,2,3,12,16,11,15,10,9,16,5,8,12,12,10,17,12,12,15,10,11,13,12,16,16,12,14,4,11,13,16,16,14,5,9,12,15,20,12,10,11,9,12,3,13,15,12,18,11,13,12,11,10,AM RLC,1,1,15,15,20,15,1,1,1,1,7,10,7,1,1
19010493,Andrezinho,1651,30/05/1990,26,0,0,0,0,175,69,3,2,1,1,1,2,4,2,2,3,1,8,13,11,8,14,7,7,8,5,5,7,2,9,11,9,8,7,7,9,7,13,9,10,1,9,8,8,9,14,12,13,7,20,13,13,10,6,7,7,9,9,9,9,15,13,14,8,10,1,18,6,M/AM LC,1,1,12,15,20,1,1,12,1,1,8,17,1,13,1
19010523,André Dias,1651,06/01/1990,26,0,0,0,0,182,0,14,11,7,1,10,10,8,13,10,10,11,4,3,2,1,6,6,1,3,2,2,2,3,2,2,10,8,14,9,14,8,14,10,3,9,2,12,9,7,11,9,9,9,9,13,11,20,3,12,10,7,2,10,9,10,10,10,9,12,3,5,7,GK ,20,1,1,1,1,1,1,1,1,1,1,1,1,1,1
19010524,Bruno Bertucci,1651,27/04/1990,26,0,0,0,0,176,76,4,2,3,1,2,1,1,1,3,2,1,13,12,13,7,12,11,6,10,6,9,12,10,9,14,6,12,9,11,12,12,12,16,14,9,12,10,11,13,15,12,8,8,20,12,14,6,13,9,10,9,11,9,12,8,14,10,11,10,9,10,6,D/WB L,1,1,1,1,1,1,1,20,1,1,1,10,1,19,1
19010526,Ruben Júnior,1651,10/04/1990,26,0,0,0,0,194,90,14,10,10,1,9,14,7,10,5,9,13,3,2,2,1,1,6,1,2,2,3,1,3,3,1,7,10,14,8,10,7,13,8,1,14,3,12,8,6,14,13,4,16,1,12,12,20,2,10,12,9,9,4,9,20,9,9,11,10,11,6,5,GK ,20,1,1,1,1,1,1,1,1,1,1,1,1,1,1
19010529,Gualberto,1651,12/03/1990,26,0,0,0,0,188,79,3,1,2,3,2,3,1,1,2,2,1,3,6,8,9,8,5,12,10,5,12,10,8,12,10,14,11,13,10,10,9,10,11,10,10,11,12,16,14,12,11,13,14,8,14,12,20,12,13,14,14,13,6,13,10,13,14,13,15,6,10,12,D/DM C,1,11,1,1,1,1,20,1,1,19,13,1,1,1,1
19010530,João Paulo,1651,17/07/1983,32,0,0,0,0,185,84,1,2,1,3,1,3,3,3,2,1,1,6,4,7,7,8,6,11,9,10,13,9,9,12,9,15,12,15,12,12,7,10,14,7,15,6,12,14,12,10,10,14,12,7,14,11,20,14,11,13,12,12,8,12,9,11,8,11,12,14,8,11,D/DM C,1,1,1,1,1,1,19,1,1,20,13,1,1,1,1
19010554,Joãozinho,1651,25/12/1988,27,0,0,0,0,165,67,4,1,2,2,1,2,2,3,2,3,3,14,13,11,9,14,13,5,13,7,5,14,13,10,13,13,14,9,13,14,14,14,12,12,12,14,8,14,15,14,16,13,4,20,12,13,8,12,6,12,3,13,5,14,16,14,14,13,14,17,13,5,AM RL,1,1,10,13,20,15,1,10,1,1,10,15,10,10,1
19010596,Kadu,1651,20/07/1986,29,0,0,0,0,189,82,3,2,2,2,3,2,2,2,3,2,1,4,6,5,6,10,4,16,7,6,15,11,9,15,9,16,13,16,13,11,6,12,14,7,14,10,14,15,15,13,12,14,14,10,14,12,20,14,14,12,13,13,6,10,12,12,11,13,14,14,11,13,D C,1,1,1,1,1,1,20,1,1,13,1,1,1,1,1
19010702,Alex Alves,1651,08/11/1986,29,0,0,0,0,189,88,15,9,12,1,12,14,15,14,6,10,13,6,1,3,1,7,9,1,2,2,3,2,3,2,2,10,10,12,10,13,9,13,3,1,10,1,13,10,9,12,8,9,16,11,13,11,20,6,10,10,5,10,10,10,8,12,11,12,12,3,7,7,GK ,20,1,1,1,1,1,1,1,1,1,1,1,1,1,1
19010831,Rafael Mineiro,1651,14/02/1986,30,0,0,0,0,174,72,3,3,3,2,3,3,2,3,2,2,1,9,12,12,10,10,4,10,6,13,10,7,9,10,12,9,10,10,10,10,10,10,5,1,9,9,9,11,8,12,13,10,6,8,11,13,20,9,11,9,7,9,9,9,15,10,10,12,11,3,13,2,D/WB R,1,1,1,1,1,1,1,1,20,1,1,1,1,1,19
19010931,Diogo,1651,30/12/1989,26,0,0,8,0,176,78,1,3,1,3,1,2,1,1,2,2,4,12,12,15,10,15,12,7,10,10,10,12,10,12,14,9,12,10,9,7,12,10,9,15,10,15,8,12,12,15,15,8,7,20,10,11,8,12,11,8,8,12,6,16,7,14,5,12,8,11,12,7,D/WB/M L,1,1,1,1,8,1,1,20,1,1,1,16,1,18,1
19010932,Fabrício,1651,23/09/1987,28,0,0,0,0,183,78,2,1,3,2,4,2,3,1,4,1,3,8,6,3,7,8,13,6,12,5,12,6,5,13,8,9,9,9,7,7,11,13,9,6,7,7,12,7,8,10,10,10,7,9,13,10,20,12,12,9,7,9,8,9,15,11,11,13,12,8,11,8,DM C,1,1,1,1,1,1,1,1,1,20,15,1,1,1,1
19010988,Camacho,1651,02/03/1990,26,0,0,0,0,181,72,1,3,1,2,3,3,2,1,2,1,1,8,12,12,12,14,13,8,13,5,13,15,10,8,13,8,14,8,12,13,14,13,16,13,5,12,11,12,14,12,14,13,7,13,13,12,20,12,8,13,6,12,11,15,17,16,15,12,8,7,12,7,M C,1,1,1,14,1,1,1,1,1,15,20,1,1,1,1
19011195,Diogo,1651,31/07/1987,28,0,0,0,0,181,73,2,1,2,3,1,3,3,3,2,3,3,1,6,7,7,4,2,8,7,9,10,8,9,11,7,15,8,13,6,7,4,7,15,8,4,7,7,11,10,10,9,8,7,7,15,10,20,12,10,14,12,11,7,12,14,13,14,13,14,12,13,13,D/WB/DM/M RC,1,4,1,9,1,5,8,1,19,20,18,1,16,1,17
19011198,Henrique,1651,13/05/1986,30,0,0,0,0,179,78,1,3,1,3,1,3,2,2,2,3,3,11,13,13,11,10,10,8,10,13,10,11,10,9,11,10,8,12,8,10,10,8,12,11,5,11,10,11,11,14,14,11,8,8,14,14,20,12,10,11,7,10,8,11,10,11,7,9,13,14,15,9,D/WB R,1,1,1,1,1,1,1,1,20,1,1,1,1,1,18
19011203,Norberto,1651,19/07/1990,25,0,0,0,0,175,71,2,2,2,2,2,2,2,3,2,3,1,9,12,11,13,13,11,8,12,8,11,12,12,10,13,11,12,11,13,9,11,10,12,14,6,13,8,12,11,13,14,11,8,6,12,13,20,13,9,11,10,11,12,12,10,16,3,11,8,8,15,15,D/WB/M/AM RC,1,1,10,16,10,18,1,1,20,1,12,6,17,1,18
19011205,Paulo Roberto,1651,04/03/1989,27,0,0,0,0,170,65,2,2,3,1,1,2,4,3,3,1,2,9,10,10,7,8,9,7,5,5,5,8,11,4,10,11,8,11,8,7,10,9,13,14,2,11,4,6,7,12,11,5,3,7,14,12,20,11,3,13,6,11,7,16,4,13,17,13,15,14,16,11,M/AM/S R,1,1,20,13,14,19,1,1,7,1,10,5,16,1,12
19011210,Robert Gladiador,1651,02/01/1986,30,0,0,0,0,177,79,3,3,1,1,1,1,1,3,1,2,1,8,7,10,13,8,10,12,8,3,4,8,9,3,8,9,12,5,13,10,10,6,9,9,12,16,9,15,8,8,2,15,12,9,15,9,20,12,13,9,9,3,9,9,9,12,11,9,13,1,7,2,S ,1,1,20,1,1,1,1,1,1,1,1,1,1,1,1
19011213,Willames,1651,02/05/1988,28,0,0,0,0,176,73,2,1,4,2,2,3,3,3,2,3,3,1,7,9,8,11,2,7,9,4,12,12,10,12,10,12,10,13,10,11,10,10,15,7,15,8,13,13,12,12,13,11,7,7,16,11,20,12,10,14,12,14,7,8,10,12,15,15,18,14,15,7,DM/M C,1,3,1,1,1,1,6,1,1,20,19,1,1,1,1
19011400,Capone,1651,22/02/1986,30,0,0,0,0,178,79,1,3,3,2,3,2,3,2,3,1,3,5,9,11,8,9,7,9,11,13,10,10,5,10,10,7,8,9,7,9,8,8,13,9,7,10,16,10,12,12,13,11,9,7,14,14,20,9,13,9,9,4,9,3,11,13,12,13,12,5,10,7,DM ,1,1,1,1,1,1,1,1,1,20,10,1,1,1,1
19011515,Rodrigo Góis,1651,30/01/1984,32,0,0,0,0,185,83,2,2,1,2,4,4,1,1,2,4,1,11,2,2,2,4,13,13,2,2,11,7,4,12,6,9,13,10,7,14,4,7,11,5,12,4,10,8,12,10,11,6,12,20,9,10,9,14,12,12,8,12,9,5,15,8,12,11,10,6,8,5,D C,1,1,1,1,1,1,20,1,1,1,1,1,1,1,1
19011657,Adriano Pardal,1651,13/06/1987,29,0,0,0,0,172,66,2,1,2,1,2,1,2,1,3,2,2,12,12,13,10,12,11,9,10,5,4,12,13,4,14,10,10,10,10,8,11,10,12,14,5,13,7,9,10,14,17,7,5,10,14,14,20,12,5,10,5,11,8,17,8,11,11,11,15,14,14,9,S ,1,1,20,13,14,11,1,6,3,1,3,12,7,10,5
19011660,Manteiga,1651,19/03/1990,26,0,0,0,0,177,69,2,1,2,3,4,2,3,3,3,1,2,4,6,8,4,13,6,6,10,1,10,10,1,9,11,9,11,8,7,8,12,7,11,9,9,7,9,7,11,10,12,11,7,9,13,12,20,11,7,9,8,5,9,9,8,17,4,11,13,12,12,10,DM/M C,1,1,1,1,1,1,1,1,1,20,16,1,1,1,1
19011661,Esdras,1651,06/03/1990,26,0,0,0,0,181,78,3,3,2,3,1,3,1,1,1,1,3,1,5,7,8,8,6,11,10,4,12,9,8,11,9,13,11,12,10,12,7,10,13,8,8,10,11,13,12,12,12,12,10,11,14,11,20,12,11,11,10,9,5,8,10,11,13,10,13,8,9,9,D/DM C,1,11,1,1,1,1,18,1,1,20,15,1,1,1,1
19011665,Fábio Saci,1651,14/02/1982,34,0,0,0,0,178,73,2,2,3,1,1,3,3,1,3,2,1,3,8,10,12,10,4,12,10,4,4,9,15,4,11,7,12,9,13,8,9,12,8,15,2,13,8,7,7,10,12,12,9,12,14,10,20,11,10,12,12,14,6,6,13,14,6,12,11,8,10,13,S ,1,1,20,1,1,1,1,1,1,1,1,1,1,1,1
19011669,Kleiton Domingues,1651,02/04/1988,28,0,0,0,0,173,71,1,3,2,3,2,3,1,2,2,1,1,13,11,13,11,12,13,8,10,5,5,12,14,5,13,8,9,10,12,12,12,11,10,14,5,14,9,8,10,15,15,9,7,20,13,14,9,12,8,13,5,11,10,12,11,12,13,10,12,7,9,11,M/AM LC,1,1,13,20,19,11,1,1,1,1,16,16,6,1,1
19011670,Lee,1651,09/03/1988,28,0,0,0,0,188,86,9,9,9,7,13,11,11,14,9,12,12,3,3,2,2,7,6,8,1,2,2,8,1,3,7,15,11,12,10,9,4,10,5,6,10,6,12,13,10,9,13,13,14,5,8,10,20,12,16,11,10,13,10,10,8,13,16,12,14,7,8,13,GK ,20,1,1,1,1,1,1,1,1,1,1,1,1,1,1
19011671,Marcão,1651,27/05/1988,28,0,0,0,0,192,84,13,12,11,1,12,12,11,13,11,6,12,3,2,2,3,7,7,3,1,1,2,6,3,1,7,4,11,11,9,13,6,12,10,2,5,5,13,9,11,8,14,12,17,11,13,10,20,11,15,9,6,10,10,10,12,11,12,9,13,12,12,8,GK ,20,1,1,1,1,1,1,1,1,1,1,1,1,1,1
19011674,Ramirez,1651,22/11/1987,28,0,0,0,0,179,82,1,1,2,2,3,3,3,2,1,1,3,4,9,10,11,9,5,10,10,9,14,11,9,13,10,16,12,15,9,11,8,9,7,9,14,11,13,15,14,13,14,13,11,7,16,13,20,16,14,15,11,12,5,14,11,17,5,13,8,6,12,10,DM/M C,1,1,1,1,1,1,10,1,14,20,18,1,5,1,12
19011679,Édson,1651,26/02/1990,26,0,0,0,0,182,79,1,3,1,1,1,1,2,3,3,3,1,4,6,11,13,12,8,12,9,2,4,11,11,6,11,11,10,11,10,8,8,10,14,12,5,12,9,12,12,13,12,13,12,11,14,13,20,13,13,11,11,10,8,7,11,12,10,12,11,10,15,8,S ,1,1,20,1,1,1,1,1,1,1,1,1,1,1,1
19011910,Welder,1651,14/04/1984,32,0,0,0,0,190,86,14,10,7,3,9,14,9,14,9,5,8,3,3,3,1,3,3,1,3,1,3,1,2,2,5,4,7,15,8,14,7,13,11,3,4,1,11,8,7,9,15,6,15,6,9,5,20,7,11,9,5,3,5,9,14,13,11,10,10,10,10,8,GK ,20,1,1,1,1,1,1,1,1,1,1,1,1,1,1
19011912,Édson Barbosa,1651,24/07/1984,31,0,0,0,0,174,0,1,1,1,1,1,1,2,2,4,3,1,11,10,11,9,10,11,6,10,10,9,10,5,9,11,10,8,10,8,8,9,8,11,11,7,11,9,9,10,11,11,7,7,20,12,11,8,11,8,11,7,10,8,14,13,10,10,11,11,8,5,4,D/WB/M/AM LC,1,1,1,12,20,1,1,19,1,10,18,17,1,18,1
19012140,Alan Kardec,1651,12/01/1989,27,0,0,15,2,187,80,2,1,1,2,3,2,1,2,3,4,3,9,10,12,13,12,10,15,12,8,8,12,14,7,12,11,13,15,13,12,10,12,15,13,12,13,6,13,13,12,12,14,13,12,13,11,20,12,13,12,13,13,11,10,13,15,10,13,11,13,15,14,S ,1,1,20,13,10,14,1,1,1,1,1,1,1,1,1
19012225,Douglas,1651,30/12/1987,28,0,0,0,0,184,74,2,1,3,3,2,2,2,1,3,2,1,2,8,9,14,8,3,18,12,6,9,11,14,8,9,15,12,12,11,13,8,9,15,8,9,12,10,14,14,13,10,12,15,20,15,14,14,13,15,13,10,13,4,9,12,14,13,15,10,11,10,8,AM/S RLC,1,1,20,15,15,17,1,1,1,1,1,1,1,1,1
19012240,Wellington,1651,15/07/1982,33,0,0,0,0,182,82,3,2,3,4,4,1,3,1,3,3,2,7,7,7,8,11,7,7,9,3,12,10,7,11,8,11,10,12,7,8,12,14,9,7,10,11,9,8,13,8,9,9,9,10,10,10,20,13,11,9,10,1,9,9,15,10,11,12,9,9,6,2,DM ,1,1,1,1,1,1,11,1,1,20,13,1,1,1,1
19012274,Antônio Marcos,1651,17/05/1985,31,0,0,0,0,170,66,2,3,1,3,3,3,3,1,1,1,4,8,11,12,8,9,5,8,7,12,9,12,5,10,11,9,6,10,10,9,9,15,9,9,7,9,10,10,10,12,13,5,7,13,10,13,20,7,7,9,9,9,5,9,12,10,10,14,10,1,14,7,D/WB R,1,1,1,1,1,1,1,12,20,1,1,1,1,10,18
19012283,Ivan,1651,02/09/1982,33,0,0,0,0,166,59,2,1,3,2,1,3,1,2,1,2,3,6,12,13,10,11,5,5,6,2,2,13,10,2,12,10,5,12,8,11,11,9,9,9,10,13,6,10,8,13,14,3,5,9,13,14,20,12,3,7,8,11,4,8,11,10,11,12,12,8,9,9,AM/S RL,1,1,20,1,18,18,1,1,1,1,1,1,1,1,1
19012611,Rascifran,1651,12/02/1981,35,0,0,0,0,186,0,13,10,8,3,10,5,8,13,9,9,8,4,1,2,1,1,6,1,2,1,3,1,2,1,4,9,8,12,7,7,6,13,4,3,11,2,9,7,5,11,11,7,10,9,4,10,20,1,9,9,6,7,6,9,18,9,11,9,10,1,9,8,GK ,20,1,1,1,1,1,1,1,1,1,1,1,1,1,1
19012659,Adenísio,1651,10/09/1985,30,0,0,0,0,172,0,2,3,3,2,3,2,1,3,1,2,3,7,4,8,4,14,7,2,9,4,8,12,3,12,10,5,8,5,7,6,7,10,3,9,9,7,11,8,11,14,14,8,4,9,15,14,20,11,7,7,1,8,9,9,8,10,14,12,11,1,16,8,DM ,1,1,1,1,1,1,1,1,1,20,12,1,1,1,1
19012781,João Paulino,1651,08/10/1983,32,0,0,0,0,184,0,1,3,2,3,3,2,2,2,3,2,1,2,10,10,8,9,3,10,8,10,11,9,8,11,9,12,10,13,10,10,8,10,3,6,5,10,9,10,10,12,11,12,12,5,14,13,20,13,12,11,14,10,15,11,12,9,12,9,11,12,4,7,D/WB/DM RC,1,1,1,1,1,1,1,1,18,16,15,1,1,1,20
19012910,Adalberto,1651,21/07/1987,28,0,0,0,0,184,77,2,3,1,2,1,2,1,1,2,4,4,3,4,5,7,5,3,14,4,2,13,7,5,13,6,13,12,12,12,11,10,12,11,13,12,9,13,12,13,12,12,13,15,11,13,12,20,13,15,11,13,10,8,4,8,10,12,11,12,11,13,11,D C,1,1,1,1,1,1,20,1,1,1,1,1,1,1,1
19012914,Daniel Martins,1651,18/04/1987,29,0,0,0,0,191,74,15,12,11,5,8,14,11,12,10,10,11,3,3,1,3,3,8,1,2,3,3,4,3,3,7,9,10,12,9,10,9,13,12,1,15,3,12,10,9,14,11,10,17,4,17,14,20,5,13,11,10,8,10,10,11,11,11,12,12,8,7,12,GK ,20,1,1,1,1,1,1,1,1,1,1,1,1,1,1
19012918,Douglas,1651,30/01/1986,30,0,0,0,0,186,84,3,3,1,1,1,1,3,2,2,1,1,9,10,11,12,11,9,12,11,4,8,11,14,8,11,11,13,12,12,12,10,12,10,12,10,12,8,10,11,12,11,7,13,9,14,12,20,13,13,12,11,12,12,10,12,11,11,13,12,12,8,8,S ,1,1,20,7,1,1,1,1,1,1,1,1,1,1,1
19012919,Dudu,1651,10/02/1982,34,0,0,0,0,179,74,1,2,3,3,1,2,1,3,3,2,4,6,10,10,9,10,9,11,7,9,13,9,10,12,11,14,11,13,12,12,10,11,11,9,14,10,11,12,11,12,12,12,8,12,9,11,20,13,12,12,13,10,10,11,15,9,12,11,12,7,9,12,DM ,1,1,1,1,1,1,1,1,1,20,12,1,1,1,1
19012920,Ednei,1651,30/11/1985,30,0,0,0,0,176,72,1,2,2,3,3,3,1,3,2,1,1,11,13,12,13,12,14,7,14,6,5,10,15,6,12,7,12,8,12,12,11,12,13,11,6,9,5,9,11,13,11,11,8,9,10,13,20,13,9,13,9,9,10,9,15,12,15,12,14,3,13,4,WB/M R,1,1,1,1,1,1,1,1,10,1,1,1,18,1,20
19012924,Hugo,1651,17/09/1986,29,0,0,0,0,180,0,3,3,2,3,1,4,3,1,1,3,4,6,3,3,6,13,6,6,11,1,8,10,2,7,9,9,8,1,8,7,13,13,5,9,9,11,7,7,11,13,13,7,9,9,9,13,20,7,8,9,9,3,9,9,12,11,9,11,9,3,7,8,M C,1,1,1,1,1,1,1,1,1,10,20,1,1,1,1
19012926,Rafael Jataí,1651,18/05/1989,27,0,0,0,0,181,71,3,2,2,2,3,1,3,2,2,2,2,10,10,9,10,15,10,12,13,4,13,11,10,12,11,12,12,13,10,11,9,10,10,9,7,11,12,14,12,12,13,11,10,1,7,12,20,14,11,10,10,9,10,10,16,10,8,12,13,12,15,1,DM/M C,1,1,1,1,1,1,1,1,1,20,17,1,1,1,1
19012930,Léo Salino,1651,22/04/1985,31,0,0,0,0,170,63,1,2,2,2,3,1,1,1,1,3,2,10,9,6,8,14,10,10,12,5,11,15,6,14,13,8,13,10,11,8,11,14,4,11,9,10,11,10,12,13,10,11,6,11,16,12,20,10,7,13,8,11,11,11,15,13,12,10,6,5,9,7,DM/M C,1,1,1,10,1,1,1,1,1,19,20,1,1,1,1
19012940,Rogério Maranhão,1651,29/01/1985,31,0,0,0,0,175,69,3,2,3,1,1,2,1,2,1,1,2,7,8,10,11,10,8,7,7,6,6,9,10,8,11,13,10,11,10,7,6,7,15,13,9,14,6,7,11,14,13,10,8,10,12,14,20,10,8,7,7,10,4,11,14,11,12,11,13,13,13,6,S ,1,1,20,1,1,1,1,1,1,1,1,1,1,1,1
19013479,Jozicley,1651,01/07/1981,35,0,0,0,0,175,69,3,3,2,2,1,2,1,3,2,1,3,6,6,2,4,13,6,6,9,1,10,11,1,13,12,9,7,7,5,8,6,13,9,9,9,5,10,7,12,11,8,7,5,9,12,10,20,13,6,9,6,8,4,9,16,11,11,8,9,1,11,6,DM/M C,1,1,1,1,1,1,1,1,1,20,16,1,1,1,1
19013481,Geovane,1651,05/08/1985,30,0,0,0,0,170,70,3,3,3,1,2,3,1,1,1,2,3,9,9,10,12,11,9,10,8,3,2,11,12,2,12,11,10,11,10,7,9,10,13,12,5,10,8,10,12,13,12,10,4,13,13,13,20,11,12,13,11,12,8,10,13,13,13,10,10,9,10,3,S C,1,1,20,15,13,13,1,1,1,1,1,1,1,1,1
19013511,Índio,1651,31/12/1983,32,0,0,0,0,181,76,1,1,1,2,2,2,3,3,2,2,2,3,5,6,4,11,1,15,6,1,11,8,4,12,8,10,12,12,10,11,9,12,5,1,14,9,15,12,11,11,7,12,11,20,11,9,7,12,12,10,5,2,8,10,7,8,5,12,12,1,15,8,D C,1,11,1,1,1,1,20,1,1,1,1,1,1,1,1
19013712,Diego Ratinho,1651,04/02/1986,30,0,0,0,0,177,73,1,3,1,3,2,3,1,1,3,1,2,6,6,13,13,13,6,8,6,1,6,10,8,3,13,4,9,5,8,7,10,9,9,13,10,8,7,5,8,12,13,10,7,20,13,14,10,11,8,9,8,2,9,9,13,11,11,10,12,7,8,6,AM/S C,1,1,18,20,1,1,1,1,1,1,1,1,1,1,1
19013713,Marinélson,1651,29/06/1982,34,0,0,0,0,179,0,3,2,4,2,4,2,2,2,1,2,2,5,5,12,13,9,5,7,6,1,4,13,6,3,13,5,8,1,5,6,9,11,1,13,10,8,7,6,8,7,10,6,8,8,8,9,20,12,6,8,8,4,8,8,20,10,12,11,12,1,2,7,M/AM/S C,1,1,20,19,1,1,1,1,1,1,18,1,1,1,1
19013821,Flávio Mineiro,1651,15/08/1982,33,0,0,0,0,187,0,1,1,3,1,3,2,3,3,2,1,2,8,13,5,8,14,7,6,7,7,10,8,7,13,10,9,8,9,10,11,6,10,2,1,10,8,8,10,7,11,13,6,13,10,4,10,20,12,12,8,9,6,8,9,11,14,12,11,12,10,6,5,D/WB R,1,1,1,1,1,1,1,1,17,1,1,1,1,1,20
19013825,Luiz Henrique,1651,02/07/1981,35,0,0,0,0,172,70,3,1,3,1,1,1,1,4,2,3,1,5,12,15,13,14,10,9,10,1,3,11,13,3,13,5,11,12,13,12,12,12,15,13,6,13,4,12,14,13,14,12,9,20,14,14,15,13,12,12,8,13,10,11,10,13,12,16,14,13,12,7,AM/S C,1,1,20,20,11,10,1,1,1,1,1,1,1,1,1
19013834,Clemilton,1651,28/06/1982,34,0,0,0,0,187,0,3,2,3,2,2,1,3,1,3,1,2,6,6,5,5,8,2,8,5,7,7,9,4,12,8,8,9,7,9,10,9,12,8,8,9,7,10,9,9,9,11,9,14,9,13,11,20,14,11,8,8,6,8,8,19,12,10,11,8,6,7,1,D/WB R,1,1,1,1,1,1,1,1,20,1,1,1,1,1,17
19013936,Higor,1651,07/08/1987,28,0,0,0,0,191,74,2,1,2,3,3,2,2,3,2,3,3,6,8,13,11,13,6,13,7,2,5,7,6,1,13,9,11,6,10,8,6,11,6,13,11,12,7,6,8,13,12,7,11,20,9,13,10,13,10,9,7,2,8,9,9,13,10,9,11,2,11,7,S L,1,1,20,1,15,1,1,14,1,1,1,10,1,10,1
19013942,Gabriel,1651,29/03/1990,26,0,0,0,0,172,0,3,3,1,3,2,3,1,2,3,2,2,5,7,4,9,14,7,7,8,2,7,13,4,9,9,9,7,8,7,7,6,13,9,8,3,9,9,8,7,14,14,8,2,9,14,14,20,12,9,9,9,9,9,9,10,11,12,11,13,7,11,1,M/AM C,1,1,1,20,1,1,1,1,1,1,16,1,1,1,1
19013946,Yuri,1651,07/10/1989,26,0,0,0,0,180,70,1,2,3,1,1,3,2,1,2,3,2,6,11,7,12,8,5,6,12,5,13,12,8,13,12,11,12,12,11,13,13,12,13,9,11,12,9,13,13,13,12,10,10,8,13,14,20,13,9,16,10,11,6,10,12,13,12,13,14,12,10,4,DM/M C,1,1,1,1,1,1,1,1,1,20,18,1,1,1,1
19013948,Darley,1651,15/12/1989,26,0,0,0,0,187,75,14,11,8,8,12,11,13,14,5,6,12,6,1,3,2,4,8,1,3,2,2,2,1,2,4,4,9,13,8,11,13,14,11,2,10,2,12,11,9,13,15,8,13,5,14,15,20,3,12,10,10,2,18,10,12,14,10,11,10,5,18,2,GK ,20,1,1,1,1,1,1,1,1,1,1,1,1,1,1
19013951,Lázaro,1651,28/06/1990,26,0,0,4,1,191,80,2,1,2,2,3,2,3,3,4,3,3,2,5,8,8,9,5,13,8,8,14,8,8,12,12,12,8,11,9,13,8,13,14,7,11,9,12,13,12,13,12,9,14,7,14,13,20,12,13,10,11,8,8,10,18,13,13,10,12,7,8,5,D C,1,1,1,1,1,1,20,1,1,1,1,1,1,1,1
19013953,Chiquinho,1651,27/07/1989,26,0,0,0,0,170,69,1,2,2,2,3,3,3,3,1,1,3,11,14,13,11,11,14,9,10,10,10,11,6,10,13,11,11,12,12,9,8,8,11,12,14,12,11,12,10,16,16,11,7,20,13,16,8,14,11,12,9,12,8,17,10,11,10,10,12,6,19,3,D/WB/M L,1,1,1,1,1,1,1,19,1,1,1,18,1,20,1
19014041,Mael,1651,19/11/1984,31,0,0,0,0,170,68,2,3,1,3,2,1,2,1,3,2,3,9,5,9,5,15,6,9,10,1,9,15,5,14,15,6,11,9,9,11,11,12,5,7,4,11,11,10,11,14,12,6,6,9,17,9,20,11,9,10,10,10,10,10,12,11,9,11,11,10,10,7,DM/M C,1,1,1,1,1,1,1,1,1,18,20,1,1,1,1
19014043,Adriano,1651,12/03/1983,33,0,0,0,0,187,78,11,13,13,5,10,11,13,13,10,10,12,6,3,3,2,11,8,7,1,1,2,11,2,1,10,12,16,11,11,12,11,13,15,8,10,3,14,14,13,7,13,9,13,10,12,11,20,11,12,12,5,12,5,11,12,14,16,16,17,14,14,7,GK ,20,1,1,1,1,1,1,1,1,1,1,1,1,1,1
19014106,Alex Fraga,1651,22/05/1986,30,0,0,0,0,180,78,3,1,4,2,3,2,2,3,3,3,1,3,8,6,6,9,4,12,7,12,12,8,7,12,7,14,11,13,10,10,6,11,12,7,13,8,11,14,11,9,7,13,9,9,15,9,20,13,13,13,12,10,7,12,14,11,14,11,13,13,13,9,D C,1,11,1,1,1,1,20,6,14,13,7,1,1,1,1
19014205,Paulo Victor,1651,12/01/1987,29,0,0,0,0,187,76,13,12,13,3,14,12,12,14,10,9,12,1,3,3,2,12,7,1,1,5,2,11,4,2,11,11,13,12,13,12,8,12,14,1,15,3,13,12,13,10,14,12,14,20,10,13,8,12,12,13,6,9,8,11,11,13,10,14,13,12,13,6,GK ,20,1,1,1,1,1,1,1,1,1,1,1,1,1,1
19014249,Marcel,1651,31/05/1983,33,0,0,0,0,171,64,2,3,2,1,2,1,2,1,3,2,3,7,12,11,9,10,5,8,9,12,11,12,5,10,11,8,10,12,9,11,9,10,5,9,7,12,12,12,12,13,13,11,4,20,9,13,5,13,6,9,8,9,9,9,13,11,12,9,13,12,10,7,D/WB L,1,1,1,1,1,1,1,18,1,1,1,1,1,20,1
19014260,Serginho,1651,04/08/1986,29,0,0,0,0,177,71,1,3,2,1,2,2,3,1,2,1,3,10,10,11,10,10,6,8,10,4,12,10,10,12,11,14,12,13,12,11,10,13,15,13,13,11,11,13,12,14,13,10,8,9,13,14,20,14,12,7,16,12,12,15,8,13,11,11,10,7,10,8,DM C,1,1,1,1,1,1,1,1,13,20,15,1,1,1,13
19014265,Júlio César,1651,01/09/1985,30,0,0,0,0,180,79,3,1,3,1,1,2,1,3,2,1,4,5,6,7,4,10,3,8,7,7,8,6,6,13,9,9,10,9,6,9,9,14,3,7,9,6,9,9,4,14,14,9,8,20,13,14,9,5,7,9,9,9,9,9,7,12,12,13,12,5,13,1,D/WB L,1,1,1,1,1,1,1,20,1,1,1,1,1,19,1
19014269,Robertinho,1651,28/04/1986,30,0,0,0,0,174,64,3,1,2,1,2,1,1,3,1,2,3,6,7,13,13,13,6,11,5,1,5,7,8,1,10,9,7,8,11,5,7,9,5,10,12,12,7,6,7,13,13,7,4,1,12,13,20,6,12,9,3,9,8,9,12,11,13,11,11,4,4,6,S ,1,1,20,1,1,1,1,1,1,1,1,1,1,1,1
19014300,Paulinho Pitbull,1651,06/12/1982,33,0,0,0,0,178,0,1,3,3,1,3,3,3,2,1,3,1,6,6,5,12,4,4,8,8,1,7,10,1,7,9,8,8,7,6,4,7,10,5,8,14,9,8,7,9,14,13,7,9,12,7,14,20,13,5,8,7,8,8,8,20,12,13,9,11,12,5,2,M/AM/S C,1,1,16,20,1,1,1,1,1,1,19,1,1,1,1
19014318,Carciano,1651,13/05/1981,35,0,0,0,0,179,76,3,2,3,2,3,3,1,2,2,1,2,5,9,3,2,9,3,13,7,5,12,9,4,13,5,9,11,9,8,9,1,14,4,1,16,7,12,7,8,10,9,10,10,10,14,7,20,11,7,9,9,9,9,9,12,9,13,9,11,12,9,2,D C,1,1,1,1,1,1,20,1,13,1,1,1,1,1,14
19014320,Daniel,1651,14/06/1989,27,0,0,0,0,185,84,1,3,1,2,1,1,1,3,2,3,1,5,5,6,6,7,5,13,7,9,10,8,7,12,7,13,10,13,8,9,5,11,14,7,13,7,12,9,13,7,7,14,13,6,12,9,20,11,14,12,13,9,8,4,12,13,12,10,12,15,13,6,D RC,1,1,1,1,1,1,20,1,15,1,1,1,1,1,1
19014323,Neto,1651,11/10/1985,30,0,0,0,0,185,85,2,1,1,2,3,1,3,3,3,2,3,8,6,6,4,10,4,12,8,2,11,10,2,13,8,9,12,10,9,9,12,10,9,1,11,7,15,13,10,13,9,9,13,3,13,9,20,9,13,9,6,6,9,9,12,10,12,9,12,13,5,5,D C,1,1,1,1,1,1,20,1,1,13,7,1,1,1,1
19014339,Marcelo Cordeiro,1651,12/04/1981,35,0,0,0,0,175,69,1,3,2,2,1,1,1,3,3,3,1,12,12,11,11,11,12,8,9,13,10,12,13,10,12,11,10,13,11,12,12,12,15,11,13,11,10,12,12,12,11,11,9,20,13,12,7,12,10,14,8,14,8,13,15,14,12,15,10,4,13,10,D/WB L,1,1,1,12,7,1,1,18,1,5,11,14,1,20,1
19014340,Marcos Rocha,1651,11/12/1988,27,2,0,0,0,176,68,2,4,4,3,1,1,1,2,2,3,2,12,14,13,12,14,9,8,11,13,12,14,11,14,15,15,12,11,13,13,14,12,13,14,9,14,12,12,13,15,13,9,11,10,17,16,20,14,8,13,13,14,9,14,18,12,11,10,12,7,10,11,D/WB RL,1,1,1,1,1,14,1,15,20,1,1,7,14,16,19
19014435,Kanu,1651,03/05/1984,32,0,0,0,0,188,80,3,2,1,1,2,1,2,1,3,2,3,2,6,9,8,9,9,14,10,5,13,10,10,15,9,18,12,16,8,10,6,13,15,6,12,14,13,16,17,11,9,9,15,8,17,10,20,16,16,12,15,14,6,7,9,13,13,14,14,4,8,8,D C,1,1,1,1,1,1,20,1,1,1,1,1,1,1,1
19014459,Maycon,1651,06/06/1986,30,0,0,0,0,179,71,4,1,1,3,1,3,2,3,3,3,1,6,6,14,11,12,7,9,11,2,4,9,9,4,13,5,6,5,11,6,4,7,9,14,12,10,4,6,8,13,12,10,10,20,10,13,11,12,10,9,9,9,10,12,11,10,12,11,16,15,18,5,S L,1,1,20,10,15,10,1,1,1,1,5,10,5,1,1
19014460,Márcio Serrão,1651,10/01/1984,32,0,0,0,0,178,72,3,3,3,3,2,1,1,1,1,1,1,10,14,8,4,14,6,5,6,6,7,8,3,8,14,8,8,7,8,8,6,6,8,7,10,7,7,7,8,11,8,7,4,20,9,8,9,7,8,8,8,3,4,8,17,8,11,12,12,10,10,6,WB/M L,1,1,1,1,1,1,1,15,1,1,1,19,1,20,1
19014601,Charles,1651,31/08/1982,33,0,0,0,0,179,0,3,3,1,2,2,2,2,1,2,2,3,8,8,2,5,4,5,11,5,6,14,9,6,11,8,10,13,10,9,14,4,14,11,1,10,8,10,8,9,10,12,9,10,4,13,11,20,11,11,10,10,2,10,10,11,11,14,10,13,1,12,2,D C,1,1,1,1,1,1,20,1,1,1,1,1,1,1,1
19014606,Dadá,1651,02/11/1983,32,0,0,0,0,172,70,2,2,3,2,2,3,2,3,1,1,2,8,11,5,9,10,12,8,9,5,13,10,5,14,10,14,12,14,10,12,9,10,13,7,11,9,13,14,13,13,10,7,7,8,14,11,20,13,10,11,10,7,7,14,20,10,11,12,10,9,9,1,DM/M C,1,1,1,1,1,1,1,1,1,20,16,1,1,1,1
19014610,Maranhão,1651,25/12/1985,30,0,0,0,0,170,70,3,1,1,2,3,3,3,1,2,3,2,10,11,10,5,6,4,5,8,11,10,11,4,10,12,12,11,12,10,11,10,9,12,11,10,12,10,11,11,14,13,8,6,5,10,14,20,15,10,10,10,10,10,10,10,9,13,11,11,8,14,4,D/WB R,1,1,1,1,1,1,1,1,17,1,1,1,1,1,20
19014623,Bogé,1651,16/05/1983,33,0,0,0,0,176,74,3,2,1,3,1,1,3,2,2,2,1,9,9,5,7,13,9,9,11,5,11,15,2,12,14,6,11,9,9,10,13,15,8,1,3,9,15,10,13,13,12,10,7,8,14,14,20,9,8,10,6,5,4,10,12,10,10,12,8,4,4,5,DM ,1,1,1,1,1,1,1,1,1,20,12,1,1,1,1
19014658,Jefferson Feijão,1651,16/12/1986,29,0,0,0,0,168,64,3,1,3,2,3,2,1,2,1,2,2,11,7,12,9,11,6,5,10,5,8,12,6,8,11,12,10,10,11,10,12,11,12,13,9,12,10,11,11,15,15,3,4,8,15,14,20,11,3,10,9,10,10,12,18,11,11,11,11,6,13,7,D/WB R,1,1,1,1,1,1,1,1,20,1,1,1,1,1,19
19014701,Marcos Pimentel,1651,26/08/1983,32,0,0,0,0,170,58,1,2,4,3,1,3,3,1,1,2,2,10,10,11,10,10,10,8,10,12,10,10,11,9,10,12,9,13,11,9,8,9,14,12,7,12,9,11,11,12,13,9,4,9,15,13,20,12,7,12,7,10,7,12,11,13,11,13,12,8,15,10,D/WB R,1,1,1,1,1,5,1,1,20,1,1,1,10,1,19
19014703,Éverton,1651,08/08/1984,31,0,0,0,0,171,65,2,4,2,3,2,2,4,2,1,2,3,11,11,12,10,10,10,6,11,6,8,11,9,9,11,14,7,10,10,9,10,9,13,13,9,11,9,10,13,13,12,6,4,20,13,13,8,13,8,10,12,13,9,18,13,12,10,13,12,11,11,9,D/WB/M/AM LC,1,1,1,13,20,1,1,19,1,12,18,18,1,19,1
19014704,Dionanthan,1651,17/02/1985,31,0,0,0,0,185,0,14,7,7,1,11,12,11,11,9,4,11,3,3,3,1,5,5,1,2,3,2,1,2,3,6,6,8,13,5,10,7,14,12,1,1,1,9,8,7,14,8,6,13,16,13,13,20,7,10,9,9,8,9,9,15,12,12,11,13,9,15,8,GK ,20,1,1,1,1,1,1,1,1,1,1,1,1,1,1
19014822,Paulo Paraíba,1651,03/11/1986,29,0,0,0,0,187,78,1,1,1,3,1,2,3,1,3,2,3,3,6,8,7,9,6,13,9,7,12,9,8,12,8,14,11,14,10,11,7,9,12,7,10,9,10,15,13,12,11,13,14,8,14,11,20,15,13,11,12,9,10,8,9,11,8,10,11,11,10,7,D C,1,11,1,1,1,1,20,1,1,1,1,1,1,1,1
19014823,Weverson,1651,03/06/1988,28,0,0,0,0,186,74,4,3,1,1,1,2,3,4,2,3,3,8,4,3,2,8,15,9,4,6,13,8,5,13,9,7,7,10,8,8,6,13,5,1,5,5,13,7,8,13,13,8,15,10,10,11,20,5,8,9,1,10,3,10,8,12,10,10,9,2,8,6,D C,1,1,1,1,1,1,20,1,1,1,1,1,1,1,1
19014878,Branco,1651,25/05/1985,31,0,0,0,0,171,72,2,1,3,2,1,3,2,1,3,3,3,8,7,14,14,14,8,14,10,5,8,7,8,6,10,10,8,8,10,8,7,11,3,9,10,11,9,8,10,14,10,8,6,9,15,12,20,6,7,10,5,10,10,10,7,13,9,11,10,1,1,7,AM/S C,1,1,20,18,1,1,1,1,1,1,1,1,1,1,1
19014887,Michell Parintins,1651,01/09/1981,34,0,0,0,0,182,0,2,3,2,3,1,4,2,3,1,3,3,12,10,11,10,12,12,8,11,4,5,12,11,6,12,8,9,10,10,10,11,10,11,10,10,10,6,9,9,11,10,11,11,8,14,11,20,10,12,10,6,10,7,10,9,8,11,11,14,7,1,1,M/AM C,1,1,1,20,10,10,1,1,1,1,19,5,5,1,1
19014907,Flamel,1651,06/10/1983,32,0,0,0,0,169,67,2,2,2,1,3,1,1,2,2,2,3,9,9,13,11,15,9,8,15,3,7,9,9,9,13,10,14,3,11,9,10,11,4,15,10,12,11,10,12,13,14,8,6,8,10,14,20,13,6,9,10,8,8,10,18,12,10,13,12,10,16,5,AM C,1,1,1,20,1,1,1,1,1,1,15,1,1,1,1
19014914,Anderson,1651,26/08/1982,33,0,0,0,0,188,85,1,4,3,1,3,1,1,1,1,3,2,4,9,8,6,9,8,13,9,13,12,10,9,11,9,15,9,14,10,10,8,10,12,8,12,9,12,14,12,10,11,13,13,20,14,11,10,12,13,10,13,9,14,13,12,14,15,12,10,10,9,14,D C,1,10,1,1,1,1,20,10,10,1,1,1,1,7,8
19014966,Luciano Mourão,1651,03/04/1982,34,0,0,0,0,173,0,2,2,2,1,2,2,2,2,2,2,1,12,10,12,8,11,11,6,8,6,7,12,10,6,13,8,13,7,8,8,13,9,8,12,6,13,8,10,10,10,12,8,8,10,14,10,20,9,6,8,8,1,9,8,7,12,9,10,10,8,8,12,M/AM C,1,1,1,18,1,1,1,1,1,10,20,1,1,1,1
19014971,Glaydson Almeida,1651,16/06/1983,33,0,0,0,0,177,79,2,1,2,2,2,3,1,2,2,3,3,4,5,6,5,6,6,5,14,6,13,12,5,13,8,12,11,13,12,12,12,13,11,10,11,9,12,13,13,12,11,12,9,7,11,12,20,13,14,10,12,11,8,8,13,12,13,11,13,14,11,9,DM C,1,1,1,1,1,1,1,1,1,20,15,1,1,1,1
19014992,Martony,1651,14/08/1987,28,0,0,0,0,187,90,3,1,3,3,2,2,1,1,1,2,3,6,4,4,4,7,3,13,3,2,13,7,3,13,4,9,8,8,7,9,3,13,9,1,8,6,13,6,7,13,10,7,8,10,5,13,20,8,10,9,5,9,6,9,8,14,11,12,13,11,11,5,D C,1,1,1,1,1,1,20,1,1,1,1,1,1,1,1
19015056,Luís Henrique,1651,27/05/1984,32,0,0,0,0,188,0,1,1,3,2,2,1,1,2,2,3,1,7,5,1,1,8,4,14,5,1,8,3,1,12,4,5,12,9,6,11,4,14,4,5,13,6,14,7,8,12,12,8,13,1,12,9,20,8,8,9,6,9,5,9,15,11,11,12,8,11,8,5,D C,1,1,1,1,1,1,20,1,1,10,1,1,1,1,1
19015060,Ricardo,1651,04/03/1985,31,0,0,0,0,182,0,2,3,2,1,2,1,2,2,1,4,2,8,5,9,6,7,3,11,8,4,11,8,3,9,9,7,11,11,8,9,8,11,4,4,12,9,11,10,11,11,13,10,11,10,17,14,20,11,10,10,8,9,4,18,15,11,12,12,11,6,10,4,D/WB RLC,1,1,1,1,1,1,20,17,18,1,14,1,1,15,16
19015119,Guilherme,1651,25/04/1987,29,0,0,0,0,175,0,1,3,2,3,2,2,1,1,3,2,1,7,9,9,7,13,7,5,6,7,9,11,5,10,13,10,9,9,9,9,7,9,3,4,11,9,9,9,9,13,13,6,8,10,9,13,20,13,6,10,10,8,10,10,7,10,10,12,11,2,17,8,WB/M RC,1,1,1,13,1,1,1,1,15,1,16,1,12,1,20
19015149,Rodrigo Longaray,1651,12/05/1985,31,0,0,0,0,171,73,1,3,2,4,1,1,1,2,2,3,2,11,10,10,7,10,11,9,10,8,14,10,6,14,11,15,12,15,10,14,10,10,13,8,11,11,12,13,14,13,10,13,6,10,12,10,20,14,13,13,8,8,11,10,7,7,12,11,11,11,12,7,DM ,1,1,1,1,1,1,1,1,1,20,10,1,8,1,1
19015168,Kássio,1651,11/02/1987,29,0,0,0,0,196,80,3,1,1,4,1,2,3,3,2,3,2,7,9,9,6,9,3,13,8,8,12,11,6,12,10,11,10,13,10,13,9,13,9,6,12,8,12,12,15,9,10,14,15,5,12,10,20,14,14,14,6,11,5,11,14,9,8,12,13,12,11,7,D/DM C,1,10,1,8,1,1,18,1,1,20,15,1,1,1,1
19015206,Bruno Farias,1651,20/11/1987,28,0,0,0,0,173,72,3,3,1,2,1,3,3,4,2,3,1,10,10,12,11,11,10,9,10,7,8,11,6,5,12,10,9,7,11,9,11,12,16,12,1,10,8,9,12,15,14,13,7,20,13,15,8,10,9,10,8,10,10,10,20,11,11,12,12,8,15,4,AM LC,1,1,9,20,16,1,1,1,1,1,10,10,1,1,1
19015208,Fernando,1651,06/01/1988,28,0,0,0,0,176,67,1,2,1,2,1,2,1,3,4,1,2,6,7,9,10,9,8,10,11,3,13,12,1,12,10,15,11,15,7,11,8,11,12,7,12,11,12,13,12,12,11,12,7,20,4,11,7,11,8,12,6,9,9,15,10,8,12,9,11,14,14,8,DM/M C,1,1,1,1,1,1,1,1,1,20,16,13,1,1,1
19015209,Fred,1651,15/01/1986,30,0,0,0,0,188,83,2,2,3,3,1,1,2,2,2,3,2,3,7,5,5,6,17,15,12,10,13,12,7,14,7,16,11,13,11,10,8,11,15,12,15,11,13,15,15,11,12,15,16,8,14,12,20,15,15,13,16,12,5,11,8,6,10,13,14,10,14,7,D/DM C,1,11,1,1,1,1,20,1,1,18,1,1,1,1,1
19015213,Titi,1651,12/03/1988,28,0,0,0,0,188,83,1,4,4,1,2,1,1,2,2,2,3,5,7,8,8,8,6,14,8,8,14,10,11,15,9,16,12,16,11,14,7,12,13,6,14,10,15,15,11,11,10,15,15,20,17,12,10,12,16,12,13,11,6,7,12,13,12,11,11,8,7,6,D C,1,1,1,1,1,1,20,1,1,1,1,1,1,1,1
19015349,Gílson,1651,14/05/1986,30,0,0,0,0,176,70,3,2,2,1,1,1,1,2,3,3,3,11,11,11,11,12,11,6,12,11,11,12,13,10,12,12,12,11,11,11,10,10,12,12,10,11,10,11,11,13,14,10,6,20,13,14,9,12,9,11,12,3,5,11,13,12,13,9,12,7,10,10,D/WB/M LC,1,1,1,1,12,1,1,18,1,15,16,15,1,20,1
19015369,Beto Fronza,1651,10/07/1984,31,0,0,0,0,185,80,1,3,2,2,1,1,3,3,2,2,4,6,8,5,4,4,6,12,5,8,10,6,13,11,7,9,9,12,11,11,6,11,8,6,11,6,12,11,11,6,9,9,13,9,11,7,20,11,11,12,8,12,7,9,13,11,11,11,9,14,14,7,DM C,1,13,1,1,1,1,15,1,1,20,1,1,1,1,1
19015607,Ernando,1651,17/04/1988,28,0,0,0,0,184,75,3,1,3,1,3,1,2,1,3,2,1,6,10,10,8,11,7,14,8,7,14,11,7,14,10,14,14,14,12,13,10,13,13,9,13,12,15,14,14,14,13,13,12,10,14,13,20,14,13,13,14,12,9,12,8,14,13,14,11,12,9,11,D LC,1,11,1,1,1,1,20,15,13,12,6,1,1,13,7
19015705,Eder,1651,21/08/1989,26,0,0,0,0,171,69,2,3,4,3,1,1,1,2,1,2,1,7,7,12,14,14,7,7,9,6,8,8,5,6,11,9,11,8,10,8,9,12,11,15,7,13,8,7,9,12,12,12,10,10,10,14,20,8,8,14,9,11,4,9,13,12,10,12,10,3,7,8,AM/S C,1,1,16,20,1,1,1,1,1,1,10,1,1,1,1
19015709,Muriel,1651,18/02/1988,28,0,0,0,0,174,63,1,2,1,1,2,3,1,3,3,2,1,7,9,8,2,11,8,8,7,8,11,11,4,10,10,8,8,9,10,10,8,11,10,2,12,9,11,9,10,14,14,9,8,10,15,14,20,6,7,10,6,2,9,10,15,11,9,14,12,8,4,7,D/WB/DM RC,1,1,1,1,1,1,1,1,20,16,15,10,1,1,19
19015710,Pedro Calçado,1651,04/08/1986,29,0,0,0,0,174,67,1,3,1,3,1,3,2,1,3,3,3,8,11,13,11,12,7,8,3,4,7,6,7,8,8,4,8,2,10,8,12,12,6,9,5,9,7,8,9,14,13,8,9,20,10,13,10,9,8,9,3,9,4,9,12,13,10,10,11,6,10,4,AM RL,1,1,15,10,20,18,1,1,1,1,1,1,1,1,1
19015745,Guilherme Moreira,1651,11/04/1987,29,0,0,0,0,170,72,2,3,2,3,1,4,1,3,3,3,2,12,12,11,8,10,12,7,9,7,4,13,9,4,13,6,12,9,12,12,13,11,11,13,5,12,8,12,13,13,12,10,7,8,12,12,20,13,10,12,6,7,10,7,12,11,14,12,13,15,15,5,M C,1,1,1,15,1,1,1,1,1,1,20,1,1,1,1
19015750,Tony,1651,29/05/1986,30,0,0,0,0,176,73,2,1,1,1,2,2,4,2,3,3,3,8,10,11,13,11,10,9,13,5,7,11,11,4,12,12,10,10,13,9,11,10,12,13,10,12,6,13,10,15,13,9,8,9,11,15,20,15,10,12,11,11,8,12,14,13,10,10,9,10,16,2,AM/S C,1,1,17,20,1,1,1,1,1,1,12,1,1,1,1
19015774,Leandro Silva,1651,07/04/1986,30,0,0,0,0,183,78,2,3,2,2,2,1,1,1,1,3,1,10,10,8,7,9,7,12,8,8,12,9,7,14,9,13,11,13,10,10,9,10,9,6,11,10,12,13,14,13,12,8,12,9,16,13,20,14,11,8,14,7,5,11,18,8,13,7,12,10,8,6,D RC,1,1,1,1,1,1,20,1,17,12,1,1,1,1,13
19015837,Otávio,1651,08/06/1988,28,0,0,0,0,172,68,4,4,2,1,3,2,2,1,3,3,1,6,5,10,7,14,8,8,8,5,9,11,6,6,12,10,11,8,10,8,12,14,9,11,6,12,9,9,13,11,12,9,6,10,13,11,20,10,6,10,4,6,10,10,12,12,13,10,11,7,13,1,M/AM C,1,1,1,20,1,1,1,1,1,1,16,1,1,1,1
19015925,Wagner Silva,1651,24/09/1989,26,0,0,0,0,189,85,1,2,3,1,3,4,1,3,2,1,3,3,3,5,4,6,4,13,4,6,12,6,7,13,5,13,9,13,6,7,5,8,14,2,7,3,11,12,12,11,10,9,12,10,12,10,20,12,12,5,10,10,6,5,10,12,12,9,12,10,10,13,D C,1,1,1,1,1,1,20,1,1,1,1,1,1,1,1
19016051,Vander,1651,03/10/1988,27,0,0,0,0,174,76,1,1,2,2,2,3,1,2,2,3,1,12,13,14,10,12,11,5,13,9,4,11,12,5,14,15,11,13,10,8,11,9,16,14,6,12,3,7,10,15,13,7,6,20,11,14,8,13,9,11,14,11,12,14,13,11,12,10,10,9,5,10,AM RL,1,1,10,12,20,17,1,1,1,1,8,15,14,1,1
19016088,Léo Franco,1651,13/08/1986,29,0,0,0,0,176,70,3,3,3,2,2,1,3,2,3,3,2,13,13,11,12,12,10,7,14,5,7,13,8,6,12,9,7,6,9,8,14,14,7,9,9,11,8,8,12,12,10,6,8,9,12,10,20,8,7,9,9,6,9,9,17,11,12,12,6,5,1,4,M/AM C,1,1,1,20,1,1,1,1,1,1,18,1,1,1,1
19016090,Thiago Carpini,1651,16/07/1984,31,0,0,0,0,185,79,2,3,4,2,3,2,3,2,3,1,3,5,9,11,10,11,7,13,11,7,12,13,12,12,12,14,10,14,12,12,10,12,12,8,8,10,13,11,11,12,13,12,12,7,14,13,20,12,12,11,14,10,9,12,11,11,9,11,15,15,9,11,DM/M C,1,10,1,8,1,1,5,1,7,20,19,6,11,1,9
19016131,Julinho,1651,28/06/1990,26,0,0,0,0,175,70,2,2,1,2,3,3,3,2,2,1,4,6,8,13,13,11,7,13,7,1,5,7,11,5,12,10,13,7,13,8,7,13,11,12,9,13,6,7,8,13,13,7,7,11,8,13,20,9,11,9,10,4,6,10,10,8,12,12,9,4,4,5,S ,1,1,20,1,1,1,1,1,1,1,1,1,1,1,1
19016132,Juninho,1651,08/01/1989,27,0,0,0,0,171,64,2,3,3,3,4,3,3,3,4,3,1,8,11,11,11,13,13,8,14,5,11,14,10,13,12,11,12,8,13,12,13,13,14,14,12,13,13,14,15,13,12,10,8,13,14,13,20,12,7,13,10,13,7,13,14,11,16,12,15,15,8,10,DM/M C,1,1,1,12,1,1,1,1,1,17,20,7,10,1,1
19016221,Danilo Baia,1651,15/03/1986,30,0,0,0,0,170,70,2,1,3,3,1,1,3,3,1,2,1,8,9,11,9,10,7,6,9,9,7,9,9,7,9,10,7,9,7,10,10,10,10,14,12,7,11,11,11,13,12,7,5,10,11,12,20,10,6,10,10,10,10,10,8,9,12,11,12,8,8,12,D/WB/M/AM R,1,1,13,1,1,17,1,1,20,1,1,1,17,1,17
19016303,Carlinhos,1651,04/08/1983,32,0,0,0,0,173,74,2,1,4,2,3,1,3,3,1,3,2,5,7,7,1,12,3,8,4,7,8,8,2,13,7,9,7,9,8,8,8,7,5,8,10,7,11,8,8,14,13,8,7,20,9,14,6,10,6,9,7,9,3,9,18,11,9,12,11,6,8,7,D/WB L,1,1,1,1,1,1,1,20,1,1,1,1,1,18,1
19016304,Vanderson,1651,27/09/1984,31,0,0,0,0,175,74,1,1,2,1,3,1,1,2,4,2,2,9,13,9,6,8,6,9,8,6,12,11,4,10,12,13,12,14,10,12,10,13,14,9,10,6,12,13,16,13,12,10,8,20,16,14,3,14,9,14,10,12,7,6,18,14,15,10,16,13,12,6,D/WB L,1,1,1,1,1,1,1,20,1,1,1,10,1,19,1
19016305,Moradei,1651,08/02/1986,30,0,0,0,0,175,69,1,3,1,2,3,2,1,1,2,3,2,5,10,7,8,10,5,10,10,10,12,11,11,13,11,14,13,15,10,11,10,12,11,10,12,11,12,15,13,10,11,12,8,12,12,10,20,12,13,10,5,10,10,11,12,12,11,11,10,12,4,5,DM/M C,1,1,1,1,1,1,14,7,10,20,17,10,13,9,12
19016413,Alekito,1651,15/11/1985,30,0,0,0,0,188,0,1,3,3,2,2,3,1,2,2,1,3,6,10,11,7,13,6,13,3,12,9,9,1,9,10,6,7,6,8,7,6,11,9,9,8,13,9,6,7,13,11,7,10,10,13,12,20,12,10,9,9,9,9,9,9,10,13,14,10,1,13,3,S ,1,1,20,1,1,1,1,1,1,1,1,1,1,1,1
19016415,Rafael,1651,20/05/1990,26,3,0,0,0,186,83,12,13,13,8,15,13,14,14,11,12,11,3,2,2,2,12,6,4,3,3,1,11,3,3,8,7,13,13,13,11,12,10,13,1,10,5,14,13,13,13,15,13,14,7,14,13,20,14,12,13,5,13,10,11,11,12,13,14,13,14,12,6,GK ,20,1,1,1,1,1,1,1,1,1,1,1,1,1,1
19016427,Luan,1651,06/04/1990,26,0,0,0,0,177,72,2,2,3,3,4,3,1,3,3,1,1,7,7,10,9,10,2,8,5,1,10,11,4,14,11,4,8,9,8,9,10,9,16,7,6,8,10,9,10,12,13,7,7,9,15,12,20,9,8,7,9,3,9,14,10,16,8,11,10,10,9,16,D/WB R,1,1,1,13,1,1,1,1,20,10,13,1,1,1,16
19016431,Carlos Alberto,1651,22/02/1988,28,0,0,2,0,174,64,1,1,3,2,2,3,1,1,3,2,3,11,11,12,11,12,11,9,10,5,7,12,8,8,14,12,9,9,10,11,12,11,4,15,5,12,7,10,11,14,14,15,7,14,13,14,20,12,3,11,13,2,7,8,19,10,4,12,11,8,12,2,M/AM C,1,1,1,20,10,10,1,1,1,1,17,1,1,1,1
19016500,Édison,1651,28/10/1989,26,0,0,0,0,192,89,2,1,4,4,3,3,3,3,2,1,3,2,5,7,5,9,6,12,6,5,9,9,5,10,7,12,8,11,7,9,6,9,8,8,4,6,9,11,11,10,8,12,16,9,10,9,20,10,12,10,10,10,5,10,7,12,11,11,12,4,12,3,D C,1,1,1,1,1,1,20,1,1,13,1,1,1,1,1
19016509,Renatinho,1651,04/08/1988,27,0,0,0,0,167,68,1,2,4,1,2,2,3,4,3,3,2,12,13,16,12,8,12,6,13,13,6,13,11,5,14,7,8,10,12,9,14,14,11,13,3,15,6,13,12,15,16,7,4,20,15,16,8,12,8,10,13,11,7,16,12,13,11,12,11,6,11,8,M/AM LC,1,1,12,19,20,1,1,7,1,1,15,18,1,9,1
19016513,Mazola,1651,08/05/1989,27,0,0,0,0,177,70,2,3,1,1,1,2,1,3,3,2,2,5,9,16,7,14,10,6,10,8,6,10,11,5,14,12,12,12,5,10,11,9,14,18,7,12,4,9,12,15,15,10,8,20,10,14,10,13,11,12,11,12,12,12,6,12,12,8,8,5,8,15,AM RLC,1,1,15,20,17,19,1,1,1,1,1,1,1,1,1
19016517,Márcio Pit,1651,10/05/1989,27,0,0,0,0,167,62,3,2,1,3,3,3,4,3,1,2,2,10,10,14,10,11,14,7,10,10,6,10,4,6,11,8,13,10,12,12,10,11,9,14,10,15,5,11,11,14,15,8,5,20,13,14,10,14,5,11,10,10,10,10,18,13,10,10,11,5,11,4,D/WB L,1,1,1,1,1,1,1,20,1,1,1,1,1,18,1
19016520,Audálio,1651,14/06/1986,30,0,0,0,0,186,82,1,3,1,2,1,3,1,2,2,2,3,4,6,5,7,6,5,12,5,6,13,12,5,13,11,12,12,13,12,11,12,13,11,11,10,13,12,13,13,13,13,13,13,7,12,13,20,13,14,11,12,12,6,11,12,10,14,13,14,7,12,10,D/DM C,1,13,1,1,1,1,20,1,1,18,1,1,1,1,1
19016522,Cal,1651,08/09/1986,29,0,0,0,0,173,72,1,1,3,2,3,2,1,3,2,3,3,5,4,2,3,7,5,9,11,7,13,8,5,13,5,14,12,13,11,12,12,12,12,14,10,13,13,14,13,14,14,10,8,7,14,14,20,14,14,12,10,11,8,7,10,11,13,11,11,8,13,12,DM C,1,1,1,1,1,1,1,1,1,20,15,1,1,1,1
19016523,Luiz Gustavo,1651,23/07/1987,28,41,2,0,0,187,80,3,2,3,2,1,1,2,3,1,4,2,7,10,11,7,12,7,10,12,13,15,13,8,18,12,18,13,17,12,14,10,12,17,7,13,9,14,17,18,14,13,16,14,20,18,13,12,18,14,15,16,15,6,15,14,13,10,14,12,8,7,8,DM/M C,1,1,1,1,1,1,14,13,1,20,20,1,1,13,1
19016606,Marcelo Mineiro,1651,14/12/1985,30,0,0,0,0,189,0,1,3,1,3,1,2,2,2,1,3,3,3,5,7,7,9,8,13,9,2,12,10,8,12,8,13,11,13,10,12,7,11,12,7,13,8,13,13,12,10,8,13,13,2,14,9,20,14,13,12,13,10,9,9,13,10,7,13,11,8,9,4,D C,1,11,1,1,1,1,20,1,1,1,1,1,1,1,1
19016686,Fabrício,1651,07/09/1986,29,0,0,0,0,183,0,3,3,2,3,1,1,1,2,2,1,3,8,8,10,12,10,8,14,10,3,1,9,1,1,11,9,15,9,9,6,8,8,9,8,6,12,7,8,9,11,11,9,11,9,12,11,20,11,11,9,9,9,3,9,13,11,11,10,13,2,15,7,S ,1,1,20,1,1,1,1,1,1,1,1,1,1,1,1
19016748,Felipe,1651,09/05/1991,25,0,0,0,0,192,75,15,9,11,1,10,12,8,11,9,8,11,2,1,3,3,3,5,1,2,2,2,1,4,3,5,6,10,15,9,10,4,9,11,3,5,5,7,9,10,7,11,9,16,5,15,8,20,6,12,9,7,9,9,9,11,10,10,9,10,10,16,6,GK ,20,1,1,1,1,1,1,1,1,1,1,1,1,1,1
19016758,Émerson,1651,08/07/1991,24,0,0,0,0,170,69,2,3,1,2,1,2,1,3,4,2,1,8,10,11,10,10,7,6,9,2,4,11,5,4,12,10,8,8,9,7,10,8,12,11,3,11,7,10,10,13,13,8,5,20,12,13,10,9,7,11,10,11,5,10,12,14,5,12,10,7,14,12,M/AM/S RLC,1,1,19,20,18,17,1,1,1,1,15,16,14,1,1
19016906,Fernando,1651,14/11/1986,29,0,0,0,0,180,76,3,3,1,2,2,1,1,3,3,4,2,7,8,12,8,11,10,15,8,3,9,9,4,6,12,10,12,10,9,10,11,10,7,9,5,9,9,10,11,12,13,10,12,20,10,11,10,10,8,10,10,9,10,10,12,11,10,11,14,10,14,3,AM/S LC,1,1,20,16,17,10,1,1,1,1,4,1,1,1,1
19016963,Hélton Luiz,1651,02/01/1987,29,0,0,0,0,171,64,3,2,2,1,3,3,1,3,2,1,3,14,11,13,12,12,14,7,12,2,5,13,14,5,13,11,9,9,12,7,14,11,17,13,6,13,8,10,11,13,15,8,5,10,13,15,20,11,6,13,11,11,8,13,11,16,10,15,15,14,13,9,M/AM RC,1,1,6,20,11,19,1,1,3,5,18,7,17,1,8
19016990,Willians,1651,22/05/1988,28,0,0,0,0,180,70,1,3,3,2,3,1,1,1,1,3,3,9,9,10,9,11,6,6,7,7,6,10,11,6,11,15,8,14,6,7,7,7,14,15,5,11,5,9,12,15,15,6,9,6,16,15,20,13,6,11,7,11,10,16,13,14,15,10,16,8,13,9,M/AM/S RLC,1,1,18,20,18,19,1,5,7,10,17,15,16,9,10
19017188,Danilo Lins,1651,23/05/1986,30,0,0,0,0,179,75,2,2,3,2,1,3,2,3,4,3,2,2,6,10,12,11,2,12,9,1,2,9,12,2,11,12,9,15,10,8,9,8,13,9,5,12,7,12,12,13,12,9,8,9,11,13,20,12,11,12,9,1,6,9,17,9,10,10,13,8,11,6,S ,1,1,20,1,1,1,1,1,1,1,1,1,1,1,1
19017804,Marcelo Oliveira,1651,29/03/1987,29,0,0,0,0,184,76,3,2,3,1,3,4,3,3,2,1,2,5,12,12,10,13,5,13,12,13,12,12,11,13,12,12,12,15,13,13,12,13,13,13,15,13,13,14,14,13,13,12,12,20,15,13,6,14,13,12,11,12,9,15,12,11,15,13,14,13,12,9,D/WB/DM LC,1,1,1,1,1,1,15,20,1,19,13,10,1,18,1
19017805,Thiago Elias,1651,09/06/1987,29,0,0,0,0,176,67,3,1,3,3,3,2,3,3,1,3,1,10,7,13,10,11,10,11,9,8,8,12,5,9,11,7,12,12,9,10,11,11,9,13,10,13,8,9,10,13,14,12,11,9,11,13,20,12,11,10,7,7,7,12,11,12,9,11,11,12,5,7,AM RLC,1,1,1,20,17,20,1,1,13,1,15,1,13,1,13
19017870,André Luís,1651,19/02/1986,30,0,0,0,0,177,71,1,1,3,1,3,2,2,2,2,1,2,5,9,14,9,10,6,9,9,3,6,11,12,8,13,10,11,11,11,12,10,11,12,12,11,11,7,11,12,16,14,12,8,8,13,16,20,12,8,12,7,9,5,10,7,12,15,13,7,7,13,11,S ,1,1,20,11,13,13,1,1,1,1,1,1,1,1,1
19017906,André,1651,25/01/1983,33,0,0,0,0,184,82,2,1,3,1,4,2,2,3,3,1,1,6,7,9,10,10,8,11,10,6,11,12,5,11,11,14,11,13,10,11,10,12,12,8,11,10,13,13,12,11,12,12,12,8,13,10,20,13,12,10,10,8,9,10,10,11,11,10,15,15,15,9,DM/M C,1,1,1,1,1,1,1,1,1,20,18,1,1,1,1
19017908,Maicon,1651,14/09/1988,27,0,0,0,0,190,85,1,1,1,2,1,1,1,3,2,1,1,7,8,9,7,11,13,15,13,10,15,12,10,14,12,16,14,14,11,11,8,11,16,7,17,7,14,14,14,13,13,7,16,10,16,14,20,16,16,12,13,15,8,10,14,13,16,15,15,10,10,9,D C,1,7,1,1,1,1,20,1,10,1,1,1,1,1,1
19018157,Lins,1651,11/09/1987,28,0,0,0,0,172,69,3,3,3,1,1,2,3,3,3,3,3,9,10,13,12,12,9,9,10,6,7,12,12,6,12,11,12,11,12,10,11,12,9,12,7,13,7,12,12,14,14,15,6,13,12,14,20,13,8,12,7,12,11,11,12,8,9,6,8,5,10,10,AM/S L,1,1,20,10,17,14,1,1,1,1,1,13,9,1,8
19018160,Marquinhos,1651,27/02/1987,29,0,0,0,0,170,65,2,1,3,3,1,3,2,1,2,3,2,5,11,4,6,7,4,7,5,6,6,6,2,6,7,9,10,13,8,12,8,13,15,2,7,5,9,8,8,12,12,14,4,9,12,11,20,12,5,9,9,9,9,9,10,12,12,12,12,7,5,8,D/WB R,1,1,1,1,1,1,1,6,20,1,1,1,1,5,17
19018163,Otávio,1651,22/11/1983,32,0,0,0,0,190,80,1,2,1,1,2,1,2,2,1,3,2,10,7,9,9,9,8,11,10,8,11,8,4,11,11,9,9,12,10,10,7,10,12,8,13,9,11,11,12,12,12,10,15,10,11,12,20,12,11,12,10,10,10,10,17,11,11,10,12,12,10,5,D C,1,1,1,1,1,1,20,1,1,1,1,1,1,1,1
19018179,Marco Aurélio,1651,27/03/1983,33,0,0,0,0,182,70,2,2,1,3,2,1,3,3,3,3,1,12,12,12,8,11,13,9,11,8,12,9,10,11,13,12,10,11,9,11,10,10,10,10,8,4,11,11,12,11,12,12,11,20,12,12,5,11,10,9,7,7,8,8,13,14,10,9,10,13,14,6,D/DM LC,1,1,1,10,8,1,1,17,1,20,15,12,1,14,1
19018299,Danilo Pitbull,1651,26/09/1980,35,0,0,0,0,179,0,1,4,1,3,1,2,1,2,3,4,2,7,5,10,10,13,7,13,8,4,5,8,7,2,10,10,13,9,13,8,6,13,5,13,6,9,8,7,8,14,13,8,5,8,14,14,20,9,9,10,8,10,10,10,7,12,9,13,13,7,15,4,S ,1,1,20,1,1,1,1,1,1,1,1,1,1,1,1
19018350,Wanderson Cafu,1651,18/03/1986,30,0,0,0,0,180,0,2,3,2,2,3,3,3,1,1,1,3,7,9,10,9,9,6,8,6,9,10,10,5,10,10,13,9,13,9,9,10,9,13,4,11,11,10,11,13,14,12,10,10,7,14,14,20,14,7,11,9,9,9,9,13,11,7,10,14,7,11,9,D/WB R,1,1,1,1,1,1,1,1,20,1,1,1,1,1,18
19018368,Fabinho,1651,19/11/1986,29,0,0,0,0,180,69,2,1,3,1,2,3,3,1,3,3,2,11,9,11,9,11,8,11,13,7,14,12,3,13,12,12,11,12,13,12,7,13,12,9,10,11,12,14,13,13,12,11,9,12,14,12,20,14,11,15,12,4,6,18,7,10,11,11,11,5,17,6,DM/M C,1,1,11,12,1,1,9,1,12,20,17,1,1,1,12
19018369,Roberson,1651,02/04/1989,27,0,0,0,0,181,72,2,2,2,3,3,2,3,3,2,2,2,11,7,14,10,14,10,8,11,6,5,10,5,7,11,11,7,14,10,11,5,12,15,12,5,13,8,11,15,16,11,10,11,10,16,15,20,16,10,10,11,11,5,11,16,16,7,11,11,12,7,1,M/AM/S C,1,1,18,20,1,1,1,1,1,1,17,1,1,1,1
19018390,Pablo,1651,16/05/1982,34,0,0,0,0,191,81,14,10,8,3,9,14,13,10,9,3,12,4,3,3,1,1,6,1,1,2,1,2,3,3,3,8,6,10,8,9,5,10,2,1,10,2,10,8,7,10,8,8,16,9,14,9,20,3,9,9,9,1,9,9,20,9,13,12,10,10,12,7,GK ,20,1,1,1,1,1,1,1,1,1,1,1,1,1,1
19018466,Mimica,1651,22/11/1985,30,0,0,0,0,185,79,2,4,3,2,3,3,2,3,1,3,2,7,6,1,4,7,2,11,5,8,11,9,3,11,4,10,11,10,6,11,8,14,5,3,6,6,13,8,9,10,13,13,13,9,10,12,20,9,13,10,10,6,10,10,20,10,5,13,7,8,7,3,D C,1,1,1,1,1,1,20,1,1,1,1,1,1,1,1
19018592,Jouberth,1651,27/05/1987,29,0,0,0,0,175,0,1,2,3,1,3,3,2,3,2,4,2,7,9,11,10,14,7,6,9,7,9,11,5,8,11,11,8,6,8,8,6,8,9,8,9,9,11,8,13,14,14,8,9,9,13,14,20,13,6,9,9,4,9,9,12,11,11,10,10,8,7,7,M LC,1,1,1,1,1,1,1,1,1,1,20,16,1,1,1
19018716,Giovane,1651,25/11/1982,33,0,0,0,0,185,76,2,2,2,1,1,2,3,2,1,2,3,9,8,10,13,12,11,8,11,1,9,9,13,3,11,3,12,7,9,8,8,10,11,13,6,12,10,4,10,9,9,10,11,20,12,11,10,9,9,12,12,9,4,9,12,14,5,11,11,7,14,7,S ,1,1,20,1,1,1,1,1,1,1,1,1,1,1,1
19018793,Leandro,1651,29/12/1983,32,0,0,0,0,183,77,1,3,3,1,1,3,4,1,1,2,3,12,10,12,11,11,11,9,10,8,9,12,11,11,12,12,10,7,8,10,10,11,11,11,10,13,8,13,13,12,12,11,11,20,12,12,8,12,11,11,15,11,8,10,14,14,15,11,10,6,7,5,D/WB L,1,1,1,1,6,1,11,17,1,1,1,12,1,20,1
19018819,Ferrinho,1651,19/03/1984,32,0,0,0,0,168,67,2,2,2,1,4,2,3,2,2,1,3,9,10,12,10,11,10,8,8,10,8,10,5,6,12,6,9,7,10,9,8,10,3,12,6,9,10,12,12,13,14,7,6,8,11,13,20,13,6,9,4,9,9,13,7,12,10,11,10,11,11,8,D R,1,1,1,1,1,1,1,1,20,1,1,1,1,1,15
19018879,Deleu,1651,01/03/1984,32,0,0,0,0,176,77,3,2,2,3,4,3,2,2,3,3,3,4,11,13,8,10,4,10,12,11,10,11,6,10,11,9,13,11,11,10,10,11,14,9,4,9,10,12,13,13,11,10,10,13,13,12,20,13,11,13,11,11,7,14,12,13,9,11,15,11,7,9,D/WB RL,1,1,1,1,5,8,8,16,19,1,1,10,14,16,20
19018941,Nilson Paraíba,1651,01/03/1980,36,0,0,0,0,186,0,2,1,2,1,2,1,1,2,2,1,3,3,2,3,2,6,3,10,3,5,13,7,7,13,5,14,8,6,10,11,5,16,12,7,11,7,10,9,11,8,9,10,11,9,10,9,20,15,11,9,12,3,9,5,20,9,11,11,13,9,9,4,D C,1,1,1,1,1,1,20,1,1,1,1,1,1,1,1
19018962,Isac,1651,08/06/1985,31,0,0,0,0,183,82,2,1,3,1,2,1,2,1,1,3,2,2,6,7,14,11,3,14,13,3,3,11,13,3,11,14,11,13,11,9,12,11,11,11,4,12,11,11,10,13,9,14,14,12,13,13,20,13,15,11,14,12,7,4,14,12,7,11,8,6,12,5,S ,1,1,20,1,1,1,1,1,1,1,1,1,1,1,1
19019030,Wanderson,1651,18/02/1986,30,0,0,0,0,180,75,2,1,3,1,4,2,1,1,3,1,3,11,11,14,14,15,15,10,14,7,5,14,13,7,15,7,13,11,13,13,14,14,12,13,5,11,10,12,10,13,13,13,10,13,12,11,20,12,10,14,5,13,7,6,14,13,13,12,13,12,12,5,AM/S L,1,1,20,10,17,13,1,1,1,1,7,7,7,1,1
19019035,Leandro,1651,09/08/1986,29,0,0,0,0,179,73,1,2,1,2,3,2,3,1,4,2,2,6,8,9,8,10,5,10,10,5,12,11,12,12,10,14,12,14,10,11,8,10,13,8,12,10,12,15,13,13,14,11,9,7,13,13,20,15,8,12,14,10,5,13,11,12,13,12,16,10,11,12,DM C,1,13,1,1,1,1,14,8,5,20,15,1,1,1,1
19019038,Osvaldo,1651,11/04/1987,29,2,0,0,0,169,62,2,2,3,3,1,2,3,1,1,3,3,11,10,13,11,11,10,10,13,10,6,10,12,6,11,11,11,12,11,12,10,9,11,16,5,13,6,9,10,16,15,9,6,7,12,17,20,14,8,11,5,11,5,12,8,11,14,13,18,10,16,5,AM/S RL,1,1,19,8,20,19,1,1,1,1,1,1,1,1,1
19019129,Fabiano,1651,28/04/1983,33,0,0,0,0,180,77,2,2,1,1,2,2,1,1,3,1,2,5,6,4,5,6,4,12,5,3,12,4,4,12,7,13,11,14,10,11,9,12,11,13,13,5,12,12,11,12,10,12,11,10,12,12,20,13,13,11,12,11,5,6,12,10,13,12,13,12,13,11,D C,1,1,1,1,1,1,20,1,1,1,1,1,1,1,1
19019131,Marcos Bala,1651,16/03/1981,35,0,0,0,0,178,76,3,1,3,1,2,3,2,1,4,2,3,5,7,11,12,9,5,8,8,1,1,9,13,1,10,7,7,7,9,5,8,7,12,8,13,13,6,5,7,13,11,6,7,1,12,13,20,11,9,8,8,3,6,8,12,11,10,11,8,8,13,3,AM/S C,1,1,20,18,1,1,1,1,1,1,1,1,1,1,1
19019146,Oliveira,1651,17/10/1981,34,0,0,0,0,189,82,14,14,11,1,12,12,13,8,6,10,13,1,1,3,2,5,3,1,2,3,3,2,3,3,9,11,12,11,9,11,9,14,3,1,9,1,14,10,7,12,10,11,15,11,13,9,20,9,12,12,11,9,7,11,11,9,10,9,10,5,18,3,GK ,20,1,1,1,1,1,1,1,1,1,1,1,1,1,1
19019151,Thiago Humberto,1651,06/07/1985,30,0,0,0,0,183,75,2,1,3,1,3,1,4,3,3,2,2,11,11,14,11,13,12,8,11,7,5,13,11,6,14,10,10,10,11,11,13,11,15,15,6,13,6,11,11,13,13,10,11,20,14,13,13,11,12,12,9,13,9,13,7,13,11,13,14,8,12,10,M/AM/S C,1,1,19,20,14,10,1,1,1,1,16,8,3,5,1
19019165,Wanderson,1651,18/11/1986,29,0,0,0,0,193,83,12,8,7,1,10,8,4,12,9,9,10,4,1,2,1,1,9,1,1,3,1,1,3,2,2,6,9,14,5,12,5,12,10,2,7,3,8,6,5,12,15,6,14,10,12,12,20,5,10,12,9,6,5,9,7,11,18,12,16,12,13,10,GK ,20,1,1,1,1,1,1,1,1,1,1,1,1,1,1
19019169,Luís Carlos,1651,15/06/1987,29,0,0,0,0,170,65,2,3,1,1,2,3,1,2,1,2,3,11,11,13,12,11,8,6,11,7,6,8,10,8,13,10,10,10,9,10,6,8,12,15,7,14,7,10,12,15,14,10,6,20,12,14,6,10,7,9,8,10,7,12,12,12,13,10,12,12,12,7,M/AM/S RL,1,1,16,10,20,16,1,1,1,1,1,16,13,1,1
19019172,Diogo Melo,1651,18/04/1984,32,0,0,0,0,182,82,1,2,3,1,2,2,1,1,2,1,1,12,12,12,11,14,12,10,12,10,12,13,12,10,13,7,12,9,12,12,11,12,12,12,11,12,10,12,11,9,10,12,10,7,7,9,20,11,11,12,7,10,8,10,12,10,12,11,11,12,12,7,M C,1,1,1,10,1,1,1,1,1,13,20,1,1,1,1
19019186,Elionar Bombinha,1651,10/06/1982,34,0,0,0,0,185,74,4,1,2,3,3,1,1,2,1,3,2,7,9,10,12,10,6,13,8,1,1,11,11,4,10,8,10,10,11,8,10,12,11,13,4,12,5,11,8,9,10,11,12,11,12,10,20,8,10,11,8,15,8,9,16,11,13,12,14,14,15,6,S C,1,1,20,15,10,13,1,1,1,1,1,1,1,1,1
19019226,Michel,1651,15/02/1990,26,0,0,3,0,174,67,1,3,2,3,2,2,3,2,3,3,2,12,14,13,12,12,10,7,10,11,12,12,11,12,12,11,13,12,12,11,11,12,14,12,7,15,13,11,12,15,15,11,7,11,14,14,20,16,9,13,8,8,12,13,14,16,12,11,13,12,14,9,D/WB R,1,1,1,1,1,1,1,1,20,1,1,1,11,1,19
19019229,Renan Silva,1651,02/01/1989,27,0,0,0,0,176,69,2,2,4,2,2,1,1,3,1,1,3,11,11,12,11,12,10,8,10,5,8,13,12,6,12,9,11,10,12,9,11,11,10,10,9,12,10,11,12,13,14,9,7,20,12,13,10,12,11,10,7,3,8,14,18,11,12,9,11,1,10,2,M/AM/S C,1,1,18,20,14,6,1,1,1,1,17,11,3,1,1
19019230,Pedro Beda,1651,05/03/1989,27,0,0,0,0,181,79,1,3,1,2,3,4,1,4,2,2,1,5,9,11,11,11,9,13,12,3,6,10,12,7,10,10,11,13,11,11,10,11,12,10,6,13,7,12,12,12,12,14,12,11,13,12,20,10,13,12,8,12,4,7,5,15,14,11,5,14,13,7,S ,1,1,20,13,1,1,1,1,1,1,1,1,1,1,1
19019231,Paulo Sergio,1651,11/06/1989,27,0,0,0,0,183,70,2,3,3,2,2,2,1,3,3,3,3,5,10,11,12,10,7,11,9,3,7,12,12,6,12,10,12,15,11,12,10,13,16,14,6,13,7,9,12,14,13,9,12,9,13,15,20,13,10,11,10,9,13,5,12,16,15,12,6,8,8,15,S ,1,1,20,1,1,1,1,1,1,1,1,1,1,1,1
19019257,Humberto,1651,03/04/1989,27,0,0,0,0,185,82,3,2,1,4,2,2,3,2,3,2,1,8,7,13,11,11,7,4,10,5,7,12,8,5,15,3,10,8,10,10,15,10,3,13,6,10,9,9,11,11,12,9,13,7,12,12,20,12,9,8,9,9,9,9,15,13,10,11,12,1,6,4,AM C,1,1,1,20,1,1,1,1,1,1,10,1,1,1,1
19019264,Fabinho Alves,1651,11/06/1986,30,0,0,0,0,175,66,3,3,1,3,2,3,3,2,2,1,1,1,13,14,12,10,1,10,8,6,5,12,11,8,10,12,11,11,10,12,11,12,13,13,9,14,10,12,13,15,16,11,8,8,13,15,20,13,11,12,11,12,11,11,17,12,9,12,13,14,14,11,S ,1,1,20,1,1,1,1,1,1,1,1,1,1,1,1
19019271,Arthur,1651,10/01/1990,26,0,0,0,0,186,75,3,2,2,3,3,1,3,3,3,3,1,1,3,1,4,6,1,14,7,1,10,8,3,8,7,8,7,9,8,10,3,14,2,1,9,7,13,7,8,12,9,8,15,8,2,14,20,8,9,9,9,9,4,9,12,11,10,11,11,6,8,3,D C,1,1,1,1,1,1,20,1,1,1,1,1,1,1,1
19019275,Felipe Lima,1651,02/02/1989,27,0,0,0,0,181,78,3,3,1,2,1,3,2,3,3,4,2,9,9,8,9,14,8,12,15,4,11,9,4,9,14,11,9,9,11,11,15,11,5,10,4,6,12,11,13,12,15,12,10,11,12,13,20,11,12,11,8,9,7,10,20,11,9,11,12,4,8,7,DM/M C,1,1,1,1,1,1,1,1,1,20,17,1,1,1,1
19019276,Fernando Bob,1651,07/01/1988,28,0,0,0,0,179,77,1,1,2,2,2,3,2,3,3,1,2,9,13,12,10,14,7,11,11,7,12,15,8,13,14,13,13,12,15,12,14,14,13,12,8,13,14,12,13,12,13,13,9,20,13,12,7,16,12,13,10,10,7,13,13,13,15,13,13,9,14,12,DM/M C,1,1,1,10,1,1,1,1,1,18,20,1,1,1,1
19019280,Leo Itaperuna,1651,12/04/1989,27,0,0,0,0,173,72,1,2,2,1,2,1,1,2,2,2,3,6,9,13,11,14,6,9,11,4,3,13,12,4,14,7,11,5,11,13,11,13,15,13,7,13,4,12,12,16,14,5,5,14,12,15,20,14,5,12,11,11,13,11,14,13,14,15,13,12,13,12,S ,1,1,20,1,12,11,1,1,1,1,1,1,1,1,1
19019285,Maurício,1651,21/10/1988,27,0,0,0,0,180,74,4,2,1,3,2,2,1,2,3,1,2,11,12,14,11,13,13,12,13,6,11,14,13,13,15,14,15,10,13,15,13,15,14,13,11,14,13,14,15,13,13,13,9,9,14,13,20,13,9,12,14,13,7,13,14,15,10,10,12,13,12,8,DM/M C,1,1,1,14,10,10,1,1,1,17,20,10,10,1,1
19019287,Mário,1651,14/01/1988,28,0,0,0,0,183,76,3,3,2,1,2,1,1,1,1,1,2,1,8,7,11,9,9,13,11,1,6,8,14,7,9,12,10,14,11,8,7,9,12,12,9,11,8,11,12,10,9,13,11,8,15,10,20,13,12,11,11,11,7,16,12,11,9,11,12,14,15,13,S ,1,1,20,1,1,1,1,1,1,1,1,1,1,1,1
19019288,Digão,1651,07/05/1988,28,0,0,0,0,186,94,1,2,2,1,3,2,3,3,1,3,4,6,7,12,7,12,9,12,8,10,13,11,5,14,11,16,15,15,13,10,8,10,16,8,12,7,13,12,13,14,11,14,14,8,13,13,20,15,18,13,16,11,13,14,19,13,14,14,13,9,10,6,D C,1,10,1,1,1,1,20,10,10,14,10,1,1,10,10
19019289,Sandro,1651,17/05/1988,28,0,0,0,0,180,78,2,3,1,2,3,1,3,3,3,3,3,5,5,9,6,8,7,14,7,10,13,8,8,13,8,13,12,15,12,12,7,12,13,6,13,9,12,13,13,12,12,10,11,11,13,12,20,15,14,11,12,10,11,10,14,15,14,14,15,13,14,10,D C,1,1,1,1,1,1,20,1,1,10,1,1,1,1,1
19019290,Tartá,1651,13/04/1989,27,0,0,0,0,171,65,2,4,2,3,3,2,3,2,1,1,2,5,10,14,11,14,11,7,12,10,6,12,13,8,14,13,11,13,11,10,13,12,16,16,8,13,6,12,11,14,14,9,4,20,13,14,5,13,8,10,10,16,10,16,13,15,13,15,13,7,14,11,AM/S RLC,1,1,18,16,18,20,1,1,1,1,15,13,1,1,1
19019358,Altemar,1651,01/05/1989,27,0,0,0,0,176,79,1,3,3,1,2,4,1,2,1,3,1,13,13,11,10,10,13,7,11,12,9,11,13,9,11,12,7,12,7,8,9,8,11,11,5,10,10,11,11,13,10,10,7,20,13,12,7,12,12,10,7,10,7,11,10,8,15,8,14,15,16,6,D/WB L,1,1,1,1,6,1,1,19,1,1,1,12,1,20,1
19019359,Anderson Lessa,1651,26/07/1989,26,0,0,0,0,171,69,3,1,3,2,2,1,2,3,3,1,1,9,11,13,12,12,11,12,11,3,4,11,14,6,13,13,12,11,11,9,10,12,12,13,5,13,9,9,12,14,14,10,6,10,13,12,20,13,8,10,8,11,13,12,10,11,17,9,14,6,12,9,AM/S R,1,1,20,1,1,18,1,1,1,1,1,1,1,1,1
19019363,Eduardo Erê,1651,12/03/1988,28,0,0,0,0,174,64,2,2,1,1,3,1,4,4,3,1,2,6,8,9,10,10,12,9,11,6,11,11,13,11,11,14,11,12,10,10,10,10,14,10,13,10,12,11,10,12,12,12,6,8,14,11,20,12,8,14,10,13,6,14,10,19,3,14,11,7,5,18,DM/M C,1,1,1,5,1,1,6,1,6,20,16,1,4,1,3
19019365,Gleibson,1651,18/06/1987,29,0,0,0,0,186,0,14,9,8,9,8,10,9,12,9,9,11,5,1,1,2,6,7,1,1,2,1,2,1,2,3,9,7,15,7,10,7,13,10,3,10,2,9,8,7,13,6,7,9,8,9,12,20,3,8,9,9,2,9,9,16,14,11,12,12,10,6,1,GK ,20,1,1,1,1,1,1,1,1,1,1,1,1,1,1
19019366,Luiz Eduardo,1651,16/06/1988,28,0,0,0,0,184,81,1,1,1,2,4,2,1,3,3,2,3,5,1,1,6,7,1,15,5,1,14,8,5,9,8,9,11,9,9,10,5,7,10,2,12,6,8,8,9,15,14,9,13,10,10,15,20,9,11,9,9,6,6,9,16,11,10,10,13,1,13,7,D C,1,1,1,1,1,1,20,1,1,1,1,1,1,1,1
19019371,Sandro Manoel,1651,23/07/1988,27,0,0,0,0,175,69,1,3,1,3,3,2,2,3,2,1,4,4,8,9,10,10,5,10,7,3,14,11,9,14,11,14,12,15,13,13,8,12,14,7,12,10,14,15,15,13,13,13,8,12,14,13,20,15,13,12,8,11,7,11,16,11,11,9,10,9,3,6,DM/M C,1,1,1,1,1,1,1,1,1,20,18,1,1,1,1
19019374,Vágner Rosa,1651,17/04/1983,33,0,0,0,0,175,67,3,2,3,4,1,3,4,2,3,2,2,6,9,9,8,10,3,8,8,2,10,11,13,10,11,12,10,11,11,11,9,11,12,11,3,9,10,10,10,12,12,12,7,16,14,12,20,12,3,13,11,12,5,5,12,13,13,14,14,13,16,10,DM/M C,1,1,1,1,1,1,1,1,1,20,19,1,1,1,1
19019435,Adi Rocha,1651,15/12/1985,30,0,0,0,0,184,85,2,2,3,1,3,2,2,1,2,3,3,9,8,14,13,12,8,12,11,5,5,11,10,5,13,9,10,10,10,11,10,9,10,14,7,12,11,11,14,11,12,12,12,10,8,12,20,11,14,7,7,10,17,4,12,9,8,10,12,10,10,5,S ,1,1,20,1,1,1,1,1,1,1,1,1,1,1,1
19019437,Maílson,1651,05/02/1988,28,0,0,0,0,185,78,4,3,2,2,1,1,2,3,1,1,2,8,6,5,6,7,8,14,8,1,12,9,5,14,9,10,12,10,7,11,7,14,13,4,9,7,12,8,9,10,12,9,14,1,7,10,20,14,12,10,6,3,10,10,8,13,8,12,12,3,4,1,D C,1,1,1,1,1,1,20,1,1,1,1,1,1,1,1
19019438,Márcio Paraíba,1651,14/02/1984,32,0,0,0,0,176,0,2,3,1,3,3,2,3,2,2,2,3,3,4,6,8,7,5,12,7,4,13,9,9,12,8,15,12,15,10,14,7,13,15,7,13,8,13,15,14,11,12,13,7,7,14,11,20,14,10,13,11,13,7,5,7,13,15,13,16,13,11,8,D C,1,13,1,1,1,1,20,1,1,1,1,1,1,1,1
19019550,Flávio Caça-Rato,1651,29/06/1986,30,0,0,0,0,175,73,3,1,2,1,1,2,1,1,1,1,1,5,7,10,13,12,10,12,11,6,6,11,15,6,11,12,12,12,13,13,11,11,12,12,12,12,7,13,12,14,13,11,8,12,17,13,20,13,11,13,5,15,5,4,7,13,15,12,12,7,12,12,S ,1,1,20,1,1,1,1,1,1,1,1,1,1,1,1
19019551,Fágner,1651,25/05/1988,28,0,0,0,0,167,62,1,2,1,2,2,1,3,2,1,2,3,8,8,12,9,11,8,4,5,8,8,11,6,6,10,8,12,13,10,13,11,14,7,9,13,13,9,3,13,14,14,7,2,9,15,14,20,15,6,12,10,3,6,10,7,11,9,9,11,6,12,7,AM/S C,1,1,18,20,1,1,1,1,1,1,1,1,1,1,1
19019554,João Neto,1651,19/08/1984,31,0,0,0,0,162,64,3,2,2,4,2,2,4,3,2,2,1,7,9,10,11,11,8,8,9,12,7,9,13,4,11,12,11,11,12,10,12,11,9,13,7,12,5,13,12,13,14,17,2,20,12,13,10,13,4,13,6,11,14,8,10,11,4,9,11,8,11,7,S ,1,1,20,10,1,1,1,1,1,1,1,1,1,1,1
19019561,Thierry,1651,06/03/1986,30,0,0,0,0,176,72,2,1,2,4,2,3,2,3,1,3,3,5,3,4,3,7,5,5,10,1,9,5,1,13,10,7,7,4,2,5,6,13,13,5,9,6,7,6,7,13,13,6,6,9,15,13,20,12,5,8,8,8,4,8,8,12,9,11,9,13,11,4,DM/M C,1,1,1,1,1,1,1,1,1,20,18,1,1,1,1
19019567,Xinho,1651,30/06/1989,27,0,0,0,0,183,75,1,2,2,1,3,4,2,1,1,4,2,4,10,11,8,10,7,10,10,12,12,11,8,11,10,13,11,13,9,10,9,10,11,6,7,11,12,13,12,13,12,11,12,8,13,13,20,12,11,10,10,7,10,9,12,10,10,10,13,5,3,1,DM/M C,1,1,1,1,1,1,1,1,1,20,16,1,1,1,1
19019720,Nino,1651,27/09/1984,31,0,0,0,0,186,78,2,2,2,2,2,2,1,2,1,1,2,2,5,4,4,7,14,15,14,3,14,8,9,14,7,14,9,13,8,9,6,9,14,7,12,6,12,9,9,9,9,9,15,8,13,10,20,11,13,12,15,10,3,12,9,11,9,12,11,8,7,9,D/DM C,1,11,1,1,1,1,20,1,1,19,15,1,1,1,1
19019734,Luciano,1651,07/11/1980,35,0,0,0,0,180,84,3,3,3,4,1,1,3,3,2,1,3,4,6,8,5,9,5,6,10,5,10,10,3,11,10,6,10,8,6,6,9,13,13,5,5,9,11,11,11,11,8,10,10,9,16,10,20,12,11,11,9,9,9,9,7,13,10,12,10,7,10,3,DM/M C,1,1,1,1,1,1,1,1,1,20,16,1,1,1,1
19019773,Flávio Beck,1651,14/03/1987,29,0,0,0,0,179,71,2,3,1,4,2,1,3,4,3,3,2,9,5,12,10,10,9,9,10,1,11,10,6,10,13,8,12,10,11,10,11,10,10,10,11,11,14,10,14,12,11,10,9,10,11,12,20,11,12,10,10,7,5,10,10,13,13,10,13,4,7,3,M/AM C,1,1,1,20,1,1,1,1,1,15,18,1,1,1,1
19019781,Alex Travassos,1651,17/02/1987,29,0,0,0,0,172,69,2,1,1,3,1,1,2,2,2,1,2,7,11,11,7,8,5,8,8,12,10,11,5,10,11,10,10,10,9,8,9,8,11,7,3,12,10,10,10,12,14,10,7,10,7,14,20,14,9,7,3,6,10,10,15,11,10,10,12,9,6,4,D/WB R,1,1,1,1,1,1,1,1,18,1,1,1,1,1,20
19019959,Reinaldo Melao,1651,07/09/1988,27,0,0,0,0,187,85,3,3,1,3,1,2,1,3,4,1,1,5,7,7,7,8,6,11,5,10,11,7,2,12,8,14,11,8,8,12,8,11,15,2,7,7,9,11,10,8,8,12,13,7,8,10,20,12,14,12,12,11,4,2,13,11,9,11,10,10,8,8,D RC,1,1,1,1,1,1,20,1,15,1,1,1,1,1,1
19019969,Zeca,1651,25/07/1990,25,0,0,0,0,180,77,1,1,1,1,2,3,3,1,2,2,3,5,7,8,6,13,3,9,1,8,10,8,7,13,9,5,9,10,9,9,6,10,10,7,4,7,10,9,9,14,14,9,7,20,5,14,10,12,7,10,10,2,9,10,9,10,10,12,9,11,14,4,D/WB L,1,1,1,1,1,1,1,20,1,1,1,1,1,16,1
19020091,Célio,1651,02/09/1982,33,0,0,0,0,188,82,3,3,4,2,1,2,1,3,2,3,1,5,4,5,5,5,7,10,6,2,11,10,4,13,9,9,13,9,10,12,5,7,6,1,12,6,14,8,9,9,11,9,14,18,10,9,20,10,10,9,2,9,6,9,19,11,10,12,11,11,14,7,D RLC,1,17,1,1,1,1,20,17,17,1,1,1,1,1,1
19020278,Zé Anderson,1651,28/10/1982,33,0,0,0,0,183,80,3,4,2,1,3,1,1,2,1,3,3,7,4,14,9,11,8,15,10,6,8,8,5,5,10,7,7,9,11,9,6,12,1,12,14,12,9,6,9,13,8,6,13,5,8,12,20,13,10,9,5,4,9,8,16,11,11,10,13,5,6,4,S ,1,1,20,1,1,1,1,1,1,1,1,1,1,1,1
19020304,Fernandinho,1651,25/11/1985,30,0,0,0,0,171,66,3,2,1,2,1,1,1,1,2,3,2,7,12,14,10,12,6,7,12,5,4,11,12,4,14,9,13,12,11,13,11,12,11,14,9,14,8,12,12,15,15,7,6,20,12,16,7,14,6,10,7,13,12,13,7,13,12,13,7,12,11,9,M/AM/S L,1,1,19,1,20,1,1,1,1,1,1,16,1,1,1
19020343,Camilo,1651,22/03/1986,30,0,0,0,0,185,78,10,11,5,6,11,8,8,13,7,9,10,7,3,1,3,3,9,1,2,2,3,1,2,2,1,5,6,10,7,10,6,13,9,2,9,2,7,7,6,12,15,7,12,9,11,10,20,6,6,9,9,9,4,9,18,12,9,9,12,5,12,4,GK ,20,1,1,1,1,1,1,1,1,1,1,1,1,1,1
19020439,Tiago Adan,1651,14/03/1988,28,0,0,0,0,188,85,2,2,1,1,1,1,3,2,2,3,4,8,8,11,11,11,10,11,11,10,6,10,10,6,11,10,12,11,12,12,10,12,13,7,7,12,8,10,11,9,11,7,14,10,10,10,20,12,14,10,10,10,10,7,8,8,12,12,10,12,18,1,S ,1,1,20,1,1,1,1,1,1,1,1,1,1,1,1
19020492,Radar,1651,10/06/1986,30,0,0,0,0,177,72,2,1,1,1,1,3,2,3,1,1,2,12,9,13,8,8,9,7,6,10,7,10,9,9,10,13,10,13,11,11,10,12,14,10,10,12,6,11,11,12,10,6,6,20,11,12,5,11,5,11,14,13,10,13,9,13,12,12,12,13,13,4,D/WB/S L,1,1,19,1,1,1,1,19,1,1,1,1,1,20,1
19020531,Pedrinho,1651,29/06/1989,27,0,0,0,0,171,62,3,1,4,1,3,2,3,3,3,1,3,8,7,8,2,8,6,6,3,8,8,10,4,13,8,9,9,9,8,10,9,13,1,8,6,6,10,9,10,15,14,14,5,20,13,15,10,11,4,9,9,9,8,9,8,11,11,12,11,7,10,8,D L,1,1,1,1,1,1,1,20,1,1,1,1,1,15,1
19020532,Tarcísio,1651,01/03/1986,30,0,0,0,0,172,62,2,1,2,3,2,2,3,3,2,1,3,8,8,10,8,11,7,8,10,8,10,12,8,11,11,15,13,14,11,14,10,9,16,7,11,12,14,14,15,13,12,12,6,8,13,12,20,14,7,15,12,11,6,16,14,14,11,12,14,12,12,8,DM/M C,1,1,1,10,1,7,1,3,10,17,20,1,1,1,7
19020586,Filipe,1651,26/04/1985,31,0,0,0,0,184,76,1,2,2,2,1,2,3,2,3,2,1,4,9,9,7,3,2,13,6,8,12,9,7,12,10,11,11,12,11,12,10,10,12,9,10,9,12,13,12,12,10,11,13,20,12,14,10,12,14,10,12,9,8,8,13,12,11,12,10,1,6,8,D C,1,10,1,1,1,1,20,1,12,1,1,1,1,1,1
19020589,Raulino,1651,26/12/1979,36,0,0,0,0,173,0,3,1,1,3,3,1,3,1,4,3,2,5,6,4,9,15,8,6,12,7,10,14,3,15,15,9,11,9,10,9,8,9,3,1,8,8,10,9,11,7,7,5,8,8,15,8,20,9,7,9,9,5,9,9,11,11,10,9,10,6,9,1,DM ,1,1,1,1,1,1,1,1,1,20,13,1,1,1,1
19020607,Élton Calé,1651,12/07/1988,27,0,0,0,0,169,65,1,2,1,3,3,2,1,1,1,3,1,12,9,13,10,12,11,6,9,6,8,13,7,6,13,10,10,9,10,8,12,8,12,13,6,11,6,10,9,13,16,10,7,7,10,12,20,10,7,14,12,10,9,14,13,12,8,10,7,10,12,6,AM/S RLC,1,1,16,17,20,16,1,1,1,1,10,14,14,1,1
19020611,Olívio,1651,21/12/1987,28,0,0,0,0,178,75,1,3,3,3,1,3,1,2,3,2,2,3,5,4,5,5,3,5,4,5,15,13,5,15,6,12,12,14,12,13,13,13,12,11,13,12,13,14,12,14,13,15,7,11,13,13,20,14,15,13,11,12,7,8,12,12,13,9,14,11,12,8,DM C,1,1,1,1,1,1,1,1,1,20,15,1,1,1,1
19020617,Furtuoso,1651,08/06/1987,29,0,0,0,0,184,75,2,2,3,3,1,3,1,3,1,2,1,6,6,13,11,13,6,12,7,4,2,5,4,2,12,8,9,8,6,7,7,10,1,12,3,13,7,6,7,14,12,7,8,9,9,14,20,11,8,9,8,6,9,9,17,10,11,11,10,1,4,5,S ,1,1,20,1,1,1,1,1,1,1,1,1,1,1,1
19020620,Kanu,1651,23/09/1987,28,0,0,0,0,190,85,4,2,3,2,2,3,3,1,1,1,3,13,9,15,9,12,13,13,10,7,6,15,12,10,15,8,12,7,9,6,13,6,12,16,7,15,8,5,13,13,11,11,14,20,15,14,16,11,13,9,11,12,11,13,11,13,3,12,5,7,7,17,AM RLC,1,1,13,20,15,15,1,1,1,7,13,13,13,1,1
19020625,Júnior Dutra,1651,25/04/1988,28,0,0,0,0,183,78,3,1,3,3,2,3,1,1,2,1,3,8,10,15,13,13,10,11,12,5,4,10,12,7,14,14,6,13,13,12,8,11,11,13,2,10,6,10,12,15,13,13,11,9,17,14,20,9,10,11,11,11,9,13,13,11,11,10,10,6,11,9,AM/S RLC,1,1,20,18,17,16,1,1,1,1,13,15,15,1,1
19020626,Renan Foguinho,1651,09/10/1989,26,0,0,0,0,181,79,3,3,2,3,3,3,2,2,3,3,2,10,11,11,9,12,8,12,10,5,14,12,14,14,12,13,12,13,12,8,12,12,13,12,11,11,13,11,13,11,13,10,11,10,12,11,20,12,11,13,14,11,11,11,12,13,15,11,12,13,12,9,DM/M C,1,1,1,1,1,1,12,1,1,20,17,1,1,1,1
19020632,Dieguinho,1651,29/09/1989,26,0,0,0,0,169,62,1,2,1,1,4,4,3,3,1,1,2,10,10,10,8,11,7,6,10,7,8,11,8,9,11,12,10,11,11,11,10,10,12,13,9,10,9,13,13,15,14,15,5,20,12,15,5,12,2,12,11,11,13,15,12,13,12,9,11,9,10,5,D/WB L,1,1,1,1,1,1,1,18,11,1,13,10,6,20,13
19020633,Klever,1651,20/06/1989,27,0,0,0,0,188,82,11,12,12,9,11,11,16,13,12,13,13,9,3,1,3,8,11,1,1,2,1,1,2,1,7,9,12,15,11,13,10,15,13,3,10,2,13,11,10,13,13,11,14,10,12,14,20,9,11,12,11,11,11,11,13,13,12,12,13,12,12,8,GK ,20,1,1,1,1,1,1,1,1,1,1,1,1,1,1
19020652,Felipe Blau,1651,18/08/1986,29,0,0,0,0,179,72,2,3,3,1,3,2,1,1,3,2,3,7,7,6,8,14,7,7,7,2,8,11,4,13,11,5,9,8,8,8,10,8,4,4,12,6,11,7,8,14,14,8,6,10,10,14,20,12,7,9,9,9,9,9,15,12,13,11,13,12,7,4,DM ,1,1,1,1,1,1,1,1,1,20,10,1,1,1,1
19020666,Bruno Perone,1651,06/07/1987,28,0,0,0,0,191,87,2,2,3,3,2,3,1,1,4,3,2,5,5,7,5,7,13,14,11,5,12,8,9,10,12,13,10,11,12,11,11,11,15,13,11,8,12,12,12,7,8,11,13,11,12,8,20,14,15,10,13,10,4,11,14,15,5,13,12,12,10,10,D C,1,10,1,1,1,1,20,1,1,1,1,1,1,1,1
19020766,Rafael Martins,1651,17/04/1983,33,0,0,0,0,177,78,4,3,3,2,1,3,1,1,3,2,3,6,7,7,13,13,6,13,5,1,5,7,3,4,13,9,9,3,9,7,6,10,8,13,14,13,7,6,8,13,8,11,7,10,11,9,20,12,9,9,8,4,5,9,13,12,10,9,10,3,8,1,S ,1,1,20,1,1,1,1,1,1,1,1,1,1,1,1
19021183,Róbson Simplício,1651,17/07/1986,29,0,0,0,0,177,69,1,3,2,1,2,3,1,3,3,1,2,7,7,8,4,8,7,11,10,1,12,11,5,11,13,15,9,8,6,8,7,11,6,4,12,8,12,8,12,14,14,12,8,10,11,12,20,8,10,9,14,3,9,9,11,10,13,11,10,10,8,1,DM/M C,1,1,1,1,1,1,1,1,1,20,18,1,1,1,1
19021352,Preto,1651,01/01/1986,30,0,0,0,0,190,89,13,7,9,1,8,13,8,13,9,4,8,3,1,3,2,1,4,1,1,1,1,2,2,2,3,8,10,15,6,9,6,13,11,2,5,3,9,7,6,10,6,7,14,9,6,12,20,6,8,9,14,9,6,9,16,13,12,12,10,7,3,5,GK ,20,1,1,1,1,1,1,1,1,1,1,1,1,1,1
19021357,Juan,1651,12/01/1984,32,0,0,0,0,187,82,4,2,2,1,1,1,1,1,3,4,1,4,3,3,5,9,6,14,5,3,12,10,4,12,9,13,13,9,8,11,5,9,12,2,4,5,10,7,8,10,9,14,14,5,13,11,20,13,14,9,14,9,9,9,10,13,15,10,10,8,10,9,D C,1,1,1,1,1,1,20,1,1,1,1,1,1,1,1
19021360,Júnior Borracha,1651,08/05/1985,31,0,0,0,0,169,69,1,3,2,3,3,1,1,1,2,2,3,7,6,9,8,8,8,7,7,7,10,10,7,9,9,9,12,9,9,8,8,13,10,9,6,9,10,9,10,12,13,9,11,8,10,11,20,15,11,9,9,6,6,9,19,11,11,10,10,12,14,8,D/DM/M C,1,1,1,13,1,1,18,1,1,17,20,1,1,1,1
19021431,Diogo Oliveira,1651,07/01/1982,34,0,0,0,0,180,72,2,4,1,3,1,1,1,3,2,3,3,11,11,14,12,12,13,8,9,7,6,14,11,6,14,11,9,8,9,7,14,8,14,12,10,12,10,12,8,13,13,11,12,10,5,13,20,11,10,11,11,13,9,11,16,10,9,8,13,8,6,4,AM C,1,1,1,20,1,1,1,1,1,13,15,1,1,1,1
19021434,Renan Gusi,1651,21/01/1984,32,0,0,0,0,185,0,11,12,12,1,14,10,11,13,9,4,10,3,2,1,2,5,5,1,1,3,1,3,3,3,5,5,7,9,9,11,8,14,14,1,6,3,11,9,8,7,12,9,12,9,4,8,20,5,8,10,9,9,6,10,11,11,9,10,13,1,11,2,GK ,20,1,1,1,1,1,1,1,1,1,1,1,1,1,1
19021436,Vavá,1651,18/07/1982,33,0,0,0,0,176,74,4,1,1,2,2,1,1,3,1,2,3,12,10,12,12,12,9,11,10,1,3,11,14,4,12,11,11,10,13,9,10,11,15,17,5,13,6,7,9,12,12,9,7,10,13,12,20,10,10,15,3,13,5,7,12,13,12,15,17,10,14,9,AM/S C,1,1,20,19,13,12,1,1,1,1,15,6,5,1,1
19021437,Éderson,1651,13/03/1989,27,0,0,0,0,172,74,2,3,2,1,2,2,3,1,3,2,3,10,10,14,15,13,13,13,12,11,8,12,13,8,14,8,12,10,12,12,12,12,11,14,12,13,7,12,12,14,14,12,6,11,13,14,20,13,10,14,5,12,14,12,9,14,11,9,13,11,12,11,AM/S C,1,1,20,19,10,10,1,1,1,1,15,5,5,1,1
19021523,Rafael Granja,1651,07/01/1984,32,0,0,0,0,172,75,3,2,3,3,1,3,2,2,1,1,1,9,10,11,10,11,11,9,10,10,9,12,13,10,12,10,8,9,11,11,11,11,14,13,3,12,10,11,11,12,13,12,6,10,13,12,20,10,10,13,9,10,7,16,11,13,12,12,14,10,14,10,M/AM C,1,1,1,18,1,1,1,1,1,1,20,1,13,1,13
19021525,Sílvio,1651,13/02/1981,35,0,0,0,0,182,73,3,3,3,1,3,3,3,3,1,1,3,2,4,7,6,9,3,12,9,3,10,10,17,11,8,12,14,12,8,11,6,8,13,1,15,8,12,12,11,9,11,11,13,7,12,10,20,16,11,15,9,13,9,9,18,11,13,12,10,10,9,5,D C,1,14,1,1,1,1,20,1,1,1,1,1,1,1,1
19021608,Anselmo Ramon,1651,23/06/1988,28,0,0,0,0,182,78,3,1,1,1,4,1,3,2,4,1,3,5,12,11,15,14,5,15,13,5,7,10,13,8,12,14,13,15,10,12,11,11,13,12,5,14,8,14,16,12,11,14,12,11,14,11,20,15,14,11,12,14,5,5,10,10,13,12,10,10,8,10,S ,1,1,20,1,1,1,1,1,1,1,1,1,1,1,1
19021610,Bruno Alsina,1651,05/08/1988,27,0,0,0,0,183,0,14,11,7,5,10,13,11,11,6,4,6,3,3,1,2,4,8,1,2,1,2,1,2,2,6,6,6,14,8,7,7,14,11,3,5,1,7,8,7,12,14,8,10,5,10,11,20,7,10,9,9,9,7,9,12,11,11,10,11,10,7,2,GK ,20,1,1,1,1,1,1,1,1,1,1,1,1,1,1
19021612,Diego Martins,1651,14/09/1987,28,0,0,0,0,187,79,3,2,3,3,2,1,1,2,1,2,3,2,5,8,5,8,5,13,8,2,12,9,7,13,8,12,11,12,8,11,7,9,15,6,8,7,11,12,12,10,11,11,14,7,14,12,20,14,13,12,12,11,9,6,11,11,14,12,17,13,12,10,DM/M C,1,1,1,1,1,1,1,1,1,17,20,1,1,1,1
19021613,Eduardo Neto,1651,24/10/1988,27,0,0,0,0,183,78,2,2,4,2,2,1,1,3,2,2,2,8,10,11,11,11,12,11,11,13,12,12,12,11,11,18,11,15,10,9,9,10,14,15,9,13,11,12,12,13,13,12,12,20,17,14,11,14,11,11,14,13,6,19,14,14,16,11,6,9,12,15,D/WB LC,1,1,1,5,10,1,19,17,1,15,10,15,1,20,1
19021616,Júlio César,1651,09/12/1988,27,0,0,0,0,169,59,2,2,1,3,2,1,3,1,1,2,3,14,11,13,11,12,13,6,12,2,4,12,12,4,13,9,8,11,12,9,12,11,10,14,3,12,7,9,11,12,14,8,4,11,13,13,20,10,5,12,5,13,6,9,7,12,15,12,14,14,16,6,M/AM RC,1,1,12,20,10,18,1,1,1,1,17,5,16,1,1
19021731,Mica,1651,23/08/1977,38,0,0,0,0,174,68,1,3,3,1,1,3,1,1,2,1,1,7,8,9,8,10,10,6,10,11,9,10,13,9,10,10,8,11,10,10,9,9,10,8,10,10,8,10,11,9,11,13,7,7,11,8,20,10,7,8,8,8,8,15,12,12,11,10,11,13,6,1,D/WB/DM/M RC,1,1,11,14,1,15,1,1,16,17,20,1,19,1,18
19021767,Gilmar Baiano,1651,03/08/1988,27,0,0,0,0,183,0,3,1,3,3,2,2,2,2,3,1,3,6,3,5,3,5,5,14,7,8,11,9,8,11,7,7,12,10,8,9,4,8,11,1,11,9,13,9,10,8,9,10,11,9,10,9,20,7,12,9,9,9,9,9,9,10,10,12,11,7,10,6,D C,1,11,1,1,1,1,20,1,1,1,1,1,1,1,1
19021768,Jobinho,1651,11/04/1985,31,0,0,0,0,174,78,2,2,3,2,3,2,2,2,1,3,1,8,11,12,10,9,10,7,9,4,4,10,14,4,12,10,13,7,8,7,9,10,10,9,5,11,7,7,12,14,14,5,8,20,14,14,7,12,8,13,7,10,6,10,12,12,11,12,14,8,13,6,AM/S LC,1,1,19,16,20,1,1,1,1,1,8,15,1,1,1
19021822,Victor Ramos,1651,05/05/1989,27,0,0,3,0,192,80,1,2,1,2,2,3,2,1,3,2,1,5,8,9,10,12,4,15,9,8,14,11,9,14,11,16,12,16,12,12,7,11,13,9,11,11,13,13,14,13,12,10,16,6,15,12,20,13,14,12,13,14,7,10,8,13,12,13,7,11,10,10,D C,1,11,1,1,1,1,20,1,10,1,1,1,1,1,10
19022100,Cláudio,1651,11/05/1984,32,0,0,0,0,184,81,2,2,3,2,1,3,3,3,2,3,4,7,11,11,7,8,4,10,4,13,11,8,4,10,9,9,6,10,7,8,6,7,11,3,14,5,10,12,9,12,12,8,12,20,8,12,7,8,11,9,9,9,8,9,10,11,10,10,11,11,8,2,D/WB LC,1,1,1,1,1,1,19,20,1,1,1,1,1,18,1
19022108,Nino Guerreiro,1651,11/10/1983,32,0,0,0,0,185,0,2,4,3,1,4,3,2,2,1,2,1,8,7,9,12,10,8,12,5,1,3,9,15,3,11,9,6,9,10,8,8,6,8,8,15,15,7,8,9,13,11,6,10,8,15,12,20,14,10,3,9,9,5,9,17,12,11,13,12,1,1,6,S ,1,1,20,1,1,1,1,1,1,1,1,1,1,1,1
19022236,Éder Ferreira,1651,07/04/1983,33,0,0,0,0,175,65,1,3,2,2,2,3,3,1,2,1,4,8,7,8,9,8,10,11,10,6,14,12,7,12,10,12,9,13,10,9,9,9,12,9,11,11,14,16,13,12,13,13,9,9,11,12,20,14,10,11,11,10,10,10,14,11,12,11,11,5,12,3,DM/M C,1,1,1,1,1,1,1,1,1,20,18,1,1,1,1
19022274,Gilberto,1651,20/10/1988,27,0,0,0,0,178,75,3,2,4,1,3,2,2,2,3,2,1,9,11,11,8,10,9,8,11,1,13,12,7,12,11,15,7,9,8,13,10,7,8,13,7,6,9,8,11,11,15,9,12,7,16,13,20,17,11,6,10,3,10,10,7,11,12,11,8,6,4,7,DM/M C,1,1,1,7,1,1,1,1,1,20,20,1,1,1,1
19022313,Bruno Paraíba,1651,10/11/1986,29,0,0,0,0,190,0,1,3,2,1,1,1,3,4,1,3,4,4,11,11,7,8,2,8,4,12,10,11,4,14,10,10,11,9,8,9,8,8,7,2,3,9,10,9,9,14,14,9,15,10,5,14,20,14,12,10,5,10,10,10,18,12,13,10,11,10,11,4,D/WB R,1,1,1,1,1,1,1,1,18,1,1,1,1,1,20
19022332,Cris,1651,05/11/1984,31,0,0,0,0,172,0,2,3,2,3,1,1,3,2,1,1,3,5,6,10,8,7,3,7,7,3,2,10,1,2,9,7,5,4,7,6,12,12,7,7,10,7,7,6,8,13,10,6,6,8,8,12,20,12,5,8,8,8,4,8,19,12,11,12,10,9,9,1,M/AM/S C,1,1,18,20,1,1,1,1,1,1,16,1,1,1,1
19022374,Reniê,1651,10/04/1989,27,0,0,0,0,183,80,1,1,2,2,2,3,2,2,3,3,3,2,7,9,8,9,7,13,9,7,12,9,8,12,9,16,12,15,11,8,8,11,14,7,10,9,12,15,12,13,12,13,12,20,15,13,8,14,15,13,12,11,6,12,11,13,16,10,12,8,10,10,D C,1,11,1,1,1,1,20,1,1,14,7,1,1,1,1
19022556,Ermínio,1651,10/11/1985,30,0,0,0,0,178,0,3,3,4,3,3,2,2,3,2,3,2,2,9,11,13,10,13,16,12,2,2,10,17,2,11,10,9,7,11,8,8,10,10,10,2,12,6,7,11,14,13,8,9,6,13,13,20,10,8,13,10,13,5,10,11,9,5,13,14,1,12,2,S ,1,1,20,14,1,1,1,1,1,1,6,1,1,1,1
19022568,Tigre,1651,25/01/1986,30,0,0,0,0,190,95,14,10,10,1,12,12,10,14,6,9,7,7,2,1,3,1,9,1,2,2,2,1,15,1,4,9,10,14,7,6,7,11,15,1,13,1,11,8,7,3,8,4,15,8,11,5,20,7,18,4,9,2,5,9,8,11,10,10,11,10,6,8,GK ,20,1,1,1,1,1,1,1,1,1,1,1,1,1,1
19022650,Wallyson,1651,17/10/1988,27,0,0,0,0,179,72,3,4,3,2,3,1,3,1,3,2,4,12,13,14,13,11,9,10,10,5,6,13,13,9,13,13,14,10,12,12,10,12,14,13,9,12,8,12,13,15,15,8,9,8,8,15,20,13,8,12,7,15,9,13,20,14,11,13,15,11,16,13,AM/S C,1,1,20,18,12,14,1,1,8,1,13,10,12,1,10
19023272,Leo Ribeiro,1651,26/08/1988,27,0,0,0,0,174,0,3,1,2,2,1,1,2,2,3,1,2,11,9,11,9,11,12,7,11,6,10,10,6,10,11,8,7,9,8,9,10,9,14,12,4,11,8,12,10,13,12,9,6,20,12,12,6,10,10,9,11,9,7,13,14,15,7,10,12,9,10,5,DM ,1,1,1,1,1,1,1,1,1,20,14,1,1,1,1
19023585,João Vítor,1651,01/06/1988,28,0,0,0,0,176,70,2,2,1,3,2,1,3,4,1,4,2,11,12,13,12,13,13,11,11,13,13,14,11,12,13,14,13,13,12,12,13,12,12,13,10,13,13,13,13,13,13,12,8,7,12,13,20,14,10,12,16,11,8,13,7,10,12,13,8,7,8,14,DM/M C,1,1,1,15,12,12,1,1,9,17,20,14,14,1,11
19023597,Leandro Camilo,1651,09/02/1986,30,0,0,0,0,188,84,3,1,1,1,1,2,2,3,2,1,2,4,6,7,8,9,10,13,10,6,12,10,10,12,10,14,10,14,10,11,9,11,12,10,13,11,12,12,13,11,10,13,14,8,15,11,20,13,14,13,14,12,8,12,13,12,12,12,14,10,10,8,D/DM C,1,13,1,1,1,1,20,1,1,18,10,1,1,1,1
19023680,Kabrine,1651,20/09/1987,28,0,0,0,0,176,68,2,3,2,2,1,1,1,2,2,2,1,5,7,6,5,9,1,8,7,5,9,9,3,14,5,9,7,7,8,7,8,13,10,7,10,7,10,8,8,14,14,8,8,20,9,14,7,12,11,11,9,9,9,9,9,11,12,9,10,10,9,3,D L,1,1,1,1,1,1,1,20,1,1,1,1,1,14,1
19023684,Paulo Wanzeler,1651,19/02/1988,28,0,0,0,0,183,83,15,14,11,10,11,11,11,7,10,10,13,2,3,3,1,5,7,2,1,1,2,1,3,3,4,10,10,13,10,12,9,15,11,2,12,3,10,10,9,11,14,10,12,1,15,12,20,7,8,10,7,10,9,10,12,10,12,11,11,8,14,3,GK ,20,1,1,1,1,1,1,1,1,1,1,1,1,1,1
19023685,João Vitor,1651,13/02/1984,32,0,0,0,0,177,74,3,1,3,1,3,1,1,2,2,1,3,6,12,13,5,7,4,3,5,11,11,13,6,11,13,11,13,10,12,12,11,11,12,8,9,8,12,13,12,13,12,10,8,20,13,14,7,13,9,10,6,9,12,11,11,13,10,12,13,6,10,11,D/WB L,1,1,1,1,1,1,1,20,1,1,12,10,1,18,1
19023719,Paulinho,1651,15/10/1984,31,0,0,0,0,178,69,2,1,2,2,1,1,2,1,1,3,1,11,11,10,10,11,14,6,11,12,11,12,12,11,12,10,10,12,11,11,12,9,13,12,11,9,10,12,13,14,14,7,8,20,14,13,9,13,7,9,9,11,11,13,7,12,14,12,13,9,11,12,D/WB/M L,1,1,1,10,14,1,1,19,1,1,10,17,1,20,1
19023726,Sandrinho,1651,18/02/1987,29,0,0,0,0,168,61,2,3,1,3,2,1,1,1,1,3,3,8,4,14,14,9,8,14,7,5,7,9,8,4,9,6,10,3,11,8,8,13,6,10,4,14,9,8,9,14,14,9,4,1,12,14,20,14,9,10,6,10,10,10,18,11,10,9,9,10,18,7,S ,1,1,20,1,1,1,1,1,1,1,1,1,1,1,1
19023780,Clayton,1651,03/07/1987,28,0,0,0,0,187,75,2,2,2,2,2,2,3,1,1,3,1,7,11,11,9,12,10,10,8,4,9,12,9,12,13,9,11,9,12,12,13,12,11,14,10,11,12,10,12,10,9,8,10,5,12,10,20,9,11,11,7,9,8,14,12,11,9,10,12,13,9,7,M C,1,1,1,15,13,13,1,1,1,1,20,1,1,1,1
19023829,Fágner,1651,11/06/1989,27,0,0,6,0,168,67,2,2,2,3,1,2,2,2,2,3,1,13,13,14,11,15,14,8,13,8,13,14,12,13,14,15,13,13,13,13,13,14,13,13,14,15,13,12,16,15,17,9,5,8,14,15,20,14,8,14,14,12,10,13,5,12,9,10,13,8,7,14,D/WB R,1,1,1,1,1,5,1,2,20,1,1,1,14,4,18
19023914,Samuel,1651,27/01/1984,32,0,0,0,0,171,66,1,2,3,2,3,3,1,1,3,2,2,9,14,9,7,14,8,8,8,8,9,10,6,10,11,6,11,9,9,8,9,12,4,10,12,9,10,9,10,14,12,9,5,20,8,11,10,10,6,10,10,4,10,10,12,11,9,10,11,6,18,6,D/WB/M/AM L,1,1,1,1,20,1,1,17,1,1,1,17,1,18,1
19023971,Wagner Bueno,1651,03/04/1980,36,0,0,0,0,192,0,13,10,9,1,9,10,8,11,4,3,10,3,2,3,2,4,6,1,2,1,2,3,4,2,6,9,8,12,8,7,7,14,4,3,11,1,13,8,7,12,12,8,15,16,12,9,20,3,11,9,4,9,9,9,19,8,10,11,12,1,1,6,GK ,20,1,1,1,1,1,1,1,1,1,1,1,1,1,1
19024067,Thiago Passos,1651,30/01/1986,30,0,0,0,0,185,74,10,11,9,10,14,11,9,14,10,5,8,1,1,3,1,8,5,1,1,1,1,1,3,3,5,6,11,11,7,10,8,11,7,1,13,1,13,9,8,10,13,9,14,1,8,12,20,8,8,10,8,10,7,10,20,13,13,10,13,3,4,2,GK ,20,1,1,1,1,1,1,1,1,1,1,1,1,1,1
19024069,Osvaldir,1651,15/05/1987,29,0,0,0,0,178,72,1,4,3,1,2,1,2,2,3,3,3,11,11,10,9,10,12,9,12,10,7,11,6,8,12,10,9,9,11,11,9,12,2,12,7,14,10,9,11,13,13,7,9,10,14,13,20,15,7,10,4,10,10,10,18,11,13,7,10,8,16,3,D/WB R,1,1,1,1,1,1,1,1,20,1,1,1,1,1,17
19024070,Jessé,1651,19/03/1982,34,0,0,0,0,180,80,1,2,2,3,3,1,3,4,3,3,1,5,7,8,9,15,6,5,7,1,8,13,7,6,10,6,9,1,11,7,10,12,8,8,15,8,8,8,13,8,10,5,9,6,9,7,20,14,7,5,8,5,8,8,15,10,10,9,11,13,3,2,M/AM C,1,1,10,20,1,1,1,1,1,1,16,1,1,1,1
19024089,Ronaldinho,1651,06/06/1988,28,0,0,0,0,187,0,1,1,3,3,1,2,1,2,1,2,3,4,7,9,8,14,7,6,8,3,8,9,6,9,9,7,8,3,8,7,10,14,9,8,12,12,9,8,13,14,14,8,8,9,12,14,20,8,8,8,9,9,7,9,12,11,12,13,11,10,10,8,M/AM C,1,1,1,20,1,1,1,1,1,1,16,1,1,1,1
19024188,Hugo,1651,23/12/1988,27,0,0,0,0,183,75,2,2,4,4,1,1,2,1,1,1,1,4,8,7,6,8,4,10,7,4,10,8,9,9,9,13,10,14,7,9,6,8,16,8,11,6,7,11,10,11,12,9,11,20,15,11,7,12,9,10,11,14,11,12,10,19,3,15,14,12,14,9,D C,1,1,1,1,1,1,20,14,1,1,1,1,1,8,1
19024391,Francisco Alex,1651,23/12/1983,32,0,0,0,0,178,71,1,2,2,2,2,1,1,3,3,1,3,5,12,11,11,10,9,8,13,9,5,12,10,6,12,8,8,7,7,7,13,9,14,11,10,11,6,9,8,13,12,9,8,20,12,14,15,11,9,12,6,8,5,6,7,13,9,8,8,10,12,9,M/AM C,1,1,1,20,1,1,1,1,1,1,16,1,1,1,1
19024412,Neymar,1651,05/02/1992,24,70,46,7,9,174,68,2,3,2,1,3,1,2,3,1,1,3,16,16,20,16,17,16,9,13,3,4,16,16,4,20,10,17,14,15,15,16,15,15,19,13,19,4,13,12,18,19,14,6,15,16,16,20,13,10,14,11,15,6,12,15,16,19,14,15,8,8,17,M/AM/S LC,1,1,19,18,20,14,1,1,1,1,1,18,12,1,1
19024780,Juliano,1651,07/03/1989,27,0,0,0,0,189,89,12,14,12,11,13,11,12,14,13,12,11,9,2,1,3,9,11,2,3,1,3,4,5,2,9,10,12,12,11,12,9,12,12,10,13,10,11,12,12,12,13,13,16,10,13,11,20,13,13,11,10,11,8,11,11,12,12,4,12,8,11,11,GK ,20,1,1,1,1,1,1,1,1,1,1,1,1,1,1
19024787,Xandão,1651,23/02/1988,28,0,0,0,0,193,88,2,3,2,1,1,1,3,4,2,1,2,4,5,8,5,10,6,14,5,3,13,10,4,11,11,11,14,14,12,13,6,10,15,6,13,11,14,14,13,11,10,12,16,9,14,13,20,14,16,14,10,12,9,11,7,16,6,13,9,12,12,11,D C,1,1,1,1,1,1,20,1,9,1,1,1,1,1,1
19024791,Dimas,1651,09/02/1989,27,0,0,0,0,187,78,3,1,3,1,2,2,1,3,2,1,2,6,5,7,7,14,2,6,4,3,10,14,1,7,13,8,7,7,5,6,10,12,4,8,1,7,10,7,11,14,14,7,13,2,15,14,20,12,9,8,8,8,8,8,7,12,11,11,12,2,14,3,DM/M C,1,1,1,1,1,1,1,1,1,20,16,1,1,1,1
19024794,Vitor Rossini,1651,06/01/1988,28,0,0,0,0,190,84,1,4,3,3,3,2,2,1,3,2,2,8,8,4,9,12,8,8,8,8,10,14,5,9,10,8,13,9,7,4,14,10,3,8,11,9,12,9,11,14,10,9,16,11,12,14,20,9,11,11,10,4,10,10,15,12,12,11,11,11,12,1,DM C,1,1,1,1,1,1,1,1,1,20,15,1,1,1,1
19024799,Rogério Onofre,1651,23/04/1990,26,0,0,0,0,182,67,1,2,2,2,1,1,3,2,3,3,1,10,11,12,6,9,14,5,7,10,1,10,10,1,10,7,10,8,9,8,10,10,8,7,9,10,5,7,10,12,12,10,11,7,5,13,20,8,9,5,7,8,5,5,20,11,12,12,11,9,16,5,AM RL,1,1,1,12,16,20,1,1,1,1,1,1,1,1,1
19024800,Talles,1651,13/03/1989,27,0,0,0,0,180,74,2,3,1,4,3,2,1,2,3,2,1,5,8,13,8,13,8,8,8,6,4,8,10,7,14,12,12,11,10,10,12,12,12,15,11,11,5,11,11,14,14,9,10,8,15,15,20,11,8,11,7,11,7,9,18,14,15,13,11,12,13,11,AM RL,1,1,8,1,20,20,1,1,1,1,1,1,1,1,1
19024802,Erivelto,1651,01/10/1988,27,0,0,0,0,184,83,3,3,2,2,4,2,2,2,2,2,1,9,8,12,9,14,13,14,10,1,9,10,4,3,11,5,12,10,12,10,9,14,11,12,12,14,10,9,9,14,12,6,15,11,14,11,20,13,10,11,6,10,11,11,16,10,12,14,10,3,14,6,S ,1,1,20,1,1,1,1,1,1,1,1,1,1,1,1
19024815,Jonathan Reis,1651,06/06/1989,27,0,0,0,0,182,82,2,2,2,3,1,3,2,1,3,2,3,7,8,14,13,13,12,12,13,6,5,11,11,3,15,6,13,8,12,10,14,12,7,16,5,13,4,10,11,13,15,13,11,12,9,12,20,8,10,5,9,11,17,12,9,7,7,8,3,4,8,18,S ,1,1,20,1,12,1,1,1,1,1,1,1,1,1,1
19024978,Luiz Fernando,1651,20/02/1988,28,0,0,0,0,186,82,13,13,8,1,10,12,7,13,7,5,10,5,2,2,3,5,8,1,1,1,3,1,3,3,4,8,9,15,7,9,7,13,10,3,13,2,9,8,7,13,13,8,12,5,6,12,20,5,9,9,10,10,10,10,7,11,13,12,11,3,8,8,GK ,20,1,1,1,1,1,1,1,1,1,1,1,1,1,1
19024980,Tiago Ulisses,1651,09/04/1989,27,0,0,0,0,175,71,3,1,3,1,1,3,1,2,2,1,3,4,5,8,7,9,7,10,8,5,10,10,9,10,10,12,11,12,9,10,9,10,9,12,9,10,11,12,11,12,11,7,7,11,9,11,20,10,8,12,12,8,8,11,18,6,8,9,10,12,11,7,DM C,1,1,1,1,1,1,1,1,1,20,15,1,1,1,1
19024981,Alex Rafael,1651,01/01/1988,28,0,0,0,0,177,66,3,1,3,3,2,3,2,1,2,3,3,7,9,10,13,13,7,13,9,3,7,8,6,5,13,9,9,9,9,8,8,11,10,13,10,12,8,8,9,13,13,8,3,5,13,13,20,13,7,9,10,6,7,10,9,8,6,12,12,10,17,7,AM/S RC,1,1,20,16,10,19,1,1,1,1,1,1,10,1,1
19024982,Allisson,1651,30/01/1988,28,0,0,0,0,187,80,2,1,1,1,3,2,3,3,2,2,2,4,6,8,12,10,11,14,11,4,4,9,13,5,9,10,10,11,11,9,8,9,11,10,7,9,9,9,10,10,10,12,13,10,13,10,20,12,12,10,8,9,10,5,10,13,13,9,14,15,9,11,S ,1,1,20,5,1,1,1,1,1,1,1,1,1,1,1
19025191,Rodrigo Carvalho,1651,05/07/1984,31,0,0,0,0,176,72,8,10,10,2,12,14,13,13,11,8,14,8,2,2,3,3,10,2,1,2,1,4,3,2,7,11,11,11,11,12,10,11,12,2,12,3,13,11,7,11,15,10,8,5,7,12,20,5,10,12,10,10,10,9,18,13,11,11,10,8,12,8,GK ,20,1,1,1,1,1,1,1,1,1,1,1,1,1,1
19025417,Max,1651,10/07/1983,32,0,0,0,0,188,84,1,1,1,1,3,2,1,2,3,2,4,4,7,10,12,11,4,13,10,2,5,12,14,6,10,13,13,13,13,12,10,12,6,11,7,12,7,13,13,11,10,6,14,9,17,11,20,13,15,12,6,12,10,3,10,6,10,11,5,5,13,15,S ,1,1,20,1,1,1,1,1,1,1,1,1,1,1,1
19025808,Hélio,1651,31/01/1986,30,0,0,0,0,186,81,2,2,3,2,4,3,2,1,2,3,2,6,7,8,5,10,7,12,5,5,12,10,4,12,9,8,10,10,8,11,8,11,8,1,11,9,13,9,10,8,8,12,14,10,12,6,20,7,11,9,5,2,8,9,10,13,7,13,10,10,4,5,D C,1,1,1,1,1,1,20,1,1,1,1,1,1,1,1
19025814,Rafael Alemão,1651,17/08/1988,27,0,0,0,0,197,85,13,11,11,8,12,11,12,12,13,11,11,2,2,2,3,4,6,6,3,4,7,6,7,9,5,9,8,12,8,8,3,8,13,2,7,4,11,9,9,8,11,4,17,3,12,8,20,9,14,12,10,14,7,5,10,12,11,10,12,11,15,9,GK ,20,1,1,1,1,1,1,1,1,1,1,1,1,1,1
19025830,Rafael Santiago,1651,10/08/1984,31,0,0,0,0,187,80,2,3,2,2,1,3,3,1,1,2,3,7,7,8,9,13,7,11,8,5,5,8,14,4,8,6,16,9,10,10,11,14,11,10,6,12,7,10,11,11,10,12,13,8,14,12,20,12,13,12,6,6,9,10,4,11,7,11,11,9,4,8,S ,1,1,20,1,1,1,1,1,1,1,1,1,1,1,1
19025840,Uendel,1651,08/10/1988,27,0,0,0,0,178,64,3,3,2,1,2,2,3,2,1,1,3,13,14,13,11,13,10,7,12,7,12,14,8,12,13,12,13,11,12,12,13,12,13,15,14,13,12,13,14,14,14,11,9,20,14,15,10,14,11,14,7,12,12,15,14,16,16,14,14,8,17,11,D/WB L,1,1,1,11,13,1,1,20,1,1,11,15,1,18,1
19026002,Rafael Costa,1651,23/08/1987,28,0,0,0,0,178,75,2,2,1,2,1,1,1,2,2,1,1,6,10,11,13,12,8,12,12,5,6,11,13,6,11,12,12,14,12,11,11,11,11,13,10,13,8,12,14,14,13,12,9,12,13,14,20,13,12,11,8,12,7,7,7,12,8,7,14,12,10,8,S ,1,1,20,10,1,1,1,1,1,1,1,1,1,1,1
19026009,João Paulo,1651,22/02/1985,31,0,0,0,0,178,70,1,1,2,1,2,1,3,2,3,3,3,10,12,11,10,11,15,12,12,15,14,12,10,13,11,11,12,12,12,12,13,12,13,12,10,12,12,13,12,14,12,11,13,9,13,13,20,13,12,11,12,10,10,13,10,12,12,12,11,11,11,6,DM/M C,1,1,1,10,1,1,1,1,1,20,16,1,1,1,1
19026042,Arilton,1651,16/05/1989,27,0,0,0,0,183,73,2,3,2,2,2,2,3,3,4,4,1,7,8,8,5,9,8,9,7,11,8,9,7,8,10,13,8,12,7,6,7,8,12,8,9,9,9,13,12,13,11,8,11,9,14,12,20,13,9,10,10,9,9,10,5,11,14,8,13,11,12,10,D R,1,2,1,1,1,1,7,8,20,1,1,1,8,4,15
19026066,Emmanuel,1651,07/09/1982,33,0,0,0,0,176,0,3,2,3,1,3,3,1,3,4,3,1,7,6,13,14,10,7,12,7,3,7,8,11,5,14,8,14,5,12,7,6,13,1,13,5,14,8,7,8,13,10,8,7,4,15,12,20,9,9,9,6,9,9,9,14,13,12,11,12,11,11,1,S ,1,1,20,1,1,1,1,1,1,1,1,1,1,1,1
19026089,Valmir Lucas,1651,12/01/1989,27,0,0,0,0,186,74,3,1,3,1,1,2,1,1,3,2,3,5,9,9,8,11,9,12,10,16,13,12,9,12,12,14,13,13,11,12,9,11,12,10,11,12,13,13,13,13,14,13,13,7,15,13,20,14,11,13,10,11,11,11,10,12,14,12,14,11,14,11,D/DM C,1,12,1,1,1,1,20,1,13,18,8,1,1,1,9
19026091,Maycki Douglas,1651,05/12/1989,26,0,0,0,0,193,88,10,10,8,1,12,16,12,12,7,9,11,3,1,3,2,4,5,9,1,3,7,9,1,8,9,10,10,10,9,11,4,10,11,2,8,5,13,11,10,10,12,11,17,10,16,10,20,7,12,10,8,10,10,10,9,11,13,9,12,11,12,8,GK ,20,1,1,1,1,1,1,1,1,1,1,1,1,1,1
19026177,Tairone,1651,14/06/1989,27,0,0,0,0,191,83,3,4,3,3,2,1,3,2,2,3,3,3,5,1,1,7,5,11,1,2,12,7,1,11,6,6,12,9,6,4,2,12,2,9,10,5,12,5,7,10,8,4,14,10,12,7,20,11,12,9,8,9,9,9,17,13,12,12,9,12,7,5,D C,1,1,1,1,1,1,20,1,1,15,5,1,1,1,1
19026229,Berg,1651,27/01/1989,27,0,0,0,0,178,68,3,3,1,1,3,2,2,1,2,2,3,5,6,7,8,13,6,6,9,3,6,10,2,6,8,9,10,8,7,5,9,11,9,9,9,9,8,7,12,13,13,7,5,20,16,13,9,13,5,9,9,3,9,9,18,11,10,11,12,10,13,8,AM C,1,1,1,20,1,1,1,1,1,1,15,1,1,1,1
19026231,Rafael Chorão,1651,26/08/1988,27,0,0,0,0,182,74,3,1,2,2,2,1,1,2,3,1,3,8,8,10,11,10,11,11,12,9,7,10,4,7,11,10,13,7,12,7,13,14,16,9,14,12,6,10,14,13,12,9,9,10,16,11,20,14,9,10,4,10,5,10,10,16,14,12,16,12,12,12,M/AM C,1,1,15,20,1,1,1,1,1,1,16,1,1,1,1
19026266,Ricardo Nascimento,1651,07/02/1987,29,0,0,0,0,189,82,1,1,2,2,2,2,2,1,1,2,2,8,10,10,10,10,10,14,9,13,14,12,12,14,12,12,12,11,9,10,11,12,11,9,12,11,12,12,12,10,12,14,16,20,13,10,6,12,14,14,12,12,7,10,10,8,11,10,10,7,14,8,D C,1,1,1,1,1,1,20,5,1,1,1,1,1,1,1
19026272,Fábio Baiano,1651,25/01/1987,29,0,0,0,0,177,72,2,4,3,1,3,3,2,1,3,3,1,7,7,3,8,8,7,7,11,5,8,9,4,13,9,7,10,4,9,9,10,12,4,6,4,8,11,8,12,14,14,8,5,10,12,14,20,8,7,9,9,9,4,9,17,11,9,9,11,1,14,7,DM C,1,1,1,1,1,1,1,1,1,20,15,1,1,1,1
19026284,Bismarque,1651,09/06/1988,28,0,0,0,0,180,69,3,1,3,2,1,1,1,3,1,1,2,7,9,12,10,14,7,6,10,6,5,11,4,8,13,7,9,8,9,8,10,9,7,10,5,9,10,8,13,12,12,10,10,20,11,13,7,13,8,9,9,9,7,9,12,12,11,11,11,6,9,4,M/AM C,1,1,7,20,14,1,1,1,1,1,16,11,1,1,1
19026285,Joãozinho,1651,06/12/1989,26,0,0,0,0,174,62,3,1,1,1,3,1,2,1,3,1,2,2,5,12,12,10,2,12,4,3,4,1,8,2,11,8,7,6,9,1,5,11,2,10,7,12,3,4,6,12,12,12,7,20,12,12,5,9,14,8,8,8,6,8,16,18,3,12,13,10,18,6,S ,1,1,20,1,12,1,1,1,1,1,1,1,1,1,1
19026287,Wagner Líbano,1651,10/03/1989,27,0,0,0,0,173,63,1,2,1,2,2,2,4,1,2,2,4,8,7,13,11,14,8,8,10,7,7,11,4,9,10,7,9,5,14,6,13,14,6,10,4,10,8,9,10,14,14,9,4,10,7,14,20,9,10,10,8,6,10,10,10,11,9,10,12,10,2,2,AM C,1,1,14,20,1,1,1,1,1,1,15,1,1,1,1
19026401,Eduardo Recife,1651,17/04/1982,34,0,0,0,0,170,69,1,2,3,2,2,3,2,3,3,2,4,8,9,10,8,8,9,10,11,9,7,9,4,6,9,9,7,9,8,8,9,10,4,9,5,7,12,10,8,10,11,7,7,10,8,9,20,12,9,7,3,4,7,20,8,11,12,10,10,10,20,2,D/WB/M/AM R,1,1,15,5,14,19,1,10,20,1,1,1,19,5,16
19026407,Wires,1651,30/12/1982,33,0,0,0,0,178,74,2,2,3,2,2,1,3,1,4,3,2,9,9,9,9,11,11,12,10,11,12,9,11,13,11,11,12,10,13,11,9,11,14,8,10,11,12,13,12,11,12,13,12,7,12,12,20,13,13,10,11,10,9,12,13,9,13,15,12,11,11,8,D/DM RC,1,1,1,1,1,1,1,1,17,20,15,1,10,1,13
19026443,Gil,1651,10/02/1988,28,0,0,0,0,186,83,13,7,7,1,13,11,5,13,3,4,9,5,2,2,2,2,8,1,2,3,3,1,2,3,2,8,7,13,7,10,6,13,4,1,12,3,10,7,6,10,9,7,15,9,12,12,20,6,9,9,8,6,9,9,10,12,12,12,11,4,5,5,GK ,20,1,1,1,1,1,1,1,1,1,1,1,1,1,1
19026466,Walter,1651,22/07/1989,26,0,0,9,5,178,104,2,1,2,3,2,2,1,3,4,2,3,9,14,13,14,15,13,14,15,10,8,15,13,8,14,14,13,14,13,12,15,12,13,14,11,14,8,12,12,11,9,13,11,15,5,10,20,10,17,12,8,13,12,9,9,6,7,6,6,8,12,15,S ,1,1,20,8,14,13,1,1,1,1,1,1,1,1,1
19026483,Cleidson,1651,13/08/1988,27,0,0,0,0,178,71,2,2,1,2,3,2,2,2,3,2,2,7,13,12,10,11,3,8,7,13,10,11,1,10,11,10,10,9,10,8,10,10,10,10,9,7,12,9,10,13,14,10,5,20,17,13,10,14,8,10,4,10,10,10,7,12,11,10,12,12,14,6,D/WB L,1,1,1,1,1,1,1,20,1,1,1,12,1,18,1
19026523,Rodrigo Dantas,1651,20/10/1989,26,0,0,0,0,182,78,2,2,2,1,3,3,2,1,1,1,3,8,8,8,5,13,9,10,11,7,11,12,5,11,12,11,11,12,10,8,9,9,13,12,11,11,12,13,13,12,11,10,11,5,13,12,20,11,11,10,11,10,7,10,11,12,12,13,12,8,10,7,DM/M C,1,1,1,1,1,1,1,1,1,17,20,1,1,1,1
19026609,Thiago Machado,1651,10/03/1984,32,0,0,0,0,178,72,2,2,3,4,1,2,2,1,1,1,2,9,11,9,7,9,8,5,9,10,11,9,5,10,10,12,9,10,8,9,11,9,13,11,5,11,10,12,12,13,11,6,10,10,13,12,20,12,10,14,9,9,9,10,14,13,12,10,12,11,11,2,D/WB R,1,1,1,1,1,1,1,1,20,1,1,1,1,1,16
19026659,Marques,1651,14/01/1985,31,0,0,0,0,185,82,3,1,3,2,3,3,3,2,1,3,3,5,7,11,9,15,12,10,12,2,3,9,4,4,10,11,10,9,9,10,9,10,12,13,11,11,5,8,9,11,10,9,12,9,16,11,20,11,10,12,4,9,9,5,18,12,11,11,13,6,3,4,S ,1,1,20,1,1,1,1,1,1,1,1,1,1,1,1
19026681,Hélder,1651,13/04/1988,28,0,0,0,0,175,68,1,1,1,1,2,4,1,2,4,3,3,10,11,9,6,9,7,8,8,13,8,9,7,11,9,10,12,12,11,10,11,9,13,8,6,12,9,13,14,17,14,12,8,8,14,16,20,14,9,10,10,13,8,10,11,11,12,11,11,10,10,7,D/WB R,1,1,1,1,1,1,1,10,20,10,1,1,14,10,16
19026689,Ivo,1651,02/10/1986,29,0,0,0,0,178,66,3,2,3,1,1,2,4,3,2,2,1,12,13,14,12,14,13,8,14,8,9,15,13,10,14,14,13,10,13,13,13,13,13,13,11,14,12,11,13,14,13,12,9,20,12,14,10,12,12,11,7,12,7,13,13,14,11,9,9,10,13,7,AM LC,1,1,14,20,16,10,1,1,1,1,12,12,6,1,1
19026701,Washington,1651,24/08/1988,27,0,0,0,0,172,71,3,1,3,2,1,3,4,3,1,2,2,8,4,11,11,11,8,6,10,5,9,11,7,10,11,4,8,8,6,11,14,14,5,8,9,14,10,9,12,14,14,8,5,20,11,14,11,11,7,12,8,7,9,10,15,10,10,13,10,11,13,1,M/AM C,1,1,1,20,1,1,1,1,1,1,18,1,1,1,1
19026724,Fidélis,1651,26/10/1988,27,0,0,0,0,178,73,1,2,3,3,3,3,1,3,3,1,3,4,9,6,1,8,2,4,2,6,8,7,5,8,6,7,7,9,6,8,9,13,3,6,14,5,8,7,7,13,13,10,8,9,6,13,20,12,6,9,9,1,9,9,18,13,11,10,10,5,1,8,D R,1,1,1,1,1,1,1,1,20,1,1,1,1,1,15
19026882,Robert,1651,10/03/1989,27,0,0,0,0,171,71,1,2,1,3,2,1,2,1,1,3,1,4,9,12,3,13,1,5,6,3,5,8,14,6,12,9,5,8,8,12,8,9,11,14,6,9,6,6,8,13,13,7,7,13,13,14,20,11,7,9,9,9,9,9,16,12,14,8,9,1,3,4,D/WB R,1,1,1,1,1,10,1,1,20,1,1,1,13,1,18
19026884,Eduardo Salles,1651,06/04/1990,26,0,0,0,0,176,74,2,3,2,1,1,1,3,1,1,1,1,6,5,13,10,13,7,9,8,3,4,8,1,4,13,10,13,4,9,5,7,11,9,13,6,11,5,7,8,13,13,10,11,20,9,14,10,12,10,10,10,2,7,10,8,12,10,13,9,3,10,8,S ,1,1,20,1,1,1,1,1,1,1,1,1,1,1,1
19026892,Anderson Luís,1651,15/09/1988,27,0,0,0,0,170,66,1,3,3,3,2,1,2,2,1,2,2,8,9,9,9,9,9,4,10,9,7,9,10,8,9,10,8,9,10,8,9,9,3,11,9,11,7,11,11,14,13,5,4,20,13,14,6,13,4,9,6,12,6,13,7,11,9,11,11,2,9,6,D/WB/M L,1,1,1,9,13,1,1,19,1,1,12,16,1,20,1
19026916,Berg,1651,06/09/1983,32,0,0,0,0,169,70,2,2,1,1,1,2,1,3,1,1,2,11,11,11,10,11,12,6,12,11,8,12,13,9,12,10,10,11,10,9,9,9,13,14,7,12,10,10,11,13,14,7,5,20,14,13,9,12,6,13,7,12,9,16,14,12,13,12,13,6,15,11,D/WB L,1,1,1,10,12,1,1,19,1,10,10,14,1,20,1
19026925,Elton,1651,17/03/1990,26,0,0,0,0,180,77,1,1,3,1,2,2,2,3,2,2,1,8,6,12,7,12,8,15,9,11,13,10,10,13,8,13,14,12,12,13,11,13,12,12,9,9,13,12,13,13,12,13,15,8,13,12,20,13,14,14,10,11,5,12,11,11,14,12,14,8,11,7,DM/M C,1,1,1,1,1,1,1,1,1,20,17,1,1,1,1
19026940,Tiago Sala,1651,03/10/1984,31,0,0,0,0,186,78,1,2,1,2,1,3,1,3,2,2,1,6,8,8,6,10,8,14,4,8,12,11,7,14,11,10,11,10,8,11,8,14,10,3,9,8,11,8,10,9,10,12,15,11,12,10,20,9,13,10,10,10,10,10,5,10,14,12,10,1,16,4,D RC,1,1,1,1,1,1,20,5,15,15,10,1,1,1,1
19026974,Rogerinho,1651,20/03/1987,29,0,0,0,0,168,66,2,3,2,3,1,3,2,3,1,2,1,2,13,14,13,12,9,9,14,1,9,14,14,7,15,5,11,11,11,13,13,7,12,16,4,13,11,14,9,8,12,9,10,7,18,16,20,12,4,15,7,16,9,20,13,12,11,12,14,14,14,10,M/AM/S C,1,1,17,20,14,12,1,1,1,1,16,11,8,1,1
19027051,Róbson,1651,16/06/1984,32,0,0,0,0,197,0,14,11,10,9,8,12,6,12,9,4,10,5,1,3,1,1,7,1,2,3,1,2,1,2,3,3,6,10,8,12,7,14,3,1,7,2,9,8,7,10,13,8,15,8,16,11,20,6,11,9,4,9,9,8,11,12,9,10,9,6,16,6,GK ,20,1,1,1,1,1,1,1,1,1,1,1,1,1,1
19027100,Micael,1651,06/06/1986,30,0,0,0,0,190,92,3,3,1,1,2,3,2,3,3,2,3,8,11,6,7,11,3,12,6,7,13,10,6,13,6,13,11,12,9,11,8,10,12,2,8,8,14,13,14,9,7,15,16,5,5,10,20,10,15,10,13,10,7,5,7,12,10,14,11,9,6,8,D C,1,1,1,1,1,1,20,1,1,1,1,1,1,1,1
19027120,Felipe Klein,1651,09/04/1987,29,0,0,0,0,177,70,3,1,4,3,2,2,3,2,1,1,2,11,12,12,11,12,12,10,13,10,11,12,5,9,13,12,11,11,9,11,11,11,11,12,11,11,11,12,12,12,12,11,7,12,12,12,20,11,10,10,13,7,11,19,10,7,8,8,13,7,15,3,M/AM RLC,1,1,12,18,14,20,1,1,1,13,15,16,18,1,1
19027202,Neylor,1651,02/04/1987,29,0,0,0,0,191,78,1,1,2,2,2,3,1,1,1,2,1,1,1,4,6,5,1,13,6,5,13,8,5,13,6,10,12,10,8,12,7,13,10,7,9,7,10,7,8,13,11,8,14,20,11,11,2,13,11,10,10,3,8,10,9,11,11,10,8,10,11,5,D C,1,1,1,1,1,1,20,1,1,1,1,1,1,1,1
19027239,Lúcio Flavio,1651,29/08/1986,29,0,0,0,0,178,76,1,2,4,3,4,1,2,1,2,3,4,10,10,14,14,11,9,11,13,9,8,13,12,7,13,11,11,10,9,12,11,11,13,12,7,14,12,8,13,13,13,11,11,12,13,12,20,13,14,12,8,12,10,9,12,13,10,11,13,7,4,5,AM/S C,1,1,20,17,1,1,1,1,1,1,1,1,1,1,1
19027249,Élton,1651,20/09/1985,30,0,0,0,0,180,72,1,1,3,3,1,2,1,3,1,2,3,6,8,10,11,10,9,11,10,6,4,10,12,5,11,11,11,10,11,9,8,10,12,12,7,11,8,8,8,12,12,9,9,10,12,12,20,11,9,12,8,10,10,8,14,10,15,11,13,13,13,8,AM/S R,1,1,20,5,5,17,1,1,1,1,1,1,1,1,1
19027277,Neguette,1651,22/01/1987,29,0,0,0,0,180,77,4,3,1,1,2,3,1,1,3,2,2,6,3,3,1,8,4,13,6,1,13,8,4,13,6,7,11,9,8,12,4,10,1,7,12,3,10,7,7,14,12,10,9,20,16,12,6,7,8,9,10,6,5,9,19,11,9,11,12,6,11,6,D C,1,1,1,1,1,1,20,1,1,10,1,1,1,1,1
19027378,Cecel,1651,28/08/1989,26,0,0,0,0,180,69,1,3,1,1,2,3,3,3,3,3,3,6,6,10,13,11,6,8,8,1,5,10,4,6,10,9,11,2,8,7,10,8,2,9,9,11,8,7,8,13,11,10,9,10,15,14,20,11,5,9,7,9,14,9,12,12,11,11,11,4,16,3,AM C,1,1,15,20,1,1,1,1,1,1,15,1,1,1,1
19027388,Ivan,1651,29/08/1987,28,0,0,0,0,193,0,13,13,6,1,13,13,8,13,8,8,7,2,2,2,1,1,3,1,2,3,1,1,1,2,4,8,10,12,6,9,5,13,4,1,6,3,9,6,5,10,8,6,10,1,11,12,20,5,9,8,5,8,8,8,14,10,10,10,9,11,8,7,GK ,20,1,1,1,1,1,1,1,1,1,1,1,1,1,1
19027394,Pitty,1651,29/11/1987,28,0,0,0,0,184,82,2,3,3,3,4,1,3,3,2,3,2,9,7,6,7,7,7,12,8,7,12,9,5,11,9,13,16,14,9,11,5,11,4,1,11,9,10,12,12,12,12,11,11,8,14,15,20,14,13,11,7,6,10,10,11,11,9,12,13,1,6,6,D C,1,1,1,1,1,1,20,1,1,1,1,1,1,1,1
19027408,Wagner,1651,03/04/1987,29,0,0,0,0,176,69,1,1,3,2,1,2,2,2,2,2,1,11,11,15,11,13,7,6,11,5,5,11,6,5,14,9,12,10,10,11,11,10,12,15,8,11,7,8,12,15,15,11,9,10,13,15,20,11,7,11,13,10,8,9,12,11,10,11,12,10,12,5,AM RL,1,1,10,8,17,20,1,1,1,1,1,13,14,1,1
19027553,Luiz Fernando,1651,17/07/1988,27,0,0,0,0,170,63,3,3,2,1,3,3,2,1,1,1,2,11,10,14,10,14,10,7,6,3,9,12,10,5,12,9,11,9,8,9,11,14,5,9,10,10,10,10,10,11,12,12,5,20,12,11,8,11,10,10,5,2,10,10,16,12,9,10,12,5,4,6,M/AM LC,1,1,1,20,15,1,1,1,1,1,18,12,1,1,1
19027564,Jair Lemos,1651,12/02/1986,30,0,0,0,0,184,83,14,9,11,9,14,12,11,14,5,9,9,5,1,2,3,7,9,1,2,1,1,1,3,2,6,7,9,10,8,7,7,11,2,2,3,1,13,8,7,13,13,8,12,9,14,14,20,7,8,9,9,6,9,9,3,3,10,10,11,5,18,4,GK ,20,1,1,1,1,1,1,1,1,1,1,1,1,1,1
19027565,Baiano,1651,10/05/1987,29,0,0,0,0,184,79,4,1,3,3,2,1,2,2,4,3,1,5,7,5,9,12,8,8,9,5,10,14,2,13,8,3,13,9,8,9,11,13,10,9,8,8,10,9,12,14,14,8,6,9,12,14,20,8,10,10,9,10,10,10,20,10,12,12,11,3,9,2,DM ,1,1,1,1,1,1,1,1,7,20,13,1,1,1,1
19027593,Vanderlei,1651,20/07/1981,34,0,0,0,0,185,82,11,6,13,1,13,12,10,7,9,9,9,6,3,1,1,4,9,1,1,1,2,1,1,1,1,6,6,12,6,13,6,13,9,1,14,2,9,7,6,12,13,3,12,6,9,11,20,3,6,9,9,9,9,9,15,11,11,12,10,6,6,3,GK ,20,1,1,1,1,1,1,1,1,1,1,1,1,1,1
19027606,Rodrigo Galo,1651,19/09/1986,29,0,0,0,0,174,70,3,2,2,3,1,3,3,1,1,1,3,13,14,13,8,12,14,7,13,12,10,13,14,10,13,13,14,13,13,12,12,12,11,11,10,12,10,13,14,14,13,9,8,8,13,15,20,13,9,12,10,10,7,14,14,12,14,12,16,12,12,6,D/WB/M R,1,1,1,10,12,10,1,12,20,1,7,10,16,10,19
19027686,Dedé,1651,04/10/1985,30,0,0,0,0,170,66,3,1,1,1,3,3,1,1,2,3,1,10,12,11,9,12,5,7,9,10,9,12,4,8,11,10,12,12,12,11,11,11,11,11,12,12,12,12,11,13,13,7,6,8,12,13,20,12,7,13,8,12,5,9,11,12,11,11,9,10,13,6,D/WB R,1,1,1,1,1,1,1,1,20,1,1,1,1,1,16
19027688,Jackson Silva,1651,16/09/1982,33,0,0,0,0,178,75,2,3,1,2,1,2,1,3,2,3,3,2,7,8,7,8,2,8,8,7,14,9,6,14,9,14,11,13,9,11,8,10,15,10,13,11,13,13,14,12,10,13,8,7,17,11,20,13,11,12,13,12,8,13,12,9,8,11,12,8,12,9,DM C,1,1,1,1,1,1,1,9,13,20,15,1,1,6,10
19027749,Marco Goiano,1651,07/08/1986,29,0,0,0,0,180,73,1,2,2,1,3,2,2,3,3,2,1,15,10,11,9,11,12,7,13,6,5,11,10,5,12,8,11,11,7,7,9,10,12,12,6,10,11,8,12,12,10,12,8,20,13,12,5,13,10,11,5,11,3,13,14,12,10,13,13,1,3,5,D/WB/M/AM LC,1,1,8,20,19,3,1,17,1,7,15,17,5,18,1
19027756,Raul Prata,1651,14/07/1987,28,0,0,0,0,176,68,3,3,1,2,3,2,1,1,2,3,3,9,8,7,7,12,5,10,8,10,12,12,4,15,10,5,13,12,10,10,6,14,2,11,13,9,12,11,11,15,15,5,5,11,4,15,20,10,9,11,3,11,7,11,16,13,13,10,9,6,14,6,D/WB R,1,1,1,1,1,1,1,14,20,1,1,1,1,13,16
19027827,Rodrigo Borges,1651,24/07/1986,29,0,0,0,0,172,70,1,1,3,2,2,4,2,3,4,3,3,4,4,10,9,8,4,3,8,1,5,10,4,4,10,12,5,2,9,5,9,12,7,11,6,9,6,6,9,12,9,6,3,20,10,7,8,12,7,8,7,8,8,8,20,12,14,10,9,6,5,8,AM C,1,1,5,20,10,10,1,1,1,1,15,10,10,1,1
19027895,Diego Gama,1651,06/05/1983,33,0,0,0,0,177,0,3,2,1,2,1,1,4,1,3,2,2,6,5,8,10,9,5,14,7,1,5,7,4,3,11,8,11,5,11,7,4,11,1,12,13,9,11,6,7,9,11,12,8,9,15,9,20,12,11,9,8,8,8,8,14,12,13,11,12,11,14,6,S ,1,1,20,1,1,1,1,1,1,1,1,1,1,1,1
19027990,França,1651,15/04/1984,32,0,0,0,0,187,83,1,2,2,1,2,2,2,3,2,3,1,4,8,11,9,9,4,11,11,4,6,10,14,6,8,12,11,12,12,10,8,12,2,9,8,10,9,11,11,7,9,14,14,8,14,9,20,13,13,7,8,8,7,7,9,15,12,11,12,3,9,7,M/AM/S RLC,1,1,19,20,15,18,1,1,1,1,17,13,14,1,1
19028036,Valdir Lima,1651,04/12/1987,28,0,0,0,0,169,70,2,3,2,2,2,1,1,3,2,2,3,7,6,9,4,10,3,10,6,9,11,11,8,8,9,10,12,11,10,7,10,14,10,8,12,9,11,10,10,15,15,7,6,11,13,15,20,12,7,10,5,10,10,10,10,11,13,15,11,10,7,4,D/WB R,1,1,1,1,1,1,1,1,20,1,1,1,1,1,16
19028043,Alemão,1651,02/03/1989,27,0,0,0,0,185,78,2,4,1,3,3,3,2,2,2,1,1,8,10,12,12,12,12,10,12,5,6,12,13,7,13,13,11,13,12,12,11,11,14,13,7,13,7,12,12,13,13,10,13,15,14,13,20,12,10,11,10,5,10,12,8,19,5,12,9,5,6,14,AM/S C,1,1,20,17,7,7,1,1,1,1,10,1,1,1,1
19028044,Anderson Sales,1651,16/02/1988,28,0,0,0,0,181,80,3,1,3,2,2,3,3,1,2,1,3,2,9,10,9,12,14,12,12,10,13,12,15,14,12,14,12,13,11,12,9,11,12,9,12,9,13,13,13,12,13,13,12,9,13,12,20,13,13,11,12,11,9,13,17,11,13,12,11,10,12,7,D C,1,1,1,1,1,1,20,1,12,15,10,1,1,1,12
19028046,Dionísio,1651,18/01/1988,28,0,0,0,0,169,67,4,2,1,1,2,3,3,3,2,1,3,10,10,11,9,10,10,6,9,5,12,12,9,12,11,16,11,13,11,10,9,10,13,10,11,9,11,14,10,12,13,10,7,9,13,13,20,12,9,11,15,8,14,14,18,12,15,13,14,13,12,7,DM/M C,1,1,1,1,1,1,1,1,11,20,18,1,1,1,13
19028047,Edmar,1651,19/09/1988,27,0,0,0,0,172,70,2,1,1,1,1,3,1,3,4,2,1,11,11,12,11,12,11,8,11,5,6,12,5,8,13,10,10,10,9,9,11,9,10,14,5,13,8,10,11,14,16,13,7,8,11,15,20,12,7,8,10,8,10,14,8,13,11,9,12,14,13,13,M/AM C,1,1,12,20,12,13,1,1,1,5,18,7,11,1,1
19028048,Húdson,1651,30/01/1988,28,0,0,0,0,179,68,2,4,1,4,2,2,1,3,2,2,3,11,6,10,10,11,6,12,10,11,12,12,10,13,11,13,11,14,12,12,11,12,13,12,13,12,13,13,13,13,12,12,8,12,14,12,20,13,12,13,13,13,11,18,13,13,11,12,13,12,12,6,D/WB/DM/M RC,1,1,1,12,1,1,12,1,18,20,19,1,1,1,19
19028050,Thiago Carleto,1651,24/03/1989,27,0,0,0,0,172,74,2,2,3,2,3,3,3,3,2,3,1,13,13,10,5,13,16,5,16,9,9,10,9,9,13,13,11,14,11,11,13,11,13,11,7,13,9,12,13,14,13,10,7,20,10,15,8,15,13,10,12,10,14,13,5,15,7,15,8,13,12,10,D/WB L,1,1,1,1,6,1,1,20,1,1,1,14,1,19,1
19028051,Tiago Luís,1651,13/03/1989,27,0,0,0,0,176,74,2,1,1,2,2,3,2,3,3,2,1,5,11,11,13,11,10,11,8,6,5,12,11,3,11,15,12,14,12,12,11,12,9,13,9,13,7,11,16,13,11,13,8,14,12,13,20,12,14,12,8,12,13,11,18,15,19,14,14,12,10,6,AM/S RLC,1,1,20,19,15,15,1,1,1,1,1,1,1,1,1
19028052,Vinícius Simon,1651,17/11/1986,29,0,0,0,0,184,74,4,2,3,3,3,1,1,1,3,1,2,6,7,11,9,10,8,14,9,5,13,11,7,12,12,11,12,12,11,13,11,12,13,11,8,10,12,12,12,13,13,10,13,10,13,13,20,13,11,11,11,10,9,13,19,11,11,12,12,10,12,9,D C,1,11,1,1,1,1,20,1,1,13,1,1,1,1,1
19028138,Deivid,1651,18/01/1989,27,0,0,0,0,174,69,3,3,3,2,3,1,1,3,2,1,2,5,10,11,11,13,10,12,12,10,16,13,10,16,12,14,15,17,13,15,11,15,14,5,10,13,13,13,13,15,14,9,7,9,14,15,20,16,8,15,12,11,9,11,8,11,13,12,14,7,12,7,DM/M C,1,1,1,1,1,1,1,1,1,20,18,1,1,1,1
19028142,Rodrigo Crasso,1651,25/02/1987,29,0,0,0,0,173,73,2,1,2,3,1,1,3,3,1,3,2,9,12,11,9,10,8,9,12,12,10,12,5,11,13,11,11,11,10,12,10,8,10,6,5,13,12,13,14,12,11,9,5,20,13,13,7,12,8,10,9,11,12,12,13,12,11,11,11,6,17,1,D/WB L,1,1,1,1,1,1,1,20,1,1,1,1,1,16,1
19028153,Robson Shimabuku,1651,26/04/1988,28,0,0,0,0,175,70,3,2,1,2,2,3,3,1,3,1,4,13,13,12,10,13,13,7,13,5,8,14,11,9,14,13,10,8,13,10,13,13,9,10,8,11,10,13,11,12,12,11,9,8,11,12,20,11,9,13,10,11,6,6,7,12,6,13,14,11,12,9,M C,1,1,1,13,5,7,1,1,1,13,20,1,1,1,1
19028156,Ricardo Duarte,1651,21/01/1989,27,0,0,0,0,180,79,4,1,1,2,3,3,3,1,1,2,3,3,3,4,1,5,1,9,4,6,10,6,1,13,5,9,13,9,3,12,4,13,4,9,8,4,10,6,7,13,13,12,10,9,14,13,20,6,12,11,8,9,9,9,14,10,11,12,12,9,10,1,D C,1,11,1,1,1,1,20,1,1,1,1,1,1,1,1
19028157,Anderson Conceição,1651,24/10/1989,26,0,0,0,0,188,81,1,1,1,1,1,1,1,1,1,1,1,7,9,9,7,11,7,13,8,7,12,8,11,13,8,14,13,13,12,14,10,9,12,6,10,8,13,12,12,11,8,12,13,20,12,12,12,14,14,11,12,9,7,12,5,9,9,12,10,8,11,8,D C,1,1,1,1,1,1,20,1,1,1,1,1,1,1,1
19028164,Nenê Apeú,1651,23/03/1990,26,0,0,0,0,180,73,4,1,1,2,1,1,1,1,4,2,3,6,5,8,13,13,6,13,4,1,6,7,8,1,10,7,13,8,11,6,7,10,9,10,5,13,6,6,7,13,13,7,7,9,11,13,20,9,6,11,3,9,9,9,16,12,11,12,13,3,7,4,S ,1,1,20,1,1,1,1,1,1,1,1,1,1,1,1
19028165,Alex Willian,1651,18/03/1988,28,0,0,0,0,181,70,2,2,3,2,2,2,3,1,2,1,3,7,9,13,11,12,10,9,12,6,7,12,12,7,13,13,11,12,11,11,12,12,10,13,9,12,7,12,11,13,11,6,10,20,14,13,9,12,11,11,8,11,3,13,9,10,13,12,10,1,4,4,M/AM C,1,1,1,20,1,1,1,1,1,1,17,1,1,1,1
19028167,Daniel Reis,1651,15/06/1989,27,0,0,0,0,166,65,3,1,1,3,2,1,1,1,1,1,1,7,11,10,13,13,6,9,6,5,6,3,9,6,13,10,11,9,9,8,8,13,8,13,7,9,8,7,6,13,15,6,4,7,12,14,20,12,6,10,10,8,10,10,11,10,12,9,12,4,17,8,AM/S R,1,1,20,1,1,19,1,1,1,1,1,1,1,1,1
19028168,Vinícius,1651,20/11/1989,26,0,0,0,0,180,76,1,1,2,3,1,2,2,1,1,1,3,6,1,3,6,13,6,6,11,2,8,13,5,12,10,9,7,8,8,8,12,10,9,8,12,7,8,8,12,13,13,8,9,4,11,13,20,12,6,12,5,8,9,9,14,12,13,14,10,10,20,5,DM/M C,1,1,1,1,1,1,1,1,1,20,17,1,1,1,1
19028171,Ganso,1651,12/10/1989,26,8,0,3,1,184,78,3,1,1,2,2,2,2,2,3,1,3,13,16,16,11,16,13,9,14,9,10,16,12,9,17,12,14,13,11,8,18,15,7,18,14,15,10,12,8,10,14,12,11,20,12,10,12,14,12,7,6,13,11,12,7,9,6,8,12,10,8,15,M/AM C,1,1,9,20,10,8,1,1,1,10,18,10,6,1,1
19028220,Marcos Martins,1651,24/07/1989,26,0,0,0,0,176,70,3,3,2,2,2,1,3,1,2,4,1,8,15,13,6,8,6,7,6,14,12,12,4,12,13,12,12,12,10,11,12,13,12,9,8,14,13,13,14,15,14,11,6,8,11,14,20,15,7,12,8,11,11,11,13,11,11,12,13,12,10,10,D R,1,1,1,1,1,1,1,1,20,1,1,1,12,1,15
19028232,André Paulino,1651,14/03/1985,31,0,0,0,0,190,84,3,3,3,1,2,3,3,2,2,2,1,5,7,6,8,9,7,11,9,9,12,9,9,11,9,12,11,9,11,12,6,12,14,8,10,10,10,10,13,11,10,11,16,7,13,11,20,13,14,13,14,9,7,6,14,11,10,13,12,3,14,1,D C,1,1,1,1,1,1,20,1,1,12,8,1,1,1,1
19028236,Wagner Carioca,1651,24/03/1987,29,0,0,0,0,181,72,1,1,4,3,3,3,2,2,2,1,2,10,9,8,9,11,7,12,9,10,12,12,5,13,10,10,11,13,12,13,12,13,13,9,10,9,14,13,14,12,12,14,13,9,12,12,20,14,13,10,10,6,9,10,18,9,11,12,13,12,12,1,M RC,1,1,1,13,1,1,1,1,14,13,20,1,16,1,9
19028244,Jéferson,1651,08/01/1987,29,0,0,0,0,189,80,12,10,9,2,9,10,11,13,8,9,10,6,1,3,1,2,8,1,3,2,1,1,2,3,2,4,8,10,7,6,6,13,9,2,5,3,10,7,6,12,16,7,15,1,11,10,20,6,8,9,8,4,9,9,8,11,14,10,8,1,10,8,GK ,20,1,1,1,1,1,1,1,1,1,1,1,1,1,1
19028275,Léo Gonçalves,1651,05/08/1980,35,0,0,0,0,187,0,3,2,1,2,1,3,2,2,3,2,2,8,10,7,8,11,8,5,10,8,10,15,15,10,12,9,10,6,9,10,8,13,5,7,7,9,9,8,12,8,10,10,13,8,11,11,20,7,9,9,9,9,6,9,12,10,11,11,9,1,6,7,M RC,1,1,1,1,1,1,1,1,1,1,20,1,19,1,1
19028281,Diogo Silva,1651,08/07/1986,29,0,0,0,0,191,80,12,11,10,9,13,11,12,14,10,9,12,3,1,3,2,9,6,1,1,1,1,5,1,3,6,8,12,14,11,12,7,11,9,1,8,1,10,12,11,9,12,12,15,6,13,9,20,13,12,7,11,9,8,11,11,6,13,6,11,11,12,5,GK ,20,1,1,1,1,1,1,1,1,1,1,1,1,1,1
19028294,Leonardo Luiz,1651,05/06/1987,29,0,0,0,0,187,75,3,3,1,4,1,2,1,2,3,3,2,7,7,6,3,8,4,6,5,1,14,9,2,14,8,10,14,10,8,10,5,13,4,1,9,7,13,7,9,13,13,8,10,11,4,13,20,12,10,10,10,4,5,10,13,11,10,13,13,1,20,5,D C,1,1,1,1,1,1,20,1,1,1,1,1,1,1,1
19028366,Chapinha,1651,14/11/1983,32,0,0,0,0,174,68,3,1,3,1,3,3,2,3,2,2,1,10,8,12,10,11,12,10,17,5,13,12,6,12,12,9,12,12,11,11,11,11,11,8,11,13,12,14,13,11,12,12,9,11,13,14,20,11,8,10,8,7,3,15,10,10,10,9,13,15,16,9,M/AM C,1,1,1,20,1,1,1,1,1,13,18,1,1,1,1
19028371,Lima,1651,04/09/1982,33,0,0,0,0,181,84,2,3,2,1,2,1,1,3,3,3,1,4,9,11,13,11,11,13,11,5,5,10,13,6,11,13,11,12,13,10,9,12,13,14,14,13,6,11,11,12,11,12,10,10,15,10,20,12,13,14,11,12,5,5,12,13,7,11,4,9,8,18,S ,1,1,20,1,1,1,1,1,1,1,1,1,1,1,1
19028374,Vasconcelos,1651,20/12/1987,28,0,0,0,0,184,80,1,3,2,2,1,2,3,3,2,4,3,9,11,13,12,11,9,12,12,4,5,12,7,6,12,10,11,11,10,10,10,10,9,9,15,12,10,10,12,12,11,12,12,1,14,13,20,13,14,9,4,4,9,9,16,14,12,11,12,3,15,2,M/AM C,1,1,1,20,1,1,1,1,1,1,16,1,1,1,1
19028394,Augusto César,1651,13/06/1981,35,0,0,0,0,188,0,1,2,1,4,4,3,2,3,2,2,1,2,2,4,13,13,4,13,5,3,4,6,9,1,8,8,11,1,12,4,6,5,8,8,11,13,5,5,7,7,11,2,8,11,15,10,20,12,9,8,4,5,6,8,17,10,13,8,9,9,9,8,S ,1,1,20,1,1,1,1,1,1,1,1,1,1,1,1
19028495,Carlos César,1651,21/04/1987,29,0,0,0,0,174,69,1,3,2,1,1,1,4,2,1,2,4,12,13,11,9,13,7,7,10,5,12,12,12,13,12,12,13,14,12,12,13,12,11,12,12,12,10,14,14,14,13,12,13,10,6,15,20,14,13,11,7,12,7,5,11,13,12,12,14,14,11,6,D/WB R,1,1,1,1,1,1,1,14,20,1,1,1,1,12,16
19028517,Mateus,1651,07/06/1986,30,0,0,0,0,184,76,2,1,3,1,3,2,1,3,3,3,3,5,10,9,8,9,8,9,10,9,13,9,8,12,9,14,11,13,9,11,8,10,13,8,11,10,12,13,13,12,11,10,11,20,13,12,10,12,10,13,12,11,7,15,10,11,12,11,12,9,11,8,WB/DM/M LC,1,1,1,1,1,1,1,14,1,20,17,15,1,16,1
19028521,Leomir,1651,07/04/1987,29,0,0,0,0,179,70,3,2,2,3,3,1,3,3,2,1,2,13,11,13,11,13,13,9,9,5,10,8,13,3,12,11,10,8,10,6,13,9,9,12,9,10,7,7,12,12,11,10,5,20,9,9,11,13,10,9,6,9,9,9,10,13,10,10,11,10,12,1,M/AM C,1,1,1,20,1,1,1,1,1,1,16,1,1,1,1
19028526,Fabiano,1651,05/06/1984,32,0,0,0,0,189,88,1,1,3,3,1,2,1,3,2,1,2,9,7,6,10,12,7,14,9,1,3,10,7,5,8,9,12,6,10,11,6,12,10,6,14,11,8,11,11,9,7,15,14,8,9,10,20,14,15,11,6,9,5,9,20,12,11,11,12,1,13,3,S ,1,1,20,1,1,1,1,1,1,1,1,1,1,1,1
19028625,Boldrin,1651,23/02/1989,27,0,0,0,0,181,75,1,3,1,1,2,1,3,3,1,3,2,14,14,15,12,15,14,10,13,2,9,14,15,9,14,7,12,12,13,13,14,13,12,14,9,12,13,14,15,13,10,11,10,20,12,12,5,14,11,13,8,13,2,12,14,13,10,12,13,14,15,7,M/AM C,1,1,1,16,14,14,1,1,1,1,20,1,1,1,1
19028631,Tiago,1651,13/07/1989,26,0,0,0,0,187,76,13,9,10,1,9,10,8,13,7,9,10,3,2,1,1,3,6,1,2,1,1,2,2,3,5,7,7,13,7,11,6,13,8,1,13,2,9,5,6,11,10,7,14,20,16,10,10,6,8,9,5,9,9,9,8,11,12,13,9,12,13,5,GK ,20,1,1,1,1,1,1,1,1,1,1,1,1,1,1
19028647,Marcinho,1651,08/09/1985,30,0,0,0,0,173,70,3,1,4,3,1,3,3,2,1,3,1,12,11,12,12,12,11,9,10,8,9,13,12,8,13,9,9,9,10,11,13,11,5,12,6,13,11,9,14,13,14,11,6,20,12,13,10,12,9,11,11,10,11,11,18,11,12,13,12,9,15,1,AM C,1,1,1,20,1,1,1,1,1,1,15,1,1,1,1
19028724,Geraldo,1651,25/05/1986,30,0,0,0,0,178,70,3,1,3,1,3,1,2,2,2,3,2,7,6,5,3,12,7,7,10,3,9,11,2,10,9,9,10,6,8,6,14,12,9,9,12,9,8,8,10,14,14,8,9,9,6,14,20,8,8,9,9,9,9,9,19,10,14,11,10,11,7,3,M C,1,1,1,1,1,1,1,1,1,1,20,1,1,1,1
19028918,Caju,1651,27/01/1989,27,0,0,0,0,174,78,3,3,4,3,4,3,3,2,2,1,2,12,11,12,7,12,10,7,6,10,8,11,13,9,12,12,8,12,8,7,7,8,15,11,6,10,8,10,10,12,12,8,5,5,13,12,20,10,6,10,10,9,9,16,14,15,11,12,11,11,11,8,D/WB/DM/S R,1,1,18,12,1,14,1,1,17,17,8,1,11,1,20
19028920,Dentinho,1651,19/01/1989,27,0,0,6,1,176,67,1,2,3,1,3,1,2,1,1,1,2,11,11,14,13,14,10,9,10,5,6,12,15,3,16,9,10,8,12,10,11,9,9,16,5,13,4,10,10,17,15,7,8,9,15,15,20,13,7,10,13,12,11,15,13,15,10,16,9,4,15,8,AM/S RLC,1,1,17,17,20,17,1,1,7,7,13,10,10,1,7
19028921,Éverton Ribeiro,1651,10/04/1989,27,6,0,4,0,174,69,2,3,2,3,1,3,3,1,3,2,2,14,13,17,12,16,13,8,12,4,5,14,13,10,16,12,16,10,11,11,17,12,14,18,10,15,8,12,16,14,16,8,7,20,13,15,11,14,6,12,8,11,9,17,11,12,13,10,12,7,11,11,M/AM RLC,1,1,11,17,19,20,1,10,1,1,16,18,19,13,1
19028922,Jean Pablo,1651,26/08/1988,27,0,0,0,0,195,74,2,2,3,2,2,4,1,1,1,3,2,3,1,1,2,8,1,13,4,3,13,7,1,13,4,5,9,10,5,7,6,13,9,5,14,7,13,7,8,13,13,8,14,5,11,13,20,11,13,10,5,8,7,10,11,12,11,11,9,2,11,2,D C,1,1,1,1,1,1,20,1,1,1,1,1,1,1,1
19028925,Rafael Santos,1651,14/03/1989,27,0,0,0,0,191,91,13,13,13,5,14,12,12,13,13,5,10,5,1,1,2,6,10,2,2,3,3,3,2,3,10,10,13,11,8,9,11,9,14,2,13,3,13,12,10,9,11,14,16,9,13,13,20,6,14,10,4,10,6,11,14,15,13,13,14,13,12,10,GK ,20,1,1,1,1,1,1,1,1,1,1,1,1,1,1
19029174,Luiz Henrique,1651,03/09/1985,30,0,0,0,0,179,76,3,1,1,3,2,3,2,2,2,2,1,14,7,10,10,14,9,8,14,7,9,9,2,7,13,5,11,9,10,7,10,14,10,12,13,13,8,9,8,14,14,9,7,1,16,14,20,12,6,7,7,10,10,10,12,9,11,10,11,10,6,4,AM C,1,1,1,20,1,1,1,1,1,1,15,1,1,1,1
19029276,Somália,1651,10/04/1984,32,0,0,0,0,183,67,1,2,3,2,3,2,3,1,2,2,2,4,12,11,6,5,5,4,8,11,13,11,5,13,11,11,11,12,11,11,9,12,11,12,10,12,11,12,12,14,13,13,8,8,13,13,20,14,14,10,12,11,8,11,11,10,10,12,11,9,10,12,DM/M C,1,1,1,1,1,1,1,1,10,20,18,1,12,1,12
19029351,Bruno Andrade,1651,02/03/1989,27,0,0,0,0,175,71,2,3,3,1,3,3,3,3,4,1,1,7,7,13,9,10,10,10,8,7,5,12,10,3,13,10,12,10,12,11,14,13,11,12,5,12,4,12,12,11,11,13,10,11,12,11,20,13,13,13,8,12,15,10,5,9,9,12,10,1,12,8,AM/S RL,1,1,19,14,20,17,1,1,1,1,12,12,12,1,1
19029353,Sérgio,1651,16/09/1988,27,0,0,0,0,184,0,2,1,1,1,2,1,3,1,1,1,3,5,5,11,13,13,5,13,6,1,5,4,6,1,13,4,6,3,8,6,6,6,2,13,7,11,6,5,5,13,12,6,8,8,12,12,20,6,11,8,5,2,6,8,10,11,11,10,11,11,7,8,S ,1,1,20,1,1,1,1,1,1,1,1,1,1,1,1
19029354,Wellington Silva,1651,06/03/1988,28,0,0,0,0,176,67,1,3,3,2,2,2,2,2,1,2,3,14,12,15,11,13,11,9,10,6,10,10,12,14,11,11,13,15,11,12,10,11,12,13,11,13,10,12,12,15,14,7,9,12,14,16,20,15,9,11,14,11,13,12,18,12,12,14,11,6,6,5,D/WB R,1,1,1,1,1,1,1,12,20,1,1,1,10,1,17
19029355,Éwerton Páscoa,1651,14/03/1989,27,0,0,0,0,190,75,1,1,1,3,1,3,2,2,3,1,2,4,6,9,7,10,7,14,7,8,12,11,14,14,11,13,11,12,11,11,11,12,3,8,12,11,13,13,13,12,11,7,15,7,13,12,20,15,11,12,12,11,7,9,18,12,11,10,11,5,4,7,D/DM C,1,1,1,1,1,1,20,1,1,18,1,1,1,1,1
19029442,Cris,1651,10/07/1987,28,0,0,0,0,187,87,2,2,3,3,3,2,2,3,3,2,1,6,4,5,8,12,4,6,8,5,9,10,5,13,12,9,10,8,7,6,13,13,5,5,14,6,6,8,11,13,10,5,13,10,13,10,20,13,15,9,9,9,6,9,10,12,11,11,12,4,10,8,DM/M C,1,1,1,1,1,1,1,1,1,20,17,1,1,1,1
19029443,Anderson Francisco de Barros,1651,09/04/1986,30,0,0,0,0,174,70,2,3,1,1,1,1,1,2,1,2,1,8,8,6,6,13,8,7,9,5,13,7,4,11,9,10,11,9,8,10,13,12,5,6,14,10,11,10,12,14,14,10,5,10,12,14,20,13,8,10,4,8,7,10,7,11,11,14,12,5,1,1,DM/M C,1,1,1,1,1,1,1,1,1,19,20,1,1,1,1
19029502,Antônio Flávio,1651,05/01/1987,29,0,0,0,0,176,78,2,1,1,2,1,2,4,1,2,2,2,10,11,12,9,11,6,8,9,5,2,10,12,4,12,7,13,11,13,13,13,13,10,14,8,12,8,11,11,13,14,11,6,10,11,13,20,13,8,10,8,11,7,12,12,10,12,13,12,5,9,12,AM/S RL,1,1,20,14,18,18,1,1,1,1,10,5,5,1,1
19029503,Cauê,1651,24/05/1989,27,0,0,0,0,186,80,3,2,2,1,1,2,1,1,1,3,1,8,8,9,7,11,7,12,11,10,12,11,9,14,10,13,12,14,10,15,9,12,12,9,11,13,14,15,15,11,12,15,14,9,15,11,20,14,15,14,13,11,7,10,10,12,8,10,15,12,13,8,DM/M C,1,1,1,7,1,1,1,1,1,20,18,1,1,1,1
19029507,Rafael Magalhães,1651,06/02/1986,30,0,0,0,0,180,80,1,2,3,1,1,1,1,2,3,1,3,4,7,10,9,12,5,12,7,3,6,13,13,6,10,13,8,12,9,14,13,14,8,11,6,14,13,13,13,12,13,13,14,5,9,12,20,11,14,13,13,10,1,6,11,8,7,8,10,10,9,6,M C,1,1,15,15,1,1,1,1,1,1,20,1,1,1,1
19029508,Ricardinho,1651,04/09/1989,26,0,0,0,0,175,69,2,4,1,1,3,3,3,3,3,1,2,10,12,13,12,11,10,9,12,8,5,11,10,5,13,8,9,9,8,10,14,10,14,15,10,13,8,10,11,13,12,11,9,20,10,13,10,12,10,12,8,13,7,10,15,12,8,13,12,12,10,10,M/AM LC,1,1,10,17,20,13,1,1,1,1,10,17,7,1,1
19029598,Cléber,1651,28/09/1977,38,0,0,0,0,189,0,1,2,1,4,1,1,3,4,2,3,1,3,7,1,4,6,1,14,2,3,14,9,3,14,5,10,14,10,6,11,6,9,3,4,8,8,14,8,9,10,10,9,10,11,15,8,20,6,9,10,5,5,7,10,12,13,11,9,10,4,9,2,D C,1,1,1,1,1,1,20,1,1,1,1,1,1,1,1
19029768,Adriano,1651,15/02/1985,31,0,0,0,0,170,67,1,2,2,2,2,3,3,1,1,3,1,5,5,7,4,8,3,8,7,7,9,9,4,13,7,7,8,9,8,13,6,14,12,9,7,6,7,4,9,14,14,6,5,10,14,13,20,10,5,9,9,7,9,9,8,12,9,10,11,10,14,4,D/WB R,1,1,1,1,1,1,1,1,20,1,1,1,1,1,17
19029769,Anderson Cavalo,1651,03/07/1986,29,0,0,0,0,186,93,2,4,1,4,2,2,2,1,2,2,1,1,4,9,11,9,2,13,9,1,3,9,12,3,9,10,10,12,9,10,7,12,3,10,8,10,10,10,11,15,15,14,14,20,12,15,11,10,14,13,7,8,10,10,7,13,10,13,11,8,14,6,S ,1,1,20,1,1,1,1,1,1,1,1,1,1,1,1
19029770,Danilo Silva,1651,24/11/1986,29,0,0,0,0,185,70,3,4,3,1,3,2,1,1,2,3,2,6,13,10,9,12,8,13,13,8,15,12,10,13,12,11,13,14,11,11,11,15,13,11,11,12,14,14,15,15,14,12,13,9,14,13,20,15,12,13,12,12,11,12,10,15,9,10,12,14,12,11,D/WB RC,1,1,1,1,1,1,18,1,20,1,1,1,13,1,17
19029773,Roberto,1651,09/09/1987,28,0,0,0,0,184,80,2,1,1,2,3,2,1,4,2,2,1,6,4,7,7,13,6,6,10,3,9,10,5,13,12,9,9,8,8,6,11,13,2,7,2,7,7,8,9,13,13,7,6,9,11,13,20,5,12,13,9,9,9,9,8,12,13,9,11,5,4,5,DM/M C,1,1,1,1,1,1,1,1,1,20,17,1,1,1,1
19029953,Daniel Tijolo,1651,30/05/1982,34,0,0,0,0,186,79,2,1,1,4,3,3,3,3,2,1,3,6,10,8,8,11,8,11,11,6,13,10,11,13,11,12,12,14,11,12,10,10,15,8,12,10,13,13,13,13,11,14,16,9,8,13,20,13,15,11,4,11,9,10,13,13,11,12,13,11,11,11,D/DM C,1,1,1,1,1,1,20,1,1,17,14,1,1,1,1
19030085,Léo Bartholo,1651,24/05/1987,29,0,0,0,0,183,78,3,1,1,2,3,1,1,2,3,3,1,7,6,8,10,11,9,12,14,9,12,12,8,11,13,10,13,10,10,11,7,10,11,13,10,9,11,12,11,12,12,10,11,10,13,12,20,12,11,14,13,12,10,10,16,11,8,10,10,6,11,9,DM/M C,1,1,1,1,1,1,7,1,1,20,17,1,1,1,1
19030088,Renê Cruz,1651,08/04/1986,30,0,0,0,0,189,91,3,3,3,3,4,2,1,2,2,1,1,3,3,8,5,7,1,12,3,2,10,7,1,11,9,9,10,9,7,7,4,13,13,10,5,10,10,6,7,9,8,15,13,10,13,10,20,12,15,9,9,1,4,9,15,12,9,9,13,11,10,8,D C,1,1,1,1,1,1,20,1,1,1,1,1,1,1,1
19030162,Eduardo,1651,18/04/1989,27,0,0,0,0,179,68,1,1,3,2,3,3,1,1,2,3,1,12,12,12,10,12,11,7,12,12,10,12,7,11,12,12,12,11,11,12,10,12,11,13,5,13,12,11,12,14,13,9,9,14,13,13,20,14,5,12,12,11,8,15,10,14,7,11,13,7,13,5,D/WB RL,1,1,1,1,1,1,6,19,20,1,1,1,5,17,18
19030163,Felipe Alves,1651,21/05/1988,28,0,0,0,0,187,79,12,9,10,16,12,12,12,13,14,16,11,9,2,10,2,10,12,2,2,3,2,10,4,3,10,9,10,12,12,10,8,11,10,3,8,2,12,12,8,11,13,9,14,20,13,11,10,14,12,10,5,10,11,10,8,10,10,6,8,7,13,16,GK ,20,2,1,1,1,1,1,1,1,1,1,1,1,1,1
19030165,Ricardinho,1651,12/01/1989,27,0,0,0,0,172,61,1,3,3,3,1,3,3,2,3,2,3,6,8,11,12,11,7,9,8,8,7,11,12,4,11,9,8,12,11,8,9,13,11,11,8,11,12,11,11,12,12,11,8,8,8,12,20,15,8,7,8,7,8,9,12,8,6,7,8,7,7,11,S ,1,1,20,1,1,1,1,1,1,1,1,1,1,1,1
19030216,Danilo Alves,1651,12/02/1989,27,0,0,0,0,181,74,1,4,4,2,3,2,2,1,1,2,1,10,8,11,8,12,8,11,12,7,11,11,5,7,12,10,12,10,8,9,12,12,10,12,9,13,11,12,10,14,12,12,9,12,8,12,20,10,8,9,7,10,12,10,16,11,5,11,11,8,1,3,DM/M C,1,1,1,14,6,8,1,1,1,17,20,5,5,1,1
19030218,Fabiano,1651,29/02/1988,28,0,0,0,0,197,90,15,14,13,4,13,14,14,16,10,12,17,7,3,1,1,8,12,10,1,3,2,10,3,1,9,13,12,14,10,10,7,11,12,1,10,5,12,12,12,8,12,15,17,7,16,8,20,14,17,12,10,8,7,11,13,11,13,7,14,11,12,4,GK ,20,1,1,1,1,1,1,1,1,1,1,1,1,1,1
19030219,Fernando,1651,08/06/1990,26,0,0,0,0,190,84,3,1,2,1,1,1,2,1,3,4,1,2,4,3,2,5,4,7,1,2,12,5,1,12,1,8,5,7,5,7,2,11,5,2,13,4,8,4,5,12,12,5,14,8,8,12,20,10,8,8,8,6,8,8,18,8,9,11,11,4,11,6,D C,1,1,1,1,1,1,20,1,1,1,1,1,1,1,1
19030226,Robinho,1651,10/11/1987,28,0,0,0,0,172,68,1,3,3,3,1,1,3,3,1,1,3,12,15,13,11,13,14,7,13,8,10,14,12,10,14,12,13,11,13,13,15,13,14,14,10,13,9,15,13,15,14,11,7,9,14,15,20,13,11,12,10,11,13,13,11,15,17,12,14,13,12,8,M/AM C,1,1,10,20,1,1,1,1,1,10,19,1,1,1,1
19030233,Rodrigo Ost,1651,02/08/1988,27,0,0,0,0,189,82,1,2,1,3,3,2,1,1,1,2,2,6,5,8,8,10,6,4,9,4,4,11,4,8,11,9,8,7,7,6,7,8,5,9,5,12,8,7,12,13,10,6,15,20,10,10,12,9,10,9,9,9,7,9,9,10,9,12,10,10,8,7,AM C,1,1,1,20,1,1,1,1,1,1,15,1,1,1,1
19030380,Bruno Silva,1651,15/02/1988,28,0,0,0,0,183,80,1,3,4,2,1,1,4,1,1,2,3,7,10,10,8,10,10,12,11,7,12,10,6,12,10,9,12,11,12,11,9,12,3,4,5,10,12,13,12,12,12,12,11,8,13,12,20,11,11,10,10,8,5,10,9,11,11,12,13,12,8,1,D C,1,1,1,1,1,1,20,1,1,15,10,1,1,1,1
19030381,Bruno Formigoni,1651,08/04/1990,26,0,0,0,0,178,69,1,3,2,3,3,2,3,3,2,1,1,6,6,11,8,11,10,9,10,9,13,10,12,15,12,11,13,15,10,10,12,12,10,7,12,7,12,12,13,13,13,9,10,8,14,13,20,14,10,13,6,6,11,12,7,12,14,16,12,6,15,10,DM/M C,1,1,1,1,1,1,1,1,1,20,17,1,1,1,1
19030383,Luan,1651,30/12/1988,27,0,0,0,0,184,84,3,3,3,3,1,3,1,1,1,1,1,6,9,7,7,10,8,11,8,10,12,11,8,12,10,15,12,14,11,11,10,11,13,11,10,10,12,13,13,10,11,8,13,9,13,11,20,14,14,12,15,6,7,10,10,11,14,10,8,4,10,3,DM ,1,1,1,1,1,1,1,1,1,20,13,1,1,1,1
19030559,Kaká,1651,16/09/1988,27,0,0,0,0,180,68,3,3,3,1,1,3,4,3,4,3,2,6,6,10,13,9,6,8,6,1,6,10,2,7,8,7,11,8,8,6,11,11,9,10,9,13,8,7,8,12,10,7,10,10,10,12,20,13,7,9,9,10,8,9,13,9,12,12,13,1,1,2,AM/S C,1,1,20,19,1,1,1,1,1,1,15,1,1,1,1
19030663,Pimentinha,1651,13/09/1987,28,0,0,0,0,165,62,2,1,3,4,2,1,4,3,3,3,3,10,12,13,10,11,7,7,12,6,6,8,8,4,13,9,12,13,11,9,11,10,3,13,13,13,12,8,12,14,15,10,3,20,7,16,10,14,4,10,4,11,8,11,15,12,13,12,11,9,7,1,AM/S RC,1,1,20,16,1,19,1,1,1,1,1,1,1,1,1
19030693,Alisson,1651,03/12/1985,30,0,0,0,0,188,84,3,3,1,1,3,4,2,2,2,2,2,2,1,1,6,6,1,13,3,3,11,4,3,13,6,6,11,9,5,9,1,13,5,1,12,4,10,6,8,13,11,7,13,1,13,13,20,12,8,9,9,8,9,9,20,8,11,11,12,1,9,4,D C,1,1,1,1,1,1,20,1,1,1,1,1,1,1,1
19030694,Diones,1651,21/06/1985,31,0,0,0,0,178,76,3,1,3,1,1,2,3,4,3,2,2,8,10,11,11,12,8,11,12,12,12,12,10,12,12,14,10,14,11,12,10,11,13,10,11,12,12,16,13,12,12,13,9,11,14,12,20,13,11,13,12,11,8,16,11,10,11,12,10,9,7,9,DM/M RC,1,1,1,10,1,9,1,10,14,18,20,12,17,11,15
19030735,Robson Alex,1651,20/05/1986,30,0,0,0,0,183,73,3,1,2,1,1,3,1,2,4,2,1,8,9,11,10,10,6,12,8,10,8,11,10,7,13,11,10,11,9,11,9,10,5,10,14,11,7,9,11,11,12,10,9,20,13,13,14,12,11,12,6,8,4,10,17,9,12,12,9,9,10,6,AM/S RL,1,1,20,1,18,18,1,1,1,1,1,1,1,1,1
19030843,Robinho,1651,31/12/1985,30,0,0,0,0,186,78,1,2,3,1,1,4,2,3,3,3,2,7,4,10,7,10,4,12,4,7,14,9,6,11,10,16,12,10,9,10,5,14,7,1,6,7,11,8,9,9,10,9,13,20,14,12,9,12,13,10,13,9,7,10,19,12,10,12,10,10,12,7,D C,1,1,1,1,1,1,20,11,1,1,1,1,1,1,1
19030933,Neto,1651,19/07/1989,26,0,0,0,0,192,84,13,14,13,6,15,10,15,16,14,13,12,5,3,1,3,10,7,6,3,2,2,9,6,3,8,8,14,12,14,15,11,14,13,6,8,3,14,10,12,12,15,15,15,7,14,13,20,14,16,8,7,10,6,12,12,15,12,13,11,11,12,8,GK ,20,1,1,1,1,1,1,1,1,1,1,1,1,1,1
19030965,Ruy,1651,26/01/1989,27,0,0,0,0,170,75,2,1,3,3,3,1,3,2,2,3,2,12,14,8,8,14,10,7,10,8,7,14,7,9,14,10,11,5,10,7,8,13,5,13,3,10,8,9,13,14,14,9,5,20,9,14,7,14,6,11,8,10,10,10,12,13,11,12,13,8,8,4,M/AM LC,1,1,1,17,20,1,1,1,1,1,17,19,1,1,1
19030966,Tiago Real,1651,26/01/1989,27,0,0,0,0,172,70,1,2,3,1,4,1,1,3,3,1,1,12,11,12,12,13,10,7,13,4,11,12,12,9,14,11,12,13,11,8,11,11,12,13,8,14,12,12,14,13,14,12,5,10,12,13,20,13,7,10,10,13,8,16,13,12,10,12,9,9,12,7,DM/M/AM C,1,1,8,18,10,14,1,1,1,16,20,8,13,1,1
19030967,Willian Farias,1651,06/06/1989,27,0,0,0,0,176,75,2,1,2,1,3,3,4,3,2,1,3,8,9,11,11,14,7,13,13,11,14,14,7,14,14,13,14,13,14,13,12,13,13,9,14,13,13,15,15,13,13,12,12,7,13,13,20,15,14,15,11,14,9,11,11,11,12,14,14,10,10,8,DM/M C,1,1,1,1,1,1,7,1,9,20,18,1,1,1,10
19030993,Éverton,1651,11/12/1988,27,0,0,0,0,174,66,3,2,1,3,1,3,2,2,2,3,2,9,12,14,10,10,7,4,10,6,9,13,13,7,14,9,11,11,10,10,12,11,15,14,5,12,5,12,12,16,16,9,7,20,13,18,10,9,9,10,13,14,13,17,6,16,9,14,13,12,14,5,WB/M/AM RLC,1,1,1,15,20,19,1,15,1,1,7,16,1,16,1
19030995,Lima,1651,11/08/1983,32,0,0,0,0,180,78,2,1,4,4,3,1,1,2,1,3,3,8,11,12,17,13,10,12,14,7,6,11,13,6,14,14,16,16,16,13,12,15,12,13,9,16,9,12,14,13,14,13,12,12,13,13,20,14,13,13,7,12,6,10,13,12,14,15,13,13,14,6,S ,1,1,20,5,5,5,1,1,1,1,1,1,1,1,1
19031249,Sérvulo,1651,21/12/1985,30,0,0,0,0,183,79,13,13,13,11,13,11,12,14,13,12,11,1,2,2,1,3,1,1,1,1,1,2,3,2,3,10,12,11,8,12,6,13,14,1,14,2,14,8,12,9,14,13,13,8,5,11,20,7,9,13,10,10,7,9,9,14,13,15,15,14,15,8,GK ,20,1,1,1,1,1,1,1,1,1,1,1,1,1,1
19031670,Douglas,1651,04/10/1988,27,0,0,0,0,189,80,1,1,2,2,2,2,2,1,2,2,2,2,6,4,3,8,4,13,4,6,13,10,11,12,6,14,11,15,6,12,5,11,14,1,16,6,13,15,13,9,7,15,15,7,15,9,20,15,15,15,11,13,6,4,13,12,15,14,16,8,10,11,D C,1,11,1,1,1,1,20,1,1,1,1,1,1,1,1
19032023,Diego Higino,1651,14/09/1986,29,0,0,0,0,183,83,1,2,4,2,1,3,3,2,4,1,2,1,6,7,12,10,7,11,9,1,3,8,15,2,9,10,10,12,11,7,7,9,12,13,5,12,6,9,9,11,10,12,13,10,14,11,20,11,13,13,8,11,6,5,18,12,12,10,12,1,8,7,S ,1,1,20,1,1,1,1,1,1,1,1,1,1,1,1
19032353,Vítor,1651,01/02/1987,29,0,0,0,0,181,80,3,1,3,2,2,1,1,1,3,2,1,6,6,8,7,11,9,9,8,8,12,10,8,11,9,13,10,13,10,12,11,11,12,12,11,10,11,11,12,11,11,11,11,10,12,12,20,12,13,10,8,10,9,8,7,9,6,11,12,8,12,8,DM ,1,1,1,1,1,1,1,1,1,20,10,1,1,1,1
19032423,Claudemir,1651,27/03/1988,28,0,0,0,0,187,73,1,2,1,2,1,3,1,2,3,1,3,8,13,8,7,14,11,6,10,18,12,14,7,13,12,7,13,8,14,12,12,13,10,4,8,11,14,16,14,11,11,11,12,11,7,11,20,15,11,12,6,13,3,16,6,9,17,14,10,15,10,2,M C,1,1,1,14,1,1,1,1,1,14,20,12,14,1,1
19032438,Elanardo,1651,30/06/1986,30,0,0,0,0,173,68,1,1,2,1,3,4,1,4,1,2,2,8,8,5,8,14,13,8,13,1,13,14,6,14,12,9,12,7,7,10,10,14,5,7,9,10,10,9,12,14,14,8,7,10,16,14,20,10,7,10,7,10,7,10,13,10,11,13,10,10,9,8,DM/M C,1,1,1,1,1,1,1,1,1,18,20,1,1,1,1
19032552,Gabriel Leite,1651,28/12/1987,28,0,0,0,0,187,82,7,12,12,14,13,15,10,15,10,8,15,1,1,2,1,7,3,1,3,2,1,2,16,3,3,11,12,13,12,12,8,14,11,1,9,1,14,9,8,7,16,9,16,3,14,8,20,8,10,13,7,13,13,10,14,12,12,10,11,10,2,8,GK ,20,1,1,1,1,1,1,1,1,1,1,1,1,1,1
19032626,Roberto Pichou,1651,05/09/1987,28,0,0,0,0,178,0,2,3,2,3,1,4,1,1,3,1,3,4,2,12,12,12,6,7,14,3,4,4,14,2,13,9,13,7,12,5,2,13,12,11,11,13,6,6,7,13,13,7,5,10,9,15,20,12,9,11,9,9,5,9,11,16,5,12,10,1,18,1,S ,1,1,20,1,1,1,1,1,1,1,1,1,1,1,1
19032708,Bileu,1651,28/03/1989,27,0,0,0,0,177,69,3,1,1,1,3,3,1,3,2,3,2,6,9,11,9,10,9,9,10,11,14,11,10,12,10,15,9,14,8,9,9,9,14,9,7,11,11,15,12,13,14,9,9,7,15,13,20,14,9,11,12,9,7,14,8,11,14,10,12,9,8,11,D/WB/DM/M RC,1,1,1,1,1,1,5,1,18,20,17,1,15,1,18
19032754,Fabiano,1651,03/06/1977,39,0,0,0,0,185,85,10,11,6,3,10,10,10,11,10,9,10,2,3,2,3,5,6,1,3,2,2,2,3,1,7,9,11,12,8,10,7,14,6,1,5,2,12,8,7,12,11,8,12,10,9,14,20,4,10,9,8,9,9,9,8,4,13,13,11,9,5,6,GK ,20,1,1,1,1,1,1,1,1,1,1,1,1,1,1
19032891,Léo Bonfim,1651,14/01/1983,33,0,0,0,0,186,80,3,3,1,1,1,3,1,3,1,1,2,4,3,4,5,8,6,13,3,6,11,8,5,11,9,12,10,12,10,11,8,11,11,7,14,9,11,14,7,7,7,9,11,20,12,8,4,10,11,11,7,8,8,8,13,13,9,12,14,1,15,5,D LC,1,1,1,1,1,1,20,15,1,1,1,1,1,1,1
19032944,Adriano,1651,29/05/1987,29,0,0,0,0,171,70,1,1,4,3,2,3,2,3,1,2,2,7,6,6,8,7,8,7,8,8,14,12,6,14,11,15,15,15,13,14,12,13,16,9,8,7,14,16,17,14,13,14,7,8,13,14,20,14,15,14,16,12,11,8,13,13,13,13,12,12,8,10,DM ,1,1,1,1,1,1,1,1,1,20,12,1,1,1,1
19032948,Wágner,1651,14/08/1986,29,0,0,0,0,177,0,2,4,3,2,3,2,2,2,1,3,1,3,4,7,7,6,1,8,1,6,7,9,3,11,9,7,8,9,9,9,9,8,9,1,11,6,10,8,9,14,14,8,4,20,8,14,10,14,8,9,5,9,5,9,12,10,13,11,12,10,19,1,D L,1,1,1,1,1,1,1,20,1,1,1,11,1,15,1
19032953,Rafael Roballo,1651,19/07/1989,26,0,0,0,0,190,90,14,9,12,9,13,11,7,14,9,9,7,2,2,1,2,3,5,1,1,1,1,3,2,1,7,9,8,10,8,14,7,14,6,3,10,1,8,8,6,12,9,7,17,1,7,11,20,2,11,9,9,9,6,9,8,12,11,10,9,10,15,2,GK ,20,1,1,1,1,1,1,1,1,1,1,1,1,1,1
19032955,Ronaldo Alves,1651,09/07/1989,26,0,0,0,0,184,84,3,2,3,3,1,3,2,1,2,4,3,10,8,8,10,12,7,14,7,8,13,12,6,14,11,12,13,14,12,13,11,15,12,13,9,10,12,13,14,13,7,13,14,12,11,12,20,13,13,13,13,12,11,12,9,6,11,10,8,11,9,6,D C,1,1,1,1,1,1,20,1,1,1,1,1,1,1,1
19032956,Raphael Martinho,1651,15/04/1988,28,0,0,0,0,183,73,1,1,3,4,2,2,1,3,3,1,3,12,13,14,10,12,10,8,11,11,8,10,13,12,13,9,11,12,9,11,12,10,14,12,9,13,12,12,13,14,14,10,10,20,10,14,5,14,12,13,6,11,14,12,15,15,11,13,13,13,13,8,M/AM L,1,1,1,10,16,12,1,12,1,1,14,20,8,14,1
19032957,Afonso,1651,14/06/1989,27,0,0,0,0,186,71,2,2,3,3,1,1,1,1,1,2,2,1,4,12,12,8,4,12,1,4,4,3,1,2,11,7,7,4,5,5,2,10,6,12,1,6,5,4,6,12,12,5,11,9,7,12,20,11,9,8,8,3,6,8,8,13,13,11,10,1,4,5,S ,1,1,20,1,1,1,1,1,1,1,1,1,1,1,1
19032959,Mauro Alonso,1651,12/08/1988,27,0,0,0,0,180,75,3,1,1,1,3,3,3,2,2,3,3,12,11,12,8,13,10,5,11,7,7,13,11,7,13,14,9,8,7,6,13,11,7,8,11,8,6,8,10,12,10,8,6,20,8,13,10,12,8,8,7,8,7,9,19,12,12,8,10,4,12,6,M C,1,1,1,10,1,1,1,1,1,1,20,10,1,1,1
19033030,Saulo,1651,02/04/1989,27,0,0,0,0,195,75,14,13,13,3,13,11,13,14,10,12,12,3,4,5,3,8,7,12,3,3,7,9,2,10,8,14,13,13,11,12,5,10,13,3,11,3,13,12,12,8,13,11,17,5,14,10,20,9,13,11,8,12,7,11,11,13,15,11,14,10,11,12,GK ,20,1,1,1,1,1,1,1,1,1,1,1,1,1,1
19033065,Adalberto,1651,16/11/1987,28,0,0,0,0,185,79,3,1,2,1,1,3,1,1,4,3,2,3,4,6,5,12,7,14,8,6,13,11,8,13,11,13,15,14,10,12,6,11,13,7,11,8,14,13,13,12,10,13,13,20,14,12,8,14,14,12,10,15,4,11,12,13,15,13,14,6,11,11,D C,1,1,1,1,1,1,20,10,1,1,1,1,1,1,1
19033124,Gílson,1651,06/07/1984,31,0,0,0,0,181,77,2,3,2,3,2,3,3,4,1,1,2,9,12,11,9,9,12,8,9,5,9,15,11,4,11,8,8,6,5,6,14,10,8,14,5,10,2,9,10,10,9,7,8,5,7,11,20,10,9,5,9,10,9,9,10,10,12,11,10,8,12,1,DM C,1,1,1,1,1,1,1,1,1,20,15,1,1,1,1
19033169,Dudu Araxá,1651,24/04/1987,29,0,0,0,0,183,77,2,1,3,1,2,3,1,1,3,2,3,6,8,8,8,11,7,10,9,6,12,12,9,11,10,11,11,13,9,10,9,9,11,8,11,11,12,12,12,11,12,11,11,10,14,11,20,13,11,10,5,10,9,11,12,12,8,10,14,15,14,8,DM/M C,1,1,1,1,1,1,1,1,1,20,18,1,1,1,1
19033197,Leandro Cardoso,1651,28/07/1981,34,0,0,0,0,190,83,1,3,3,1,3,3,2,2,1,1,4,4,3,7,5,10,1,10,6,1,11,8,5,11,6,6,12,11,9,11,8,15,11,1,9,9,15,9,10,10,8,10,12,10,12,8,20,9,12,10,9,4,10,10,11,10,13,12,13,11,10,9,D C,1,1,1,1,1,1,20,1,1,1,1,1,1,1,1
19033222,Nequinha,1651,29/03/1981,35,0,0,0,0,167,68,3,2,2,2,2,1,2,1,4,1,1,5,7,6,8,12,2,9,5,6,11,11,7,13,9,5,11,9,10,14,11,16,9,7,8,9,10,10,11,11,11,10,4,10,8,9,20,12,9,9,7,9,9,9,16,10,9,10,11,6,8,7,D/WB R,1,1,1,1,1,1,1,1,20,13,10,1,1,1,18
19033327,Gabriel Machado,1651,02/09/1989,26,0,0,0,0,184,80,1,1,1,1,1,2,4,2,1,1,2,6,6,11,9,10,4,9,8,3,3,8,8,3,13,12,10,10,7,8,6,7,14,17,7,14,5,11,12,11,13,9,7,7,14,13,20,13,9,11,5,14,9,8,14,13,10,12,12,12,10,5,S ,1,1,20,12,1,12,1,1,1,1,1,1,1,1,1
19033333,Jô,1651,04/01/1987,29,0,0,0,0,186,0,2,2,2,3,2,2,3,3,3,4,1,8,13,11,12,10,7,9,9,3,7,6,3,4,11,10,11,7,11,8,8,7,6,13,3,13,8,8,7,13,12,7,9,10,17,11,20,12,8,10,8,8,3,10,13,10,11,9,13,2,3,1,AM/S RLC,1,1,17,20,17,17,1,1,1,1,1,1,1,1,1
19033532,Pastor,1651,25/10/1988,27,0,0,0,0,190,0,1,3,1,2,3,2,2,3,2,1,1,1,1,2,1,5,2,12,1,1,8,2,1,12,3,8,10,7,5,4,4,12,1,1,13,4,12,4,5,12,11,5,9,8,14,12,20,10,10,8,8,7,8,8,10,11,11,11,11,2,8,2,D C,1,1,1,1,1,1,20,1,1,1,1,1,1,1,1
19033539,Elton,1651,31/01/1987,29,0,0,0,0,187,0,1,1,1,1,3,2,2,2,1,2,4,6,6,3,6,13,6,6,7,1,7,13,3,12,13,4,9,7,8,7,9,13,9,6,5,4,11,7,10,13,11,7,11,8,11,13,20,6,8,9,7,2,9,9,17,14,15,11,10,3,9,1,DM ,1,1,1,1,1,1,1,1,1,20,13,1,1,1,1
19033554,Anderson Corrêa,1651,21/02/1982,34,0,0,0,0,189,84,10,11,10,8,8,12,11,9,8,7,11,3,5,1,2,6,1,6,2,2,3,7,1,3,3,10,10,9,9,11,10,10,4,8,10,8,12,12,13,9,9,9,12,5,10,12,20,13,16,11,9,9,5,4,20,12,9,12,13,2,12,4,GK ,20,1,1,1,1,1,1,1,1,1,1,1,1,1,1
19033558,Cléber Alves,1651,15/07/1986,29,0,0,0,0,188,92,10,6,9,1,11,13,8,11,9,6,9,3,1,2,1,1,8,1,1,1,3,1,3,3,4,9,8,12,7,9,6,13,3,3,10,3,10,7,6,11,15,7,13,10,15,10,20,4,10,9,9,1,6,9,18,12,9,9,11,8,13,6,GK ,20,1,1,1,1,1,1,1,1,1,1,1,1,1,1
19033594,Junior Moraes,1651,04/04/1987,29,0,0,0,0,178,75,2,2,3,2,2,2,1,3,3,3,1,6,11,15,14,16,11,14,13,3,3,14,14,5,16,12,10,12,13,12,15,14,14,15,14,14,11,15,17,14,15,12,10,12,14,14,20,14,14,15,5,14,6,9,17,14,15,14,19,14,12,5,AM/S C,1,1,20,17,1,10,1,1,1,1,1,1,8,1,1
19033601,Marcelo,1651,20/05/1987,29,0,0,4,0,191,80,1,3,3,3,2,2,1,2,2,1,3,4,4,7,8,8,4,16,7,10,15,13,7,15,10,12,13,12,12,14,8,13,16,7,13,10,14,10,11,11,11,14,16,10,14,13,20,12,16,14,12,12,10,5,13,15,9,12,10,9,7,17,D C,1,1,1,1,1,1,20,1,1,10,1,1,1,1,1
19033625,Geandro,1651,26/11/1987,28,0,0,0,0,179,87,3,1,1,3,1,2,3,3,1,3,4,9,9,9,9,14,12,9,10,7,9,10,7,11,13,9,12,12,11,11,11,12,12,10,15,10,12,11,12,12,11,11,9,11,11,12,20,10,14,12,4,1,10,10,11,12,11,13,12,10,11,9,DM C,1,1,1,1,1,1,1,1,12,20,15,1,1,1,10
19033633,Jairo,1651,31/12/1986,29,0,0,0,0,179,78,2,1,2,3,2,1,3,1,2,3,1,2,4,8,9,9,2,10,8,6,12,5,4,12,10,13,12,14,10,10,4,9,14,7,13,6,14,15,15,10,11,10,8,8,9,10,20,13,12,12,6,12,7,8,6,6,16,12,15,12,8,12,D/DM C,1,1,1,1,1,1,16,1,1,20,12,1,1,1,1
19033637,Edílson,1651,18/02/1989,27,0,0,0,0,190,87,12,11,5,7,12,9,10,12,8,8,7,2,1,2,2,1,4,1,2,1,1,1,3,2,1,8,8,15,5,4,4,10,8,3,9,1,4,5,4,12,8,5,12,8,8,11,20,1,9,8,8,7,8,8,20,12,13,9,11,1,1,1,GK ,20,1,1,1,1,1,1,1,1,1,1,1,1,1,1
19033641,Petterson,1651,21/07/1988,27,0,0,0,0,190,81,2,1,3,1,3,3,3,3,2,1,3,1,5,2,1,6,1,11,5,1,7,7,2,12,4,9,11,9,6,10,1,13,6,4,9,6,12,6,7,13,9,8,14,20,13,13,10,12,12,9,9,9,9,8,13,11,13,13,10,8,13,8,D C,1,1,1,1,1,1,20,1,1,1,1,1,1,1,1
19033650,Endy,1651,02/02/1989,27,0,0,0,0,179,78,1,1,2,2,3,3,1,3,1,3,1,6,4,3,3,13,6,6,10,6,8,12,1,13,12,9,10,8,7,8,7,13,8,5,11,6,8,7,11,13,13,7,8,7,10,13,20,7,5,9,8,5,9,9,10,9,11,12,10,10,6,1,DM ,1,1,1,1,1,1,1,1,1,20,10,1,1,1,1
19033651,Claydir,1651,30/09/1987,28,0,0,0,0,163,0,1,3,2,2,3,3,1,3,2,2,3,6,5,8,5,11,7,7,9,7,9,14,3,13,8,9,10,8,8,7,10,12,7,9,4,11,9,10,17,14,14,8,2,9,10,13,20,10,6,9,6,9,9,9,7,11,10,12,12,8,3,4,D/DM/M RC,1,1,1,10,1,1,1,1,20,18,16,1,1,1,1
19033655,Rafael Oliveira,1651,06/07/1987,28,0,0,0,0,187,79,3,1,1,4,2,3,4,2,3,3,3,7,6,8,14,12,7,13,11,4,5,11,12,5,10,12,10,13,12,11,10,12,11,11,11,10,10,11,14,13,12,13,14,8,12,13,20,11,13,12,9,12,14,8,11,10,10,11,11,10,13,12,S ,1,1,20,1,1,1,1,1,1,1,1,1,1,1,1
19033912,Bruno,1651,09/01/1990,26,0,0,0,0,184,0,1,2,3,1,3,2,1,1,2,3,3,6,4,13,9,13,6,13,7,3,5,5,6,1,9,9,12,2,13,7,7,13,5,9,10,10,6,6,7,13,13,7,8,9,13,13,20,9,6,9,7,9,9,9,18,11,9,10,13,10,7,1,S ,1,1,20,1,1,1,1,1,1,1,1,1,1,1,1
19033916,Cláudio Willian,1651,10/03/1987,29,0,0,0,0,178,0,2,2,2,2,3,1,2,3,1,3,3,6,6,6,7,12,6,6,6,1,7,14,2,6,12,8,7,7,7,7,10,7,6,11,5,8,6,7,8,14,14,7,5,8,10,14,20,12,5,8,7,4,8,8,11,10,10,11,9,1,10,7,M/AM C,1,1,1,20,1,1,1,1,1,1,16,1,1,1,1
19033996,Rodrigues,1651,15/06/1986,30,0,0,0,0,175,60,3,3,4,3,2,1,1,1,2,1,2,8,10,12,7,10,12,7,10,10,9,10,5,10,11,8,11,10,9,9,8,10,1,11,7,9,7,8,7,16,13,9,7,20,8,16,7,9,8,9,11,9,8,8,13,10,12,13,14,12,10,4,D/WB L,1,1,1,1,1,1,1,20,1,1,1,1,1,16,1
19034028,Zambi,1651,19/01/1987,29,0,0,0,0,182,0,2,1,2,1,1,3,2,3,3,2,3,6,4,14,10,14,8,14,7,4,8,9,6,5,10,7,14,9,13,7,7,10,7,9,10,14,9,8,9,14,13,9,7,9,11,13,20,14,11,10,6,6,7,10,13,13,10,12,11,4,14,8,S ,1,1,20,1,1,1,1,1,1,1,1,1,1,1,1
19034071,Andrezinho,1651,12/02/1986,30,0,0,0,0,175,67,3,2,2,2,2,2,3,3,2,3,1,12,14,12,10,13,7,8,10,6,7,13,4,8,10,10,13,12,9,8,10,10,13,13,3,10,7,9,13,10,9,11,9,12,11,10,20,14,13,5,7,4,10,10,11,10,13,12,12,8,15,1,M/AM RLC,1,1,1,17,15,17,1,1,1,1,20,15,17,1,1
19034380,Panda,1651,09/07/1984,31,0,0,0,0,177,80,2,1,1,3,1,2,2,1,2,1,2,13,12,11,7,6,14,5,12,14,12,12,13,11,12,13,12,14,13,12,10,12,12,14,11,12,12,13,12,13,11,13,7,20,14,13,7,13,11,12,10,13,8,14,11,12,16,13,14,11,13,7,D/DM/M LC,1,1,1,1,1,1,1,20,1,20,18,12,1,15,1
19034458,Fernando Belém,1651,03/08/1983,32,0,0,0,0,185,83,3,2,2,3,2,3,3,2,3,4,1,1,3,6,5,7,3,13,6,8,11,8,2,15,6,9,11,10,10,9,5,10,5,1,5,6,11,8,9,10,12,9,13,10,9,13,20,13,12,9,9,9,9,9,10,12,13,13,10,3,5,3,D C,1,11,1,1,1,1,20,1,1,1,1,1,1,1,1
19034461,Clebson,1651,04/09/1985,30,0,0,0,0,164,69,3,1,3,1,2,3,3,3,3,1,2,10,13,14,13,13,8,11,12,10,9,16,6,8,13,9,13,9,11,7,12,12,4,14,9,13,12,13,12,14,15,5,4,10,16,13,20,7,5,12,5,3,5,16,16,11,10,12,13,6,9,2,M/AM RLC,1,1,1,20,1,1,1,1,1,1,18,18,18,1,1
19034612,Gilmak,1651,02/12/1986,29,0,0,0,0,179,69,2,2,2,1,1,2,4,2,1,2,4,2,7,8,8,10,8,13,9,5,12,11,7,14,10,12,13,13,11,11,7,11,13,10,12,9,13,14,13,13,14,13,10,9,13,12,20,14,10,12,11,11,7,7,11,11,11,11,13,13,13,11,D/DM C,1,17,1,1,1,1,19,1,1,20,5,1,1,1,1
19034617,Rafael Tchuca,1651,03/01/1989,27,0,0,0,0,179,76,2,1,3,1,3,3,3,2,1,1,1,1,7,8,9,9,4,8,9,6,13,10,5,11,10,13,10,13,8,10,9,10,9,8,14,9,12,14,12,12,11,11,9,1,14,12,20,13,10,9,9,7,9,9,7,11,9,10,11,1,11,7,DM/M C,1,1,1,1,1,1,1,1,1,20,18,1,1,1,1
19034636,Adriano Miranda,1651,22/06/1989,27,0,0,0,0,165,62,1,1,2,3,1,1,1,2,1,2,2,11,10,11,8,11,9,7,9,7,6,8,3,7,11,9,7,11,8,8,9,8,6,13,4,11,6,10,10,13,12,5,3,20,12,11,15,9,4,13,10,13,8,8,9,13,11,10,12,4,4,4,AM RLC,1,1,1,20,17,17,1,1,1,1,1,1,1,1,1
19034819,Weverton,1651,13/12/1987,28,0,0,0,0,189,86,14,14,15,8,14,13,15,16,16,14,14,2,1,2,2,13,6,2,3,10,3,6,4,2,10,15,14,14,13,14,4,11,14,7,16,2,13,11,14,14,15,14,17,5,14,12,20,14,17,13,7,9,4,12,12,12,14,10,8,5,10,10,GK ,20,1,1,1,1,1,1,1,1,1,1,1,1,1,1
19034986,Zaquel,1651,26/07/1985,30,0,0,0,0,183,74,1,1,3,3,3,1,1,3,3,3,3,3,5,7,8,8,6,11,8,7,14,10,7,13,9,14,10,13,8,10,8,9,15,7,11,9,12,14,13,13,11,12,13,9,14,12,20,13,12,11,12,10,7,8,8,10,15,10,12,10,9,9,DM/M C,1,1,1,1,1,1,1,1,1,20,16,1,1,1,1
19034994,Dunga,1651,30/01/1988,28,0,0,0,0,167,66,3,3,1,4,2,1,3,2,3,1,3,5,7,9,7,9,9,6,8,7,13,10,5,12,9,14,11,13,9,10,8,9,13,9,8,10,11,13,13,10,11,11,5,9,14,10,20,13,10,12,10,11,7,9,14,12,10,10,10,8,9,6,DM/M C,1,1,1,7,1,1,1,1,1,20,18,1,1,1,1
19035089,Carlos Alberto,1651,15/07/1987,28,0,0,0,0,186,81,2,2,2,1,3,3,3,2,2,3,4,5,8,9,13,10,9,13,7,5,3,10,7,5,12,8,9,9,9,8,8,9,13,9,6,10,8,10,6,13,8,11,13,10,13,13,20,11,14,10,10,6,10,10,18,10,11,12,10,1,4,4,S ,1,1,20,1,1,1,1,1,1,1,1,1,1,1,1
19035114,Rodolpho Fernandes,1651,09/02/1984,32,0,0,0,0,194,85,14,9,9,1,10,9,9,6,9,5,13,12,2,1,3,2,14,1,1,3,1,1,3,2,1,9,11,12,5,8,6,14,9,3,11,3,11,8,7,13,13,4,18,10,9,12,20,3,11,9,6,9,5,9,12,13,12,11,10,5,4,8,GK ,20,1,1,1,1,1,1,1,1,1,1,1,1,1,1
19035148,Guilherme Santos,1651,05/02/1988,28,0,0,0,0,174,72,2,2,2,2,3,2,1,2,3,2,3,12,12,12,11,13,13,10,12,14,13,12,10,12,13,14,12,12,13,12,12,11,12,14,10,7,11,9,12,15,14,9,6,20,15,14,7,14,13,12,14,13,12,12,8,15,8,12,6,7,12,16,D L,1,1,1,6,12,1,1,20,1,10,8,14,1,15,1
19035408,Diogo Roque,1651,13/10/1986,29,0,0,0,0,181,78,1,3,3,1,3,3,4,3,2,3,3,8,12,7,8,11,10,12,6,6,13,8,7,13,10,13,12,12,13,12,8,10,12,7,11,8,13,13,12,12,12,13,11,9,11,10,20,14,14,12,14,12,8,12,18,11,7,9,13,12,8,11,D/DM C,1,1,1,1,1,1,16,1,1,20,13,1,1,1,1
19035439,Jardel,1651,28/06/1986,30,0,0,0,0,176,70,2,3,1,1,2,3,1,3,1,2,2,5,7,8,8,9,7,10,10,7,12,10,9,12,10,15,11,15,10,11,9,10,14,7,11,9,13,15,14,12,12,12,8,10,15,12,20,14,8,12,7,10,7,9,11,12,16,12,8,7,5,10,DM/M C,1,1,1,1,1,1,1,1,1,17,20,1,1,1,1
19035448,Edilsinho,1651,11/07/1981,34,0,0,0,0,164,64,2,3,1,1,1,3,3,2,3,2,1,7,9,10,7,10,7,6,5,7,5,11,4,4,11,8,7,5,8,9,10,8,8,11,9,9,6,4,10,11,11,5,2,20,6,11,13,10,3,13,4,7,6,9,11,11,11,12,9,1,9,5,D/WB/M/AM LC,1,1,1,18,20,1,1,17,1,1,15,17,1,17,1
19035468,Leandro Carrijó,1651,03/09/1985,30,0,0,0,0,186,83,2,1,2,2,1,3,3,3,2,3,3,11,8,12,14,12,9,13,12,10,4,13,9,5,13,10,13,13,14,12,13,13,7,10,12,13,5,10,10,12,11,12,14,9,16,13,20,13,11,15,11,5,6,11,11,10,13,8,14,12,12,9,S ,1,1,20,1,1,1,1,1,1,1,1,1,1,1,1
19035505,Ronan,1651,29/07/1981,34,0,0,0,0,188,81,1,2,1,2,3,3,3,1,1,3,3,5,3,5,13,13,5,13,5,1,5,6,6,5,9,8,11,7,11,6,4,10,8,9,10,7,5,5,7,12,7,6,9,9,13,7,20,12,8,8,8,8,7,8,17,11,12,10,13,6,10,8,S ,1,1,20,1,1,1,1,1,1,1,1,1,1,1,1
19035536,Leandro Djalma,1651,07/05/1986,30,0,0,0,0,185,79,3,1,1,3,3,3,2,2,1,2,4,2,5,13,13,13,6,13,7,1,4,7,8,3,10,9,8,8,9,7,5,13,9,10,10,12,7,6,8,13,13,7,10,1,16,13,20,12,8,9,3,9,9,8,8,8,11,12,9,6,5,2,S ,1,1,20,1,1,1,1,1,1,1,1,1,1,1,1
19035579,Chimba,1651,15/10/1983,32,0,0,0,0,167,0,2,1,2,1,2,3,3,3,3,3,3,5,10,12,11,11,7,7,10,5,5,11,12,6,12,13,13,13,11,11,10,10,13,13,7,13,7,11,12,15,15,8,6,8,14,15,20,13,8,12,11,10,7,12,10,12,11,12,11,8,13,8,S ,1,1,20,12,10,14,1,1,1,1,1,1,1,1,1
19035624,Negretti,1651,16/12/1985,30,0,0,0,0,185,77,2,3,3,1,3,1,2,3,1,1,1,2,5,5,7,9,5,12,9,8,12,7,10,12,7,16,12,16,10,10,6,9,15,5,14,9,12,16,13,12,12,13,12,8,15,11,20,15,12,13,16,11,5,6,9,11,11,11,11,6,5,12,D C,1,11,1,1,1,1,20,1,1,1,1,1,1,1,1
19035655,Anderson Pedra,1651,13/06/1983,33,0,0,0,0,177,79,3,1,1,2,2,3,2,2,3,4,2,4,7,8,7,8,7,14,10,8,16,12,7,15,8,15,13,14,9,11,8,9,11,7,12,8,14,16,15,11,10,15,12,8,5,11,20,16,18,12,16,10,18,10,18,11,12,11,13,12,10,9,DM C,1,1,1,1,1,1,1,1,1,20,15,1,1,1,1
19035667,Evandro Ferreira,1651,04/05/1981,35,0,0,0,0,175,72,1,2,3,3,3,3,2,2,2,1,4,9,10,9,9,12,6,12,7,9,11,11,12,9,10,16,9,13,8,9,8,8,14,6,8,11,10,11,12,13,12,13,11,13,14,13,20,12,13,15,3,6,4,10,8,9,12,13,12,13,17,2,S ,1,1,20,1,1,1,1,1,1,1,1,1,1,1,1
19035668,Lima,1651,01/07/1986,30,0,0,0,0,185,85,1,3,2,2,3,4,2,2,1,1,3,5,5,8,5,10,5,12,5,11,12,10,8,12,11,12,13,13,10,11,10,11,12,9,13,12,12,12,13,12,13,13,13,10,14,12,20,14,13,12,13,11,8,8,11,12,7,11,11,12,10,10,D RC,1,1,1,1,1,1,20,1,15,15,1,1,1,1,1
19035681,Pablo,1651,08/11/1985,30,0,0,0,0,192,81,2,2,1,2,1,2,1,3,1,1,3,5,2,12,12,10,5,12,6,4,3,5,4,1,12,9,8,7,12,6,6,5,9,13,10,12,6,5,6,12,9,6,16,11,14,11,20,11,9,9,9,9,9,9,15,12,10,12,10,4,3,8,S ,1,1,20,1,1,1,1,1,1,1,1,1,1,1,1
19035761,Renato Justi,1651,23/03/1987,29,0,0,0,0,185,85,1,3,3,1,3,3,2,1,1,4,3,4,1,1,3,5,1,13,6,3,13,6,3,13,4,9,13,10,6,7,6,13,1,3,11,5,13,7,8,13,9,8,12,11,14,13,20,8,14,4,4,10,7,10,19,12,13,13,15,3,8,1,D C,1,1,1,1,1,1,20,10,1,1,1,1,1,10,1
19035802,Geovane,1651,20/02/1989,27,0,0,0,0,179,75,3,3,2,3,2,2,3,1,4,2,2,9,7,9,8,10,9,10,9,2,12,11,5,14,11,10,15,9,11,9,10,9,11,10,13,10,13,13,12,11,12,10,10,9,14,11,20,12,10,10,7,9,5,10,12,12,10,8,13,12,14,10,DM/M C,1,1,1,1,1,1,1,1,1,20,16,1,1,1,1
19035862,Danilo Tarracha,1651,22/09/1984,31,0,0,0,0,174,69,1,3,3,3,3,3,3,1,2,3,2,12,12,13,11,13,10,8,12,13,11,13,12,11,12,12,11,10,11,10,11,13,12,14,4,14,11,13,11,14,14,8,6,20,12,13,7,13,9,12,6,13,6,10,9,11,12,13,13,11,7,7,D/WB L,1,1,1,1,13,1,1,20,1,1,1,14,1,18,1
19035871,Leandrinho,1651,22/02/1985,31,0,0,0,0,176,62,2,4,3,2,3,3,2,3,3,3,2,7,11,12,9,13,5,11,9,10,10,10,5,10,12,8,10,9,10,9,8,10,5,9,3,12,9,10,11,14,12,10,7,11,12,15,20,13,9,10,8,10,10,10,8,10,13,10,11,6,15,3,D/WB R,1,1,1,1,1,1,1,1,20,1,1,1,1,1,18
19035938,Josa,1651,24/09/1984,31,0,0,0,0,183,77,3,2,4,1,1,3,2,1,3,2,1,6,9,9,6,10,7,12,7,4,13,10,7,13,10,13,12,14,10,10,9,12,13,12,11,11,12,13,13,13,12,9,11,20,13,13,8,14,12,13,13,12,8,12,11,11,12,10,13,12,13,6,DM ,1,1,1,1,1,1,8,13,1,20,14,1,1,10,1
19035980,Bruno Corrêa,1651,22/06/1986,30,0,0,0,0,190,84,3,3,1,3,2,1,2,3,2,2,2,3,10,11,12,12,4,12,10,5,4,12,13,5,11,13,12,9,13,10,10,12,13,13,6,12,8,13,9,12,12,7,15,10,10,12,20,13,12,8,6,14,10,8,15,11,11,10,12,4,11,7,S ,1,1,20,10,1,10,1,1,1,1,1,1,1,1,1
19035983,Gilmar Baiano,1651,07/02/1984,32,0,0,0,0,176,74,3,1,2,1,1,1,2,3,1,1,2,9,9,11,9,12,10,11,9,8,8,11,8,6,12,10,10,6,14,9,9,12,11,11,14,12,9,14,11,13,13,13,7,8,11,13,20,11,7,11,16,10,7,10,8,9,7,10,7,10,8,5,M/AM/S C,1,1,18,20,1,1,1,1,1,1,16,1,1,1,1
19035988,João Luiz,1651,24/06/1985,31,0,0,0,0,182,79,2,1,1,1,1,2,3,3,3,2,1,8,10,11,10,12,11,12,12,10,10,12,11,12,13,13,11,13,13,12,12,11,14,10,10,12,11,13,14,10,10,13,14,8,14,10,20,13,13,11,9,10,7,12,14,13,14,12,14,14,13,5,DM C,1,1,1,1,1,1,1,1,1,20,15,1,1,1,1
19036004,Vinícius Bovi,1651,18/12/1981,34,0,0,0,0,180,0,3,3,2,3,3,3,3,1,4,3,4,10,10,11,10,11,10,9,11,9,10,11,6,9,10,10,14,10,7,12,9,11,4,13,10,10,10,9,12,13,13,11,10,7,12,13,20,10,12,9,10,10,9,18,17,10,13,9,12,1,1,6,D/WB/M RC,1,1,13,1,1,1,1,1,20,1,17,1,1,1,16
19036018,Baraka,1651,21/07/1986,29,0,0,0,0,180,80,2,3,3,2,2,1,1,1,1,3,1,6,7,9,7,11,8,9,11,11,16,9,8,14,11,15,13,16,10,10,9,12,13,11,13,11,15,16,15,13,11,10,12,8,15,12,20,16,14,13,11,12,7,11,10,11,10,12,13,12,14,4,DM ,1,1,1,1,1,1,7,1,1,20,13,1,1,1,1
19036019,Diogo Borges,1651,27/02/1984,32,0,0,0,0,185,84,1,2,3,1,3,1,1,1,1,2,1,3,7,6,6,8,4,15,6,9,13,7,13,16,5,13,12,13,8,11,8,9,6,6,14,5,13,14,14,9,7,13,14,5,13,9,20,13,16,11,11,7,13,7,7,11,13,12,12,13,16,1,D C,1,1,1,1,1,1,20,1,1,1,1,1,1,1,1
19036023,Jordã,1651,10/08/1983,32,0,0,0,0,173,0,1,1,1,1,3,2,3,1,3,3,1,7,7,3,3,12,6,7,9,1,8,14,7,12,14,9,12,8,8,9,7,10,4,9,11,5,8,8,12,14,11,8,7,8,13,10,20,8,8,9,5,9,5,9,18,11,10,12,10,5,9,2,DM ,1,1,1,1,1,1,1,1,1,20,12,1,1,1,1
19036027,Marcus Vinícius,1651,16/05/1984,32,0,0,0,0,181,79,3,1,2,1,2,1,3,2,2,2,2,4,2,3,1,4,5,11,4,4,13,5,2,13,1,13,11,13,10,10,5,12,8,10,13,6,11,12,10,12,11,10,13,10,12,12,20,11,13,11,8,11,4,2,11,11,10,10,12,9,10,8,D C,1,1,1,1,1,1,20,1,1,1,1,1,1,1,1
19036031,Samuel Teram,1651,30/11/1984,31,0,0,0,0,191,86,3,3,2,1,1,1,2,2,1,1,2,9,5,7,5,8,9,13,5,9,11,9,1,12,8,12,9,11,8,11,7,9,14,5,12,9,11,14,10,11,10,12,14,10,13,12,20,13,12,11,11,10,7,10,12,10,10,11,11,5,10,3,D C,1,1,1,1,1,1,20,1,1,1,1,1,1,1,1
19036033,Serginho,1651,19/12/1984,31,0,0,0,0,169,68,1,2,2,1,3,3,1,2,1,3,1,9,10,14,12,13,12,8,8,9,6,11,11,4,12,10,11,9,11,11,12,10,10,13,8,14,9,7,13,16,15,8,4,20,12,16,11,12,10,12,8,12,4,7,7,12,11,9,8,5,12,7,S ,1,1,20,1,1,1,1,1,1,1,1,1,1,1,1
19036116,Maranhao,1651,19/06/1984,32,0,0,0,0,175,73,1,3,4,1,3,1,2,1,2,3,3,5,8,11,8,11,5,9,6,1,4,10,11,5,11,16,11,11,7,10,11,11,3,14,5,11,5,9,12,15,14,10,11,10,14,13,20,13,9,7,7,6,7,9,14,9,12,7,14,11,16,8,AM/S L,1,1,20,1,17,1,1,1,1,1,1,14,1,1,1
19036119,Marcelinho,1651,09/06/1986,30,0,0,0,0,184,74,1,3,3,2,4,1,3,1,2,1,2,6,7,9,6,11,8,12,9,7,12,10,8,12,10,12,11,12,11,12,8,10,11,8,11,9,12,12,12,11,13,12,12,2,13,11,20,12,10,12,8,9,8,12,11,12,7,10,15,11,11,10,D C,1,13,1,1,1,1,20,1,1,10,5,1,1,1,1
19036205,Naldo,1651,11/01/1986,30,0,0,0,0,186,75,13,13,6,1,13,11,9,13,9,6,11,4,2,2,1,1,6,1,1,1,2,1,3,1,5,9,6,12,7,8,6,13,4,3,5,2,5,5,6,10,14,7,12,8,10,11,20,3,7,9,6,4,7,9,16,10,9,10,10,8,7,7,GK ,20,1,1,1,1,1,1,1,1,1,1,1,1,1,1
19036242,Juninho,1651,23/08/1983,32,0,0,0,0,178,0,3,1,2,2,3,1,3,1,2,3,3,3,7,3,5,15,7,5,12,2,10,11,4,12,12,8,8,3,7,8,12,15,2,5,6,10,10,7,10,8,9,8,7,8,8,8,20,11,6,8,8,6,3,8,11,11,12,11,10,10,17,4,M C,1,1,1,1,1,1,1,1,1,1,20,1,1,1,1
19036246,Reinaldo,1651,03/10/1984,31,0,0,0,0,180,0,2,2,4,1,3,3,3,2,4,2,2,8,8,5,4,14,5,6,6,8,10,10,1,15,10,9,8,10,7,13,4,12,6,6,7,7,9,9,9,8,10,9,10,20,13,10,10,12,10,9,9,9,5,9,12,10,11,12,10,9,12,3,D L,1,1,1,1,1,1,1,20,1,1,1,1,1,15,1
19036356,Marcelo Dias,1651,29/09/1985,30,0,0,0,0,177,77,2,1,3,2,2,3,1,3,1,2,3,6,8,10,12,13,6,7,5,6,6,3,1,6,13,9,7,8,7,7,6,7,9,13,3,8,5,7,8,13,13,7,5,20,11,13,15,13,8,9,7,9,9,9,20,9,11,12,11,9,6,8,M/AM/S RL,1,1,18,1,19,20,1,1,1,1,1,15,16,1,1
19036390,Deivid,1651,23/02/1988,28,0,0,0,0,176,73,2,4,3,3,1,1,2,2,1,3,3,6,8,13,11,14,8,14,8,6,8,11,3,9,13,10,13,9,10,5,12,11,6,12,11,13,10,9,10,12,11,10,8,10,13,13,20,9,6,10,10,4,8,10,18,9,9,13,10,1,4,6,AM/S C,1,1,17,20,1,1,1,1,1,1,1,1,1,1,1
19036408,Leandro Melo,1651,11/03/1986,30,0,0,0,0,176,83,3,3,1,3,1,3,2,3,3,1,1,7,6,5,9,13,7,7,13,4,11,13,2,13,12,6,10,9,9,7,7,13,10,8,14,8,10,9,12,13,13,10,7,2,5,13,20,13,14,10,14,5,10,10,12,11,11,12,7,1,6,4,DM/M C,1,1,1,1,1,1,1,1,1,20,17,1,1,1,1
19036464,Allan Júnior,1651,16/05/1982,34,0,0,0,0,176,74,1,3,3,3,3,3,3,3,3,3,1,10,11,12,9,12,9,12,9,8,9,12,13,8,12,12,11,8,9,12,11,11,9,11,8,12,8,7,11,11,12,11,9,13,15,13,20,11,11,14,5,9,6,10,16,10,13,9,12,7,14,6,S ,1,1,20,1,1,1,1,1,1,1,1,1,1,1,1
19036478,Pablo,1651,01/08/1986,29,0,0,0,0,189,79,1,3,1,3,1,2,2,1,3,2,3,6,1,3,7,8,6,7,5,7,9,8,4,14,5,4,13,9,8,11,7,12,1,1,13,6,14,7,8,11,9,8,14,9,13,10,20,9,11,9,9,3,9,9,20,13,10,10,10,4,8,7,D C,1,1,1,1,1,1,20,1,1,1,1,1,1,1,1
19036496,Almir Dias,1651,16/04/1982,34,0,0,0,0,172,0,3,1,2,1,2,1,1,1,2,3,2,8,8,10,7,10,8,8,14,2,9,14,6,10,12,9,10,6,10,8,8,11,9,9,13,11,9,9,14,10,9,9,3,20,13,9,10,14,7,9,9,9,9,9,8,13,11,12,11,4,13,4,M/AM C,1,1,1,20,1,1,1,1,1,1,18,1,1,1,1
19036502,Denílson Gabionetta,1651,05/10/1985,30,0,0,0,0,178,65,2,3,3,3,3,3,2,2,2,1,3,9,11,16,8,14,10,6,13,7,5,13,14,4,15,16,10,10,8,9,12,10,12,18,8,13,8,7,11,16,14,12,7,20,15,14,7,12,13,13,15,12,5,11,15,9,14,12,10,15,9,5,AM RLC,1,1,10,15,20,18,1,1,1,1,1,12,12,1,1
19036574,Danilo Neco,1651,17/01/1986,30,0,0,0,0,175,72,3,1,2,3,2,2,2,3,2,3,2,8,10,12,14,11,5,8,11,5,5,12,13,7,12,12,11,10,13,10,12,10,11,11,5,11,4,13,9,14,14,10,8,14,14,14,20,12,10,12,11,11,8,11,15,11,13,11,12,8,10,2,S ,1,1,20,13,13,13,1,1,1,1,10,1,1,1,1
19036648,Paulo de Tárcio,1651,20/02/1987,29,0,0,0,0,178,0,2,4,1,2,3,3,2,1,1,2,1,4,5,8,2,10,7,7,5,7,9,10,1,14,8,9,7,8,9,7,8,11,9,4,13,7,12,8,9,14,14,8,5,10,9,14,20,12,7,9,4,5,8,9,19,11,13,13,8,3,8,1,D/WB/DM R,1,1,1,1,1,1,1,1,18,20,13,1,1,1,18
19036669,Thiago Mendes,1651,17/03/1985,31,0,0,0,0,180,76,3,1,2,1,3,1,3,1,3,2,3,10,11,10,6,9,12,9,12,10,12,11,9,13,10,12,11,13,9,10,9,10,10,5,10,11,12,13,11,12,12,10,12,10,12,12,20,13,11,10,4,10,6,10,9,9,10,7,12,5,12,6,DM/M C,1,1,1,13,1,1,1,1,12,17,20,1,7,1,14
19036706,Raul,1651,09/11/1985,30,0,0,0,0,170,73,1,3,3,2,2,2,3,2,2,1,1,12,12,13,11,14,11,7,11,12,9,13,12,8,13,11,13,11,11,11,12,11,12,15,5,14,9,12,12,14,15,9,5,20,13,14,9,14,9,12,5,11,4,13,17,12,12,14,13,2,18,3,D/WB L,1,1,1,13,13,1,1,18,1,10,12,12,1,20,1
19036708,Vladimir,1651,16/07/1989,26,0,0,0,0,190,84,12,12,11,12,14,10,12,17,13,12,10,7,2,3,3,8,11,10,2,3,1,9,4,3,10,6,11,12,10,12,8,12,14,4,10,5,12,8,8,14,15,13,17,20,12,12,4,11,14,12,5,11,6,11,10,16,11,13,13,8,11,2,GK ,20,1,1,1,1,1,1,1,1,1,1,1,1,1,1
19036718,Assis,1651,30/03/1986,30,0,0,0,0,177,75,1,2,1,2,2,3,1,1,2,1,1,5,8,6,7,11,5,7,2,3,7,12,2,13,7,9,9,8,9,7,9,13,6,4,11,7,11,8,9,14,14,8,7,20,12,13,10,6,9,9,9,9,6,9,16,9,12,11,10,4,12,8,D/DM L,1,1,1,1,1,1,1,20,1,18,13,1,1,15,1
19036728,Daniel Costa,1651,05/04/1988,28,0,0,0,0,183,80,2,2,1,3,1,1,3,2,4,1,1,14,10,12,11,15,15,8,14,4,7,15,12,9,14,8,10,9,13,9,14,15,10,14,8,11,9,13,10,11,11,12,10,7,12,10,20,10,12,13,8,13,11,11,12,10,10,11,10,8,12,12,AM RC,1,1,1,20,1,19,1,1,1,1,13,1,1,1,1
19036735,Thiago Furlan,1651,18/09/1985,30,0,0,0,0,175,72,4,3,2,1,1,1,1,1,1,3,1,6,4,14,14,14,8,14,5,2,6,9,2,4,14,6,14,5,7,9,7,12,5,13,7,11,6,8,9,14,13,10,8,9,13,13,20,14,8,10,9,10,8,10,10,11,13,9,10,9,4,8,S ,1,1,20,1,1,1,1,1,1,1,1,1,1,1,1
19036798,Felipe Menezes,1651,20/01/1988,28,0,0,0,0,185,76,3,2,3,2,2,4,3,2,2,1,2,13,13,12,14,13,13,12,14,6,6,15,15,10,15,17,12,8,11,9,15,10,11,16,4,14,14,12,9,12,11,13,12,9,13,12,20,13,13,11,9,12,6,10,7,12,13,12,13,12,12,10,M/AM C,1,1,1,20,1,1,1,1,1,14,18,1,1,1,1
19036810,Rogélio Balotelli,1651,07/07/1987,28,0,0,0,0,191,82,3,3,2,1,3,1,4,3,1,2,3,1,6,7,12,8,3,13,4,4,6,8,12,6,7,12,11,13,11,9,8,11,12,11,7,10,10,11,11,11,9,13,15,9,14,10,20,13,14,11,12,11,6,7,14,11,11,13,12,12,12,11,S ,1,1,20,1,1,1,1,1,1,1,1,1,1,1,1
19036876,Ranieri,1651,18/01/1982,34,0,0,0,0,186,78,3,2,2,3,1,2,1,2,3,1,3,7,3,1,1,5,5,13,1,4,13,4,2,13,5,10,11,10,7,12,3,13,15,1,13,7,13,7,8,9,13,8,12,10,16,12,20,13,9,10,6,8,8,10,16,11,8,12,12,10,4,4,D C,1,1,1,1,1,1,20,1,1,1,1,1,1,1,1
19036886,André Lima,1651,13/08/1986,29,0,0,0,0,179,82,1,1,2,2,3,2,2,2,2,2,1,1,1,2,2,6,1,12,5,4,13,7,2,13,6,9,12,10,7,8,3,13,9,5,13,7,13,7,8,13,13,8,12,11,15,13,20,13,13,12,3,1,9,10,19,10,14,12,10,4,7,2,D C,1,1,1,1,1,1,20,1,1,1,1,1,1,1,1
19036901,Wellington Saci,1651,05/01/1985,31,0,0,0,0,173,63,1,2,1,1,3,1,1,1,3,2,2,11,11,12,10,8,12,4,10,13,11,12,12,11,12,12,11,13,10,11,11,12,12,12,10,12,11,12,12,13,12,9,7,20,13,12,7,13,7,10,10,11,8,12,7,12,11,12,12,8,12,11,D/M LC,1,1,1,1,1,1,1,20,1,1,18,13,1,15,1
19036905,Vânder,1651,02/08/1985,30,0,0,0,0,170,0,2,2,1,1,3,1,3,3,2,2,2,8,11,10,5,8,8,5,4,8,9,10,4,7,13,3,12,9,4,8,8,14,2,12,8,8,9,9,10,14,14,9,5,20,15,14,10,14,6,10,7,1,10,10,17,10,12,11,12,2,6,2,D/WB/AM L,1,1,1,1,16,1,1,19,1,1,1,15,1,20,1
19036997,Diego Silva,1651,09/05/1989,27,0,0,0,0,189,0,3,2,4,1,3,1,2,2,1,2,3,3,5,7,6,9,7,10,7,3,13,9,5,13,7,8,11,8,11,12,6,12,5,4,5,8,14,15,15,11,10,11,14,7,14,11,20,15,11,10,6,7,10,17,15,12,13,11,11,2,5,5,DM R,1,1,10,1,1,1,1,1,15,20,13,1,1,1,12
19037001,Buick,1651,12/05/1983,33,0,0,0,0,170,0,1,3,2,4,2,1,3,2,3,1,2,10,11,11,8,10,10,6,10,12,10,11,10,10,11,13,9,12,9,10,9,10,11,9,10,10,10,12,11,12,13,8,4,20,14,12,9,13,8,13,12,11,8,12,12,11,9,12,12,15,13,7,D/WB L,1,1,1,1,5,1,1,20,1,1,1,11,1,19,1
19037081,Rafael Ricardo,1651,26/10/1989,26,0,0,0,0,178,71,2,2,3,2,3,2,2,3,2,3,2,6,10,13,12,12,6,7,7,2,6,8,6,7,7,9,8,8,7,8,7,9,8,9,13,9,7,7,8,13,13,7,7,20,14,13,9,13,6,9,9,2,9,9,9,13,13,9,12,4,11,1,AM L,1,1,15,1,20,1,1,1,1,1,1,1,1,15,1
19037206,Ulisses,1651,10/10/1983,32,0,0,0,0,177,76,3,1,3,2,3,3,1,1,1,2,1,7,7,9,13,12,11,11,7,3,7,9,12,7,9,9,11,5,9,6,7,13,4,6,10,12,5,7,9,11,13,4,10,11,8,13,20,14,9,9,5,9,8,9,14,13,13,10,13,3,6,1,AM/S C,1,1,18,20,1,1,1,1,1,1,1,1,1,1,1
19037375,Diego Rosa,1651,22/03/1989,27,0,0,0,0,179,71,3,2,4,2,2,1,3,1,2,2,2,5,6,11,9,12,7,9,10,7,9,10,9,9,11,13,11,12,10,11,10,10,11,10,11,12,11,11,12,13,11,11,8,20,13,13,8,12,9,12,10,9,10,13,10,7,9,11,10,9,10,9,AM/S LC,1,1,20,18,20,1,1,1,1,12,15,1,1,1,1
19037376,Bregalda,1651,09/07/1990,25,0,0,0,0,183,77,1,3,3,2,1,3,2,3,2,3,1,3,4,5,3,8,2,12,9,3,11,7,9,11,7,11,14,10,9,12,6,15,19,8,9,7,15,9,9,8,10,9,10,20,10,11,5,10,13,8,10,4,7,9,17,11,12,12,12,10,3,8,D C,1,1,1,1,1,1,20,1,1,1,1,1,1,1,1
19037377,Paulo Sérgio,1651,10/05/1989,27,0,0,0,0,186,83,1,3,2,2,1,3,1,2,1,2,1,9,8,8,8,10,7,13,8,5,12,10,7,12,8,10,13,11,9,13,8,13,4,1,13,7,13,9,10,12,11,14,14,5,8,11,20,10,15,10,10,9,4,10,10,12,11,13,12,1,14,2,D C,1,5,1,1,1,1,20,1,1,1,1,1,1,1,1
19037380,Bryan Jones,1651,23/01/1990,26,0,0,0,0,180,79,3,2,1,2,3,2,2,2,2,2,3,8,9,12,12,13,5,11,11,5,6,10,7,6,13,12,8,11,9,10,8,9,13,12,7,10,9,9,11,13,9,14,12,7,11,12,20,9,13,12,12,10,20,11,13,15,5,11,12,10,8,9,AM/S RLC,1,1,20,15,17,18,1,1,1,1,1,1,1,1,1
19037382,Adriel,1651,05/02/1991,25,0,0,0,0,174,71,3,3,2,3,3,1,1,3,3,2,3,7,6,5,7,13,5,7,10,7,12,8,6,14,9,9,7,8,9,6,10,14,5,9,11,8,11,9,10,10,12,9,7,8,12,10,20,7,9,9,7,9,9,9,20,12,12,11,11,1,16,4,DM/M C,1,1,1,10,1,1,1,1,1,20,17,1,1,1,1
19037409,Marcelo Valverde,1651,21/11/1989,26,0,0,0,0,185,75,10,10,10,3,12,11,11,11,10,12,11,1,2,3,1,5,4,1,1,1,3,2,3,3,10,9,9,10,9,10,9,10,12,2,7,1,12,11,9,12,12,11,10,8,14,11,20,9,11,9,9,5,4,9,14,12,12,10,10,13,12,9,GK ,20,1,1,1,1,1,1,1,1,1,1,1,1,1,1
19037412,Fabrício,1651,20/02/1990,26,0,0,2,0,186,82,3,3,2,1,2,1,3,2,3,3,1,6,10,7,8,12,14,12,13,15,13,11,14,12,12,15,12,16,12,10,11,12,15,11,12,11,13,13,13,12,10,13,14,20,14,12,5,13,15,12,13,14,9,15,11,15,12,13,13,6,9,13,D C,1,5,1,1,1,1,20,1,1,1,1,1,1,1,1
19037413,Thiago Sales,1651,07/05/1987,29,0,0,0,0,187,80,2,3,1,2,1,1,3,2,1,3,1,5,6,7,5,11,7,12,7,5,14,10,7,12,11,10,12,12,11,11,5,12,14,10,11,4,12,12,10,12,12,13,15,15,12,9,20,12,12,12,6,13,5,7,7,12,12,11,13,12,12,7,D C,1,10,1,1,1,1,20,1,1,1,1,1,1,1,1
19037414,Tamba,1651,05/10/1989,26,0,0,0,0,168,68,2,2,3,2,3,1,2,2,1,3,2,5,9,8,5,10,8,10,7,5,10,10,4,10,10,12,10,13,11,9,9,11,8,9,9,8,8,11,14,15,12,10,5,8,14,12,20,13,8,9,12,1,9,14,13,11,12,13,12,6,11,8,D/DM RC,1,1,1,1,1,1,16,1,20,18,12,1,1,1,14
19037415,Lenon,1651,02/05/1990,26,0,0,0,0,177,65,1,2,1,4,1,2,2,2,2,2,3,3,7,10,9,12,4,9,12,5,13,13,8,14,12,12,13,13,12,13,11,13,14,5,10,8,14,13,15,13,13,9,9,8,15,12,20,14,9,14,10,12,9,10,7,12,13,12,11,7,6,15,DM/M C,1,1,1,1,1,1,1,1,1,20,19,1,1,1,1
19037416,Rodrigo Andrade,1651,05/02/1988,28,0,0,0,0,179,72,3,3,2,2,3,2,1,3,3,3,1,10,12,12,12,11,11,8,11,5,7,12,13,5,13,11,11,11,12,11,12,12,3,12,6,11,8,11,12,12,12,10,9,16,12,12,20,13,9,11,12,12,6,10,16,14,11,14,6,4,8,5,M/AM C,1,1,1,20,1,1,1,1,1,1,16,1,1,1,1
19037417,Bruno Paulo,1651,14/02/1990,26,0,0,0,0,176,75,2,2,2,3,1,3,2,3,1,3,1,6,12,15,9,11,7,7,9,6,6,11,10,5,12,5,12,8,8,9,11,12,13,15,6,12,6,8,14,14,13,10,8,12,9,15,20,13,9,9,3,11,5,13,12,13,5,13,12,7,10,7,AM/S LC,1,1,18,20,15,13,1,1,1,1,14,13,5,1,1
19037419,Diego Carlos,1651,15/05/1988,28,0,0,0,0,174,67,3,4,1,1,1,3,1,3,2,1,2,11,8,11,9,13,6,7,12,8,10,10,3,6,12,10,13,7,12,8,10,9,12,13,5,12,9,12,11,14,14,11,7,10,15,12,20,11,6,9,6,10,10,9,11,14,9,11,12,8,8,8,AM L,1,1,15,13,20,13,1,1,1,1,10,13,10,10,1
19037595,Felipe,1651,15/05/1987,29,0,0,0,0,193,85,2,3,3,2,2,1,3,3,2,1,4,4,8,7,5,11,9,13,10,5,14,12,8,14,11,12,15,16,13,9,10,12,16,8,11,4,13,10,9,9,8,14,18,20,12,11,8,10,16,10,14,14,17,7,17,13,13,12,11,14,11,11,D C,1,6,1,1,1,1,20,6,1,1,1,1,1,6,1
19037738,Luan,1651,21/09/1988,27,0,0,0,0,184,75,3,2,3,1,2,1,1,1,1,1,4,8,12,12,12,12,10,12,12,9,11,12,12,10,12,15,11,14,10,11,12,9,15,12,7,13,10,11,14,13,12,10,12,20,12,13,7,14,12,11,15,12,13,15,5,15,10,9,18,9,7,13,AM L,1,1,15,13,20,11,1,9,1,1,9,15,7,12,1
19037813,Willians,1651,29/01/1986,30,0,0,0,0,175,71,1,3,2,2,3,3,3,2,1,3,2,3,11,9,7,11,7,12,11,1,14,9,10,14,11,17,15,18,15,9,10,11,9,8,7,10,14,13,15,14,13,13,8,9,16,13,20,15,12,14,16,14,6,14,8,9,15,10,5,7,5,15,DM/M C,1,1,1,1,1,1,1,1,12,20,18,1,13,1,14
19038038,Raphael Luz,1651,18/07/1989,26,0,0,0,0,176,68,1,3,2,1,2,2,3,1,2,2,1,15,14,12,9,10,13,7,12,4,5,11,8,5,12,10,9,11,9,7,11,10,3,9,4,12,12,8,12,13,15,8,8,6,15,16,20,12,7,10,10,4,4,10,12,10,12,11,9,8,7,8,M/AM/S C,1,1,18,20,10,10,1,1,1,1,16,5,5,1,1
19038039,Rodrigo,1651,21/03/1987,29,0,0,0,0,193,85,2,2,3,1,3,3,3,3,3,3,2,3,4,7,6,10,5,11,7,6,12,11,7,11,11,9,13,10,9,9,11,9,9,8,6,6,12,9,11,5,8,11,14,7,12,9,20,9,12,7,4,9,6,9,11,10,14,12,14,9,12,4,D/DM C,1,1,1,1,1,1,19,1,1,20,14,1,1,1,1
19038040,Roni,1651,25/04/1991,25,0,0,0,0,178,79,2,1,1,2,3,3,1,3,3,1,2,8,9,11,11,12,6,12,9,7,6,11,12,10,13,9,11,10,11,11,11,13,7,12,8,14,6,12,11,11,12,11,11,12,12,11,20,9,10,12,4,8,9,6,6,11,12,8,10,6,11,7,S ,1,1,20,1,1,1,1,1,1,1,1,1,1,1,1
19038042,Wellington,1651,28/01/1991,25,0,0,0,0,173,70,3,4,2,3,3,1,3,2,4,1,2,6,9,11,8,12,6,10,7,10,13,12,10,13,13,11,13,14,12,11,10,12,12,7,10,11,12,13,14,18,15,7,7,10,14,14,20,16,8,10,13,11,15,6,17,15,11,12,10,7,11,12,DM/M C,1,1,14,14,1,1,1,1,1,18,20,1,1,1,1
19038080,Harrison,1651,25/01/1990,26,0,0,0,0,183,78,1,3,3,3,2,2,1,1,3,2,1,2,1,1,4,4,1,8,4,2,12,5,1,12,3,8,7,7,5,7,1,12,4,1,11,4,7,4,5,12,10,5,10,8,15,11,20,7,7,8,6,8,8,8,20,12,8,14,12,12,19,8,D C,1,10,1,1,1,1,20,1,1,1,1,1,1,1,1
19038081,Lucas,1651,26/03/1988,28,2,0,0,0,174,74,2,2,2,1,2,1,1,1,2,3,2,12,14,14,10,14,10,5,11,11,13,14,10,11,15,14,14,12,11,11,13,12,12,12,12,14,13,14,14,14,15,10,8,5,11,14,20,15,8,11,15,13,6,7,6,11,13,14,10,9,11,12,D/WB R,1,1,1,1,1,1,1,1,20,1,1,1,1,1,19
19038082,Anderson Luís,1651,31/07/1988,27,0,0,0,0,175,71,2,2,2,1,1,2,2,3,3,2,3,8,12,12,8,12,7,7,10,11,9,12,7,13,13,11,14,13,12,14,11,11,14,13,9,13,10,13,13,15,14,12,8,7,12,14,20,14,10,13,5,12,9,10,12,12,12,11,13,11,14,8,D/WB R,1,1,1,1,1,1,1,13,20,1,1,1,1,10,20
19038083,Pedro Botelho,1651,14/12/1989,26,0,0,0,0,186,72,3,3,2,4,3,1,2,3,2,3,3,7,11,12,9,11,8,6,11,12,6,12,10,7,11,10,13,14,13,12,13,13,11,15,11,16,9,13,12,13,12,12,13,20,12,14,7,13,11,13,8,13,11,13,6,9,8,9,5,13,7,15,D/WB/AM LC,1,1,1,20,14,1,1,18,1,1,10,15,1,17,1
19038158,Luiz Felipe,1651,05/10/1987,28,0,0,0,0,182,0,1,1,2,2,1,3,3,3,1,1,2,8,7,11,14,10,8,11,9,8,6,8,8,5,13,10,14,9,10,9,8,13,3,12,11,14,9,7,9,14,13,5,10,9,11,14,20,6,7,10,8,10,10,10,12,12,11,12,13,12,5,2,S ,1,1,20,1,1,1,1,1,1,1,1,1,1,1,1
19038257,Bady,1651,27/04/1989,27,0,0,0,0,170,65,4,3,2,1,1,1,1,2,1,4,3,13,13,12,11,12,12,7,11,11,10,12,13,10,12,11,11,12,11,12,13,12,9,14,10,12,9,12,13,13,13,16,5,11,13,13,20,13,7,11,12,10,11,11,13,11,11,11,10,7,13,5,M/AM RC,1,1,1,20,1,14,1,1,1,1,19,1,15,1,1
19038410,André Cassaco,1651,20/09/1988,27,0,0,0,0,185,0,2,1,3,1,3,3,2,2,3,3,2,7,9,10,9,10,10,10,9,4,8,9,9,7,10,5,12,3,6,8,9,13,10,8,4,13,9,7,9,13,12,8,8,10,12,13,20,13,9,10,8,4,10,11,13,11,11,8,9,6,7,3,S C,1,1,20,15,1,1,1,1,1,1,10,1,1,1,1
19038479,Bruno Recife,1651,13/03/1986,30,0,0,0,0,189,0,2,2,2,4,1,2,2,1,1,3,1,6,4,5,7,10,4,15,4,4,12,9,3,15,7,9,14,10,6,13,6,10,8,1,10,6,11,9,10,15,13,10,14,5,17,11,20,11,11,10,10,10,4,10,9,14,8,11,10,10,12,3,D C,1,1,1,1,1,1,20,1,1,1,1,1,1,1,1
19038481,Camilo,1651,06/03/1989,27,0,0,0,0,193,92,11,8,8,1,12,14,10,13,10,10,11,4,3,2,2,5,8,1,1,1,2,1,1,2,6,10,11,14,7,14,8,14,7,2,5,3,10,9,8,10,14,9,16,9,11,13,20,8,12,10,5,10,10,10,16,12,9,11,10,2,8,5,GK ,20,1,1,1,1,1,1,1,1,1,1,1,1,1,1
19038489,Johnnattan,1651,13/08/1988,27,0,0,0,0,176,69,1,1,1,2,3,2,3,2,3,1,3,3,11,12,4,5,3,3,4,11,14,13,6,14,12,12,12,11,8,8,13,11,11,10,12,11,13,12,12,12,13,12,8,7,12,13,20,12,13,11,7,12,7,10,11,10,12,12,10,13,12,11,DM/M C,1,1,1,1,1,1,1,1,12,20,19,1,1,1,10
19038492,Rafinha,1651,11/08/1988,27,0,0,0,0,167,0,2,3,1,1,2,1,1,2,1,2,3,8,10,12,9,9,8,5,9,11,7,10,5,7,11,10,6,12,7,7,9,6,9,11,3,11,7,8,10,13,12,6,4,20,11,13,7,10,4,9,9,5,9,13,10,13,11,7,11,8,4,3,D/WB/M/AM LC,1,1,1,18,18,1,1,17,1,1,17,16,1,20,1
19038570,Ramón,1651,22/08/1990,25,0,0,0,0,187,82,2,3,1,1,3,2,3,1,1,3,3,3,9,9,8,10,3,11,10,10,12,10,11,14,10,18,11,15,12,11,7,10,10,10,5,9,11,13,12,12,11,13,14,6,16,14,20,14,15,13,17,13,5,12,15,15,15,14,15,13,11,10,D RC,1,11,1,1,1,1,20,5,17,13,10,1,6,1,10
19038577,Adriano,1651,28/09/1987,28,0,0,0,0,171,68,1,3,2,2,1,2,2,4,2,2,1,7,11,12,13,12,10,11,12,2,4,11,12,5,12,13,13,13,11,11,11,11,15,16,8,14,8,8,11,14,14,9,8,10,12,14,20,14,9,14,14,13,8,10,12,12,12,16,13,8,12,7,S ,1,1,20,14,10,10,1,1,1,1,1,5,5,1,1
19038785,Alan Santos,1651,24/04/1991,25,0,0,0,0,182,75,2,1,1,1,1,2,2,1,3,2,3,11,10,12,10,13,11,12,10,6,14,13,10,14,12,14,13,14,12,13,12,11,14,12,10,12,14,14,14,12,12,13,11,8,11,12,20,12,13,13,8,12,12,13,8,14,6,13,11,12,12,13,DM ,1,1,1,1,1,1,1,1,1,20,13,1,1,1,1
19038788,Ari,1651,06/08/1991,24,0,0,0,0,172,72,2,1,1,1,1,2,1,3,1,2,1,7,9,12,8,12,3,8,10,1,9,11,9,9,11,9,11,11,8,10,8,10,6,10,5,12,10,11,11,13,13,13,6,10,14,13,20,12,8,12,9,6,10,15,8,13,10,9,9,5,12,1,D/WB R,1,1,1,10,1,1,1,1,20,10,10,1,1,1,16
19038791,Danillo Galvão,1651,21/01/1991,25,0,0,0,0,183,82,3,2,1,1,1,1,2,1,2,3,2,8,6,14,12,14,8,14,9,2,8,8,7,5,14,10,14,3,12,7,9,13,10,13,7,12,8,3,7,14,14,9,15,1,6,14,20,9,13,10,10,10,3,10,12,12,10,10,11,7,7,12,S ,1,1,20,1,1,1,1,1,1,1,1,1,1,1,1
19038794,Eliomar,1651,16/03/1988,28,0,0,0,0,175,73,1,2,1,1,2,3,3,1,4,3,3,12,11,13,11,12,13,9,12,7,6,12,11,6,14,11,10,12,11,10,12,11,11,13,11,12,7,10,11,13,12,11,7,14,12,13,20,11,10,12,9,10,8,10,10,12,12,10,11,6,9,9,AM RLC,1,1,10,17,20,17,1,1,1,1,10,14,10,1,1
19038795,Elkeson,1651,13/07/1989,26,0,0,0,0,180,77,1,1,3,2,2,1,3,1,1,2,2,10,11,15,17,13,13,14,13,3,6,12,12,10,15,9,14,11,14,13,12,15,16,15,4,14,8,14,12,14,14,13,12,14,15,13,20,12,13,15,7,19,7,12,14,14,13,13,13,11,10,8,AM/S LC,1,1,20,18,15,13,1,1,1,1,1,1,1,1,1
19038798,Jó,1651,18/01/1989,27,0,0,0,0,182,75,3,1,1,1,2,3,2,2,2,3,2,10,11,12,13,11,10,10,12,5,5,11,5,6,12,7,9,9,11,7,10,9,5,1,5,10,9,11,15,12,12,10,12,9,14,13,20,11,11,9,9,9,8,9,11,13,10,10,12,7,16,7,M C,1,1,1,1,1,1,1,1,1,15,20,1,1,1,1
19038800,João Paulo,1651,20/01/1989,27,0,0,0,0,185,80,11,9,9,1,10,10,11,10,11,8,9,3,1,1,2,5,7,1,2,2,3,4,3,1,5,12,9,12,8,10,3,8,12,1,10,3,10,9,9,6,11,14,13,8,15,7,20,7,16,8,8,8,5,8,18,11,13,12,12,9,17,2,GK ,20,1,1,1,1,1,1,1,1,1,1,1,1,1,1
19038801,Jéferson,1651,30/11/1991,24,0,0,0,0,183,0,14,14,10,9,10,9,11,11,9,8,13,5,1,2,1,1,7,1,2,2,2,3,3,1,1,6,7,11,8,10,4,14,9,3,9,2,12,8,7,13,11,8,7,1,15,14,20,6,9,9,9,8,8,9,10,11,11,13,13,8,11,8,GK ,20,1,1,1,1,1,1,1,1,1,1,1,1,1,1
19038805,Leílson,1651,08/03/1991,25,0,0,0,0,169,71,1,3,1,1,4,1,2,3,1,4,2,8,10,12,12,12,11,8,11,4,4,11,13,4,12,11,12,10,11,7,11,9,10,14,4,12,4,10,9,15,12,11,5,6,8,14,20,12,9,12,6,12,14,12,10,12,13,12,9,8,14,16,AM/S LC,1,1,18,15,20,13,1,1,1,1,12,12,13,1,1
19038806,Luanderson,1651,07/06/1989,27,0,0,0,0,187,76,3,2,2,2,3,2,1,4,3,2,2,5,3,2,2,12,6,8,6,4,9,14,4,14,8,8,7,5,6,5,5,13,4,8,14,6,14,7,11,6,1,8,14,15,12,5,20,13,8,8,8,8,4,8,9,12,12,9,11,10,2,8,DM C,1,1,1,1,1,1,15,1,1,20,1,1,1,1,1
19038812,Marquinhos,1651,17/10/1989,26,0,0,0,0,175,68,1,3,1,1,3,2,3,1,2,4,1,13,12,14,10,12,12,5,11,3,6,13,14,7,12,10,12,10,10,10,12,10,13,16,11,15,7,13,13,15,13,5,5,8,13,15,20,12,5,12,5,14,8,13,4,12,9,10,11,8,18,10,M/AM/S RC,1,1,19,19,14,20,1,1,1,1,12,12,19,1,10
19038816,Rogério,1651,04/01/1989,27,0,0,0,0,179,77,2,2,1,2,2,3,3,1,1,2,2,3,12,12,9,10,4,9,10,14,10,11,10,10,11,12,9,12,9,11,8,9,12,11,5,12,11,11,12,13,12,11,12,6,14,13,20,13,12,13,8,10,7,12,15,11,10,9,9,4,16,4,D/WB R,1,1,1,1,1,5,1,11,18,1,1,1,10,9,20
19039093,Alexandre Villa,1651,13/06/1983,33,0,0,0,0,191,85,12,11,7,1,13,13,11,11,10,7,9,4,3,3,1,2,8,1,3,2,3,1,4,2,4,10,12,15,8,9,7,12,13,2,9,2,13,8,3,6,12,13,15,9,11,9,20,4,9,15,10,9,5,10,9,10,4,5,13,11,3,3,GK ,20,1,1,1,1,1,1,1,1,1,1,1,1,1,1
19039102,Jairo,1651,31/01/1988,28,0,0,0,0,169,64,2,3,1,2,3,2,1,4,1,1,4,9,11,11,11,12,13,5,13,6,7,8,12,6,13,10,11,9,9,11,12,10,12,4,7,12,11,9,12,13,12,6,8,10,13,14,20,13,8,6,6,9,7,9,8,16,5,8,12,13,14,8,M/AM C,1,1,1,20,1,1,1,1,1,1,18,1,1,1,1
19039323,Rafael Carioca,1651,18/06/1989,27,0,0,0,0,179,72,2,3,1,1,3,1,4,2,1,4,3,11,9,14,11,15,6,11,13,6,13,14,8,14,15,13,13,13,15,13,14,14,12,13,9,12,15,13,11,13,14,12,10,14,14,14,20,13,12,12,6,12,9,11,13,12,14,15,8,7,10,9,DM/M C,1,1,1,1,1,1,12,1,1,20,19,1,1,1,1
19039398,Bruno Iotti,1651,15/01/1987,29,0,0,0,0,180,76,3,4,2,4,3,3,3,2,1,3,3,13,12,12,10,11,14,10,11,11,8,11,10,10,12,3,9,8,9,10,10,10,6,13,1,11,10,12,9,13,13,10,11,20,10,13,8,12,10,10,10,5,12,12,18,10,10,12,10,4,14,4,M/AM LC,1,1,1,16,20,10,1,14,1,1,10,16,7,14,1
19039465,Márcio Tarrafas,1651,13/04/1985,31,0,0,0,0,180,0,3,2,3,2,1,4,1,1,2,3,2,9,6,13,10,11,8,11,13,1,6,11,5,6,12,7,9,6,10,8,11,9,10,10,7,14,9,10,11,13,15,8,12,9,14,15,20,11,11,10,10,10,10,10,16,12,10,10,10,1,17,1,M/AM/S C,1,1,16,20,1,1,1,1,1,1,16,1,1,1,1
19039481,Léo Guerreiro,1651,17/10/1983,32,0,0,0,0,187,0,3,1,4,1,3,3,4,1,2,3,1,4,5,9,11,10,8,11,9,5,4,7,12,5,10,9,11,12,10,10,4,10,12,12,13,11,5,8,12,13,14,12,14,20,13,13,8,11,12,12,9,4,5,9,9,12,10,8,12,9,3,8,S ,1,1,20,1,1,1,1,1,1,1,1,1,1,1,1
19039553,Júnior,1651,23/04/1990,26,0,0,2,0,177,69,2,2,1,1,3,3,1,3,3,2,2,5,5,9,10,5,6,7,10,3,4,6,9,3,6,9,11,9,12,10,7,10,10,9,13,10,3,8,11,10,11,7,13,20,11,11,10,15,11,5,9,9,3,4,6,12,10,9,10,10,10,7,S ,1,1,20,1,1,1,1,1,1,1,1,1,1,1,1
19039555,Tiago Dutra,1651,17/09/1990,25,0,0,10,0,175,76,1,2,2,2,2,1,1,3,3,3,3,10,10,8,7,11,10,8,9,5,11,12,11,13,12,16,11,16,11,11,11,11,16,12,8,11,11,13,13,13,12,11,6,20,15,14,9,12,11,11,12,9,11,12,9,14,8,10,10,12,12,9,DM/M C,1,1,1,1,1,1,1,1,1,20,16,12,1,10,1
19039621,Eduardo,1651,15/09/1981,34,0,0,0,0,195,94,13,11,7,2,8,10,8,13,7,8,8,5,3,1,1,5,9,1,2,3,3,1,1,3,1,9,8,11,7,10,6,13,3,2,10,1,6,7,6,10,13,7,16,10,13,12,20,3,11,9,9,4,5,9,19,12,10,9,11,10,2,1,GK ,20,1,1,1,1,1,1,1,1,1,1,1,1,1,1
19039624,Hudson,1651,18/07/1986,29,0,0,0,0,172,70,2,3,4,3,1,1,3,2,1,2,2,10,10,14,9,13,9,3,8,5,7,8,8,8,12,6,7,5,8,14,5,7,12,13,6,15,4,7,13,14,14,10,6,7,11,15,20,12,7,13,9,13,8,7,14,10,12,12,12,10,10,2,D/WB/AM R,1,1,1,1,1,19,1,1,20,1,1,1,15,1,18
19039650,Negretti,1651,01/08/1987,28,0,0,0,0,187,72,1,3,1,2,1,2,3,3,1,2,2,7,5,1,7,7,3,11,1,2,13,8,4,12,7,6,13,10,8,6,6,13,10,7,6,5,13,7,8,13,13,8,7,13,10,13,20,5,13,10,11,1,10,10,11,9,13,12,12,10,3,6,D C,1,1,1,1,1,1,20,1,1,1,1,1,1,1,1
19039660,Rafael Tavares,1651,03/04/1986,30,0,0,0,0,190,88,2,3,4,2,3,3,2,3,3,3,3,1,5,4,4,7,1,13,8,10,11,11,9,13,7,10,11,11,7,8,7,14,5,1,11,10,8,13,14,9,8,8,15,14,12,9,20,10,14,10,12,1,10,10,17,12,12,10,11,2,13,3,D C,1,1,1,1,1,1,20,1,1,1,1,1,1,1,1
19039792,Aírton,1651,08/02/1989,27,0,0,0,0,175,70,3,3,2,3,1,1,2,1,1,4,2,9,12,12,8,11,6,11,6,11,10,11,4,11,12,12,12,13,10,13,13,10,12,1,7,13,11,12,12,13,13,7,8,20,13,12,7,13,6,10,10,10,7,10,7,12,12,12,11,7,10,2,D/WB L,1,1,1,1,1,1,1,20,1,1,1,10,1,19,1
19039833,Marquinhos,1651,08/10/1986,29,0,0,0,0,180,0,3,3,2,1,3,3,2,1,2,2,2,5,2,2,1,6,3,14,3,1,14,5,1,14,2,6,7,8,4,6,2,14,8,1,13,6,7,6,7,14,14,7,9,1,13,14,20,6,9,8,7,6,8,8,10,10,11,13,10,8,16,8,D C,1,1,1,1,1,1,20,1,1,1,1,1,1,1,1
19039834,Nata,1651,16/03/1985,31,0,0,0,0,181,75,2,1,2,2,2,3,3,1,3,1,1,9,9,5,7,15,9,9,11,2,8,14,3,12,11,3,13,9,11,11,11,15,10,1,13,10,14,10,14,10,8,7,9,10,14,11,20,15,8,10,7,10,10,10,15,11,10,9,9,10,2,3,DM/M C,1,1,1,1,1,1,1,1,10,20,18,1,13,1,10
19039835,Paulo Cézar,1651,23/09/1981,34,0,0,0,0,179,0,4,3,3,2,2,4,2,2,2,2,2,6,12,13,2,12,7,7,6,13,12,11,1,10,12,8,10,8,8,6,8,14,9,5,8,8,10,6,9,13,13,8,6,20,8,13,5,14,6,9,9,7,9,8,7,11,10,13,11,4,12,7,D/WB LC,1,1,1,1,1,1,1,20,1,1,15,15,1,16,1
19039886,Fabinho,1651,07/09/1983,32,0,0,0,0,163,59,3,1,1,3,2,2,3,2,1,1,1,12,12,14,11,13,12,8,11,8,7,11,11,7,12,10,13,11,10,10,11,12,13,14,8,15,7,10,15,14,15,8,3,10,8,13,20,14,7,11,12,9,8,12,12,12,12,10,10,7,15,7,AM/S R,1,1,20,1,14,19,1,1,1,1,1,1,1,1,1
19040170,Alan Santolini,1651,14/08/1987,28,0,0,0,0,187,0,1,1,3,1,1,3,3,2,2,2,3,5,2,12,12,12,5,12,6,2,5,5,4,3,7,5,7,2,11,6,6,12,8,9,11,12,6,5,6,12,12,6,10,9,12,11,20,11,6,9,9,6,6,9,13,2,8,12,12,1,11,6,S ,1,1,20,1,1,1,1,1,1,1,1,1,1,1,1
19040298,Thiago Silva,1651,02/11/1986,29,0,0,0,0,177,70,3,1,2,1,3,3,1,2,2,3,2,5,8,12,13,8,5,13,7,1,5,7,4,2,11,8,10,4,9,6,3,10,5,11,5,8,5,5,7,13,13,7,8,6,7,13,20,8,6,8,8,8,8,8,12,10,12,11,10,10,10,1,AM/S R,1,1,20,1,1,17,1,1,1,1,1,1,1,1,1
19040391,Dudu,1651,17/04/1990,26,0,0,0,0,180,65,3,1,4,3,2,3,2,1,2,3,2,4,7,7,8,9,2,10,8,6,15,10,6,15,9,12,10,12,8,10,8,9,7,1,12,6,11,10,10,9,10,10,10,20,9,9,8,10,10,12,6,4,3,9,7,11,8,10,12,8,7,5,D C,1,12,1,1,1,1,20,1,11,1,1,1,1,1,1
19040392,Anderson Carvalho,1651,29/05/1990,26,0,0,0,0,174,75,3,3,2,1,3,1,3,1,1,2,2,8,11,11,12,11,8,12,12,5,11,13,3,12,13,12,11,13,12,12,11,13,15,8,9,13,10,13,14,12,11,13,7,12,10,12,20,12,12,14,4,8,7,8,11,10,11,12,15,13,10,9,DM/M/AM LC,1,1,1,1,18,13,1,1,1,20,20,15,10,1,1
19040402,Paulinho,1651,14/06/1988,28,0,0,0,0,177,63,4,3,1,2,3,1,3,1,1,2,1,7,11,14,12,13,8,9,12,5,5,12,12,5,13,12,12,11,11,11,13,11,13,15,10,12,7,11,11,15,13,12,9,12,9,15,20,12,6,11,6,14,15,15,14,13,12,14,9,8,12,7,AM/S RLC,1,1,19,15,20,19,1,1,1,1,1,1,1,1,1
19040456,Eli Sabiá,1651,31/08/1988,27,0,0,0,0,189,88,3,1,1,3,3,2,2,4,2,2,2,5,4,9,8,7,5,12,5,5,11,11,8,12,11,12,10,13,11,10,8,11,13,11,12,10,11,13,13,10,11,14,15,20,12,10,9,13,14,10,12,12,5,7,7,14,13,13,12,10,12,9,D C,1,1,1,1,1,1,20,1,1,1,1,1,1,1,1
19040458,Eron,1651,09/09/1988,27,0,0,0,0,186,80,3,2,1,2,1,2,3,1,4,3,2,5,7,4,9,10,9,15,4,4,12,10,8,10,9,4,8,11,10,7,3,12,4,6,4,9,15,9,10,10,13,10,14,10,10,12,20,7,12,6,8,10,7,10,11,13,12,12,9,9,19,4,D C,1,1,1,1,1,1,20,1,1,1,1,1,1,1,1
19040469,Wesley,1651,24/06/1987,29,2,0,0,0,177,66,1,1,2,1,3,3,3,1,3,3,3,10,12,13,11,12,11,8,12,8,11,12,11,11,13,13,12,11,11,12,13,13,9,14,11,12,11,11,11,15,15,9,9,14,14,14,20,14,10,10,9,11,12,16,5,12,7,10,9,8,12,14,DM/M RC,1,1,10,15,9,13,1,1,12,18,20,9,15,1,13
19040508,Serginho,1651,03/12/1990,25,0,0,0,0,166,62,2,3,1,1,1,3,1,3,2,2,1,11,11,13,12,12,11,4,10,3,5,12,12,7,13,11,12,10,11,11,12,11,13,13,7,13,8,12,11,14,15,15,3,7,11,14,20,12,4,12,9,11,11,15,10,10,9,12,12,11,11,9,AM/S RC,1,1,17,18,11,20,1,1,10,1,10,9,15,1,11
19040521,Reis,1651,04/07/1988,27,0,0,0,0,188,80,1,3,2,1,2,2,1,2,3,3,3,2,9,11,12,12,8,13,11,8,6,11,13,4,10,10,13,12,12,11,11,11,11,10,9,12,8,13,11,11,11,16,15,12,14,11,20,14,14,13,11,10,8,9,16,11,11,10,10,8,7,8,S ,1,1,20,13,1,1,1,1,1,1,1,1,1,1,1
19040525,Bruno Maia,1651,19/05/1988,28,0,0,0,0,190,85,3,4,2,1,3,3,2,1,3,1,2,9,5,4,3,10,7,14,3,8,14,10,6,14,9,11,12,11,8,11,6,12,2,6,14,9,9,6,9,14,12,10,13,20,15,13,6,14,14,11,11,8,9,11,17,12,10,10,11,5,5,7,D C,1,1,1,1,1,1,20,1,1,1,1,1,1,1,1
19040631,Arlan,1651,05/11/1986,29,0,0,0,0,169,64,2,1,1,1,2,1,3,3,2,1,1,7,11,10,8,9,8,8,7,8,8,10,4,7,12,10,10,9,10,7,9,14,9,11,11,11,8,9,10,13,12,6,5,10,12,14,20,14,6,10,9,10,15,12,18,10,13,11,12,7,16,5,WB/M/AM R,1,1,1,1,1,16,1,1,15,1,1,1,20,1,17
19040636,Eric,1651,05/12/1985,30,0,0,0,0,175,78,3,1,1,1,2,3,3,1,1,1,1,13,12,13,12,12,16,7,12,5,4,14,12,9,14,10,11,12,12,13,14,15,14,16,13,12,10,11,12,12,13,13,8,20,13,12,8,11,11,15,7,14,7,12,15,15,12,12,13,14,9,11,AM RLC,1,1,14,20,16,15,1,1,1,1,11,10,10,1,1
19040639,Vitinho,1651,20/02/1989,27,0,0,0,0,173,76,1,2,1,2,1,1,1,2,3,3,3,6,10,12,10,12,8,10,10,5,4,10,10,3,11,10,10,13,9,10,10,10,7,13,9,10,9,8,8,14,13,12,11,10,14,13,20,12,10,7,6,12,13,9,8,12,11,11,13,7,14,7,S C,1,1,20,15,1,1,1,1,1,1,1,1,1,1,1
19040684,Alcione,1651,17/06/1984,32,0,0,0,0,183,74,3,1,3,1,3,1,3,3,1,3,2,4,7,7,8,14,7,6,10,3,5,14,2,4,11,9,6,4,13,8,13,14,9,10,13,9,9,8,12,9,10,8,12,2,5,10,20,7,8,9,9,9,9,9,15,10,11,13,10,10,3,6,M/AM C,1,1,1,20,1,1,1,1,1,1,18,1,1,1,1
19040965,Thompson,1651,23/12/1981,34,0,0,0,0,175,78,1,1,2,4,1,1,2,3,1,3,2,6,8,6,3,13,7,7,6,7,7,7,3,11,9,5,9,8,9,10,9,13,9,6,13,6,11,8,9,10,14,8,8,9,10,14,20,7,7,9,10,9,5,9,9,11,9,11,10,10,12,2,D/WB/DM R,1,1,1,1,1,1,1,1,19,20,11,1,1,1,17
19041001,Vilson,1651,03/04/1988,28,0,0,0,0,189,79,1,2,4,2,1,1,1,2,2,1,3,5,7,11,11,10,8,14,6,9,13,10,7,12,10,15,13,14,12,13,8,13,16,11,13,11,13,13,14,12,11,14,15,9,14,12,20,13,15,12,13,10,13,14,7,15,14,14,12,13,12,11,D C,1,11,1,1,1,1,20,8,7,15,5,3,1,6,4
19041059,Deurick,1651,17/01/1981,35,0,0,0,0,177,77,2,3,3,2,1,2,2,1,3,3,2,4,4,3,2,9,6,14,4,7,11,4,6,15,8,8,10,7,8,11,3,15,1,1,6,6,7,7,10,10,6,8,7,9,14,7,20,14,8,8,8,5,4,8,11,9,11,11,11,3,17,1,D C,1,1,1,1,1,1,20,1,1,15,5,1,1,1,1
19041082,Rogério,1651,22/09/1985,30,0,0,0,0,189,84,1,3,2,2,2,3,3,4,1,1,1,6,4,5,2,7,7,8,4,5,13,6,1,13,6,10,13,10,7,10,3,13,5,8,5,6,13,7,8,13,13,8,10,10,10,13,20,13,12,10,10,10,10,10,12,11,11,13,10,7,7,8,D C,1,1,1,1,1,1,20,1,1,1,1,1,1,1,1
19041123,Chicão,1651,08/11/1985,30,0,0,0,0,180,70,1,2,1,1,3,2,2,2,1,4,2,7,7,6,7,9,7,9,8,1,11,9,4,13,8,10,13,9,8,9,8,13,10,6,14,7,13,8,12,13,13,8,9,12,9,10,20,9,9,9,4,9,5,10,14,10,12,13,9,8,11,4,DM C,1,1,1,1,1,1,15,1,1,20,1,1,1,1,1
19041141,Leandro,1651,29/10/1986,29,0,0,0,0,178,70,2,2,2,1,2,2,1,3,1,1,2,6,6,12,13,11,5,8,8,4,3,6,11,10,13,11,11,15,12,10,12,12,5,15,6,12,7,11,9,12,11,13,8,11,12,12,20,10,7,12,7,12,9,10,15,10,12,11,11,11,14,8,M/AM C,1,1,13,20,1,1,1,1,1,1,16,1,1,1,1
19041590,Felipe,1651,06/12/1988,27,0,0,0,0,198,85,13,9,10,7,10,13,12,13,8,14,14,3,2,2,1,4,4,1,2,2,2,2,3,2,8,12,12,13,8,9,9,8,4,3,9,2,12,10,9,7,6,14,16,7,10,8,20,9,16,12,6,4,9,9,14,13,6,11,11,9,9,8,GK ,20,1,1,1,1,1,1,1,1,1,1,1,1,1,1
19041609,Diego Sacoman,1651,15/12/1986,29,0,0,0,0,184,79,1,2,3,3,3,4,1,2,1,1,3,7,10,9,8,10,11,13,9,12,13,11,10,13,10,13,12,13,11,11,9,10,13,10,11,11,13,14,14,12,12,13,13,20,13,13,9,14,12,12,12,12,7,15,13,12,18,13,17,9,15,4,D LC,1,12,1,1,1,1,20,16,1,1,1,1,1,8,1
19041611,Marcelinho,1651,28/03/1990,26,0,0,0,0,173,69,3,1,1,1,2,3,2,3,1,3,1,11,10,11,9,12,14,7,10,10,4,12,12,2,11,12,10,12,10,11,10,10,10,12,9,14,9,7,10,14,15,4,5,12,12,14,20,14,5,11,8,11,8,9,20,14,12,13,12,9,10,6,AM/S C,1,1,20,18,13,13,1,1,1,1,1,1,1,1,1
19041660,Walter,1651,18/11/1987,28,0,0,0,0,186,82,13,13,13,10,15,12,14,15,12,11,13,7,3,2,2,8,11,1,3,3,2,2,3,3,13,9,13,12,12,12,12,13,12,3,13,1,14,13,12,13,14,13,13,10,12,11,20,12,13,12,9,10,9,12,8,12,12,13,13,11,10,11,GK ,20,1,1,1,1,1,1,1,1,1,1,1,1,1,1
19041667,Luan,1651,17/09/1988,27,0,0,0,0,183,0,3,3,2,1,2,2,3,2,1,1,1,5,3,4,4,7,1,11,2,5,12,8,1,14,7,5,11,9,7,7,1,14,9,1,8,7,14,7,9,14,11,8,9,9,13,12,20,13,9,9,9,9,9,9,17,12,12,12,10,6,13,3,D C,1,1,1,1,1,1,20,1,1,1,1,1,1,1,1
19041668,Vinícius,1651,11/03/1987,29,0,0,0,0,187,73,1,2,2,3,2,3,3,3,2,1,3,3,6,5,5,9,1,11,5,7,10,9,3,14,10,7,8,10,4,8,5,14,6,1,14,8,10,8,9,14,14,9,16,1,11,14,20,9,11,10,10,8,9,10,12,13,11,11,10,9,14,7,D C,1,1,1,1,1,1,20,1,1,1,1,1,1,1,1
19041669,Bruno Barra,1651,11/04/1986,30,0,0,0,0,175,72,3,1,1,2,2,3,4,1,3,2,2,6,4,4,7,8,6,7,12,3,13,13,5,13,11,10,8,13,9,9,10,6,10,12,14,8,12,8,12,13,13,12,8,9,15,13,20,14,12,10,10,8,5,10,17,11,11,11,12,6,11,3,DM/M C,1,1,1,1,1,1,1,1,1,20,16,1,1,1,1
19041783,Bernardo,1651,26/08/1989,26,0,0,0,0,187,76,2,3,2,2,3,1,3,4,2,3,1,5,3,4,6,8,7,12,4,1,10,9,5,13,4,6,14,9,8,11,6,10,2,5,7,5,12,8,9,14,11,9,14,20,9,10,10,14,13,10,10,10,4,10,17,9,8,11,11,6,10,3,D C,1,1,1,1,1,1,20,1,1,1,1,1,1,1,1
19041934,Gabriel,1651,06/12/1987,28,0,0,0,0,170,72,4,1,2,2,2,4,2,2,1,2,1,10,11,12,11,10,11,6,11,12,9,12,11,9,12,12,10,11,11,9,11,11,13,12,6,12,11,12,10,12,12,14,5,7,12,11,20,11,8,11,5,10,11,11,11,12,15,12,16,14,16,8,D/WB R,1,1,1,1,1,1,1,1,20,1,1,1,13,1,19
19041939,Diego Renan,1651,18/03/1988,28,0,0,0,0,170,62,1,1,3,1,3,1,3,2,3,2,1,4,7,5,10,10,6,7,5,6,8,9,1,11,10,9,8,8,8,11,9,8,2,10,12,7,8,7,8,13,13,7,5,9,10,13,20,11,5,9,11,5,9,9,20,10,12,11,10,9,12,8,D/M/AM RLC,1,1,1,18,1,1,1,16,20,1,17,1,1,1,1
19041950,Ricardo Maranhão,1651,01/10/1986,29,0,0,0,0,175,76,1,3,3,2,3,2,3,2,4,3,3,5,7,10,9,13,7,8,9,1,7,10,10,8,14,9,8,1,13,8,9,12,9,13,9,8,8,8,9,8,11,8,9,10,7,11,20,14,7,9,11,1,9,9,17,11,11,10,12,1,8,6,M/AM/S C,1,1,17,20,1,1,1,1,1,1,16,1,1,1,1
19042120,Eloir,1651,07/09/1987,28,0,0,0,0,183,81,1,1,2,1,4,2,2,1,1,3,2,10,12,12,11,12,10,10,10,9,8,12,13,8,12,15,10,10,11,10,11,12,10,13,12,12,9,13,12,14,13,11,11,20,16,13,6,13,13,15,14,12,12,17,19,9,9,11,10,9,9,4,M/AM LC,1,1,14,20,15,1,9,13,7,14,19,13,1,14,1
19042210,Welinton,1651,10/04/1989,27,0,0,8,0,187,83,3,1,1,1,2,2,3,3,2,3,2,4,7,10,8,11,6,15,6,6,12,12,11,13,9,12,12,13,12,11,11,12,13,9,8,10,12,11,11,14,11,13,13,12,9,13,20,15,13,11,13,11,9,13,14,13,13,8,8,13,12,8,D C,1,1,1,1,1,1,20,1,12,13,1,1,1,1,12
19042226,Roni,1651,07/07/1987,28,0,0,0,0,188,81,14,14,7,1,13,14,11,14,10,10,8,4,3,2,1,6,7,1,3,2,2,2,1,3,2,7,10,15,9,8,8,14,7,1,5,1,9,9,8,10,6,9,17,2,15,12,20,5,10,12,10,10,10,10,19,12,12,14,12,4,12,3,GK ,20,1,1,1,1,1,1,1,1,1,1,1,1,1,1
19042286,Agenor,1651,11/12/1989,26,0,0,0,0,187,84,13,11,11,7,13,13,13,13,13,12,11,8,3,2,3,10,10,2,1,2,1,5,14,3,10,11,13,9,12,12,9,16,15,10,8,1,14,12,11,8,18,12,14,20,14,7,10,8,10,12,10,10,5,11,18,14,16,13,10,1,11,2,GK ,20,1,1,1,1,1,1,1,1,1,1,1,1,1,1
19042287,Artur,1651,14/05/1991,25,0,0,0,0,180,74,1,3,2,3,3,2,2,2,2,2,3,7,6,6,6,14,12,6,11,2,10,12,4,11,14,7,12,8,8,9,10,11,5,9,13,6,11,8,12,9,10,8,7,9,8,8,20,9,12,9,6,9,9,9,20,10,12,11,14,5,4,6,DM ,1,1,1,1,1,1,1,1,1,20,10,1,1,1,1
19042290,Daniel,1651,14/09/1990,25,0,0,4,0,183,80,1,2,3,1,4,1,3,2,4,1,1,3,11,8,6,10,8,11,6,12,12,12,6,12,12,14,12,10,11,11,9,12,9,12,9,12,11,11,13,12,10,9,11,9,13,12,20,13,12,10,13,11,3,13,17,8,8,10,10,9,7,8,D/DM RC,1,1,1,1,1,1,18,1,20,16,1,1,1,1,13
19042292,Pessanha,1651,26/02/1988,28,0,0,0,0,182,72,3,1,4,3,1,1,2,2,2,3,3,2,3,7,2,10,8,14,7,1,13,10,3,11,7,10,11,12,10,9,7,14,13,1,7,8,12,8,10,11,10,9,14,20,12,11,8,12,11,10,7,5,5,10,7,12,12,12,13,12,12,11,D C,1,1,1,1,1,1,20,14,1,14,8,1,1,12,1
19042293,Douglas Silveira,1651,11/04/1991,25,0,0,0,0,177,72,2,4,1,1,1,3,3,3,1,1,1,5,1,7,6,13,5,5,6,1,5,8,2,7,11,8,8,4,8,5,9,12,9,12,9,9,6,6,4,13,13,6,7,9,8,13,20,8,8,8,8,7,8,8,9,11,10,8,13,4,4,5,M/AM C,1,1,1,20,1,1,1,1,1,1,18,1,1,1,1
19042296,Fabinho,1651,17/03/1990,26,0,0,12,2,175,74,1,2,2,2,2,3,1,1,3,1,3,6,11,12,12,10,6,10,13,10,9,12,11,5,10,7,9,8,16,9,12,12,11,11,7,13,10,10,14,12,13,8,9,10,10,13,20,9,10,10,7,10,6,12,7,11,12,9,9,1,7,7,S ,1,1,20,1,1,1,1,1,1,1,1,1,1,1,1
19042298,Guilherme,1651,08/05/1991,25,0,0,0,0,187,85,11,8,10,1,9,7,9,12,7,3,7,2,3,1,2,5,4,1,3,1,1,1,2,1,5,7,10,14,4,11,6,13,9,1,5,1,8,7,6,10,14,5,13,9,7,10,20,6,13,9,9,9,5,9,17,9,11,10,13,2,12,5,GK ,20,1,1,1,1,1,1,1,1,1,1,1,1,1,1
19042300,Jair,1651,10/06/1988,28,0,0,0,0,179,72,3,1,3,3,1,3,2,1,1,2,3,9,10,13,13,11,11,9,11,7,6,10,10,7,13,14,11,10,13,11,10,10,5,13,7,11,7,11,10,14,12,10,10,20,13,11,13,11,10,13,10,11,14,9,19,13,8,8,12,13,2,2,AM/S LC,1,1,20,15,17,1,1,1,1,1,10,12,1,1,1
19042303,João Paulo,1651,08/03/1991,25,0,0,0,0,171,71,3,1,2,2,1,3,3,3,1,3,1,11,13,13,11,12,11,6,13,8,8,14,13,5,14,11,13,11,12,12,13,13,11,13,9,13,7,12,13,13,13,14,7,9,17,13,20,13,11,12,9,9,3,14,17,12,11,10,13,6,9,8,AM RLC,1,1,1,20,15,15,1,1,1,1,13,1,1,1,1
19042304,Juan Jesus,1651,10/06/1991,25,4,0,23,0,185,83,1,3,2,1,2,3,1,2,3,3,2,4,9,11,6,11,5,13,6,10,14,12,9,16,12,16,14,15,12,11,11,13,15,7,13,9,13,14,15,13,13,17,13,20,15,14,9,16,17,12,13,13,5,12,14,13,14,11,15,12,14,10,D LC,1,1,1,1,1,1,20,17,1,1,1,1,1,1,1
19042305,Fogaça,1651,18/04/1991,25,0,0,0,0,172,65,2,1,2,4,3,2,3,1,3,3,1,4,3,13,7,7,6,8,8,1,2,8,5,2,7,5,10,8,9,6,9,9,5,7,12,12,2,7,7,14,12,12,6,9,2,12,20,11,5,8,5,9,9,9,16,13,10,10,11,4,16,5,S ,1,1,20,14,12,14,1,1,1,1,13,1,1,1,1
19042306,Juninho,1651,07/05/1988,28,0,0,0,0,180,70,2,3,2,3,1,2,2,1,2,2,1,10,10,11,8,10,10,9,10,12,10,11,10,10,11,10,9,10,9,10,10,9,10,11,7,11,10,10,11,13,13,11,12,8,13,14,20,14,10,9,9,7,6,11,9,9,9,9,14,17,14,6,D/WB R,1,1,1,1,1,5,1,6,18,1,1,1,10,8,20
19042307,Lucas Roggia,1651,21/01/1991,25,0,0,0,0,177,75,1,1,2,2,3,2,1,2,2,3,2,7,5,13,11,16,3,8,9,5,1,6,5,2,13,10,11,10,11,11,10,15,5,14,7,12,5,11,6,15,15,8,11,10,12,12,20,11,8,11,6,10,8,7,13,10,10,10,13,5,7,6,S ,1,1,20,1,1,1,1,1,1,1,1,1,1,1,1
19042312,Márcio,1651,01/06/1991,25,0,0,0,0,177,70,2,3,3,2,2,2,2,1,4,1,2,6,4,5,3,11,1,5,4,6,7,8,1,12,7,8,6,6,7,8,7,9,7,4,6,6,9,7,7,14,14,13,8,20,12,14,5,12,7,8,8,1,6,8,13,10,10,12,9,5,4,7,D/WB L,1,1,1,1,1,1,1,20,1,1,1,1,1,16,1
19042315,Pedro Henrique,1651,17/11/1989,26,0,0,0,0,176,72,4,3,1,2,3,1,2,1,2,1,1,9,13,9,9,10,11,7,10,4,12,9,9,10,9,10,11,9,9,9,8,9,9,14,9,8,9,8,9,13,13,7,8,20,8,12,10,10,6,10,5,10,4,10,14,10,14,12,11,5,7,1,D/WB/M/AM L,1,1,1,1,17,1,1,20,1,1,1,17,1,18,1
19042316,Pierre,1651,31/05/1987,29,0,0,0,0,189,83,1,3,2,1,3,2,3,1,4,2,3,7,3,3,3,10,7,9,7,2,10,9,11,10,10,10,10,9,9,11,7,13,6,10,3,4,12,8,12,10,10,12,13,10,6,11,20,8,12,10,10,10,6,10,15,11,10,13,13,5,8,7,D/DM C,1,1,1,1,1,1,18,1,1,20,14,1,1,1,1
19042317,Rafael Pilões,1651,03/02/1989,27,0,0,0,0,184,79,3,3,2,3,2,1,2,4,3,2,2,5,8,10,11,11,6,10,8,4,4,10,10,4,11,13,12,10,10,7,11,8,9,13,6,12,6,10,14,14,12,8,13,9,10,12,20,11,11,10,10,11,15,9,12,15,5,12,11,7,9,7,S ,1,1,20,1,1,1,1,1,1,1,1,1,1,1,1
19042321,Sandro,1651,15/03/1989,27,17,1,13,2,187,83,3,3,1,4,3,2,3,3,1,3,2,9,10,10,9,13,8,14,10,7,14,12,6,16,12,16,15,18,13,14,9,11,14,10,14,10,12,16,15,8,12,15,12,8,5,10,20,9,18,12,16,13,19,12,9,13,13,13,12,10,13,6,DM/M C,1,1,1,1,1,1,8,1,1,20,20,1,1,1,1
19042324,Derley,1651,02/08/1986,29,0,0,0,0,187,74,3,3,3,1,1,2,3,2,4,3,3,9,9,11,11,11,7,13,12,10,15,12,12,14,11,15,12,15,12,12,11,11,14,11,13,11,13,16,14,12,11,14,13,10,15,13,20,14,14,13,13,11,7,12,12,14,13,13,13,8,8,14,DM/M C,1,1,1,12,1,11,1,1,10,20,19,1,13,1,7
19042325,Willian,1651,31/05/1990,26,0,0,0,0,192,92,14,10,10,1,10,9,10,10,13,10,10,2,3,4,5,6,5,10,6,5,6,7,5,7,5,12,10,12,9,10,4,9,13,5,10,5,10,7,9,9,6,15,16,3,13,8,20,12,18,12,7,10,7,3,19,12,15,12,9,9,10,4,GK ,20,1,1,1,1,1,1,1,1,1,1,1,1,1,1
19042340,Kléber,1651,02/05/1990,26,2,0,0,0,188,79,4,3,1,3,3,2,1,2,3,2,1,7,10,12,13,11,9,15,11,8,6,11,13,6,14,10,13,14,14,8,10,12,14,11,10,13,7,11,11,12,11,15,15,12,8,12,20,8,14,12,5,12,14,8,8,14,10,10,14,14,14,5,S ,1,1,20,7,1,1,1,1,1,1,1,1,1,1,1
19042357,Anderson Uchoa,1651,04/02/1991,25,0,0,0,0,181,80,1,1,2,3,3,3,1,1,1,3,3,2,10,9,10,13,6,13,10,8,14,13,12,14,13,13,13,13,12,13,12,13,12,8,11,10,14,15,14,14,15,14,11,1,14,13,20,14,11,11,8,11,1,12,8,10,9,11,12,13,12,4,DM C,1,1,1,1,1,1,15,1,1,20,11,1,1,1,1
19042358,Bruno Colaço,1651,10/06/1991,25,0,0,0,0,187,80,11,10,10,1,12,9,12,11,10,8,10,4,3,1,3,7,8,8,3,1,2,10,8,2,10,12,11,10,10,11,7,10,5,1,8,1,11,9,8,11,12,14,15,1,11,10,20,11,13,10,6,5,10,10,17,10,11,12,10,7,11,2,GK ,20,1,1,1,1,1,1,1,1,1,1,1,1,1,1
19042371,Mauro,1651,22/05/1984,32,0,0,0,0,190,82,3,1,2,3,3,2,1,2,1,2,1,5,1,1,3,8,3,13,5,7,13,8,3,13,7,10,13,10,8,10,3,13,12,4,6,7,13,7,8,12,10,8,14,1,13,9,20,13,11,12,8,10,10,10,8,12,13,14,9,2,15,2,D C,1,1,1,1,1,1,20,1,1,1,1,1,1,1,1
19042556,Henrique Almeida,1651,27/05/1991,25,0,0,16,9,177,75,3,3,3,3,1,3,2,1,2,1,3,5,11,11,12,12,8,12,12,10,7,11,14,7,12,12,13,14,12,12,11,12,9,12,7,13,8,12,13,13,13,12,9,13,16,13,20,13,13,11,7,8,6,11,14,13,8,11,11,6,11,10,S ,1,1,20,10,1,13,1,1,1,1,1,4,1,1,1
19042558,Rafael Tavares,1651,27/12/1990,25,0,0,0,0,175,73,3,2,1,1,3,2,2,1,2,3,2,10,13,6,11,15,9,6,9,9,9,14,6,9,15,7,11,9,11,10,11,10,10,13,9,11,8,10,14,15,15,10,8,20,6,15,5,9,8,9,5,10,10,10,7,10,12,12,14,7,12,2,M/AM LC,1,1,8,16,20,1,1,1,1,1,12,16,1,1,1
19042814,Dorielton,1651,07/03/1990,26,0,0,0,0,185,76,2,2,3,1,1,2,1,1,3,1,1,5,7,13,11,11,12,11,9,7,4,11,13,5,12,13,12,11,10,12,10,11,13,11,6,12,8,12,12,14,14,11,12,10,13,13,20,12,11,11,8,11,5,11,6,12,12,12,11,8,11,11,S ,1,1,20,1,1,1,1,1,1,1,1,1,1,1,1
19042882,Héverton,1651,14/01/1988,28,0,0,0,0,188,82,1,1,2,3,1,1,2,3,2,1,3,3,4,4,8,10,5,14,7,5,12,9,3,12,8,12,10,13,10,11,8,9,14,1,11,6,12,11,11,10,9,13,15,20,12,13,10,13,14,11,3,11,10,10,12,13,10,11,10,8,9,12,D C,1,11,1,1,1,1,20,7,1,1,1,1,1,1,1
19042920,Digão,1651,04/04/1985,31,0,0,0,0,172,0,3,2,3,2,1,2,3,2,2,1,3,5,6,7,9,9,6,8,8,1,6,13,4,4,13,9,9,5,8,6,13,13,9,13,11,8,7,7,8,13,8,7,2,9,11,11,20,11,6,9,9,8,6,9,15,12,13,13,8,1,8,6,M/AM/S C,1,1,16,20,1,1,1,1,1,1,18,1,1,1,1
19043006,Leandro Assumpção,1651,03/02/1986,30,0,0,0,0,176,73,3,4,1,1,3,1,2,4,3,2,3,12,7,12,11,13,12,8,10,6,4,8,14,10,13,5,12,10,12,13,14,11,2,15,5,13,11,8,12,14,13,12,10,10,13,13,20,11,10,8,6,7,10,10,12,8,8,10,12,5,8,1,M/AM/S C,1,1,17,20,1,1,1,1,1,1,18,1,1,1,1
19043041,Klebson,1651,26/01/1990,26,0,0,0,0,175,0,3,4,1,2,3,3,1,3,1,3,1,6,6,7,7,13,6,6,9,1,11,11,1,10,10,6,8,12,8,9,11,9,2,9,9,7,11,11,5,13,13,7,9,8,13,12,20,7,6,9,6,2,7,9,19,10,12,10,12,11,10,1,DM/M C,1,1,1,1,1,1,1,1,1,20,16,1,1,1,1
19043080,João Paulo,1651,20/07/1990,25,0,0,0,0,172,72,3,2,1,1,2,2,1,1,1,1,3,12,11,11,8,11,12,5,12,5,8,12,13,10,13,13,11,10,12,11,12,11,13,13,10,13,8,13,12,14,14,14,6,20,12,14,9,13,8,12,11,11,10,18,13,15,12,13,14,13,14,11,D/WB L,1,1,1,9,11,1,1,16,7,1,6,13,1,20,9
19043083,Dudu,1651,30/04/1991,25,0,0,0,0,181,0,1,1,3,2,2,1,1,3,1,3,2,6,12,7,1,9,4,9,6,7,11,9,7,11,9,9,12,9,8,7,8,7,7,7,4,7,12,8,9,13,14,8,11,11,13,15,20,13,6,9,9,6,9,9,14,8,11,11,10,10,15,4,D/WB R,1,1,1,1,1,1,13,1,20,1,1,1,1,1,17
19043151,Júlio César,1651,20/06/1989,27,0,0,0,0,176,72,4,3,4,1,1,1,1,1,2,2,2,7,7,5,8,11,7,7,11,1,12,13,3,13,13,10,12,9,7,7,9,13,10,6,9,8,8,8,12,13,13,7,8,9,11,13,20,13,5,10,9,10,8,10,15,8,10,9,14,3,10,6,DM C,1,1,1,10,1,1,1,1,1,20,15,1,1,1,1
19043173,André Luiz,1651,19/11/1984,31,0,0,0,0,180,0,3,1,2,3,3,2,3,2,1,3,1,7,6,2,3,7,2,11,5,7,10,8,6,14,8,5,14,9,9,10,4,11,9,2,11,5,11,7,9,7,10,9,6,17,10,7,20,13,9,9,9,5,9,9,16,11,12,13,11,3,14,3,D C,1,19,1,1,1,1,20,1,1,1,1,1,1,1,1
19043182,Bruno Lopes,1651,19/08/1986,29,0,0,0,0,181,75,3,3,3,2,2,2,1,2,2,1,3,9,7,12,14,14,9,14,9,8,7,10,6,2,14,6,13,10,10,10,8,13,3,13,9,14,10,9,10,14,14,10,8,10,10,14,20,12,12,11,11,9,9,11,15,10,9,13,8,10,5,8,S ,1,1,20,1,1,1,1,1,1,1,1,1,1,1,1
19043345,Renan,1651,18/05/1989,27,0,0,6,0,190,89,14,13,11,6,13,13,14,13,12,11,11,1,2,3,2,7,3,7,1,3,1,6,3,3,7,9,12,14,13,12,11,10,13,2,10,3,13,14,14,13,14,12,16,11,17,13,20,14,15,10,12,12,9,11,7,10,14,15,16,11,13,9,GK ,20,1,1,1,1,1,1,1,1,1,1,1,1,1,1
19043347,Leandro Silva,1651,11/01/1989,27,0,0,1,0,184,82,1,1,1,3,2,1,2,3,1,2,2,3,7,5,7,7,7,12,8,10,12,7,10,11,8,12,11,12,10,9,6,10,15,6,7,5,12,11,11,11,10,13,13,10,13,10,20,11,13,10,10,10,11,6,13,16,6,11,13,12,10,3,D C,1,10,1,1,1,1,20,1,1,1,1,1,1,1,1
19043348,Gerônimo,1651,01/07/1989,27,0,0,0,0,174,71,3,1,1,1,1,3,2,2,1,1,1,8,13,11,10,11,9,9,12,10,11,11,7,10,12,10,13,10,11,13,10,10,12,10,10,10,10,9,12,15,12,8,7,8,12,14,20,11,12,10,9,8,10,10,11,12,11,9,12,6,13,8,D/DM R,1,1,1,1,1,1,1,1,20,19,1,1,1,1,15
19043352,Pecka,1651,02/05/1989,27,0,0,0,0,171,69,1,1,1,1,1,1,1,1,1,1,1,4,6,9,8,10,7,5,8,5,11,12,8,11,12,7,10,9,12,13,9,10,13,8,9,6,12,13,13,14,13,10,6,12,7,13,20,12,7,1,1,8,6,10,19,12,14,12,16,13,19,1,DM/M C,1,1,1,1,1,1,1,7,1,20,20,1,1,1,1
19043354,Renan Oliveira,1651,29/12/1989,26,0,0,6,0,182,70,2,3,1,3,1,3,1,2,3,2,1,6,10,13,12,14,9,7,9,9,10,13,12,9,16,12,12,11,12,12,14,12,15,15,11,11,6,8,8,15,14,11,12,8,14,15,20,12,11,8,9,11,9,14,10,16,15,15,16,15,16,6,M/AM C,1,1,15,20,1,1,1,1,1,1,16,1,1,1,1
19043395,Rafael Dida,1651,25/04/1989,27,0,0,0,0,193,87,11,11,10,8,13,11,12,14,9,11,11,2,2,2,5,6,9,6,8,2,7,10,9,10,8,12,9,11,8,10,3,9,11,5,7,3,11,10,10,7,12,12,15,20,13,9,3,8,14,13,10,10,7,5,11,13,14,10,15,8,10,10,GK ,20,1,1,1,1,1,1,1,1,1,1,1,1,1,1
19043460,Thomas Anderson,1651,29/04/1988,28,0,0,0,0,172,66,1,4,2,2,2,3,1,1,3,1,2,8,10,11,11,11,10,7,10,2,3,10,12,3,11,10,9,12,11,8,10,10,9,11,5,12,6,10,10,14,14,14,6,8,13,14,20,12,4,9,8,9,9,8,15,8,12,13,10,6,16,8,S ,1,1,20,11,12,14,1,1,1,1,1,1,1,1,1
19043503,Paulão,1651,12/03/1985,31,0,0,0,0,190,0,1,3,2,3,1,1,1,1,3,3,3,5,6,9,11,11,6,11,9,2,2,9,9,2,9,11,9,11,9,11,9,11,2,9,6,11,10,11,9,11,9,11,15,9,13,11,20,9,18,10,8,11,10,9,6,10,11,10,9,4,2,1,S ,1,1,20,1,1,1,1,1,1,1,1,1,1,1,1
19043511,Danilo,1651,30/01/1989,27,0,0,0,0,185,0,4,1,3,3,1,1,3,3,1,1,1,7,5,6,8,13,7,2,10,3,11,7,7,10,9,9,9,9,9,9,7,13,10,10,9,7,8,8,12,13,13,8,9,10,12,12,20,13,9,10,10,1,10,10,20,11,10,10,10,2,17,6,DM ,1,1,1,1,1,1,1,1,1,20,13,1,1,1,1
19043525,Maurício,1651,20/09/1988,27,0,0,0,0,185,83,1,3,1,2,1,1,3,1,1,3,3,3,7,8,7,12,6,14,8,10,14,12,7,14,11,18,15,16,12,13,8,13,15,8,11,9,14,15,16,13,13,15,12,10,16,13,20,15,13,14,14,13,5,10,15,13,14,12,16,13,11,8,D C,1,15,1,1,1,1,20,1,10,1,1,1,1,1,1
19043528,Rafael Vaz,1651,17/09/1988,27,0,0,0,0,188,79,3,2,1,2,2,2,1,3,1,3,1,7,8,10,12,10,14,15,13,5,14,9,10,14,12,13,12,13,12,11,10,11,15,7,11,12,14,14,13,14,14,13,16,20,15,13,8,13,13,12,12,12,8,13,8,11,10,10,13,13,13,11,D C,1,11,1,1,1,1,20,14,1,15,6,1,1,12,1
19043533,Luís Carlos,1651,28/07/1987,28,0,0,0,0,190,74,13,12,12,7,13,12,12,14,12,13,12,6,1,1,1,9,11,3,3,2,3,2,2,1,10,13,12,13,11,11,4,12,3,9,12,4,12,13,13,10,12,8,16,4,13,10,20,13,12,12,10,13,6,11,20,11,10,12,10,9,15,1,GK ,20,1,1,1,1,1,1,1,1,1,1,1,1,1,1
19044027,Fininho,1651,29/10/1985,30,0,0,0,0,177,73,3,2,2,3,1,2,3,3,2,2,1,7,5,11,9,10,7,7,8,5,1,7,2,2,11,10,10,7,7,10,9,13,9,15,7,9,4,8,11,13,12,8,8,16,10,13,20,8,9,9,7,10,6,10,18,12,10,10,10,6,12,2,M/AM C,1,1,1,20,1,1,1,1,1,1,18,1,1,1,1
19044072,Murilo Gomes,1651,19/06/1990,26,0,0,0,0,188,82,3,3,3,2,2,2,2,3,2,1,1,3,7,6,10,7,5,14,9,8,13,8,8,13,7,15,10,15,10,10,6,10,15,10,5,12,11,14,12,10,9,14,14,8,15,11,20,11,15,11,13,10,6,13,10,14,13,11,14,6,11,15,D C,1,13,1,1,1,1,20,1,5,1,1,1,1,1,1
19044526,Júnior Beliato,1651,26/09/1987,28,0,0,0,0,194,88,15,15,9,2,15,15,11,14,10,9,10,7,1,2,2,1,9,1,3,2,3,2,3,2,2,10,10,13,9,9,9,15,10,1,3,1,13,10,9,11,12,8,17,1,12,11,20,7,11,11,10,6,8,10,12,12,9,12,12,5,7,2,GK ,20,1,1,1,1,1,1,1,1,1,1,1,1,1,1
19044529,Patrik Silva,1651,19/07/1990,25,0,0,0,0,172,64,1,1,3,3,1,3,3,1,2,1,3,10,10,11,10,11,10,10,10,5,7,11,11,6,12,11,11,12,10,11,11,10,12,11,5,11,7,11,11,13,12,10,5,11,14,13,20,12,7,10,9,12,8,15,9,13,14,14,12,10,13,7,M/AM/S RC,1,1,19,20,12,17,1,1,7,1,16,8,15,1,10
19044710,Douglas Costa,1651,14/09/1990,25,17,3,12,4,172,65,1,1,1,1,1,1,1,1,1,1,1,14,15,18,10,15,14,5,13,10,5,13,11,6,16,14,12,9,10,11,12,10,13,18,5,13,7,8,14,19,18,14,6,20,14,16,11,15,9,13,4,12,3,12,10,12,15,13,12,8,11,14,M/AM RLC,1,1,8,15,18,20,1,1,1,1,10,18,20,1,1
19044714,Léo Carvalho,1651,04/03/1989,27,0,0,0,0,169,65,3,1,1,1,2,4,2,1,1,3,3,8,9,8,11,12,8,9,11,1,8,10,8,7,9,5,12,9,11,10,7,9,10,6,8,11,9,9,10,14,14,9,5,20,12,14,9,9,10,10,9,10,10,10,16,12,11,10,10,10,9,2,AM LC,1,1,15,20,1,1,1,12,1,1,1,13,1,15,1
19044898,Malaquias,1651,11/11/1986,29,0,0,0,0,178,70,1,1,3,1,3,3,1,2,1,2,3,7,9,13,10,12,7,7,6,6,4,11,4,4,12,8,12,9,10,10,11,8,12,13,7,14,11,9,9,13,16,7,8,11,10,14,20,11,7,12,5,16,6,10,18,10,9,10,10,7,13,4,S ,1,1,20,13,1,1,1,1,1,1,1,1,1,1,1
19044901,Samuel Araújo,1651,28/03/1988,28,0,0,0,0,192,85,1,4,1,4,1,3,3,1,3,3,2,2,6,3,2,8,6,14,7,1,11,6,6,14,8,7,9,9,8,6,6,10,2,6,5,6,14,7,9,7,9,8,15,8,12,9,20,11,10,9,3,9,8,9,8,11,9,11,9,10,11,4,D C,1,1,1,1,1,1,20,1,1,15,10,1,1,1,1
19045113,Rodrigo Fabiano,1651,17/08/1989,26,0,0,0,0,183,0,1,2,3,2,2,2,2,3,3,3,1,5,2,5,3,8,4,14,4,3,11,8,7,10,7,9,10,9,7,6,3,14,3,3,11,7,11,7,8,14,14,8,7,6,10,14,20,13,10,9,9,9,9,9,13,12,12,10,11,8,6,5,D C,1,1,1,1,1,1,20,1,1,1,1,1,1,1,1
19045163,Bruno Uvini,1651,03/06/1991,25,3,0,16,1,187,85,1,3,1,3,1,1,1,1,2,3,1,6,7,9,12,10,7,14,7,5,14,12,8,15,12,10,13,13,13,13,7,12,12,9,6,6,14,13,13,11,13,14,15,8,15,9,20,12,15,12,12,10,9,10,9,14,12,11,10,11,11,6,D C,1,1,1,1,1,1,20,1,1,1,1,1,1,1,1
19045164,Éverson,1651,22/07/1990,25,0,0,0,0,192,86,13,12,13,11,13,12,13,13,13,13,12,3,1,2,2,10,6,8,3,3,3,10,1,3,9,14,12,15,9,11,3,12,14,11,14,7,13,15,14,10,13,10,14,8,13,10,20,14,14,14,11,13,3,11,13,10,12,12,13,10,8,13,GK ,20,1,1,1,1,1,1,1,1,1,1,1,1,1,1
19045256,Rômulo,1651,19/09/1990,25,8,1,0,0,186,83,3,3,2,2,2,2,3,3,1,3,3,5,6,13,7,14,5,15,8,8,14,13,7,12,14,13,16,14,14,12,10,12,14,10,11,10,14,15,15,13,12,12,13,12,16,14,20,14,13,12,11,11,12,12,12,13,12,13,13,12,9,8,DM/M C,1,1,1,10,1,1,10,1,1,20,17,1,1,1,1
19045271,Ricardo Capanema,1651,01/01/1985,31,0,0,0,0,169,69,4,3,2,2,3,1,2,3,2,2,2,8,5,9,7,9,8,8,7,7,12,12,4,13,14,9,13,9,9,10,10,13,10,1,11,8,13,9,13,14,11,10,6,11,14,13,20,14,8,10,14,10,9,10,13,10,12,11,11,2,13,5,DM ,1,1,1,1,1,1,1,1,1,20,10,1,1,1,1
19045277,Michel Cury,1651,24/07/1981,34,0,0,0,0,185,76,1,3,3,2,2,2,2,1,2,2,1,9,10,12,9,12,11,8,11,9,7,12,8,10,13,8,11,10,11,11,11,10,10,15,5,13,6,12,11,12,13,12,13,20,7,11,8,12,10,13,9,5,6,10,9,11,11,12,11,9,7,6,M/AM LC,1,1,1,15,16,1,1,1,1,1,18,20,1,1,1
19045311,Ray,1651,28/03/1985,31,0,0,0,0,179,75,2,1,1,3,3,2,2,3,1,2,2,4,7,9,11,10,8,9,5,8,4,10,12,4,10,8,11,10,12,10,10,10,9,8,8,7,11,10,12,13,14,10,10,9,10,12,20,11,8,10,9,11,8,10,18,11,14,10,14,7,9,3,S ,1,1,20,1,1,1,1,1,1,1,1,1,1,1,1
19045428,Róbson,1651,31/03/1988,28,0,0,0,0,183,75,3,1,1,2,3,3,3,4,1,1,2,2,4,7,6,7,6,11,8,4,11,8,7,10,7,14,11,14,8,10,6,8,12,7,8,7,10,13,11,11,11,8,11,10,14,11,20,11,10,11,13,9,7,7,10,12,13,11,11,8,10,12,D C,1,11,1,1,1,1,20,1,1,1,1,1,1,1,1
19045450,Thiago Araújo,1651,18/02/1988,28,0,0,0,0,179,69,1,3,2,3,1,2,1,2,1,1,1,5,5,8,5,12,12,7,1,8,10,10,5,14,10,10,11,10,9,9,8,10,5,4,9,7,11,9,9,14,13,12,9,9,8,14,20,10,10,10,10,10,8,10,17,9,8,12,9,3,14,3,D/WB R,1,1,1,1,1,1,1,12,20,1,1,1,7,13,17
19045457,Gercimar,1651,28/08/1990,25,0,0,0,0,180,77,1,2,1,1,1,3,3,2,3,1,3,5,8,9,8,9,9,9,10,10,12,11,3,14,10,10,10,12,8,10,9,10,4,6,14,9,13,15,13,11,10,12,11,9,14,11,20,13,12,12,11,10,7,10,9,12,13,11,11,2,12,1,DM ,1,1,1,1,1,1,1,1,1,20,13,1,1,1,1
19045487,Almeida,1651,15/01/1984,32,0,0,0,0,174,76,1,1,3,4,1,1,1,1,1,3,1,5,7,9,9,12,8,8,6,8,9,13,6,14,10,9,10,9,10,11,8,7,12,3,14,9,12,8,10,9,9,4,7,20,12,9,9,7,9,9,9,9,6,9,13,10,6,10,11,7,15,4,D/WB/DM LC,1,1,1,1,1,1,1,18,1,20,15,1,1,16,1
19045496,Bruno Gallo,1651,07/05/1988,28,0,0,0,0,182,75,2,4,1,2,3,2,2,3,1,1,1,11,12,13,11,12,11,10,11,10,12,13,12,13,13,11,12,12,12,12,13,13,13,12,10,12,12,13,13,12,12,12,12,20,13,12,6,12,12,11,8,12,8,12,12,13,11,13,14,14,14,6,D/WB/DM/M LC,1,1,1,1,7,1,1,17,1,18,20,17,1,17,1
19045503,William,1651,30/01/1985,31,0,0,0,0,169,69,1,1,3,4,3,1,1,2,3,3,3,5,6,8,8,14,6,2,12,6,8,14,1,8,14,8,9,5,8,8,10,9,8,13,13,6,8,8,10,13,10,14,4,8,8,12,20,6,5,12,6,8,4,8,16,10,11,11,11,2,16,2,M/AM C,1,1,1,17,1,1,1,1,1,1,20,1,1,1,1
19045555,Romano,1651,10/11/1987,28,0,0,0,0,179,74,2,2,1,3,3,3,1,3,1,3,3,10,11,11,7,11,11,9,11,7,7,11,6,8,12,12,11,11,10,10,11,10,12,12,8,11,8,11,10,12,12,12,8,20,12,14,10,13,11,12,12,9,10,12,15,13,7,11,10,9,9,7,D/WB/DM/M/AM L,1,1,1,1,17,1,1,20,1,19,1,19,1,17,1
19045620,Fernandão,1651,27/03/1987,29,0,0,2,0,192,95,3,2,3,1,3,1,3,3,1,3,2,3,7,10,14,12,9,15,12,5,9,10,17,4,10,16,12,18,13,14,8,13,11,12,12,13,9,14,12,10,13,17,16,15,15,11,20,13,17,12,13,13,9,6,12,15,9,9,8,9,14,8,S ,1,1,20,1,1,1,1,1,1,1,1,1,1,1,1
19045732,Fred,1651,07/01/1986,30,0,0,0,0,172,0,3,3,1,3,3,3,2,4,2,3,1,6,5,4,6,11,6,6,13,4,7,9,5,13,11,6,10,8,6,6,7,13,9,6,4,6,11,7,12,13,13,7,2,16,10,13,20,13,5,9,6,9,9,9,15,14,11,11,10,3,6,3,DM ,1,1,1,1,1,1,1,1,1,20,10,1,1,1,1
19045746,Hegon,1651,06/05/1988,28,0,0,0,0,174,67,2,2,3,1,3,2,2,2,2,2,1,12,12,12,9,12,10,8,9,6,7,12,10,6,12,8,9,8,8,7,11,8,9,11,7,12,8,7,8,12,13,7,7,14,10,12,20,9,8,8,10,8,8,12,10,12,13,9,12,6,10,8,AM RLC,1,1,14,20,17,18,1,1,1,5,14,10,12,1,1
19045754,Tiago Chulapa,1651,05/02/1988,28,0,0,0,0,191,94,3,1,2,2,2,2,1,2,2,3,2,4,3,2,13,13,8,14,6,5,6,9,13,6,4,12,12,14,12,10,9,10,12,12,10,8,11,12,12,13,11,13,15,11,12,13,20,12,15,10,11,8,7,7,12,11,13,12,11,10,12,10,S ,1,1,20,1,1,1,1,1,1,1,1,1,1,1,1
19045798,Gabriel Davis,1651,23/10/1989,26,0,0,0,0,182,77,2,3,1,2,2,3,3,2,1,3,2,4,7,8,13,12,6,13,7,1,3,6,8,1,7,9,11,8,9,7,7,10,1,9,8,10,6,6,7,13,13,8,11,10,16,12,20,12,9,9,8,7,9,9,15,9,10,11,9,6,1,5,S ,1,1,20,1,1,1,1,1,1,1,1,1,1,1,1
19045800,Arghus,1651,19/01/1988,28,0,0,0,0,189,83,4,3,3,3,4,2,3,2,3,2,2,10,8,7,6,8,8,14,8,9,13,12,9,13,6,16,9,12,11,14,9,10,13,10,10,13,13,14,13,12,10,12,14,20,14,13,5,13,13,11,16,15,8,9,13,14,14,11,12,12,5,15,D C,1,1,1,1,1,1,20,1,1,1,1,1,1,1,1
19045817,Kássio,1651,23/05/1987,29,0,0,0,0,176,63,1,3,2,1,3,3,1,1,3,1,3,10,9,13,10,9,9,8,10,7,6,12,10,4,13,5,10,13,11,13,11,11,15,16,9,13,8,7,11,12,15,8,8,11,12,12,20,12,6,12,9,10,10,13,18,14,13,13,11,9,9,9,M/AM C,1,1,1,20,10,10,1,1,1,1,18,5,5,1,1
19045822,Ângelo,1651,23/11/1983,32,0,0,0,0,182,76,1,2,2,1,2,3,1,3,3,3,1,5,9,8,7,8,1,6,7,10,9,10,3,9,8,4,9,10,9,10,9,9,11,9,15,10,9,10,9,12,11,8,10,10,10,12,20,11,9,8,9,8,7,8,12,10,11,11,12,6,3,7,D/WB R,1,1,1,1,1,1,1,1,20,1,1,1,1,1,18
19045929,Pablo,1651,03/08/1988,27,0,0,0,0,178,75,3,1,2,2,2,1,3,3,2,2,1,8,12,12,7,13,8,9,10,13,10,12,9,11,12,16,12,11,10,11,9,11,15,12,10,12,8,13,12,15,15,9,9,10,14,14,20,13,8,13,11,12,11,16,11,13,12,11,15,12,10,8,D/WB/DM/M R,1,1,1,1,1,1,1,10,19,16,12,9,18,12,20
19046018,Claudinho,1651,25/09/1981,34,0,0,0,0,175,70,2,1,1,4,1,1,3,3,2,1,2,5,9,7,2,10,7,8,6,6,9,9,6,11,9,7,9,4,6,10,3,12,8,8,13,6,12,8,8,14,9,3,8,20,8,9,8,8,7,8,8,8,8,8,8,12,9,8,11,3,3,6,D L,1,1,1,1,1,1,1,20,1,1,1,1,1,15,1
19046028,Luís Guilherme,1651,04/06/1992,24,0,0,7,0,185,77,10,10,11,5,12,12,11,12,11,10,9,2,3,1,1,6,6,2,1,2,3,3,2,1,12,10,11,10,10,12,9,12,15,1,12,2,13,10,9,14,14,10,12,9,10,14,20,9,8,12,9,10,10,10,15,15,12,15,16,13,13,4,GK ,20,1,1,1,1,1,1,1,1,1,1,1,1,1,1
19046030,Gérson,1651,04/10/1992,23,0,0,7,3,179,74,3,1,3,3,4,3,1,3,1,1,2,5,8,7,6,8,8,12,7,8,11,9,7,12,7,13,11,13,9,12,6,9,12,8,13,7,11,11,13,11,12,15,13,8,12,14,20,11,12,11,13,8,8,10,11,12,12,10,11,9,6,4,D C,1,1,1,1,1,1,20,1,1,10,1,1,1,1,1
19046031,Jairo,1651,31/12/1992,23,0,0,0,0,189,86,2,2,2,1,2,1,1,2,1,3,4,3,5,6,2,9,1,13,6,6,12,10,3,12,6,14,12,14,7,13,9,9,8,7,7,8,12,10,11,9,9,13,12,9,9,9,20,12,13,8,9,9,8,9,10,9,13,9,5,6,8,5,D C,1,11,1,1,1,1,20,1,1,1,1,1,1,1,1
19046032,Maurício,1651,12/10/1992,23,0,0,1,0,184,79,1,1,1,1,2,3,4,2,3,3,1,3,5,6,7,8,6,15,4,8,14,9,8,15,8,12,15,15,11,15,9,14,15,3,16,10,15,15,14,11,11,15,13,9,15,12,20,13,14,15,6,13,9,2,14,15,11,13,16,13,13,4,D C,1,1,1,1,1,1,20,1,1,1,1,1,1,1,1
19046034,Bernardo,1651,18/01/1992,24,0,0,7,0,175,66,3,2,4,2,3,2,4,3,1,1,2,6,9,7,5,14,3,7,7,5,9,9,2,13,9,9,12,12,8,9,7,9,2,6,11,8,6,8,8,13,11,8,5,10,12,13,20,12,11,9,9,8,6,9,18,15,10,9,11,3,5,6,D/WB R,1,1,1,1,1,1,1,1,16,1,1,1,1,1,20
19046035,Eron,1651,17/01/1992,24,0,0,7,1,173,68,3,2,4,2,1,2,3,4,1,1,2,7,10,8,6,16,5,10,8,6,9,11,5,9,12,10,12,10,8,13,10,14,13,6,5,6,10,11,11,12,14,14,6,20,10,12,12,12,7,12,10,3,6,10,9,17,5,10,10,9,10,14,D/WB L,1,1,1,1,1,1,1,16,1,1,1,1,1,20,1
19046038,Elivélton,1651,21/01/1992,24,0,0,7,0,168,70,3,2,3,1,2,2,1,3,2,3,3,6,6,9,8,9,6,5,6,5,12,10,12,11,9,14,13,14,10,11,8,10,14,10,12,11,11,12,13,13,13,11,5,8,16,12,20,11,11,10,14,12,7,10,16,14,11,12,10,11,7,13,DM ,1,1,1,1,1,1,1,1,1,20,10,1,1,1,1
19046039,Fernando,1651,03/03/1992,24,8,0,17,0,175,75,3,2,1,2,3,3,1,2,3,2,1,12,8,11,8,13,16,7,12,9,14,14,12,12,14,16,16,16,12,13,14,13,12,10,12,12,14,15,13,14,15,13,8,12,14,12,20,14,12,14,13,11,8,12,20,12,13,12,13,6,12,9,DM/M C,1,1,1,1,1,1,1,1,1,20,19,1,1,1,1
19046041,Philippe Coutinho,1651,12/06/1992,24,17,4,7,3,172,71,2,3,3,2,2,1,1,1,2,2,2,11,13,18,13,16,12,5,15,3,8,15,10,11,18,11,14,12,17,13,17,14,15,18,6,15,13,15,15,15,17,15,6,12,13,13,20,14,11,14,8,14,9,11,14,16,12,13,17,13,15,4,AM LC,1,1,8,18,20,12,1,1,1,1,14,14,10,1,1
19046042,Wellington Nem,1651,06/02/1992,24,3,0,7,2,165,65,3,3,1,4,2,3,3,2,3,3,3,12,14,15,11,13,13,9,10,12,5,14,12,5,16,9,13,11,12,12,14,13,12,13,8,14,5,11,12,16,16,10,4,20,14,15,8,14,12,12,2,12,13,15,12,13,16,13,12,11,13,8,AM/S RLC,1,1,17,17,20,17,1,1,1,1,10,13,10,1,1
19046043,Felipinho,1651,29/01/1992,24,0,0,7,3,166,64,1,1,3,3,4,3,1,3,2,2,2,9,10,11,12,10,5,8,10,5,7,10,5,4,11,9,5,13,11,8,9,13,3,8,3,11,8,10,10,11,9,13,3,20,16,12,15,10,13,12,6,9,3,9,13,12,11,12,10,5,12,4,S ,1,1,20,1,1,1,1,1,1,1,1,1,1,1,1
19046045,Matheus Carvalho,1651,11/03/1992,24,0,0,0,0,177,72,3,3,1,3,1,3,3,2,2,1,3,5,12,12,14,13,11,13,8,4,3,11,12,4,12,11,12,12,12,12,10,12,13,13,7,13,4,10,12,14,14,10,8,20,12,14,8,12,10,11,8,12,10,11,10,14,9,12,11,11,13,1,AM/S L,1,1,20,10,20,13,1,1,1,1,1,7,1,1,1
19046046,Johnathan,1651,08/01/1992,24,0,0,5,0,177,0,3,3,2,3,2,3,3,2,1,3,3,5,9,11,12,11,8,10,11,5,4,13,11,5,11,10,8,10,10,8,13,10,11,11,3,13,7,8,9,12,13,9,8,7,14,13,20,14,12,10,5,10,10,9,7,10,10,10,13,7,20,2,S ,1,1,20,1,1,1,1,1,1,1,1,1,1,1,1
19046193,Felipe,1651,20/07/1986,29,0,0,0,0,183,0,2,3,2,2,3,3,1,2,3,2,1,3,7,10,11,9,6,10,13,6,14,11,7,12,10,13,11,14,10,11,9,10,13,7,8,8,13,15,12,12,12,11,10,3,13,12,20,14,12,11,13,9,6,7,17,11,14,11,13,8,14,7,DM/M C,1,1,1,1,1,1,1,1,1,20,16,1,1,1,1
19046244,Edu Pina,1651,23/01/1989,27,0,0,0,0,180,76,3,3,2,1,1,1,1,2,2,2,2,11,7,9,8,9,12,8,9,6,9,10,8,10,8,13,9,15,9,10,8,10,14,9,12,9,10,12,14,12,11,8,8,20,14,12,9,11,10,13,13,13,8,11,12,14,14,10,10,8,3,7,D/WB L,1,1,1,1,1,1,1,20,1,1,1,1,1,16,1
19046322,Jefferson Madeira,1651,15/02/1988,28,0,0,0,0,175,79,2,1,2,2,4,2,2,3,1,3,1,5,7,9,11,9,11,13,10,5,5,9,14,8,10,12,9,12,11,8,8,9,14,11,6,11,10,10,10,14,10,13,9,10,13,11,20,13,14,11,11,9,7,7,10,12,12,10,12,10,8,13,S ,1,1,20,5,1,1,1,1,1,1,1,1,1,1,1
19046506,Jorge Preá,1651,10/01/1984,32,0,0,0,0,182,80,1,1,4,3,2,2,3,2,3,2,1,4,5,10,11,10,6,11,9,3,7,10,13,7,9,13,10,13,10,11,7,12,15,3,5,10,5,13,12,13,10,14,13,8,15,14,20,15,15,10,7,12,9,4,7,11,12,12,13,9,14,8,S ,1,1,20,1,1,1,1,1,1,1,1,1,1,1,1
19046568,Guina,1651,20/03/1986,30,0,0,0,0,175,0,1,4,3,2,2,2,3,3,3,2,2,5,7,7,7,13,6,5,7,6,8,11,5,13,12,9,8,8,8,7,11,8,9,12,10,8,8,7,8,13,13,7,8,20,9,13,10,13,9,9,8,6,5,9,11,12,13,12,12,10,4,7,D/WB/M/AM LC,1,1,1,18,1,1,1,20,1,1,18,1,1,18,1
19046569,Denílson,1651,25/11/1988,27,0,0,0,0,180,76,1,2,3,2,1,1,2,2,1,2,2,6,5,13,13,13,6,7,7,3,6,10,6,7,11,9,9,6,8,5,12,8,9,11,8,11,6,7,8,13,13,7,9,10,16,13,20,9,8,9,9,4,9,9,18,13,15,12,10,6,6,3,AM C,1,1,15,20,1,1,1,1,1,1,11,1,1,1,1
19046644,Xandão,1651,21/03/1989,27,0,0,0,0,187,83,1,4,1,3,1,2,1,3,1,1,2,3,1,5,1,8,1,11,4,4,13,5,3,13,7,10,11,10,7,12,6,13,5,3,8,7,13,7,8,12,10,8,11,9,16,10,20,8,9,10,7,6,9,10,17,9,11,10,10,1,15,2,D C,1,1,1,1,1,1,20,1,1,1,1,1,1,1,1
19046648,Rafael Rocha,1651,03/04/1989,27,0,0,0,0,181,70,3,3,3,1,1,1,2,2,3,1,1,12,11,13,9,11,13,7,8,11,7,10,12,9,13,11,11,12,10,11,10,10,13,14,6,11,7,8,10,13,12,8,7,20,12,13,1,11,8,8,9,12,4,10,14,11,8,12,7,9,10,8,M L,1,1,7,10,15,1,1,11,1,1,13,20,1,10,1
19046651,Erick,1651,24/03/1988,28,0,0,0,0,178,71,2,3,3,2,1,1,3,1,2,1,2,6,7,9,5,10,10,10,13,6,12,11,5,13,10,13,12,14,9,10,8,11,12,4,10,11,13,13,11,11,10,13,7,7,13,12,20,16,15,8,6,7,6,10,13,12,10,12,10,10,12,8,DM/M C,1,1,1,1,1,1,1,1,1,20,17,1,1,1,1
19046661,Luís Gustavo,1651,07/01/1992,24,0,0,0,0,189,80,1,2,2,3,4,2,2,2,2,3,3,7,8,8,4,10,7,14,9,4,11,9,3,11,6,8,14,10,9,9,5,9,3,9,4,7,14,8,10,14,10,9,14,10,10,13,20,14,11,10,3,10,10,10,17,10,10,10,12,6,9,3,D C,1,1,1,1,1,1,20,1,1,15,10,1,1,1,1
19046664,Moacir,1651,01/03/1989,27,0,0,0,0,171,73,1,3,2,2,3,3,2,2,1,2,4,8,8,13,11,12,9,7,9,9,5,11,6,4,11,10,10,12,11,8,10,11,8,14,12,13,11,8,11,13,14,6,4,20,9,13,7,10,6,10,9,10,10,10,18,9,12,10,9,11,10,1,M/AM RL,1,1,13,10,20,17,1,1,1,1,1,18,15,1,1
19046665,Murilo Ceará,1651,13/01/1988,28,0,0,0,0,182,76,2,1,2,1,2,2,3,3,3,2,1,4,6,5,7,13,1,9,3,8,10,7,4,12,9,6,10,10,9,9,5,12,2,9,11,6,11,9,9,14,12,9,8,20,14,14,9,10,10,5,5,1,9,9,16,13,13,10,10,9,14,3,D L,1,1,1,1,1,1,1,20,1,1,1,1,1,15,1
19046726,David Lazari,1651,30/04/1989,27,0,0,0,0,178,74,3,1,1,1,2,3,1,3,1,3,2,14,11,13,11,13,15,7,14,9,7,12,14,7,13,10,10,10,9,6,9,7,9,16,9,7,7,8,10,13,14,11,11,20,14,12,9,14,11,13,5,15,5,13,12,7,12,11,12,11,10,7,M/AM LC,1,1,1,18,19,10,1,13,1,1,18,20,10,12,1
19046971,Danilinho,1651,01/04/1985,31,0,0,0,0,178,68,2,3,4,3,1,1,2,1,2,3,3,7,3,9,9,11,11,2,12,2,8,11,1,10,11,6,9,9,8,9,12,9,4,11,11,9,10,8,11,13,12,6,8,18,10,10,20,13,6,12,7,8,9,10,12,11,12,12,8,8,15,2,AM C,1,1,1,20,1,1,1,1,1,12,14,1,1,1,1
19047053,Luan,1651,02/05/1989,27,0,0,0,0,194,0,1,3,3,3,3,2,1,3,2,4,3,6,3,3,1,7,4,13,3,5,13,7,1,13,3,9,11,9,7,9,4,9,3,9,11,6,13,6,7,13,9,7,10,2,9,13,20,9,10,9,9,9,6,9,9,12,8,10,11,10,16,7,D C,1,1,1,1,1,1,20,1,1,1,1,1,1,1,1
19047081,Naylson,1651,19/01/1987,29,0,0,0,0,192,77,14,9,11,1,14,14,5,14,5,17,11,5,2,2,1,3,10,1,3,3,2,2,14,3,5,10,12,11,9,10,8,14,8,2,7,1,14,9,8,14,9,7,16,10,9,13,20,7,12,10,4,1,10,10,15,12,10,10,11,6,8,8,GK ,20,1,1,1,1,1,1,1,1,1,1,1,1,1,1
19047094,Nikão,1651,29/07/1992,23,0,0,0,0,174,75,1,3,3,2,2,1,1,3,3,3,3,13,13,15,13,14,12,11,12,12,10,15,13,10,13,7,12,10,12,11,12,11,9,13,11,13,12,10,11,12,12,10,12,20,11,12,12,12,12,12,10,10,11,12,16,18,4,11,13,14,12,7,M/AM RLC,1,1,15,20,18,17,1,1,1,1,17,15,10,1,1
19047105,Jael,1651,30/10/1988,27,0,0,0,0,186,88,2,1,1,4,2,2,2,2,2,3,3,3,9,12,13,12,12,14,13,4,5,12,13,7,12,14,12,14,12,12,12,11,15,12,12,13,7,11,12,13,12,6,14,12,13,12,20,14,15,13,12,11,9,10,6,13,6,12,8,8,4,17,S ,1,1,20,8,8,8,1,1,1,1,1,1,1,1,1
19047106,Edvânio,1651,04/03/1988,28,0,0,0,0,185,71,3,3,3,1,2,1,3,3,3,3,2,5,8,8,2,10,4,13,8,8,14,10,7,14,6,7,12,10,7,11,10,14,2,7,10,8,14,8,10,14,10,9,13,10,17,12,20,6,8,10,10,7,9,10,15,11,12,12,8,2,10,6,D/DM C,1,1,1,1,1,1,20,1,1,18,10,1,1,1,1
19047107,Evandro,1651,04/03/1988,28,0,0,0,0,190,81,1,3,1,3,3,2,2,3,3,2,3,7,8,7,7,8,3,8,4,6,9,9,7,12,7,9,7,9,8,8,8,14,1,6,10,7,9,8,8,14,14,8,15,20,12,14,10,13,12,9,9,4,7,9,13,11,10,10,5,10,15,7,D/WB L,1,1,1,1,1,1,1,20,1,1,1,1,1,18,1
19047127,Fabinho,1651,27/08/1990,25,0,0,0,0,190,74,2,3,3,3,1,1,3,4,3,1,1,9,7,8,8,11,9,14,11,7,9,10,4,7,13,9,11,8,11,10,10,9,2,9,11,9,10,9,11,14,10,10,13,10,11,13,20,7,11,9,7,9,9,9,17,10,11,14,11,4,6,7,S ,1,1,20,14,12,12,1,1,1,1,11,1,1,1,1
19047159,Cicinho,1651,26/12/1988,27,0,0,0,0,168,65,2,3,3,4,3,1,1,3,1,3,1,10,12,13,9,12,11,7,10,12,10,12,10,10,14,13,10,10,11,10,12,10,14,13,5,15,10,13,14,16,16,9,7,10,12,13,20,13,7,10,9,10,8,14,7,11,12,10,10,10,11,6,D/WB R,1,1,1,1,1,11,1,1,20,1,1,1,14,1,16
19047184,Guilherme,1651,07/03/1988,28,0,0,0,0,178,75,1,1,2,1,2,4,1,1,1,2,3,6,7,9,9,12,7,6,8,4,8,13,5,8,10,8,9,8,9,9,11,14,9,9,3,9,9,8,9,14,14,7,9,20,4,14,9,14,5,9,5,5,9,9,19,6,13,11,9,9,10,7,M/AM C,1,1,1,20,1,1,1,12,1,1,17,1,1,13,1
19047344,Maycon,1651,05/06/1987,29,0,0,0,0,176,69,3,2,1,2,2,3,4,4,2,1,2,10,12,11,13,13,8,11,7,5,4,7,8,1,11,9,8,7,9,7,6,9,3,11,12,10,4,7,8,12,13,10,6,9,6,14,20,6,10,9,9,9,6,8,17,12,11,14,10,7,18,3,AM/S RL,1,1,20,1,17,17,1,1,1,1,1,1,1,1,1
19047410,Ewerton,1651,23/03/1989,27,0,0,0,0,190,83,3,1,3,1,2,4,1,1,2,1,2,6,8,8,7,11,9,13,10,10,14,12,7,14,12,12,14,14,13,13,9,12,14,6,10,9,13,10,12,12,10,15,16,20,12,14,10,13,14,13,10,11,10,6,11,14,11,12,13,7,11,12,D C,1,12,1,1,1,1,20,14,1,1,1,1,1,10,1
19047429,Alisson,1651,01/07/1990,26,0,0,0,0,172,59,3,3,2,3,2,2,2,2,3,1,1,6,8,13,12,11,6,7,6,1,6,8,4,7,13,9,9,8,8,7,7,12,3,13,11,10,7,7,8,13,13,6,3,10,14,13,20,6,10,9,6,4,4,9,8,9,14,12,13,3,8,6,AM/S RC,1,1,20,15,1,18,1,1,1,1,1,1,1,1,1
19047439,Fágner,1651,15/03/1989,27,0,0,0,0,187,84,1,2,3,2,1,2,2,1,1,3,3,2,7,7,9,9,4,14,10,6,12,9,3,12,10,13,9,13,7,10,8,9,9,8,12,9,9,14,12,10,8,12,15,10,14,10,20,13,15,10,8,10,9,13,10,12,12,11,11,3,8,6,D/DM C,1,10,1,1,1,1,20,1,1,19,12,1,1,1,1
19047491,Manoel,1651,01/02/1989,27,0,0,0,0,185,79,2,2,1,1,3,2,1,1,3,1,1,7,8,11,12,15,8,13,10,8,9,7,8,9,12,11,9,12,10,10,10,12,13,9,8,12,11,9,10,13,12,11,12,10,13,13,20,12,11,12,6,6,10,12,16,14,13,12,10,10,12,8,S ,1,1,20,10,7,10,1,1,1,1,1,1,1,1,1
19047492,Rodolfo Testoni,1651,15/12/1988,27,0,0,0,0,179,75,1,2,1,3,1,1,1,1,3,3,3,9,10,9,10,9,12,10,12,9,12,9,5,11,10,10,9,10,9,11,10,11,11,9,10,10,8,11,11,12,12,11,9,20,11,12,9,14,8,10,9,11,9,9,11,12,10,8,12,12,10,2,D L,1,1,1,1,1,1,1,20,1,2,1,5,1,15,1
19047498,Dida Júnior,1651,03/04/1988,28,0,0,0,0,196,88,13,13,6,9,13,12,7,13,10,10,12,3,2,1,3,3,6,1,2,3,3,1,1,3,6,8,9,13,8,8,7,13,7,1,13,2,8,8,7,13,10,6,16,6,14,12,20,7,13,10,10,10,7,10,9,10,12,10,11,9,11,1,GK ,20,1,1,1,1,1,1,1,1,1,1,1,1,1,1
19047513,Michel,1651,22/10/1985,30,0,0,0,0,180,72,3,3,2,3,3,4,3,2,2,1,2,6,3,3,7,13,6,6,13,1,9,10,6,13,9,8,10,8,7,6,8,13,1,7,12,6,13,7,8,13,13,7,9,9,15,13,20,8,6,9,6,7,5,9,11,8,9,11,12,4,9,1,DM ,1,1,1,1,1,1,1,1,1,20,10,1,1,1,1
19047533,Maxwell,1651,29/01/1988,28,0,0,0,0,169,0,3,3,2,3,3,1,1,3,2,1,3,5,8,11,9,8,8,7,8,4,2,9,5,3,11,11,11,13,9,11,8,15,14,11,7,10,8,8,10,11,11,6,5,14,11,12,20,14,5,9,12,9,5,6,9,12,11,9,9,10,12,11,S ,1,1,20,1,1,1,1,1,1,1,1,1,1,1,1
19047577,Jumar,1651,28/04/1986,30,0,0,0,0,172,74,2,3,3,3,2,4,1,1,3,3,1,2,7,10,9,11,11,10,10,8,13,11,10,14,11,15,12,15,9,11,10,10,16,12,10,11,13,14,14,12,10,13,9,8,15,12,20,13,13,13,10,14,11,14,10,12,13,13,14,10,14,12,D/DM/M LC,1,1,1,1,1,1,1,16,10,20,18,1,10,14,10
19047677,Reynaldo,1651,24/08/1989,26,0,0,0,0,172,63,2,3,2,3,2,1,3,3,3,3,1,11,11,13,10,14,11,7,10,2,3,12,10,3,14,7,8,9,10,8,12,9,6,13,6,11,4,5,9,14,13,4,5,8,12,15,20,7,4,12,5,12,6,10,17,8,11,8,6,1,8,14,M/AM RLC,1,1,15,20,18,18,1,1,1,1,17,14,11,1,1
19047776,Fabiano,1651,25/09/1991,24,0,0,0,0,184,81,2,1,3,3,3,3,3,1,1,2,1,5,2,2,4,5,1,13,6,2,9,7,5,10,2,9,10,9,4,6,1,7,13,1,14,6,13,6,8,13,13,7,12,9,10,13,20,12,13,9,6,9,9,9,13,10,10,13,12,4,3,8,D C,1,1,1,1,1,1,20,1,1,1,1,1,1,1,1
19047778,Oscar,1651,09/09/1991,24,48,12,16,3,179,70,1,2,2,1,2,1,2,1,4,3,4,8,14,14,12,15,13,8,14,10,10,15,13,13,16,12,14,12,15,13,16,13,12,16,8,17,14,16,16,13,15,9,9,12,18,14,20,15,8,9,5,12,7,13,20,16,7,8,12,12,14,10,AM RC,1,1,1,20,14,18,1,1,1,1,15,13,13,1,1
19047779,Vinícius,1651,21/02/1990,26,0,0,0,0,181,77,2,1,3,3,2,2,1,1,1,3,1,8,11,10,3,13,9,13,11,7,13,12,5,12,12,8,12,12,13,12,10,12,13,9,13,9,12,13,13,13,12,12,11,10,13,12,20,13,12,12,9,11,6,11,17,10,11,12,11,11,5,8,D C,1,14,1,1,1,1,20,1,1,1,1,1,1,1,1
19047845,Róbson Salles,1651,17/01/1984,32,0,0,0,0,189,0,2,1,3,3,2,2,2,4,2,1,3,8,5,14,14,14,6,14,9,7,7,9,12,2,13,10,12,2,14,9,9,14,4,12,11,14,9,8,9,11,8,9,9,1,15,9,20,14,11,10,4,10,8,10,17,11,13,10,11,1,7,6,S ,1,1,20,1,1,1,1,1,1,1,1,1,1,1,1
19047914,Vinícius,1651,08/02/1992,24,0,0,7,0,181,76,1,3,3,1,1,2,1,3,1,1,1,6,4,1,1,6,1,12,3,2,13,4,4,13,6,9,10,9,7,12,1,11,15,6,13,6,7,6,7,13,13,7,10,20,15,13,10,7,13,9,6,9,7,9,12,13,5,11,11,13,11,6,D C,1,1,1,1,1,1,20,1,1,1,1,1,1,1,1
19047990,Marcos Bambam,1651,19/03/1991,25,0,0,0,0,176,71,4,2,3,2,1,3,3,3,1,2,2,8,12,13,13,12,6,10,11,4,5,12,13,6,14,8,9,13,13,8,11,9,8,14,8,12,5,8,8,13,13,9,8,8,9,13,20,10,8,6,6,11,12,11,14,12,12,9,8,6,9,13,AM/S C,1,1,20,17,14,10,1,1,1,1,10,6,7,1,1
19048096,Paulo Henrique,1651,11/08/1989,26,0,0,0,0,174,66,3,1,2,2,3,1,3,3,1,1,2,5,10,12,8,16,1,10,8,8,9,12,1,8,12,7,12,11,11,11,12,13,10,10,15,10,9,11,11,13,13,5,6,11,10,14,20,13,5,10,10,1,10,10,13,11,12,11,13,6,12,3,D/WB R,1,1,1,1,1,1,1,1,20,1,1,1,1,1,18
19048104,Maylson,1651,06/03/1989,27,0,0,7,2,180,71,1,3,3,3,2,1,3,2,1,3,1,8,11,11,11,11,7,9,13,7,10,12,11,10,12,12,11,13,11,11,12,13,15,14,9,12,12,12,12,14,12,11,10,10,13,14,20,14,10,11,13,11,8,13,13,15,13,13,12,8,10,11,M/AM RC,1,1,1,16,1,17,1,1,1,13,20,1,18,1,1
19048212,Hernane,1651,08/04/1986,30,0,0,0,0,184,79,3,1,2,3,2,3,1,3,2,1,3,7,8,11,13,12,9,13,11,9,7,11,12,7,12,13,13,15,12,10,11,11,13,9,13,13,10,14,13,13,13,12,13,12,14,13,20,13,14,10,13,10,11,6,8,12,18,10,11,6,8,6,S ,1,1,20,1,1,1,1,1,1,1,1,1,1,1,1
19048379,Ricardo Ehle,1651,18/12/1984,31,0,0,0,0,187,84,2,2,3,2,1,3,3,3,4,2,3,6,6,8,7,9,1,12,6,2,12,4,4,11,9,10,13,10,8,11,5,14,14,8,7,6,11,8,9,9,11,15,15,8,12,10,20,13,15,10,5,10,10,10,12,15,9,12,13,2,10,10,D C,1,1,1,1,1,1,20,1,1,1,1,1,1,1,1
19048381,Luís Paulo,1651,01/05/1988,28,0,0,0,0,185,0,2,1,3,2,1,3,3,2,3,3,2,5,2,7,12,12,4,8,7,1,3,8,4,5,12,9,6,5,10,5,8,8,8,13,4,12,7,6,7,12,12,6,8,18,14,15,20,5,7,9,9,9,3,9,8,12,13,10,12,1,4,5,M/AM/S C,1,1,20,18,1,1,1,1,1,1,17,1,1,1,1
19048785,Duda,1651,08/02/1987,29,0,0,0,0,175,80,1,3,3,1,3,1,4,1,1,1,2,7,6,6,8,12,7,7,10,2,10,13,5,14,11,9,12,8,8,9,7,14,4,5,8,7,14,8,11,11,7,7,7,10,15,11,20,7,13,9,9,9,8,9,8,12,12,14,11,3,17,5,DM ,1,1,1,1,1,1,1,1,1,20,10,1,1,1,1
19048787,Alan Mineiro,1651,29/09/1987,28,0,0,0,0,173,78,3,2,2,1,1,1,3,2,1,2,1,14,10,11,11,12,14,7,11,8,7,14,8,6,13,7,12,11,12,12,13,13,13,14,1,13,10,10,12,13,13,12,7,10,13,12,20,14,11,14,8,14,5,11,12,12,13,12,14,12,12,5,AM LC,1,1,1,20,17,1,1,1,1,1,13,13,1,1,1
19049388,Renato Chaves,1651,04/05/1990,26,0,0,0,0,185,85,1,1,1,3,3,1,1,4,1,1,3,4,3,6,6,8,14,12,6,7,14,10,9,14,11,13,11,13,11,11,4,11,15,12,11,10,12,11,13,12,10,13,14,20,13,13,18,12,14,14,11,8,16,12,16,16,14,13,13,11,12,12,D C,1,1,1,1,1,1,20,1,1,10,1,1,1,1,1
19049833,Paulo Rangel,1651,04/02/1985,31,0,0,0,0,189,86,2,3,1,3,3,2,1,1,4,2,2,10,9,8,12,12,10,13,11,5,5,10,9,5,9,10,16,8,12,11,10,10,7,10,6,16,11,10,11,12,7,11,15,8,16,9,20,13,14,8,6,8,10,10,18,10,1,10,9,9,12,4,S ,1,1,20,1,1,1,1,1,1,1,1,1,1,1,1
19050274,Lucas Zen,1651,17/06/1991,25,0,0,0,0,181,72,2,3,3,1,2,3,1,4,1,3,1,12,10,10,9,11,6,11,10,12,12,12,10,11,11,6,12,12,13,12,11,12,11,11,13,11,12,11,11,12,12,10,12,5,13,11,20,11,11,10,11,12,11,13,17,13,11,12,11,9,19,3,D/DM/M RC,1,1,1,1,1,1,13,1,17,20,17,1,1,1,14
19050276,Alex Lopes,1651,16/05/1989,27,0,0,0,0,186,70,3,3,1,3,3,2,1,1,1,2,3,4,5,3,7,6,1,10,7,1,11,9,6,13,7,10,13,11,9,9,5,13,6,1,4,7,13,7,9,13,10,9,11,8,10,13,20,8,8,10,10,10,10,10,8,8,12,9,13,8,1,5,D RC,1,1,1,1,1,1,20,1,17,1,1,1,1,1,1
19050278,Wellington Júnior,1651,20/06/1989,27,0,0,4,0,178,68,3,2,3,2,4,1,3,2,1,3,3,4,11,6,8,11,5,7,9,4,10,10,9,9,7,12,10,12,10,10,10,11,10,10,10,9,11,12,12,12,12,7,7,18,6,8,20,11,8,12,9,11,8,16,11,11,10,9,9,8,10,10,DM/M/AM C,1,1,1,18,1,1,1,1,1,20,19,1,1,7,6
19050293,Kim,1651,10/09/1987,28,0,0,0,0,175,76,3,3,1,2,2,3,1,1,2,3,1,12,12,11,8,11,6,6,10,5,9,12,10,8,12,12,7,10,12,11,12,12,8,13,10,11,8,10,11,13,11,12,7,20,12,13,9,11,12,9,7,9,8,12,19,10,8,8,12,10,14,8,D/WB L,1,1,1,1,1,1,1,20,1,1,1,1,1,18,1
19050523,George,1651,04/01/1989,27,0,0,0,0,178,75,1,3,3,2,1,1,3,3,3,2,1,8,10,11,8,10,6,10,9,12,10,11,3,16,10,9,11,10,8,10,8,8,7,5,9,8,10,11,11,12,12,11,9,9,10,12,20,11,12,9,9,9,3,9,18,13,11,10,9,10,7,1,D/WB R,1,7,1,1,1,5,10,1,20,1,1,1,9,1,17
19050528,Memo,1651,14/02/1988,28,0,0,0,0,179,71,1,3,1,3,3,1,3,2,2,3,1,8,7,9,9,14,8,10,13,2,13,13,7,14,11,9,11,9,10,10,12,10,10,7,6,9,12,9,13,14,14,9,10,11,8,14,20,9,9,10,10,10,10,10,12,9,12,10,11,2,15,7,DM/M C,1,1,1,1,1,1,1,1,1,20,16,1,1,1,1
19050531,Miller,1651,17/01/1990,26,0,0,0,0,164,57,3,2,2,2,3,1,1,1,2,1,2,6,10,12,9,12,9,5,8,4,5,12,9,5,12,9,7,9,16,8,11,11,9,12,3,13,11,11,15,13,15,5,3,1,13,13,20,10,2,9,6,6,7,9,9,11,9,10,11,7,17,8,M/AM C,1,1,1,20,10,10,1,1,1,1,19,5,5,1,1
19050663,Velicka,1651,26/02/1986,30,0,0,0,0,177,72,3,1,1,1,1,3,4,3,3,3,2,7,9,8,7,11,8,12,8,8,14,12,4,12,10,8,9,9,10,9,12,13,2,9,3,7,14,9,9,14,14,12,8,20,13,14,11,11,7,12,10,10,10,14,7,12,11,9,12,12,14,8,D/DM/M LC,1,1,1,1,1,1,13,20,1,18,17,13,1,13,1
19050730,Mazinho,1651,16/10/1987,28,0,0,0,0,165,68,1,1,2,2,2,1,2,3,2,4,1,7,10,12,11,10,10,10,9,1,5,11,9,4,11,10,11,12,12,11,12,12,16,13,8,12,5,11,12,15,14,3,2,20,10,15,9,15,8,11,11,14,11,13,18,12,11,10,14,3,3,7,AM L,1,1,14,13,20,14,1,1,1,1,10,15,12,1,1
19051301,Carlos André,1651,19/03/1987,29,0,0,0,0,175,71,1,4,1,2,2,1,2,3,2,1,3,2,6,10,13,12,6,8,6,5,7,10,3,5,7,9,8,4,9,7,9,13,6,7,12,10,8,4,8,13,13,7,4,11,16,13,20,13,6,9,4,8,9,9,16,10,11,10,10,2,16,8,M/AM/S C,1,1,18,20,1,1,1,1,1,1,18,1,1,1,1
19051500,Diego Dedoné,1651,12/09/1985,30,0,0,0,0,176,67,3,2,3,1,2,2,2,1,3,1,3,11,12,12,10,11,8,8,8,10,8,12,10,7,11,8,10,15,8,10,12,10,14,10,8,10,12,11,11,15,14,8,8,11,8,16,20,12,8,10,8,10,8,9,16,9,8,11,14,5,15,2,S ,1,1,20,1,1,1,1,1,1,1,1,1,1,1,1
19051507,Diego Macedo,1651,15/09/1987,28,0,0,0,0,188,88,1,2,4,3,1,3,3,3,3,2,2,3,5,5,6,7,6,13,7,8,12,8,8,13,8,14,12,14,8,11,7,10,13,5,10,7,11,14,13,10,8,15,15,10,13,10,20,15,16,10,12,10,3,8,8,12,10,10,11,8,10,11,D C,1,11,1,1,1,1,20,1,1,1,1,1,1,1,1
19051579,Gonçalves,1651,11/04/1987,29,0,0,0,0,185,79,10,13,7,1,14,11,12,14,9,8,9,1,3,2,1,7,3,1,1,1,3,1,1,1,5,9,9,9,7,13,7,14,9,1,11,2,11,8,7,13,8,4,13,20,12,12,9,4,8,9,8,5,5,9,14,13,10,10,12,4,10,2,GK ,20,1,1,1,1,1,1,1,1,1,1,1,1,1,1
19051583,Marcel,1651,17/03/1987,29,0,0,0,0,172,73,3,1,3,1,3,1,2,2,3,1,1,3,4,3,8,13,7,7,9,5,9,13,5,11,13,10,10,6,7,8,11,13,4,4,9,6,8,8,11,13,13,8,5,12,7,13,20,11,9,10,9,8,10,10,11,9,9,13,11,4,11,6,M C,1,1,1,1,1,1,1,1,1,1,20,1,1,1,1
19051585,Raphael Toledo,1651,05/08/1989,26,0,0,0,0,182,75,1,1,3,2,4,1,1,3,1,1,3,13,13,13,12,13,13,8,12,8,7,13,12,7,13,10,13,10,12,11,14,12,11,14,10,13,9,10,11,11,11,11,9,20,11,11,5,11,11,10,7,10,10,11,13,14,10,12,13,13,13,6,D/WB/AM LC,1,1,5,20,12,10,1,19,1,1,5,10,1,19,1
19051612,Jaílton Paraíba,1651,11/10/1990,25,0,0,0,0,172,74,1,3,2,1,3,2,3,2,2,2,3,7,11,13,8,10,9,6,7,3,3,11,12,3,12,15,9,14,10,10,11,9,13,11,4,10,5,7,12,16,16,7,5,8,9,15,20,14,8,13,9,6,6,7,16,11,13,10,13,4,3,5,AM/S RL,1,1,18,12,20,18,1,1,1,1,8,1,1,1,1
19051692,Wescley Lagoa,1651,13/08/1983,32,0,0,0,0,163,0,2,1,3,3,4,1,2,1,2,1,3,6,5,7,5,6,7,9,6,8,10,10,4,15,10,9,12,10,6,12,7,11,9,1,14,7,11,9,9,14,11,9,1,9,12,13,20,9,6,9,1,4,8,9,15,11,11,12,11,5,10,3,D/WB R,1,1,1,1,1,1,1,1,20,1,1,1,1,1,18
19051706,Siloé,1651,22/05/1990,26,0,0,0,0,179,72,3,1,1,2,3,2,2,4,2,1,3,4,10,13,11,12,5,7,7,4,2,10,12,3,13,11,13,11,12,8,11,12,13,15,6,12,2,5,12,14,14,10,8,20,10,14,10,12,6,12,6,11,12,12,7,12,7,11,11,5,12,6,AM/S L,1,1,20,10,17,10,1,1,1,1,1,1,1,1,1
19051721,Cláudio Allax,1651,07/01/1991,25,0,0,0,0,171,61,1,2,3,1,4,2,1,2,3,1,1,8,9,9,5,10,6,8,9,7,10,10,3,14,7,10,11,9,7,12,6,14,4,3,7,8,14,9,10,14,14,7,6,10,16,14,20,9,7,10,6,10,10,10,15,12,12,11,11,3,12,8,D/WB/DM R,1,1,1,1,1,1,1,1,20,19,10,1,1,1,18
19051723,Andrey,1651,12/01/1990,26,0,0,0,0,175,69,1,2,2,2,1,1,1,1,1,3,4,6,5,8,8,13,6,1,8,2,7,13,5,7,13,4,7,4,7,6,6,13,8,13,14,11,6,7,12,13,13,7,7,20,7,13,10,12,6,9,9,6,7,9,15,9,11,12,11,7,5,4,M/AM C,1,1,1,20,1,1,1,1,1,1,18,1,1,1,1
19051733,Juan Lima,1651,10/05/1991,25,0,0,0,0,173,72,1,3,2,2,2,1,1,3,3,1,3,8,9,14,14,14,8,14,9,3,7,9,7,3,9,10,12,9,8,9,4,10,10,8,10,12,8,8,9,14,14,9,3,10,16,12,20,13,7,10,5,10,10,10,19,10,11,12,11,9,6,1,S ,1,1,20,1,1,1,1,1,1,1,1,1,1,1,1
19051844,Wallace,1651,14/03/1990,26,0,0,0,0,167,0,3,2,1,2,2,3,3,3,2,3,2,11,12,12,11,12,13,8,10,7,5,12,11,6,12,11,10,11,10,10,13,11,9,10,9,11,6,10,11,11,11,10,6,5,13,11,20,12,9,12,5,10,9,8,12,11,9,9,11,4,1,5,M/AM C,1,1,1,20,1,1,1,1,1,1,19,1,1,1,1
19051901,Zezinho,1651,14/03/1992,24,0,0,0,0,174,66,1,1,1,1,1,2,1,1,3,3,1,7,12,13,10,12,10,10,11,4,5,11,8,8,13,11,11,9,10,9,12,10,10,13,6,12,6,12,13,14,14,10,7,20,15,14,7,14,6,10,8,11,8,15,7,12,11,13,9,5,13,7,M/AM LC,1,1,14,19,20,1,1,11,1,14,17,13,1,12,1
19051977,Fernando Júnior,1651,20/12/1989,26,0,0,0,0,193,85,14,11,11,1,14,14,10,12,9,9,6,1,2,3,2,3,6,1,1,3,1,1,3,1,3,7,10,12,8,10,7,14,4,3,9,1,9,8,7,10,7,14,15,1,11,14,20,6,14,9,9,7,7,8,13,11,11,10,10,1,4,3,GK ,20,1,1,1,1,1,1,1,1,1,1,1,1,1,1
19051982,Wallinson,1651,16/06/1989,27,0,0,0,0,193,87,1,3,1,1,3,3,1,3,2,2,2,5,5,8,5,12,4,13,5,5,11,9,9,11,9,16,14,14,10,8,3,14,4,4,5,7,9,8,12,8,6,4,16,10,15,9,20,11,15,10,11,10,10,10,10,12,11,13,11,2,2,4,D C,1,1,1,1,1,1,20,1,1,1,1,1,1,1,1
19051992,Marçal,1651,19/02/1989,27,0,0,0,0,178,72,2,3,2,3,2,3,3,1,1,2,1,13,14,11,7,12,10,9,10,13,13,12,10,14,13,12,14,14,13,14,11,12,14,13,8,14,13,13,15,15,13,10,10,20,13,15,6,14,10,13,13,12,8,12,15,14,13,14,13,13,12,6,D/WB L,1,1,1,1,10,1,1,20,1,1,1,10,1,18,1
19051994,Hélder,1651,21/10/1988,27,0,0,0,0,180,79,3,3,2,2,1,2,2,2,3,1,3,10,11,10,5,9,11,9,8,10,10,10,9,10,10,13,12,12,9,10,10,10,10,10,8,10,10,12,10,12,11,10,9,20,11,12,8,11,8,10,12,4,8,10,9,15,13,11,11,12,10,11,D/WB L,1,1,1,1,10,1,1,20,1,1,1,12,1,19,1
19052001,Isael,1651,13/05/1988,28,0,0,0,0,171,71,2,2,3,3,4,3,2,3,3,3,1,11,13,13,12,11,13,7,12,7,8,12,12,6,15,12,9,12,10,10,15,9,10,15,8,11,6,7,7,13,16,8,7,20,12,13,12,10,6,10,11,8,7,11,10,12,12,9,11,13,15,8,AM RLC,1,1,1,15,18,20,1,1,1,1,10,13,13,1,1
19052006,Dhiego Souza,1651,04/05/1989,27,0,0,0,0,176,73,1,4,1,2,3,2,3,2,3,1,1,4,4,9,6,11,4,4,11,1,8,10,2,8,11,6,8,2,10,4,11,11,8,13,1,10,5,5,7,13,10,8,10,8,12,12,20,11,9,9,9,5,9,9,11,16,7,10,12,14,7,5,M/AM C,1,1,1,18,1,1,1,1,1,1,20,1,1,1,1
19052008,Gabriel Marques,1651,31/03/1988,28,0,0,0,0,184,79,2,3,1,2,4,2,1,3,2,1,1,11,12,12,10,13,11,11,9,12,11,12,12,10,13,13,12,12,12,10,12,12,11,12,10,13,12,12,12,14,12,12,10,11,13,13,20,12,9,10,8,10,10,15,10,10,10,8,11,13,14,7,D/WB/DM/M RC,1,1,1,1,1,1,18,1,15,20,8,1,16,1,16
19052010,Júlio César,1651,04/01/1988,28,0,0,0,0,180,78,1,1,1,4,1,2,2,2,3,3,2,3,4,10,7,8,4,8,9,8,11,7,4,12,7,10,11,10,12,11,13,15,7,1,11,9,11,14,14,13,8,7,11,10,13,12,20,10,13,12,9,6,7,10,18,12,13,11,9,1,6,8,DM/M C,1,1,1,1,1,1,1,1,7,20,17,1,1,1,1
19052135,Luiz Ricardo,1651,22/04/1989,27,0,0,0,0,190,91,1,3,3,3,2,3,2,2,2,2,1,6,6,4,5,13,6,6,9,1,7,13,1,13,10,9,7,8,7,7,10,13,5,5,14,7,12,7,12,8,11,7,14,20,5,11,9,13,9,9,8,5,9,9,17,12,12,10,11,10,14,7,DM C,1,1,1,1,1,1,1,1,1,20,15,1,1,1,1
19052277,Gabriel Pimba,1651,04/07/1990,25,0,0,0,0,173,67,2,3,1,3,3,2,1,2,1,1,1,6,10,12,11,10,9,9,10,5,5,11,9,6,13,12,11,11,11,11,12,11,10,12,10,10,6,10,11,12,13,5,9,11,11,11,20,11,9,11,11,12,7,12,14,10,14,13,10,8,12,8,AM C,1,1,13,20,1,1,1,1,1,1,15,1,1,1,1
19052282,Douglas Maia,1651,12/04/1989,27,0,0,0,0,178,71,1,2,1,4,3,2,1,2,3,2,1,9,11,9,8,10,10,9,9,9,11,9,10,11,10,12,9,13,9,9,10,9,13,11,11,11,11,13,12,12,12,10,8,8,14,11,20,10,10,12,13,10,10,15,12,12,13,13,14,11,11,10,DM/M RC,1,1,1,5,1,5,1,1,15,16,20,1,12,1,15
19052304,Cesinha,1651,29/11/1989,26,0,0,0,0,177,74,1,1,1,2,1,2,1,1,1,3,3,10,14,12,10,11,8,8,8,7,8,12,5,6,12,7,12,13,7,7,10,9,3,14,5,15,8,7,10,14,13,4,7,14,13,14,20,14,4,12,3,9,10,14,10,11,11,11,9,8,16,8,AM RL,1,1,13,10,17,20,1,1,1,1,1,1,1,1,1
19052314,Diego Aragão,1651,29/10/1986,29,0,0,0,0,172,75,3,3,2,1,1,1,2,1,3,1,1,7,9,9,7,12,4,8,11,3,11,10,1,11,14,10,10,13,8,9,13,14,3,4,10,8,10,12,11,14,14,9,4,10,14,14,20,13,8,7,10,3,10,10,12,11,12,12,11,7,9,1,DM C,1,1,1,1,1,1,1,1,10,20,15,1,1,1,10
19052443,Sílvio Carrasco,1651,29/07/1988,27,0,0,0,0,180,79,1,3,2,2,2,1,1,2,1,2,2,3,4,5,6,8,8,11,9,8,11,8,7,11,7,13,11,13,9,11,10,10,12,7,11,10,11,13,13,11,11,11,10,8,13,12,20,13,12,11,9,10,8,8,9,11,11,7,11,7,3,1,D C,1,1,1,1,1,1,20,1,1,1,1,1,1,1,1
19052492,Didira,1651,09/06/1988,28,0,0,0,0,171,70,1,2,2,1,2,2,3,2,2,2,3,12,12,13,11,11,13,5,14,13,11,13,12,11,13,10,11,14,12,11,11,11,11,10,10,13,11,12,12,14,15,8,5,7,13,14,20,14,8,10,10,11,7,13,11,10,11,12,12,11,10,13,AM RC,1,1,1,20,10,20,1,1,10,1,15,1,15,1,10
19052595,Carlão,1651,22/10/1990,25,0,0,0,0,191,79,11,13,12,1,12,11,12,13,12,10,12,2,3,2,3,6,4,6,3,2,4,7,6,7,6,15,10,14,7,10,3,9,12,5,10,3,11,8,10,8,13,11,15,2,15,8,20,9,12,14,10,13,6,2,10,14,17,12,17,9,14,5,GK ,20,1,1,1,1,1,1,1,1,1,1,1,1,1,1
19052604,Jefferson Maranhão,1651,10/06/1989,27,0,0,0,0,178,72,2,1,1,3,1,2,3,1,1,1,1,11,12,12,10,10,11,9,9,12,9,12,11,10,11,10,12,11,8,10,10,8,13,10,3,11,9,11,11,12,11,10,10,20,12,15,11,10,10,12,8,12,8,12,5,7,12,10,12,9,11,6,AM/S L,1,1,18,1,20,1,1,10,1,1,1,15,1,10,1
19052611,Rafael Donato,1651,17/03/1989,27,0,0,0,0,195,92,3,2,2,1,1,3,1,4,3,1,1,6,6,7,7,8,4,15,7,6,13,9,11,12,7,15,12,15,11,10,6,12,10,8,10,11,13,15,15,9,7,3,17,9,15,9,20,14,17,12,10,11,7,5,15,10,9,8,11,10,11,7,D C,1,1,1,1,1,1,20,1,1,1,1,1,1,1,1
19052625,Diogo,1651,27/03/1990,26,0,0,0,0,185,75,2,1,3,2,1,2,3,3,3,3,1,5,8,12,11,8,11,12,11,5,7,9,12,7,11,14,11,14,9,7,7,8,15,13,5,10,7,13,11,11,9,14,13,20,18,10,10,12,14,12,10,12,5,15,13,13,14,10,14,13,13,8,M/AM/S C,1,1,18,20,13,9,1,1,1,12,19,11,8,1,1
19052640,Anderson,1651,07/01/1990,26,0,0,0,0,178,60,1,1,2,1,2,4,3,2,1,2,2,4,10,12,12,10,7,9,10,6,4,11,12,5,13,11,10,8,11,7,12,9,12,12,4,13,7,7,7,14,14,9,10,7,13,15,20,10,8,11,12,9,7,10,11,13,11,12,11,6,10,12,S ,1,1,20,14,10,12,1,1,1,1,5,1,1,1,1
19052675,Gustavo,1651,02/07/1988,27,0,0,0,0,168,64,2,2,3,3,3,2,2,3,3,1,1,11,14,10,9,12,9,10,10,11,9,12,7,9,12,9,10,11,12,12,9,14,4,4,12,13,12,12,8,11,10,8,5,6,15,12,20,10,7,10,8,6,7,9,15,10,12,10,12,5,13,8,D R,1,1,1,1,1,1,10,12,20,1,1,1,1,1,15
19052685,Edson Farias,1651,12/01/1992,24,0,0,0,0,168,68,4,2,3,1,3,1,2,3,2,3,1,7,9,14,11,11,6,6,7,5,8,10,6,8,13,13,13,13,10,8,8,8,14,14,5,14,8,11,14,16,15,10,4,8,12,15,20,11,6,10,9,10,8,11,11,12,14,10,11,11,9,6,AM/S RL,1,1,18,13,19,20,1,1,1,1,1,7,7,1,1
19052732,Carlão,1651,14/09/1989,26,0,0,0,0,185,74,13,11,11,5,15,11,10,15,10,10,9,5,3,1,3,7,10,2,1,3,2,4,4,3,8,9,10,10,10,7,9,15,2,3,4,3,11,10,9,13,7,10,14,1,14,13,20,8,11,10,10,5,10,10,9,13,12,12,12,11,8,7,GK ,20,1,1,1,1,1,1,1,1,1,1,1,1,1,1
19052736,Alex Moraes,1651,25/03/1988,28,0,0,0,0,195,87,2,3,3,2,1,3,2,3,2,3,2,5,6,8,9,9,9,11,8,5,10,9,10,11,10,11,11,11,11,11,6,10,12,11,9,10,11,11,12,9,8,14,13,12,12,12,20,13,13,11,11,11,8,5,13,11,9,10,12,10,10,9,D C,1,1,1,1,1,1,20,1,1,1,1,1,1,1,1
19052743,Rudiero,1651,31/07/1987,28,0,0,0,0,180,76,2,1,2,3,3,2,4,1,1,4,1,5,8,8,3,13,5,7,8,4,12,13,1,14,9,9,9,8,6,8,4,13,7,8,11,7,10,8,9,14,14,8,10,10,15,14,20,10,12,9,9,9,5,9,20,11,9,11,13,7,19,1,D/WB/DM R,1,1,1,1,1,1,1,1,17,20,10,1,1,1,17
19052745,Alan Ruschel,1651,23/08/1989,26,0,0,0,0,175,72,2,3,1,1,2,2,2,1,1,1,1,10,11,11,8,11,7,7,11,13,12,10,10,11,10,12,10,10,11,10,11,10,8,11,6,11,12,11,12,14,15,14,7,20,5,13,7,13,8,12,8,6,14,11,14,10,9,8,12,6,7,4,D/WB L,1,1,1,1,1,1,1,20,1,1,13,15,1,17,1
19052788,Téo,1651,05/02/1979,37,0,0,0,0,182,0,1,4,2,1,2,1,3,1,1,3,1,8,13,14,8,13,7,5,7,7,4,8,6,6,14,9,8,8,11,8,9,14,5,13,8,11,10,8,11,11,10,8,10,10,9,8,20,8,8,9,3,7,9,9,8,8,8,10,9,10,12,1,M/AM R,1,1,8,1,1,20,1,1,1,1,1,1,20,1,1
19052881,Cleiton,1651,25/02/1989,27,0,0,0,0,195,89,3,1,4,3,1,2,1,2,3,1,3,1,5,6,5,8,1,13,5,6,11,6,3,13,6,9,7,9,6,8,4,7,2,1,9,4,11,6,7,13,10,3,16,20,6,11,9,12,11,9,9,9,8,8,11,12,9,12,12,1,4,2,D C,1,11,1,1,1,1,20,1,1,1,1,1,1,1,1
19052886,Josean,1651,21/01/1989,27,0,0,0,0,182,0,1,1,3,1,1,1,2,3,1,2,1,12,12,12,10,11,10,10,9,8,9,11,10,10,11,11,11,12,10,9,11,10,5,9,10,12,12,13,12,11,11,11,9,20,12,12,1,11,11,12,11,11,9,9,9,11,13,11,11,3,5,7,D/WB L,1,1,1,1,1,1,1,20,1,1,1,1,1,17,1
19052901,Talis,1651,12/09/1989,26,0,0,0,0,196,92,1,3,3,1,2,1,1,2,2,2,1,7,4,4,6,9,2,13,6,2,11,5,6,11,4,9,13,10,10,15,9,11,9,2,7,6,11,9,10,10,6,3,17,3,9,10,20,13,16,9,9,9,3,9,13,12,10,10,13,8,6,1,D C,1,1,1,1,1,1,20,1,1,1,1,1,1,1,1
19052912,Marcus Vinícius,1651,18/01/1990,26,0,0,0,0,178,73,3,2,3,1,3,2,2,2,3,2,1,5,8,10,10,12,8,10,10,4,9,10,13,7,11,6,12,4,11,10,8,11,6,8,4,16,7,10,7,13,13,10,9,20,13,13,12,12,9,12,10,9,10,10,12,10,12,11,9,8,17,8,S ,1,1,20,10,10,10,1,1,1,1,1,1,1,1,1
19052922,Rafael Tolói,1651,10/10/1990,25,0,0,19,0,185,75,4,2,1,1,3,1,1,1,3,3,3,5,8,10,9,12,10,14,11,8,14,12,10,15,12,13,14,13,13,13,11,13,15,13,11,12,14,13,14,13,13,14,13,9,15,13,20,14,14,10,12,13,8,13,10,13,14,15,13,8,9,14,D C,1,1,1,1,1,1,20,7,13,1,1,1,1,1,1
19053217,Alexandro,1651,06/11/1986,29,0,0,0,0,184,80,2,2,1,2,2,2,2,1,3,2,2,5,5,11,13,9,7,15,9,6,5,10,14,4,10,12,12,15,10,10,7,9,13,11,8,13,5,16,15,13,11,13,13,9,13,12,20,13,14,9,7,11,7,8,12,14,10,11,12,13,12,9,S ,1,1,20,1,10,7,1,1,1,1,1,1,1,1,1
19053232,Léo,1651,02/07/1990,26,0,0,0,0,179,70,1,2,3,1,4,2,1,2,3,2,1,6,9,11,12,9,9,15,10,2,9,10,4,8,13,11,12,9,10,10,15,14,1,11,3,14,11,10,8,10,13,10,8,20,12,10,13,8,12,10,5,3,10,10,8,11,10,11,12,2,13,1,M/AM/S C,1,1,20,16,1,1,1,1,1,1,16,1,1,1,1
19053233,Flávio Boaventura,1651,12/07/1987,28,0,0,0,0,182,77,3,1,3,3,2,3,3,2,1,2,3,3,4,5,6,6,5,15,3,2,14,5,3,14,5,13,12,14,11,9,9,11,12,14,11,9,12,13,12,14,12,13,14,8,13,15,20,14,15,10,13,12,4,5,12,11,11,11,12,10,16,12,D C,1,1,1,1,1,1,20,1,1,1,1,1,1,1,1
19053416,Hiroshi,1651,20/02/1986,30,0,0,0,0,181,77,2,1,2,1,2,3,3,2,3,3,2,5,6,5,6,10,6,6,13,1,10,13,6,8,13,9,9,2,6,12,7,13,6,6,13,5,12,7,12,13,13,7,7,10,13,13,20,13,10,9,5,3,8,9,14,11,11,12,10,6,6,8,DM ,1,1,1,1,1,1,1,1,1,20,10,1,1,1,1
19053424,Gil,1651,12/06/1987,29,10,0,0,0,192,87,2,2,1,1,1,2,3,1,3,3,3,6,7,8,7,9,7,15,9,9,16,10,10,16,10,15,15,17,12,14,10,12,15,8,12,10,16,13,15,14,11,15,16,8,15,13,20,14,17,13,11,13,8,7,7,15,10,11,14,12,12,9,D C,1,1,1,1,1,1,20,1,1,1,1,1,1,1,1
19053437,Flávio,1651,11/12/1988,27,0,0,0,0,185,83,3,4,1,3,2,2,1,3,3,2,3,6,6,13,13,13,6,13,6,4,6,7,4,3,11,4,8,6,11,6,6,11,5,11,5,10,5,6,8,13,13,7,14,8,11,13,20,12,9,9,9,9,9,9,16,10,10,10,13,11,11,3,S ,1,1,20,1,1,1,1,1,1,1,1,1,1,1,1
19053478,Everton Silva,1651,04/08/1988,27,0,0,0,0,171,68,1,3,1,1,1,2,2,3,3,2,1,8,11,11,9,11,10,7,10,12,9,12,3,10,12,12,11,12,11,11,10,11,9,8,8,11,10,12,12,16,15,15,5,8,14,15,20,15,4,12,14,2,5,17,10,10,12,9,10,7,5,3,D/WB R,1,1,1,8,6,12,9,11,17,2,5,7,15,10,20
19053496,Jefferson,1651,05/04/1990,26,0,0,0,0,185,81,13,10,11,1,13,13,11,13,7,6,12,4,1,1,2,2,6,1,1,2,1,1,3,3,5,6,6,9,7,9,6,11,9,1,7,2,9,7,2,12,9,3,15,12,12,10,20,1,7,9,9,5,8,8,7,9,10,11,11,10,10,4,GK ,20,1,1,1,1,1,1,1,1,1,1,1,1,1,1
19053498,Grafite,1651,20/10/1987,28,0,0,0,0,178,73,2,3,3,1,3,2,1,3,1,1,1,5,7,7,4,13,3,8,5,7,8,9,3,12,8,10,9,8,8,9,6,13,2,10,12,7,11,8,8,13,13,8,4,20,12,13,10,13,10,10,3,10,10,10,15,8,14,9,12,1,13,1,D/WB RL,1,1,1,1,1,1,1,18,20,1,1,1,1,15,19
19053512,Doriva,1651,13/04/1987,29,0,0,0,0,182,74,3,3,2,2,3,3,3,2,3,2,2,11,10,12,10,12,12,8,12,6,12,12,7,12,15,11,11,12,11,11,13,11,12,12,7,12,11,11,11,12,13,12,11,10,12,12,20,12,11,11,6,10,13,15,13,14,12,8,9,8,10,8,DM/M C,1,1,1,12,7,8,1,1,10,18,20,10,10,1,1
19053521,Michel,1651,25/06/1989,27,0,0,0,0,178,75,2,3,2,2,2,2,2,2,3,1,3,7,8,13,7,12,6,7,7,7,6,8,8,6,12,17,11,8,10,11,11,9,10,8,10,12,6,11,9,14,14,8,8,13,14,14,20,12,6,10,10,10,8,12,9,11,9,10,10,4,4,5,AM RL,1,1,1,14,19,20,1,1,1,1,1,15,15,1,1
19053526,Derley,1651,29/12/1987,28,0,0,0,0,183,81,1,1,4,2,3,3,2,2,1,2,3,5,7,12,12,13,7,14,12,6,8,11,13,6,12,12,12,15,12,12,9,11,17,12,7,12,11,13,13,13,12,15,13,9,15,12,20,12,13,8,11,11,7,9,12,13,11,12,14,11,12,4,S ,1,1,20,1,1,1,1,1,1,1,1,1,1,1,1
19053533,Almir,1651,22/08/1985,30,0,0,0,0,179,70,2,2,2,2,2,2,1,3,3,4,1,7,9,12,10,12,9,9,9,6,3,9,8,4,10,11,10,12,9,9,9,11,13,12,6,10,3,11,9,13,11,10,10,20,13,13,9,10,8,11,6,9,9,8,11,8,12,13,12,6,7,3,AM/S RLC,1,1,17,20,20,20,1,1,1,1,1,12,12,1,1
19053709,Felipe,1651,28/05/1990,26,0,0,0,0,171,67,3,3,1,2,2,1,2,3,1,1,3,12,12,13,12,13,11,10,13,4,3,14,13,4,14,12,13,12,12,11,13,12,15,15,10,11,12,11,12,14,14,12,6,8,13,14,20,12,8,12,6,14,6,12,9,16,10,14,13,10,13,13,M/AM LC,1,1,13,20,15,12,1,1,1,10,16,11,10,1,1
19053712,Dênis,1651,22/04/1990,26,0,0,0,0,169,68,2,3,3,2,2,3,2,4,1,1,1,11,10,10,7,11,13,5,11,12,7,12,10,6,13,6,12,13,8,13,11,12,12,12,5,14,11,13,14,12,11,8,4,20,13,14,9,12,9,13,10,7,9,14,8,13,11,11,13,7,12,7,D/WB L,1,1,1,1,1,1,1,17,1,1,1,10,1,20,1
19053995,Romarinho,1651,12/08/1991,24,0,0,0,0,178,0,1,3,1,1,2,1,1,3,1,3,2,1,1,10,12,12,4,11,4,5,3,10,4,5,10,8,7,5,11,6,7,10,3,11,12,10,7,5,7,12,12,7,2,8,12,12,20,12,9,11,5,4,9,9,10,14,10,13,11,9,14,2,S ,1,1,20,14,1,1,1,1,1,1,13,1,1,1,1
19054197,Élton Lira,1651,21/09/1986,29,0,0,0,0,185,75,1,1,1,3,3,2,1,3,2,3,3,8,11,10,7,12,10,10,7,7,11,11,1,12,8,10,12,10,12,13,9,11,9,7,9,11,11,11,11,9,9,11,10,20,17,11,8,13,12,10,5,6,3,10,10,9,10,8,10,8,11,8,D/WB L,1,1,1,1,1,1,1,20,1,1,1,15,1,18,1
19054208,Amaral,1651,07/06/1985,31,0,0,0,0,178,0,2,2,3,3,2,3,3,3,2,4,1,4,7,6,4,10,1,6,5,8,7,10,1,12,9,5,10,9,6,8,7,12,2,8,7,8,11,9,9,11,10,9,9,7,12,6,20,14,9,8,7,8,7,8,16,9,9,8,10,10,11,6,D/WB R,1,1,1,1,1,1,1,1,20,1,1,1,1,1,16
19054257,Douglas,1651,17/07/1987,28,0,0,0,0,177,75,1,1,1,1,2,2,2,3,3,3,1,2,2,11,12,12,4,12,5,1,3,5,5,1,8,5,11,6,12,5,1,7,5,9,11,6,3,4,6,12,12,5,6,9,10,12,20,11,5,8,7,7,8,8,9,9,9,10,10,10,13,8,S ,1,1,20,1,1,1,1,1,1,1,1,1,1,1,1
19054339,Cassiano,1651,16/06/1989,27,0,0,0,0,184,82,3,3,3,2,2,1,1,3,3,3,1,8,11,12,12,13,9,13,11,8,9,11,13,8,12,12,12,13,12,11,12,11,9,11,7,12,8,13,12,10,12,15,13,11,11,10,20,13,15,10,7,9,6,7,19,8,10,9,9,7,10,12,S ,1,1,20,1,1,1,1,1,1,1,1,1,1,1,1
19054343,Jocenir,1651,14/02/1989,27,0,0,0,0,173,63,2,1,1,1,3,2,1,1,3,1,3,11,13,12,7,12,7,7,7,7,8,7,5,10,13,10,8,9,9,7,6,6,4,14,13,8,9,8,9,13,11,8,5,10,14,13,20,13,8,6,10,10,10,13,7,10,11,8,11,9,11,2,D/WB/AM R,1,1,1,8,1,16,1,1,19,1,1,1,10,1,20
19054347,Tiago Volpi,1651,19/12/1990,25,0,0,0,0,189,84,14,15,14,7,14,11,14,13,11,14,11,4,1,1,3,6,7,3,3,1,8,7,2,6,5,7,15,15,16,14,10,12,12,8,15,6,15,12,12,13,14,15,14,13,12,13,20,14,14,14,6,15,3,3,16,13,13,12,12,13,13,6,GK ,20,1,1,1,1,1,1,1,1,1,1,1,1,1,1
19054354,Dagoberto,1651,11/02/1990,26,0,0,0,0,175,73,2,2,2,2,1,1,4,1,2,2,4,7,6,7,7,13,5,8,7,3,8,12,3,13,9,8,6,9,9,7,5,9,9,3,8,7,9,9,9,15,14,9,8,10,10,14,20,14,9,9,3,8,9,9,14,12,13,11,8,10,8,6,D/WB R,1,1,1,1,1,1,1,1,20,1,1,1,1,1,19
19054411,Alexandre Carioca,1651,15/02/1982,34,0,0,0,0,180,75,1,1,4,2,2,3,4,2,4,2,3,6,9,6,10,13,9,11,11,1,11,12,5,16,8,9,15,9,10,9,6,14,9,6,10,9,13,10,13,11,10,9,10,1,10,9,20,9,12,9,9,9,6,9,18,14,11,13,11,5,3,1,D/DM C,1,1,1,1,1,1,16,1,1,20,10,1,1,1,1
19054414,Robinho,1651,08/09/1987,28,0,0,0,0,176,66,3,1,3,4,3,2,3,1,1,3,3,8,7,13,11,12,6,12,8,6,3,10,12,3,13,12,13,11,12,12,12,12,13,14,9,14,6,9,13,15,15,8,8,20,13,15,10,14,8,11,5,10,6,11,20,13,11,13,12,9,8,8,S ,1,1,20,1,1,1,1,1,1,1,1,1,1,1,1
19054417,Caio,1651,09/08/1990,25,0,0,0,0,175,65,2,2,2,1,3,1,3,2,2,1,1,6,11,14,11,14,8,3,9,7,6,14,9,5,14,5,10,12,11,11,11,12,13,13,7,13,5,11,12,15,15,10,7,5,11,14,20,14,7,10,10,11,12,14,15,13,10,11,8,5,7,14,AM/S R,1,1,20,1,1,17,1,1,1,1,1,1,1,1,1
19054418,Lucas,1651,30/01/1989,27,0,0,0,0,175,77,2,3,1,2,2,3,3,3,2,3,2,5,3,12,12,12,5,12,6,4,4,6,9,1,9,9,8,6,12,6,2,8,5,10,11,12,6,5,7,12,10,6,5,20,14,11,7,11,9,9,4,9,9,9,7,9,11,12,12,4,12,3,S ,1,1,20,1,1,1,1,1,1,1,1,1,1,1,1
19054425,Carlinhos,1651,01/04/1990,26,0,0,0,0,177,74,1,2,4,2,1,2,1,3,1,3,4,10,11,11,9,11,8,5,9,5,9,12,7,9,11,12,11,10,11,11,12,10,12,14,9,11,9,11,11,14,11,11,8,20,14,15,8,9,11,12,10,5,7,11,18,11,13,10,13,6,12,9,AM C,1,1,1,20,1,1,1,12,1,1,10,10,1,12,1
19054533,Leandro Silveira,1651,13/11/1986,29,0,0,0,0,185,87,13,11,12,1,11,9,11,13,5,7,10,6,2,3,2,3,8,1,2,3,3,3,3,1,7,9,9,12,6,13,7,9,7,2,12,2,9,8,7,13,6,8,13,10,11,10,20,7,15,9,5,1,5,9,13,11,13,12,11,9,8,8,GK ,20,1,1,1,1,1,1,1,1,1,1,1,1,1,1
19054535,Brinner,1651,16/07/1987,28,0,0,0,0,189,73,3,1,3,2,1,2,1,3,1,1,3,7,7,7,7,10,5,13,6,9,10,10,10,12,11,11,12,12,13,12,10,9,15,12,12,10,11,13,10,13,12,9,14,10,12,12,20,13,13,10,12,13,9,6,10,12,10,12,12,9,10,8,D C,1,1,1,1,1,1,20,1,1,1,1,1,1,1,1
19054553,Rubran,1651,06/07/1988,27,0,0,0,0,185,79,3,2,1,2,2,2,3,1,1,2,1,1,1,2,1,1,1,8,2,2,12,3,3,12,2,9,11,8,4,8,4,12,8,9,12,5,10,5,6,12,10,6,11,9,9,11,20,11,10,9,7,9,7,9,9,14,12,11,10,9,8,8,D C,1,1,1,1,1,1,20,1,1,1,1,1,1,1,1
19054610,Bruno Tiago,1651,28/03/1989,27,0,0,0,0,172,65,2,2,3,3,1,2,2,3,2,2,2,9,8,12,11,12,10,3,13,3,7,12,6,7,12,7,12,8,11,10,12,12,9,11,12,11,11,10,11,13,14,4,6,11,10,13,20,11,4,10,12,10,10,6,8,12,12,10,10,7,12,9,M/AM C,1,1,1,17,1,1,1,1,1,1,20,1,1,1,1
19054611,Cleitinho,1651,06/03/1990,26,0,0,0,0,169,69,3,3,1,3,3,2,2,1,3,2,1,6,10,11,11,13,8,6,11,4,9,13,4,9,12,11,11,9,10,8,12,12,8,10,11,14,9,14,13,11,13,7,6,10,12,13,20,13,6,13,11,10,8,13,9,10,14,8,12,9,9,6,AM C,1,1,1,20,1,1,1,1,1,1,1,1,1,1,1
19054613,Obina,1651,13/05/1990,26,0,0,0,0,174,73,2,2,2,2,3,3,2,3,1,1,3,6,6,10,11,10,9,8,8,6,6,9,9,6,11,6,11,11,12,11,10,12,14,11,8,11,6,11,13,11,12,12,13,8,11,15,20,13,13,11,7,10,5,10,18,15,9,11,13,6,17,2,S ,1,1,20,1,1,1,1,1,1,1,1,1,1,1,1
19054614,Rodrigo Lindoso,1651,06/06/1989,27,0,0,0,0,182,72,2,3,3,3,2,3,2,3,3,1,2,13,13,13,13,14,5,14,13,13,14,15,13,11,14,5,13,10,12,13,14,12,16,13,10,13,13,13,13,14,14,14,13,20,12,13,5,13,13,12,5,11,5,10,11,10,9,11,11,7,6,5,DM/M C,1,1,1,1,1,1,1,1,1,20,19,1,1,1,1
19054680,Jóbson,1651,15/02/1988,28,0,0,0,0,175,72,2,3,2,1,4,1,1,1,3,1,3,4,8,13,12,12,8,9,11,6,4,11,14,5,13,7,11,9,10,8,10,11,5,15,6,13,4,10,9,14,13,10,7,11,10,14,20,12,11,10,5,12,10,7,5,8,5,6,5,7,7,17,S ,1,1,20,1,1,1,1,1,1,1,1,1,1,1,1
19054726,Alex Junio,1651,08/02/1990,26,0,0,0,0,192,0,2,3,2,2,3,1,4,4,4,3,2,6,5,11,9,12,6,8,5,1,4,12,3,7,11,10,9,9,9,7,8,6,8,14,14,11,7,7,8,12,10,11,10,16,12,13,20,11,10,9,9,1,10,10,18,12,12,8,12,1,8,5,AM C,1,1,15,20,1,1,1,1,1,1,10,1,1,1,1
19054728,Gustavo,1651,01/01/1989,27,0,0,0,0,194,84,13,11,10,1,12,13,10,13,9,10,13,8,1,2,2,1,10,1,3,2,1,1,2,3,3,10,10,12,8,11,7,13,14,2,6,1,12,8,7,11,13,8,17,1,9,13,20,3,9,12,10,10,10,10,15,14,11,10,12,11,8,1,GK ,20,1,1,1,1,1,1,1,1,1,1,1,1,1,1
19054769,Bruno Renan,1651,19/04/1991,25,0,0,0,0,176,71,2,3,1,1,3,3,3,1,3,2,3,7,7,12,9,12,9,5,8,6,12,12,7,11,13,11,12,13,10,10,13,11,16,13,11,12,10,11,10,14,13,7,9,7,15,14,20,11,7,13,6,11,5,12,10,14,15,14,12,12,13,7,DM ,1,1,1,7,1,1,1,1,11,20,14,1,1,1,9
19054770,Lipe,1651,10/03/1990,26,0,0,0,0,180,76,3,1,1,2,1,2,2,2,1,3,3,4,5,14,7,8,6,7,6,3,3,7,6,6,13,8,7,9,6,6,12,13,13,12,6,14,4,8,10,12,12,4,7,20,15,13,15,11,3,7,10,8,6,10,8,13,8,12,9,8,16,5,AM/S C,1,1,20,19,1,1,1,1,1,1,10,1,1,1,1
19054771,Neuton,1651,14/03/1990,26,0,0,0,0,182,79,3,2,4,3,2,1,2,2,1,3,1,6,7,10,8,11,8,12,9,7,11,11,10,13,12,13,8,15,12,8,8,9,17,13,11,10,14,12,14,13,12,11,12,20,13,13,10,14,14,8,10,10,6,15,10,13,10,14,13,8,15,10,D LC,1,1,1,1,1,1,19,20,1,10,1,1,1,1,1
19054772,Jonas Pessalli,1651,24/09/1990,25,0,0,0,0,180,73,3,1,2,1,1,2,1,2,3,1,1,8,9,11,8,13,12,9,12,3,11,12,3,9,13,13,12,11,11,10,13,12,11,13,11,11,10,11,9,14,12,10,11,14,13,12,20,14,9,11,9,9,8,10,18,10,8,7,9,8,9,14,DM ,1,1,1,1,1,1,1,1,1,20,12,1,1,1,1
19054773,Saimon,1651,03/03/1991,25,0,0,0,0,183,74,2,1,1,1,2,1,2,2,4,1,2,7,9,8,7,11,7,13,8,10,12,10,9,12,11,13,11,15,12,11,8,10,12,8,12,11,11,11,11,12,11,12,12,9,13,12,20,10,13,13,14,11,10,14,19,11,12,12,11,11,8,13,D RC,1,1,1,1,1,1,20,5,16,1,1,1,1,1,1
19055091,Galhardo,1651,30/10/1991,24,0,0,3,0,176,70,3,1,2,1,3,2,2,3,1,2,2,14,13,13,11,13,15,9,13,11,9,13,12,9,13,12,12,12,13,13,13,12,13,13,7,14,10,14,13,14,12,9,8,7,12,13,20,12,10,12,8,13,12,12,3,13,12,13,13,12,12,8,D/WB/M/AM R,1,1,1,14,1,16,1,1,16,1,1,1,19,1,20
19055093,Christiano,1651,29/10/1991,24,0,0,0,0,186,78,2,1,3,2,3,1,2,3,3,1,3,8,11,12,9,9,11,10,11,9,10,10,10,11,10,13,11,12,10,11,10,10,10,10,11,11,10,12,12,13,11,11,12,20,15,13,12,12,11,10,4,12,4,13,12,13,9,7,11,3,12,2,D L,1,1,1,1,1,1,12,20,1,1,1,1,1,15,1
19055095,Maxwell,1651,23/10/1989,26,0,0,3,0,175,73,1,1,3,2,1,2,2,2,2,1,2,11,11,11,8,10,9,4,8,5,7,11,4,6,11,6,10,8,10,11,10,10,6,13,4,10,7,12,11,12,11,11,5,20,13,13,10,12,6,13,4,11,11,8,15,14,13,13,9,12,12,8,D/WB L,1,1,1,1,1,1,1,20,1,1,1,1,1,16,1
19055097,Luiz Antônio,1651,11/03/1991,25,0,0,0,0,179,73,1,3,3,1,3,1,1,1,3,2,1,6,12,12,13,13,13,8,14,11,13,14,12,12,14,11,12,12,11,10,12,12,12,6,9,13,12,15,13,13,13,12,11,8,13,12,20,14,11,12,12,13,11,8,14,12,5,13,10,10,9,5,DM/M RC,1,1,1,10,1,10,1,1,14,18,20,1,19,1,13
19055098,Aírton,1651,21/02/1990,26,0,0,0,0,180,77,2,3,3,2,2,4,1,2,3,1,3,1,2,5,1,14,1,15,1,10,16,15,10,14,14,14,16,16,15,14,14,13,12,12,13,10,15,16,15,14,15,15,15,10,13,14,20,13,17,16,16,14,10,11,5,13,9,14,13,12,6,9,DM ,1,1,1,1,1,1,10,1,1,20,12,1,1,1,1
19055099,Vítor Saba,1651,11/07/1990,25,0,0,0,0,184,73,1,3,2,2,1,1,2,1,3,2,1,13,13,13,13,12,12,8,11,7,8,13,10,7,13,9,11,6,10,10,11,10,8,14,8,11,8,11,7,12,11,10,11,20,8,10,10,9,8,9,12,10,10,13,13,10,7,8,7,12,8,12,AM C,1,1,14,20,14,10,1,1,1,1,14,10,7,1,1
19055102,Vinicius Paquetá,1651,31/01/1990,26,0,0,0,0,173,70,4,3,1,1,3,1,1,2,1,3,3,6,9,9,11,9,7,9,8,1,8,9,6,6,11,8,11,8,10,10,9,10,8,11,6,11,4,11,9,8,11,9,7,8,12,10,20,13,9,12,6,10,8,11,18,13,11,12,14,10,5,4,S ,1,1,20,1,1,1,1,1,1,1,1,1,1,1,1
19055104,Diego Maurício,1651,25/06/1991,25,0,0,3,1,183,80,3,3,3,2,3,2,3,1,2,2,2,6,8,14,11,11,7,6,13,5,8,10,13,2,12,8,12,10,11,9,8,10,8,12,6,12,7,8,10,13,13,12,11,13,12,13,20,14,14,10,3,11,10,8,8,12,11,9,9,9,12,11,S ,1,1,20,10,7,13,1,1,1,1,1,1,1,1,1
19055141,Paulinho,1651,10/05/1989,27,0,0,0,0,175,73,2,3,1,3,4,3,2,3,1,2,2,11,8,9,9,13,12,9,12,8,12,13,11,12,12,14,13,11,14,8,11,12,8,11,12,12,11,8,13,10,13,12,8,8,18,12,20,10,12,11,13,10,6,15,7,11,10,9,12,10,7,5,DM/M C,1,1,1,10,1,1,1,1,1,17,20,1,1,1,1
19055145,Anderson Manga,1651,13/03/1988,28,0,0,0,0,179,0,1,2,3,3,1,3,2,3,2,1,3,6,6,12,11,13,6,9,8,4,6,8,11,1,9,9,9,7,11,6,7,11,4,9,11,12,7,6,8,13,13,7,7,10,6,13,20,12,10,9,8,8,5,9,18,11,10,10,12,7,8,2,AM/S C,1,1,20,16,1,1,1,1,1,1,1,1,1,1,1
19055152,Wallacer,1651,03/06/1986,30,0,0,0,0,178,70,4,3,3,1,1,1,3,2,1,3,3,11,9,10,12,13,11,5,13,2,7,11,7,6,13,8,9,8,8,12,14,12,10,12,8,11,7,11,13,11,13,11,8,7,16,13,20,14,7,14,10,16,10,13,19,10,10,10,10,8,12,2,M/AM C,1,1,1,20,1,1,1,1,1,13,18,7,7,1,1
19055214,David,1651,25/08/1988,27,0,0,0,0,186,84,9,10,11,10,9,12,8,13,10,9,11,4,2,3,1,1,7,1,1,1,2,1,3,1,5,10,9,12,7,9,7,13,4,2,12,3,8,8,7,13,15,8,14,5,7,12,20,3,8,10,10,10,10,10,10,9,12,9,10,1,8,3,GK ,20,1,1,1,1,1,1,1,1,1,1,1,1,1,1
19055215,Jairo,1651,17/05/1989,27,0,0,0,0,179,0,3,1,3,4,2,3,1,3,1,2,3,13,11,13,10,11,13,9,12,12,9,11,12,9,11,11,9,11,9,9,9,11,12,11,5,10,9,10,10,13,12,9,7,7,13,14,20,12,7,12,6,10,6,12,10,13,15,10,15,15,15,10,D/WB R,1,1,1,1,1,10,1,1,18,1,1,1,14,1,20
19055216,Rodrigo Brasília,1651,09/08/1988,27,0,0,0,0,187,79,1,1,1,3,3,1,2,1,1,1,1,13,11,14,12,12,14,13,14,9,8,13,14,8,15,11,10,11,11,10,12,12,10,13,8,12,11,12,12,13,12,14,15,1,14,12,20,14,14,11,7,11,7,10,11,12,12,11,13,13,14,11,M/AM C,1,1,1,20,12,12,1,1,1,1,18,8,8,1,1
19055217,Serginho,1651,27/01/1988,28,0,0,0,0,186,75,1,3,4,2,1,2,1,1,3,1,1,2,7,6,3,6,2,11,3,6,14,12,2,14,9,12,14,14,11,12,11,13,12,12,11,11,14,13,14,15,13,14,14,5,14,14,20,14,15,10,11,11,5,7,8,10,13,11,13,10,13,12,DM ,1,1,1,1,1,1,1,1,1,20,13,1,1,1,1
19055218,Ronivaldo,1651,24/03/1989,27,0,0,0,0,171,73,2,1,2,2,1,2,2,3,3,3,1,3,8,11,10,11,9,11,6,2,1,10,13,1,12,11,12,12,10,10,8,10,2,13,8,11,11,9,10,13,13,9,7,9,12,13,20,11,9,13,9,10,16,10,10,8,12,9,10,5,5,4,AM/S RC,1,1,20,18,14,16,1,1,1,1,1,1,1,1,1
19055324,Roberto,1651,04/12/1990,25,0,0,0,0,176,76,4,3,2,3,1,1,1,1,3,3,3,12,12,12,12,11,11,11,10,11,7,12,12,7,13,14,10,12,11,9,11,10,13,17,2,13,9,10,10,14,13,9,8,20,15,13,7,10,12,12,11,13,7,17,10,13,12,13,12,10,15,8,D/WB/M/AM LC,1,1,13,17,17,1,1,20,1,1,14,18,1,19,1
19055331,Waldson,1651,12/05/1990,26,0,0,0,0,184,87,11,11,13,3,12,9,10,10,13,11,10,2,3,2,2,1,4,1,3,2,1,4,3,2,5,12,9,12,7,10,3,9,12,2,5,5,9,7,10,7,11,11,11,3,13,8,20,11,13,8,7,5,8,8,10,13,14,11,15,15,14,8,GK ,20,1,1,1,1,1,1,1,1,1,1,1,1,1,1
19055468,Júnior Timbó,1651,14/11/1990,25,0,0,0,0,181,71,3,3,1,2,3,2,2,1,2,2,3,7,9,15,11,14,11,12,12,6,6,14,4,6,15,7,9,9,13,9,13,8,5,15,5,13,9,15,11,14,15,11,11,8,12,14,20,10,11,10,9,10,5,10,13,12,8,11,9,12,11,6,M/AM C,1,1,1,20,10,10,1,1,1,1,18,5,5,1,1
19055479,Bismarck,1651,25/08/1990,25,0,0,0,0,177,73,1,2,1,2,3,3,3,1,1,3,3,11,11,12,10,12,12,5,12,5,3,13,12,4,12,10,8,9,10,8,12,11,11,7,10,13,6,10,10,13,12,11,8,7,13,14,20,11,7,10,5,12,9,11,11,12,17,11,10,14,15,9,AM RC,1,1,1,18,1,20,1,1,1,1,15,1,12,1,1
19055482,Marllon,1651,30/05/1991,25,0,0,0,0,169,70,1,3,1,1,3,2,1,1,1,2,1,11,11,12,9,10,11,7,11,1,2,12,10,2,12,11,7,10,10,8,11,10,12,15,4,12,6,7,10,12,14,7,4,8,12,13,20,10,7,12,5,11,5,7,10,11,16,12,16,7,12,8,M/AM RC,1,1,11,20,12,18,1,1,1,1,16,6,15,1,1
19055484,Régis,1651,20/11/1989,26,0,0,0,0,187,79,3,1,3,2,1,3,1,4,3,3,3,3,5,7,7,8,5,11,9,8,14,9,13,14,9,16,11,14,8,11,8,9,15,8,11,11,13,15,13,11,12,12,14,9,16,13,20,14,13,13,14,12,7,10,11,13,15,12,12,6,6,13,D/DM/M C,1,13,1,1,1,1,17,1,1,20,16,1,1,1,1
19055588,Acácio,1651,14/01/1992,24,0,0,0,0,174,0,2,3,2,2,2,1,4,3,2,2,1,5,2,7,5,8,5,3,7,2,6,13,5,7,13,8,4,5,7,3,6,12,8,13,10,8,7,7,11,13,13,6,6,9,13,13,20,7,3,8,8,8,5,8,13,9,9,13,9,5,10,4,AM C,1,1,1,20,1,1,1,1,1,1,15,1,1,1,1
19055590,Rafinha,1651,26/04/1990,26,0,0,0,0,178,75,3,3,4,3,3,2,1,3,2,1,3,7,8,5,8,10,9,9,15,1,12,15,8,12,11,9,13,9,10,11,11,10,2,11,9,10,11,11,12,13,12,12,8,11,13,13,20,13,12,10,8,4,7,10,14,14,10,11,12,13,10,8,DM C,1,1,1,1,1,1,1,1,1,20,15,1,1,1,1
19055591,Richard,1651,01/03/1991,25,0,0,0,0,183,73,7,11,12,12,12,9,12,15,3,7,10,6,1,3,3,7,9,2,1,2,2,9,11,2,7,11,11,15,11,12,10,12,11,3,11,1,7,11,11,9,14,11,9,10,12,8,20,12,12,9,11,10,10,10,16,9,12,7,12,9,12,5,GK ,20,1,1,1,1,1,1,1,1,1,1,1,1,1,1
19055775,Marcelo Júlio,1651,16/08/1989,26,0,0,0,0,176,0,2,3,2,1,3,2,4,2,2,3,1,6,5,12,10,12,4,13,7,1,4,6,3,2,8,9,7,6,11,6,6,13,1,9,12,13,7,6,7,12,13,7,8,3,16,13,20,8,9,7,9,4,8,9,9,10,11,14,9,3,13,4,S ,1,1,20,1,1,1,1,1,1,1,1,1,1,1,1
19055863,Felipe Manoel,1651,04/11/1989,26,0,0,0,0,183,83,3,3,4,1,1,3,2,4,2,2,1,4,7,4,8,14,7,7,9,4,9,10,6,11,13,9,9,8,8,9,10,14,14,6,4,8,11,8,13,11,11,13,14,10,13,13,20,8,12,9,8,6,9,9,20,16,9,10,13,5,14,5,DM C,1,2,1,3,1,1,7,1,1,20,15,5,5,1,1
19055968,Julinho,1651,21/07/1987,28,0,0,0,0,185,72,1,2,1,3,2,3,4,1,2,3,2,10,10,10,8,11,8,11,9,10,10,10,6,11,12,8,11,11,10,12,10,10,4,6,13,9,9,9,10,12,11,13,12,20,14,10,11,15,14,12,10,2,3,10,20,11,14,9,10,9,12,2,D/WB L,1,1,1,1,1,1,1,20,1,1,1,1,1,16,1
19056119,Fernando,1651,16/07/1986,29,0,0,0,0,183,70,1,3,2,1,4,2,4,3,2,3,1,6,8,11,12,15,9,10,7,1,3,11,16,3,11,10,11,10,11,10,15,10,15,13,14,11,3,10,11,13,8,10,14,20,7,15,11,12,9,12,3,1,10,9,9,13,8,10,13,6,9,8,M/AM C,1,1,15,20,1,1,1,1,1,1,18,1,1,1,1
19056135,Dudu,1651,30/06/1985,31,0,0,0,0,185,83,2,1,2,3,2,1,1,4,3,2,1,4,4,9,11,9,7,11,11,5,5,9,7,8,9,11,9,13,11,11,9,16,7,10,15,12,11,10,15,14,13,15,14,3,13,13,20,13,15,12,10,10,10,10,7,13,11,11,10,7,13,6,S ,1,1,20,1,1,1,1,1,1,1,1,1,1,1,1
19056162,Ícaro,1651,16/04/1989,27,0,0,0,0,182,74,3,2,2,2,2,2,2,3,2,2,4,6,8,7,6,7,4,16,6,9,13,5,6,13,5,16,14,14,13,13,6,12,12,5,11,8,13,12,13,10,11,12,15,6,12,11,20,13,14,13,8,15,7,8,15,12,10,14,12,14,10,10,D C,1,1,1,1,1,1,20,1,1,1,1,1,1,1,1
19056167,Kaká,1651,08/06/1981,35,0,0,0,0,187,0,3,1,1,2,1,2,3,2,3,2,3,7,9,15,7,8,5,10,1,10,11,10,4,10,8,4,8,9,7,10,9,10,9,11,12,9,10,11,10,14,13,14,14,20,16,13,4,10,10,9,7,5,4,9,7,13,11,12,10,10,12,3,D/WB L,1,1,1,1,1,1,1,20,1,1,1,1,1,18,1
19056171,Chefe,1651,25/06/1984,32,0,0,0,0,180,0,3,3,4,3,1,1,2,2,3,3,3,7,8,11,12,13,7,13,8,4,7,7,6,5,13,8,11,8,11,6,11,12,10,13,10,12,9,7,9,13,13,8,9,6,9,12,20,10,14,10,6,9,5,9,9,13,11,13,10,10,8,8,AM/S C,1,1,20,17,1,1,1,1,1,1,1,1,1,1,1
19056446,Braga,1651,28/09/1985,30,0,0,0,0,190,84,3,3,3,3,1,2,1,2,1,1,2,6,2,6,3,6,6,13,6,1,12,5,4,13,7,7,11,10,8,13,3,12,8,2,14,7,13,7,8,13,13,8,12,9,9,13,20,9,10,10,7,2,10,10,16,13,11,10,12,1,11,8,D C,1,1,1,1,1,1,20,1,1,1,1,1,1,1,1
19056450,Kiko,1651,26/08/1983,32,0,0,0,0,180,70,3,1,3,1,3,3,3,1,2,1,2,2,6,9,10,10,7,9,11,5,11,10,11,10,10,14,9,12,10,9,8,9,12,9,9,8,11,13,11,11,11,11,9,8,15,11,20,13,8,11,9,11,9,9,10,12,8,11,11,14,10,12,DM/M C,1,1,1,14,1,1,1,1,1,19,20,1,1,1,1
19056510,Diego Eli,1651,03/09/1986,29,0,0,0,0,180,76,1,3,1,1,3,2,1,2,2,3,1,9,7,8,8,9,9,11,12,3,9,10,4,11,9,14,12,10,10,11,12,10,12,2,5,9,12,10,11,9,9,12,13,10,9,7,20,13,10,13,15,6,9,9,9,11,9,13,13,6,5,1,DM ,1,1,1,1,1,1,1,1,1,20,10,1,1,1,1
19056515,Michel,1651,22/04/1982,34,0,0,0,0,185,0,3,2,2,3,3,1,1,3,2,3,2,8,5,14,14,10,8,14,9,5,8,9,9,8,13,6,13,9,11,7,5,11,7,12,14,14,8,8,9,8,12,5,11,11,10,8,20,9,11,10,6,6,5,10,11,13,11,10,9,1,2,6,S ,1,1,20,1,1,1,1,1,1,1,1,1,1,1,1
19056823,Henrique,1651,19/01/1987,29,0,0,0,0,187,81,3,2,2,2,3,3,4,1,1,3,2,6,7,11,12,9,11,13,8,6,6,9,12,6,11,8,11,9,11,12,10,10,13,14,8,10,11,11,11,9,10,13,14,11,13,10,20,11,12,10,7,9,9,7,10,8,8,10,9,10,12,8,S ,1,1,20,11,1,1,1,1,1,1,1,1,1,1,1
19056866,Danilo Martins,1651,02/12/1983,32,0,0,0,0,180,79,1,3,4,3,3,1,2,1,1,1,1,5,7,10,14,11,7,12,6,4,3,8,15,6,12,9,12,10,12,9,7,10,5,13,11,14,10,10,9,10,14,12,10,12,9,8,20,10,11,10,10,10,10,10,15,13,11,11,11,5,12,1,S ,1,1,20,1,1,1,1,1,1,1,1,1,1,1,1
19056919,Gilberto,1651,05/06/1989,27,0,0,0,0,178,70,2,1,1,2,2,1,3,3,1,3,1,7,9,14,13,14,10,13,13,8,9,11,13,8,14,11,12,11,12,13,13,12,11,15,5,13,8,12,13,14,14,11,10,12,14,14,20,13,9,12,7,11,6,12,8,14,7,12,10,6,12,8,S ,1,1,20,12,12,12,1,1,1,1,1,1,1,1,1
19057070,Gil Bahia,1651,07/02/1992,24,0,0,0,0,169,70,2,1,1,4,3,2,3,1,2,3,1,13,12,12,12,10,12,10,10,11,9,11,11,10,11,12,11,13,11,11,10,11,9,11,9,12,10,11,12,13,13,10,6,4,15,14,20,13,8,10,6,10,3,12,12,9,10,10,8,5,6,11,D/WB R,1,1,1,1,1,1,1,1,20,1,1,1,14,1,19
19057584,Jhonnattann,1651,27/07/1989,26,0,0,0,0,160,0,2,2,1,3,4,2,3,3,3,3,1,8,12,12,10,13,7,8,8,5,7,7,4,6,13,10,9,3,13,8,6,12,6,13,6,9,5,8,9,15,14,3,4,15,15,12,20,10,2,10,10,3,7,10,14,11,11,10,9,2,12,4,AM RLC,1,1,15,15,16,20,1,1,1,1,1,1,1,1,1
19057932,Igor Alves,1651,24/04/1988,28,0,0,0,0,177,67,1,2,3,2,2,2,3,2,4,1,2,8,7,10,8,9,14,7,9,4,2,10,7,3,11,9,12,9,10,11,9,11,9,8,6,11,4,10,11,12,14,9,11,20,6,13,10,12,11,9,7,9,15,9,14,12,9,9,12,9,18,8,M/AM/S C,1,1,16,20,1,1,1,1,1,1,18,1,1,1,1
19058369,Cássio Lopes,1651,27/09/1983,32,0,0,0,0,185,82,1,3,2,3,2,3,2,1,2,3,1,9,11,4,7,11,4,7,6,6,9,9,6,8,11,9,8,8,7,11,6,13,6,9,8,10,7,8,9,13,11,12,12,8,12,15,20,13,11,8,9,9,9,9,20,11,11,11,10,3,2,5,D/WB R,1,1,1,1,1,11,1,7,20,8,1,1,13,7,18
19058373,Juninho Silva,1651,21/06/1986,30,0,0,0,0,174,64,3,1,2,2,3,2,3,1,3,2,3,7,8,13,9,11,7,9,10,6,7,13,11,9,13,11,12,12,11,11,12,11,13,12,8,12,7,12,13,14,13,7,7,10,12,15,20,12,6,11,12,11,11,12,10,15,7,11,11,12,13,7,M/AM C,1,1,5,20,1,1,1,1,1,1,18,1,1,1,1
19058505,Eduardo Ramos,1651,25/03/1986,30,0,0,0,0,182,78,2,2,2,4,1,2,3,3,3,1,2,9,12,11,11,12,9,10,12,7,9,12,11,9,12,9,12,12,10,9,12,10,11,15,8,12,11,11,11,13,10,12,11,20,14,11,9,12,12,10,10,12,7,15,11,10,9,10,12,10,10,6,DM/M/AM C,1,8,5,20,6,7,10,1,1,16,19,11,13,1,1
19058515,Ramón,1651,22/10/1982,33,0,0,0,0,189,83,1,3,2,1,1,3,2,1,1,2,3,5,1,2,8,9,1,12,4,2,11,11,8,16,8,10,12,11,9,9,3,16,9,4,12,10,11,10,11,8,5,15,16,4,9,7,20,12,15,10,7,10,9,10,13,12,10,9,10,7,12,8,D C,1,1,1,1,1,1,20,1,1,1,1,1,1,1,1
19058671,Dudu,1651,07/01/1992,24,2,0,0,0,167,63,3,2,2,1,1,1,3,3,1,2,3,14,13,16,10,14,10,10,11,5,8,14,11,10,16,13,13,12,13,13,15,13,13,15,12,15,7,13,14,16,16,16,3,9,13,16,20,13,5,11,13,13,6,11,6,13,13,11,10,8,11,10,AM RLC,1,1,11,18,20,15,1,1,1,1,10,12,11,1,1
19058675,Bruno Costa,1651,15/01/1987,29,0,0,0,0,181,82,3,2,2,4,3,3,3,3,1,2,3,6,5,5,5,7,2,13,3,6,13,8,4,11,7,10,8,10,8,9,7,9,12,1,10,8,11,8,9,14,14,9,13,9,12,14,20,12,15,10,9,10,10,10,8,11,5,9,9,7,13,2,D C,1,1,1,1,1,1,20,1,1,1,1,1,1,1,1
19058734,Alisson,1651,02/10/1992,23,9,0,5,0,191,91,13,12,15,12,14,13,16,15,7,6,14,6,3,2,2,4,8,9,1,2,2,7,2,3,4,4,15,14,16,15,3,15,14,5,14,3,14,13,12,13,14,15,15,5,12,13,20,13,15,11,11,14,9,11,17,15,9,13,12,11,11,9,GK ,20,1,1,1,1,1,1,1,1,1,1,1,1,1,1
19058786,Nino Paraíba,1651,10/01/1986,30,0,0,0,0,168,63,3,2,1,2,1,3,3,1,3,2,1,12,13,13,10,13,11,5,10,12,11,12,10,12,13,14,13,13,12,12,12,12,15,14,6,12,12,12,14,15,15,13,4,5,16,16,20,14,7,12,12,13,11,12,11,11,9,15,13,9,15,9,D/WB R,1,1,1,1,1,8,1,12,20,1,1,1,13,10,19
19058790,Anselmo,1651,20/02/1989,27,0,0,5,0,185,82,1,2,2,2,2,1,2,3,1,1,3,5,10,12,10,12,8,9,10,7,13,11,10,14,12,14,13,13,12,12,11,12,15,14,9,13,11,13,13,14,12,13,12,20,16,13,10,14,15,14,14,14,8,13,11,14,13,13,14,8,11,8,DM/M C,1,1,1,14,1,7,1,1,12,20,19,9,13,1,11
19058850,Renan Mota,1651,01/10/1991,24,0,0,0,0,169,64,2,2,1,1,1,3,4,3,1,3,2,6,5,12,11,12,10,8,8,5,5,10,11,5,13,13,10,13,11,12,11,11,12,13,1,11,3,10,13,14,14,2,4,12,10,14,20,12,3,11,6,10,10,9,15,13,12,11,10,6,12,10,AM/S RLC,1,1,17,20,17,17,1,1,1,1,10,1,1,1,1
19058875,Crystian,1651,10/06/1992,24,0,0,0,0,171,64,3,1,3,1,1,2,2,1,1,2,1,9,10,12,9,12,8,5,11,9,10,11,10,8,11,11,10,11,11,11,11,10,12,12,7,12,10,10,13,15,14,14,5,13,13,14,20,12,6,11,5,12,8,13,16,8,14,12,10,6,10,10,D/WB R,1,1,1,1,1,5,1,14,20,1,1,1,10,13,18
19058879,Alfredo,1651,06/07/1992,23,0,0,0,0,176,73,2,2,2,1,3,1,1,3,3,1,2,11,9,17,12,12,11,13,8,7,7,9,14,7,12,9,11,10,12,11,12,9,10,12,2,12,9,13,12,14,12,13,8,11,13,13,20,14,10,9,10,10,10,10,17,8,14,9,14,8,2,1,S ,1,1,20,1,1,1,1,1,1,1,1,1,1,1,1
19058903,Ricardo,1651,08/08/1988,27,0,0,0,0,189,0,3,3,2,1,4,3,2,1,2,3,3,6,4,11,13,12,6,13,5,1,6,4,9,3,11,5,5,2,9,7,7,8,9,11,9,10,6,6,7,13,12,6,12,8,7,11,20,12,11,9,8,2,8,9,13,12,7,11,7,6,10,8,S ,1,1,20,1,1,1,1,1,1,1,1,1,1,1,1
19058912,Jeff Silva,1651,29/06/1986,30,0,0,0,0,178,69,4,2,2,2,1,1,3,3,3,2,1,10,9,9,8,8,5,5,8,10,9,9,10,8,11,13,10,13,10,10,8,10,12,10,11,10,10,10,10,12,10,8,7,20,12,12,7,11,7,13,14,10,8,13,11,12,9,11,12,9,10,11,D/WB L,1,1,1,12,13,1,1,20,1,1,6,15,1,18,1
19058959,Daniel Boi,1651,02/03/1989,27,0,0,0,0,175,0,2,1,3,1,2,2,2,3,1,1,1,6,7,13,13,13,6,13,7,1,6,7,7,5,9,9,7,6,7,7,6,11,1,9,10,10,7,6,7,13,13,7,7,16,7,13,20,9,7,9,9,9,9,9,20,11,11,13,12,2,12,4,S ,1,1,20,1,1,1,1,1,1,1,1,1,1,1,1
19058961,Pedro Costa,1651,24/10/1991,24,0,0,0,0,184,82,3,1,1,3,1,1,1,2,1,1,1,9,11,12,11,10,7,8,7,3,4,7,6,7,9,8,9,5,7,7,9,8,8,8,5,9,7,10,14,8,10,14,8,20,9,9,5,12,13,8,8,3,8,8,12,11,11,9,10,7,9,8,AM RL,1,1,10,1,20,17,1,1,1,1,1,13,10,1,1
19058985,Ricardinho,1651,10/06/1985,31,0,0,0,0,173,72,1,2,3,3,3,4,2,1,2,3,2,11,12,12,11,13,11,8,11,10,5,12,12,7,13,14,13,10,12,9,11,12,2,12,8,12,6,12,12,14,13,8,6,12,12,14,20,13,5,12,12,10,7,11,12,13,12,11,11,10,6,2,AM RC,1,1,1,20,12,15,1,1,1,1,15,9,11,1,1
19058990,Elízio,1651,22/02/1988,28,0,0,0,0,176,70,2,3,2,3,3,1,1,3,3,3,1,10,12,10,8,12,10,12,11,12,12,10,10,11,11,13,12,13,11,9,8,10,15,9,5,12,12,11,13,13,11,10,15,20,13,12,8,14,11,11,12,8,7,11,12,13,12,12,11,8,9,9,D L,1,1,1,1,8,1,1,20,1,1,1,10,1,15,1
19059012,Wellington,1651,01/04/1989,27,0,0,0,0,179,74,2,3,3,3,1,2,3,1,1,3,2,10,11,12,8,12,10,9,9,9,11,8,5,13,13,11,10,10,8,8,9,9,9,10,8,9,11,8,11,13,12,10,8,20,9,13,5,12,9,10,4,8,10,10,9,10,8,12,14,5,6,4,D/WB/M L,1,1,1,1,1,1,1,20,1,1,1,17,1,18,1
19059492,Totonho,1651,22/09/1983,32,0,0,0,0,175,71,2,2,2,2,2,3,1,2,1,1,1,7,6,5,5,15,4,10,2,7,11,10,4,12,11,10,11,11,10,13,8,15,1,1,13,9,11,10,10,9,8,10,8,10,12,9,20,13,8,10,8,10,10,10,16,14,11,10,12,2,14,5,D R,1,1,1,1,1,1,1,1,20,1,1,1,1,1,15
19059577,Ricardinho,1651,27/03/1989,27,0,0,0,0,174,66,3,1,3,1,2,1,1,3,1,3,1,11,10,11,10,11,11,7,10,7,10,12,11,10,12,10,10,10,11,10,11,10,11,10,7,12,11,12,12,13,13,14,7,9,12,13,20,13,6,11,9,11,3,15,8,13,11,9,12,12,13,12,D/WB/M RC,1,1,1,14,1,1,1,1,20,13,17,1,1,1,18
19059716,Jean Carlo,1651,03/08/1986,29,0,0,0,0,182,78,3,1,4,3,2,1,1,1,1,3,1,10,9,11,10,10,11,11,10,6,8,10,11,8,11,11,9,11,9,8,9,9,11,11,7,11,9,10,12,11,10,10,12,10,13,11,20,12,12,11,8,10,9,11,11,11,11,9,12,14,15,11,M/AM RC,1,1,10,20,9,16,1,1,5,10,18,6,15,1,7
19059722,Mateus,1651,02/05/1984,32,0,0,0,0,191,84,3,1,3,3,4,1,2,2,2,1,3,1,6,7,6,6,11,13,9,6,11,8,7,13,8,16,10,15,8,9,8,8,12,9,12,9,10,14,14,10,9,14,15,20,13,9,11,12,13,13,12,12,10,5,11,10,10,11,13,12,11,9,D C,1,1,1,1,1,1,20,10,1,1,1,1,1,1,1
19059889,Rafael Xavier,1651,02/06/1986,30,0,0,0,0,170,68,2,2,2,1,1,3,3,1,3,1,1,6,8,12,8,7,6,7,6,1,6,8,3,6,12,9,10,6,8,6,7,11,4,12,6,9,5,7,8,13,13,7,4,10,10,13,20,9,9,9,4,9,5,9,16,11,10,11,10,13,4,2,AM/S RLC,1,1,16,20,15,17,1,1,1,1,12,1,1,1,1
19060036,Thiago Carvalho,1651,24/06/1988,28,0,0,0,0,187,80,1,1,3,2,1,2,1,4,1,1,2,4,7,8,7,11,4,11,8,5,11,12,10,12,12,16,11,15,13,11,9,12,15,5,11,8,12,15,14,12,12,9,14,8,12,12,20,13,12,12,8,11,10,11,10,9,12,11,14,12,13,6,D C,1,1,1,1,1,1,20,1,1,11,1,1,1,1,1
19060670,Marinho,1651,29/05/1990,26,0,0,0,0,168,62,2,1,2,1,1,3,3,4,1,3,3,12,11,16,12,14,13,5,13,3,5,12,14,4,14,15,14,14,11,9,13,10,13,15,9,13,5,5,13,16,16,15,5,20,15,16,5,15,7,14,11,14,8,16,11,17,5,13,13,6,14,15,AM/S RL,1,1,18,13,17,20,1,1,1,1,12,13,15,1,1
19060672,Léo,1651,22/02/1989,27,0,0,0,0,176,0,2,2,3,1,1,2,1,2,3,1,3,5,6,4,8,12,7,5,11,2,8,12,5,13,13,8,8,3,9,8,13,13,5,9,3,11,10,8,12,13,13,8,5,7,11,13,20,13,9,10,3,7,10,10,17,12,12,11,12,12,19,8,M C,1,1,1,1,1,1,1,1,1,1,20,1,1,1,1
19060675,Souza,1651,11/02/1989,27,3,0,5,0,188,82,3,1,1,3,1,1,4,3,1,1,2,12,11,12,11,12,10,12,13,6,14,12,12,14,13,14,14,12,13,14,10,12,12,12,11,12,12,16,15,13,11,13,14,13,13,13,20,16,13,12,8,12,7,12,8,11,10,12,12,5,12,11,DM/M RC,1,1,1,10,1,1,1,1,1,20,18,10,15,1,1
19060752,Diego Teles,1651,01/06/1989,27,0,0,0,0,179,78,1,2,2,1,2,3,3,2,1,3,3,6,1,4,6,10,6,6,12,1,7,13,3,13,11,9,10,8,5,8,9,13,4,6,14,6,11,7,11,11,13,10,8,10,15,13,20,8,11,9,9,9,9,9,13,10,11,11,12,9,6,1,DM ,1,1,1,1,1,1,1,1,1,20,13,1,1,1,1
19060754,Marco Aurélio,1651,14/02/1988,28,0,0,0,0,174,75,3,1,2,2,3,1,1,3,1,1,1,8,7,9,10,14,8,8,14,5,7,11,6,10,13,8,10,6,12,9,14,13,5,12,9,10,10,9,13,14,14,9,8,8,10,14,20,8,6,10,6,10,5,10,15,12,11,11,10,1,9,5,M/AM C,1,1,1,20,1,1,1,1,1,1,18,1,1,1,1
19060777,Diego,1651,07/08/1989,26,0,0,0,0,187,0,3,2,3,3,3,2,3,3,2,1,2,4,4,2,5,11,6,6,13,1,9,11,3,13,13,9,9,8,6,8,9,13,9,3,13,6,7,7,12,13,12,7,12,9,12,13,20,13,8,9,6,9,9,9,7,12,12,11,10,10,5,6,DM ,1,1,1,1,1,1,1,1,1,20,10,1,1,1,1
19060946,Careca,1651,19/08/1989,26,0,0,0,0,177,76,3,1,3,1,3,3,2,2,2,2,4,8,10,15,10,12,9,13,10,1,8,9,7,4,14,10,11,6,12,10,9,15,10,12,6,14,10,9,10,12,11,14,9,1,12,12,20,12,14,10,10,10,10,10,15,10,10,9,12,6,4,1,S ,1,1,20,1,1,1,1,1,1,1,1,1,1,1,1
19061138,Thiaguinho,1651,22/11/1984,31,0,0,0,0,171,65,1,1,1,3,1,1,2,2,1,1,3,5,11,11,9,7,9,7,11,4,11,11,11,11,10,13,12,18,12,12,12,12,16,11,10,12,10,15,12,13,12,9,7,8,14,13,20,13,6,14,16,13,9,18,14,15,13,15,11,9,7,7,D/WB/DM/M RC,1,1,1,14,1,1,10,1,20,19,18,1,12,1,19
19061203,Paulo Ricardo,1651,21/10/1986,29,0,0,0,0,184,80,2,2,1,1,1,3,2,1,1,2,4,6,4,3,5,8,6,8,5,6,10,8,4,9,7,12,10,9,7,8,7,13,9,2,9,6,13,6,3,13,13,8,11,9,6,12,20,4,10,9,11,9,8,9,10,10,11,12,11,4,7,8,D/DM C,1,1,1,1,1,1,20,1,1,17,1,1,1,1,1
19061276,Valdanes,1651,29/08/1986,29,0,0,0,0,170,64,3,1,1,1,2,2,3,3,1,3,1,4,10,12,11,10,4,9,5,4,3,10,5,4,10,9,12,5,10,10,10,14,6,7,10,15,9,10,11,12,14,9,6,14,11,14,20,12,5,10,10,5,8,11,16,12,11,12,10,10,3,8,AM/S R,1,1,20,13,1,18,1,1,1,1,1,1,1,1,1
19061311,Thiago Silva,1651,02/10/1986,29,0,0,0,0,183,0,2,1,2,2,1,3,2,3,1,3,3,8,9,11,10,13,8,12,7,5,6,9,8,3,10,10,10,7,14,9,8,10,12,10,9,13,9,8,9,14,14,9,6,6,13,14,20,14,9,10,5,9,8,10,13,13,11,13,10,5,8,8,S ,1,1,20,1,1,1,1,1,1,1,1,1,1,1,1
19061313,Washington,1651,03/07/1985,30,0,0,0,0,175,70,1,2,3,2,3,2,4,1,2,1,1,7,8,8,9,15,7,4,6,8,8,11,8,7,11,8,9,3,15,9,15,14,3,10,1,9,11,10,12,15,15,10,5,3,8,15,20,14,7,10,9,10,5,10,17,10,14,13,11,4,13,7,AM C,1,1,5,20,1,1,1,1,1,1,15,1,1,1,1
19061363,Vando,1651,09/06/1986,30,0,0,0,0,180,70,2,1,4,1,3,3,2,1,1,3,1,11,10,10,6,8,11,11,7,11,9,9,9,10,9,12,8,13,7,7,9,7,11,10,7,11,7,11,10,12,13,10,10,20,12,12,7,14,9,10,9,10,11,12,8,14,10,8,14,10,8,9,D/WB/M L,1,1,1,1,10,1,1,18,1,1,1,17,1,20,1
19061438,Rayan,1651,21/12/1989,26,0,0,0,0,185,80,2,1,2,3,3,3,2,2,2,2,2,6,8,5,7,8,2,8,8,3,14,9,6,11,4,9,10,10,9,12,7,14,10,1,7,7,14,8,9,14,12,9,12,20,16,13,10,9,11,10,10,7,4,10,10,12,10,14,11,12,7,8,D C,1,1,1,1,1,1,20,1,1,1,1,1,1,1,1
19061448,Bruno Moraes,1651,12/01/1989,27,0,0,0,0,184,78,2,2,3,1,3,3,3,1,1,2,3,11,7,10,13,12,11,14,11,6,10,12,13,10,11,11,12,11,13,11,11,11,3,10,10,11,11,12,12,11,11,11,14,11,12,11,20,13,13,10,9,10,8,10,20,10,12,12,12,8,6,7,S ,1,1,20,1,1,1,1,1,1,1,1,1,1,1,1
19061449,Maikon Leite,1651,03/08/1988,27,0,0,0,0,168,62,2,1,2,3,3,3,2,2,4,2,3,12,12,13,11,13,11,7,10,3,4,12,13,5,14,12,12,11,12,11,12,11,12,13,6,13,6,11,12,16,16,6,4,9,14,17,20,13,7,11,10,12,13,11,7,13,9,14,13,7,13,12,S ,1,1,20,11,14,13,1,1,1,1,1,1,1,1,1
19061461,Renato Santos,1651,30/01/1987,29,0,0,0,0,187,90,1,2,2,4,1,2,2,1,1,1,2,5,9,9,8,11,6,13,9,6,12,10,7,12,10,14,11,14,11,11,7,11,13,11,8,10,12,13,12,11,11,14,14,20,12,11,7,14,15,12,12,12,6,12,17,12,11,11,9,7,9,7,D LC,1,1,1,1,1,1,20,15,1,1,1,1,1,12,1
19061471,Alan Mota,1651,12/09/1986,29,0,0,0,0,185,79,2,2,3,1,1,2,3,2,1,2,2,1,8,9,6,8,3,8,11,8,12,11,1,10,9,15,10,12,9,10,10,9,12,8,12,11,11,15,11,12,12,9,12,10,13,11,20,12,10,12,13,9,9,12,11,8,12,10,12,10,9,12,DM C,1,1,1,1,1,1,1,1,1,20,15,1,1,1,1
19061473,Alemão,1651,14/07/1986,29,0,0,0,0,190,84,1,1,2,1,1,2,1,2,2,2,2,6,8,7,9,10,7,15,8,5,13,10,9,13,10,16,12,16,10,9,5,12,13,14,14,12,13,14,15,11,9,16,16,7,14,10,20,15,16,12,14,12,5,4,11,12,11,10,13,8,6,11,D C,1,1,1,1,1,1,20,1,1,1,1,1,1,1,1
19061502,Rodrigo Pimpão,1651,23/10/1987,28,0,0,0,0,174,69,4,1,2,3,1,3,2,2,3,1,2,10,10,13,14,12,10,10,13,2,1,13,15,10,14,14,12,13,13,10,14,12,14,13,8,13,12,13,14,15,14,10,8,10,14,15,20,12,12,12,12,12,13,12,9,15,13,12,14,7,9,9,AM/S RL,1,1,20,1,17,17,1,1,1,1,1,1,1,1,1
19061518,Casemiro,1651,23/02/1992,24,11,0,15,3,184,83,1,3,3,2,4,1,3,3,3,3,1,10,11,12,9,14,10,13,12,10,13,14,11,15,13,18,14,16,15,16,12,15,13,12,10,12,16,17,19,12,12,15,13,13,15,14,20,19,17,16,9,11,5,12,13,12,10,14,12,10,13,14,DM/M C,1,1,1,1,1,1,1,1,1,20,19,1,1,1,1
19061519,Dener,1651,13/03/1992,24,0,0,0,0,185,76,4,2,3,2,2,4,2,2,3,2,3,10,10,12,11,12,11,8,12,7,7,13,9,8,14,9,11,9,13,11,12,12,7,12,9,12,9,10,8,14,13,12,11,9,11,12,20,12,10,10,9,8,7,10,9,8,12,12,12,10,15,10,M/AM C,1,1,1,20,1,1,1,1,1,1,19,1,1,1,1
19061520,Jeferson Paulista,1651,27/03/1992,24,0,0,0,0,173,0,1,1,2,2,1,2,3,1,1,3,1,1,4,12,10,12,14,1,13,14,4,13,9,10,13,5,9,4,9,9,13,9,9,13,6,12,11,11,9,13,13,10,8,20,12,12,9,11,10,11,10,11,8,11,16,11,12,9,8,5,10,10,M/AM LC,1,1,1,18,20,1,1,1,1,1,17,17,1,1,1
19061521,Paulinho,1651,23/04/1992,24,0,0,0,0,177,77,3,3,2,3,2,2,2,3,1,1,4,6,2,8,6,13,6,4,8,2,7,13,4,8,11,7,7,8,10,7,13,7,6,11,13,12,7,7,11,13,13,5,4,10,8,13,20,13,4,9,9,9,9,9,20,11,10,10,9,9,15,3,AM C,1,1,1,20,1,1,1,1,1,1,15,1,1,1,1
19061522,Zé Vítor,1651,23/09/1991,24,0,0,0,0,187,82,3,2,3,3,2,1,2,4,2,1,3,7,6,10,10,11,7,11,10,6,13,12,9,13,13,11,13,12,13,12,12,13,13,10,9,8,13,12,13,13,11,12,11,9,12,12,20,13,12,10,13,9,10,14,10,12,12,12,10,7,10,6,DM/M C,1,1,1,10,1,1,12,1,1,20,16,1,1,1,1
19061553,Douglas,1651,23/04/1990,26,0,0,0,0,179,0,2,2,4,1,1,3,1,1,2,1,1,6,6,2,4,6,6,6,10,4,9,13,2,13,10,9,12,8,6,8,12,10,4,9,13,6,11,7,11,13,13,7,4,9,9,11,20,8,11,9,9,8,3,9,18,10,11,12,9,6,8,8,DM ,1,1,1,1,1,1,1,1,1,20,10,1,1,1,1
19061583,Jean Carioca,1651,01/06/1988,28,0,0,0,0,176,71,2,2,1,3,1,2,3,1,1,2,1,5,13,14,11,13,9,13,11,3,5,13,11,7,14,12,10,11,12,9,13,11,12,15,5,15,9,10,12,14,14,10,9,8,13,14,20,10,8,13,12,9,11,14,6,14,11,11,13,14,14,10,AM/S C,1,1,17,20,12,14,1,1,1,1,14,5,7,1,1
19061600,Vaninho,1651,10/04/1984,32,0,0,0,0,171,0,1,2,1,1,1,1,1,3,1,3,2,5,11,12,7,11,9,5,9,6,5,12,12,5,12,8,7,11,8,7,10,8,11,13,5,11,6,10,11,12,15,7,4,20,13,14,8,10,4,12,9,10,8,14,15,12,11,10,6,10,16,15,M/AM LC,1,1,1,16,20,5,1,1,1,1,14,18,6,10,8
19061779,William Matheus,1651,02/04/1990,26,0,0,0,0,187,78,2,1,2,3,2,1,1,1,3,3,1,10,12,14,9,11,11,13,8,14,13,11,9,12,14,13,13,13,13,12,12,11,15,12,8,13,13,13,14,15,12,8,14,20,12,14,6,14,12,12,13,11,12,15,8,15,9,15,14,12,15,10,D/WB L,1,1,1,1,1,1,10,20,1,10,1,1,1,16,1
19061803,Thales Magalhães,1651,06/07/1989,26,0,0,0,0,180,71,2,3,1,2,3,1,1,3,2,2,3,7,7,11,9,10,7,9,6,6,7,12,12,5,11,7,13,14,7,8,8,6,4,9,14,15,8,12,10,12,10,11,13,10,9,14,20,9,9,6,9,6,9,8,15,12,12,10,9,11,10,6,S ,1,1,20,1,1,1,1,1,1,1,1,1,1,1,1
19061842,Guilherme,1651,30/04/1990,26,0,0,0,0,194,0,2,3,1,3,2,1,2,1,1,3,2,4,2,6,4,7,2,12,5,6,11,7,6,10,2,9,10,9,7,10,2,8,9,3,6,3,14,7,8,14,14,13,16,13,15,14,20,11,13,9,9,9,6,9,16,12,11,13,11,8,12,4,D C,1,1,1,1,1,1,20,1,1,1,1,1,1,1,1
19062098,Elvis,1651,09/09/1990,25,0,0,0,0,175,73,2,1,1,1,2,1,2,3,1,3,3,12,12,13,12,13,11,12,12,10,6,13,10,6,13,12,13,9,10,12,14,13,10,13,12,13,10,13,13,14,14,14,6,7,12,14,20,13,8,10,7,11,10,9,11,9,10,8,7,8,10,13,M/AM C,1,1,1,20,1,1,1,1,1,1,16,1,1,1,1
19062121,Branquinho,1651,02/01/1983,33,0,0,0,0,172,71,1,3,3,2,2,1,3,1,1,2,3,12,13,13,13,12,11,10,13,6,7,14,12,8,13,11,13,12,14,10,12,12,14,13,7,14,8,11,11,13,13,8,6,11,14,13,20,13,8,12,8,11,7,13,15,13,14,12,14,12,12,9,M/AM/S LC,1,1,17,20,15,13,1,1,1,1,18,5,7,1,1
19062131,Tatu,1651,05/12/1984,31,0,0,0,0,178,71,1,1,3,1,1,2,3,3,3,3,1,1,7,10,13,10,2,12,12,7,4,9,14,5,11,15,11,14,11,10,8,11,5,15,4,13,4,9,11,12,11,13,8,7,15,13,20,12,12,14,8,15,7,7,10,10,10,12,10,6,15,4,S ,1,1,20,10,5,5,1,1,1,1,1,1,1,1,1
19062178,Alex Perreira,1651,15/05/1982,34,0,0,0,0,181,77,3,1,1,4,1,3,1,3,1,1,2,12,12,11,5,12,12,10,9,8,10,10,5,10,12,9,11,9,9,11,12,11,7,13,6,14,11,10,11,11,11,11,10,20,14,12,3,13,11,10,8,10,13,3,12,7,7,9,8,11,10,5,D/M L,1,1,1,1,13,1,1,20,1,1,1,18,1,15,1
19062236,Willian Rocha,1651,01/04/1989,27,0,0,0,0,186,73,3,4,3,1,2,3,2,2,1,3,3,7,8,9,8,9,8,12,7,8,13,10,10,12,9,15,11,18,12,12,8,11,13,5,13,9,13,17,12,11,10,10,12,20,5,10,10,13,12,12,15,12,18,12,10,10,12,10,9,11,7,13,D/DM C,1,1,1,1,1,1,20,10,1,18,15,1,1,1,1
19062238,Marquinhos,1651,15/06/1989,27,0,0,0,0,169,67,3,3,3,3,2,3,2,1,2,2,3,11,10,13,11,14,8,5,8,10,8,12,8,6,14,7,12,10,8,8,8,9,8,14,9,14,10,7,12,14,14,7,3,20,8,14,10,12,5,10,7,8,7,13,9,10,12,6,7,5,16,5,AM C,1,1,1,20,13,13,1,1,1,1,13,1,1,1,1
19062351,Fransérgio,1651,18/10/1990,25,0,0,0,0,187,84,3,1,1,1,3,1,3,2,2,3,2,6,7,10,10,12,10,15,13,6,12,14,13,13,12,12,15,13,13,13,13,12,14,13,7,13,14,13,14,12,12,15,15,12,12,13,20,15,14,13,13,10,8,16,12,13,10,12,14,9,7,6,DM/M C,1,1,1,13,1,1,10,1,1,20,19,7,7,1,1
19062506,Moacir,1651,14/02/1986,30,0,0,0,0,181,72,3,1,3,2,2,2,1,1,1,2,1,12,10,12,8,11,11,11,10,12,12,12,10,13,11,13,12,14,10,10,8,10,14,10,8,13,13,16,14,13,14,10,11,7,14,14,20,14,11,10,13,10,7,15,11,12,13,12,13,13,11,10,D/WB/DM RC,1,1,1,1,1,5,8,7,20,19,15,1,12,9,19
19062509,Célio Gabriel,1651,08/02/1986,30,0,0,0,0,183,0,11,11,7,9,12,11,7,13,7,9,11,3,2,3,2,1,8,1,1,2,3,1,3,1,1,9,10,11,7,6,6,13,3,1,10,3,11,7,6,10,13,7,9,9,13,9,20,2,9,9,9,4,9,9,7,9,11,14,13,10,7,7,GK ,20,1,1,1,1,1,1,1,1,1,1,1,1,1,1
19062770,Patrick,1651,26/10/1987,28,0,0,0,0,188,82,3,2,2,2,1,1,3,3,2,1,3,3,8,12,10,10,4,12,14,7,6,9,8,6,9,15,9,14,9,12,10,9,14,6,7,12,6,7,14,16,12,17,16,10,11,15,20,14,16,8,7,13,8,8,7,12,12,14,15,16,7,5,S ,1,1,20,1,1,1,1,1,1,1,1,1,1,1,1
19064216,Franklin,1651,12/06/1989,27,0,0,0,0,181,70,2,1,2,3,3,1,1,3,1,1,2,4,7,10,10,8,7,9,7,5,2,9,11,3,11,14,10,9,10,10,9,11,13,12,9,10,2,10,12,16,12,9,11,20,12,12,9,13,10,11,8,11,10,13,11,10,11,10,11,12,11,13,AM/S RL,1,1,20,12,18,15,1,1,1,1,1,1,1,1,1
19064236,Esquerdinha,1651,10/10/1989,26,0,0,0,0,175,65,2,3,1,1,3,3,2,1,4,1,1,11,11,13,10,12,12,6,8,10,9,12,11,8,12,8,10,8,9,8,10,9,11,15,4,12,10,12,9,15,15,13,7,20,13,15,8,10,5,10,7,10,10,12,19,9,11,11,13,1,12,4,M/AM L,1,1,15,12,20,1,1,12,1,3,9,18,1,14,1
19064241,Thiago Cunha,1651,25/04/1985,31,0,0,0,0,177,69,1,1,3,2,3,2,1,2,3,2,3,11,6,13,13,12,11,11,12,5,3,10,12,4,11,11,13,11,11,11,9,12,11,11,10,14,5,11,12,14,14,11,9,20,13,14,8,13,11,12,8,12,8,11,20,10,12,11,10,2,16,5,S ,1,1,20,10,14,11,1,1,1,1,1,1,1,1,1
19064264,Vaná,1651,25/04/1991,25,0,0,0,0,194,80,12,11,12,14,11,12,11,13,11,14,12,8,1,2,2,8,11,7,3,2,2,9,3,3,10,11,12,13,12,12,8,12,10,9,7,8,10,11,12,11,14,12,14,10,15,12,20,12,12,12,7,12,7,11,20,12,11,13,10,6,1,4,GK ,20,1,1,1,1,1,1,1,1,1,1,1,1,1,1
19064302,Clayton He-Man,1651,05/03/1985,31,0,0,0,0,172,0,1,1,2,4,1,4,3,1,2,2,3,3,6,8,5,9,5,11,9,8,13,10,4,13,9,16,11,16,9,7,9,9,15,9,11,9,12,13,13,12,11,10,7,20,14,13,10,13,9,11,9,9,8,9,20,10,9,11,12,7,6,5,D/DM C,1,1,1,1,1,1,19,1,1,20,15,1,1,1,1
19064405,Dráusio,1651,21/08/1991,24,0,0,0,0,188,86,1,2,3,1,3,3,1,2,2,2,1,10,11,10,10,11,10,14,10,10,12,11,10,12,12,11,12,12,12,12,11,11,12,10,13,11,12,11,12,11,11,11,14,12,11,11,20,13,11,10,10,10,10,13,14,12,12,11,10,9,9,11,D/DM C,1,1,1,1,1,1,20,1,1,18,10,1,1,1,1
19064415,Mayko,1651,03/02/1991,25,0,0,0,0,187,0,3,1,2,3,2,3,2,3,3,3,1,5,5,7,6,7,5,14,8,5,13,8,6,13,7,14,9,13,7,11,5,9,15,6,15,6,13,12,12,10,10,15,13,10,16,9,20,13,13,13,10,12,8,12,8,11,12,12,14,8,12,11,D C,1,11,1,1,1,1,20,1,1,1,1,1,1,1,1
19064461,Norton,1651,08/07/1989,26,0,0,0,0,177,0,2,2,3,3,2,1,3,3,3,2,2,5,8,10,5,14,8,8,13,6,9,11,3,10,12,9,11,9,12,9,12,12,9,9,3,12,10,9,13,14,14,9,5,10,13,14,20,13,6,10,5,9,10,10,11,9,12,13,10,1,13,5,M/AM C,1,1,1,20,1,1,1,1,1,1,18,1,1,1,1
19064806,Lúcio Curió,1651,02/07/1984,31,0,0,0,0,184,80,1,3,2,3,3,3,3,3,1,1,3,2,8,9,11,10,9,10,11,4,5,8,13,4,11,12,10,12,11,11,8,10,14,13,5,11,5,10,10,11,12,11,10,20,14,12,8,11,11,13,13,12,16,6,15,14,9,13,13,12,11,13,S ,1,1,20,12,5,5,1,1,1,1,1,1,1,1,1
19064847,David Modesto,1651,01/03/1991,25,0,0,0,0,169,68,2,3,2,1,3,1,1,1,1,3,3,8,8,14,10,12,4,4,6,10,6,11,6,4,12,7,12,7,9,9,7,11,3,14,7,12,7,12,9,14,16,8,4,13,6,13,20,12,7,10,7,10,8,12,20,13,11,14,11,6,17,2,D/WB R,1,1,1,7,7,13,1,1,20,1,1,1,13,1,17
19064852,João Gabriel,1651,07/02/1991,25,0,0,0,0,184,0,3,2,3,2,1,1,1,2,4,2,1,5,6,6,4,9,1,6,5,5,9,9,3,14,9,8,7,9,9,11,9,14,9,1,7,5,7,9,9,14,11,9,7,20,13,14,10,14,8,9,9,9,9,9,13,10,9,13,14,8,8,4,D/WB L,1,1,1,1,1,1,1,20,1,1,1,1,1,19,1
19064853,Taubaté,1651,15/09/1991,24,0,0,0,0,181,72,1,4,3,3,3,3,1,1,3,1,3,9,12,13,13,13,7,6,7,3,4,7,7,5,10,9,6,4,8,7,8,10,2,10,9,9,5,7,8,13,13,6,9,9,13,13,20,12,6,9,9,6,5,9,14,11,10,10,12,8,9,4,AM R,1,1,15,1,1,20,1,1,1,1,1,1,1,1,1
19064867,Rafael Costa,1651,19/01/1991,25,0,0,0,0,183,79,1,1,2,3,1,1,1,1,2,4,3,12,12,12,11,14,14,9,13,8,8,12,13,7,14,10,12,10,11,11,11,10,4,14,9,12,12,12,12,12,11,12,11,20,11,12,8,11,12,11,8,11,8,13,13,8,11,9,12,8,17,2,M/AM LC,1,1,1,20,12,1,1,5,1,1,17,19,1,7,1
19064902,Jhulliam,1651,04/04/1988,28,0,0,0,0,182,69,3,1,2,3,3,1,2,1,2,2,1,5,7,9,14,10,10,12,10,2,3,9,12,3,11,10,10,10,12,12,8,9,1,11,4,11,8,10,10,13,9,11,14,10,12,11,20,12,12,12,7,12,10,10,12,9,9,13,11,11,13,4,S ,1,1,20,1,1,1,1,1,1,1,1,1,1,1,1
19065025,Marcelo Xavier,1651,19/02/1988,28,0,0,0,0,193,78,3,1,2,2,2,3,3,3,1,2,1,4,4,7,7,8,4,14,4,9,12,9,7,14,7,14,10,12,9,11,10,8,10,8,7,8,12,11,11,10,8,15,16,20,14,9,6,12,14,10,8,9,11,9,8,11,13,13,10,1,9,5,D C,1,1,1,1,1,1,20,11,1,1,1,1,1,1,1
19065028,Rafael Serrano,1651,02/09/1989,26,0,0,0,0,169,70,1,3,1,3,3,3,3,3,2,1,1,9,9,11,9,10,11,8,6,12,8,10,6,6,11,9,10,12,9,9,8,9,9,11,6,11,11,13,10,12,13,14,5,20,10,13,8,11,7,10,6,8,4,13,10,13,12,10,11,3,18,8,D/WB/M/AM L,1,1,1,1,17,1,1,20,1,1,1,17,1,16,1
19065319,Nirley,1651,09/04/1988,28,0,0,0,0,185,84,2,3,3,1,2,2,1,2,1,3,2,7,10,9,11,11,6,14,10,10,13,11,10,12,8,12,12,14,10,11,10,12,4,7,11,8,12,13,13,11,10,10,13,9,10,10,20,13,12,10,15,9,13,10,12,9,10,10,9,7,1,1,D C,1,1,1,1,1,1,20,1,1,1,1,1,1,1,1
19066324,Soares,1651,30/12/1988,27,0,0,0,0,183,76,1,3,1,1,2,1,3,3,1,3,3,11,10,10,8,11,8,9,10,8,11,14,8,13,13,15,13,14,13,12,10,12,13,6,10,12,14,14,14,12,11,13,12,6,12,11,20,15,12,13,13,8,8,10,9,12,9,10,11,10,10,10,DM/M C,1,1,1,1,1,1,9,1,1,20,17,1,1,1,1
19066453,Danilo,1651,11/11/1986,29,0,0,0,0,187,85,3,1,1,1,3,1,2,3,3,3,1,6,8,13,10,13,5,13,13,8,6,10,11,12,13,8,12,13,11,12,13,11,10,11,4,13,7,10,14,11,10,14,13,13,13,14,20,13,13,8,6,9,5,11,10,9,13,10,14,1,6,4,AM/S R,1,1,20,1,13,17,1,1,1,1,1,1,1,1,1
19066569,Daniel Lemos,1651,05/01/1990,26,0,0,0,0,178,70,2,1,2,2,2,4,1,3,1,1,2,5,7,13,8,10,7,11,9,4,3,8,11,5,12,11,12,11,10,10,10,11,9,12,6,11,5,11,11,12,13,8,9,15,11,14,20,11,6,11,9,5,8,12,14,10,10,9,11,13,6,5,M/AM C,1,1,15,20,1,1,1,1,1,1,18,1,1,1,1
19066607,Robemar,1651,05/05/1984,32,0,0,0,0,170,0,2,4,1,3,1,2,1,4,2,4,1,9,6,11,10,9,9,5,9,5,5,6,15,5,11,11,11,10,10,10,10,9,2,12,10,11,5,12,12,12,14,13,5,7,15,12,20,13,9,14,5,9,9,12,11,11,13,11,12,8,10,1,S ,1,1,20,1,1,1,1,1,1,1,1,1,1,1,1
19066657,Marquinho,1651,27/02/1983,33,0,0,0,0,181,0,3,1,2,2,1,3,1,2,3,3,2,6,4,1,1,6,6,13,7,5,8,8,1,13,1,9,9,9,8,12,6,10,3,1,6,7,14,7,8,12,12,8,11,8,9,9,20,11,12,9,9,9,9,9,11,11,9,11,12,2,13,4,D C,1,1,1,1,1,1,20,1,1,1,1,1,1,1,1
19066696,Heitor,1651,20/12/1987,28,0,0,0,0,178,0,2,2,3,1,1,3,3,3,1,2,1,2,1,12,12,12,1,12,4,4,4,5,2,1,9,8,9,2,9,5,1,11,1,10,8,12,5,4,6,12,12,5,3,9,11,12,20,11,6,8,3,8,8,8,10,10,9,10,13,12,8,6,S ,1,1,20,1,1,1,1,1,1,1,1,1,1,1,1
19066701,Juninho,1651,11/01/1990,26,0,0,0,0,171,69,1,3,3,1,1,2,1,2,3,2,3,12,12,13,10,13,10,8,9,10,8,12,8,8,12,11,13,13,13,12,13,12,11,12,10,13,12,13,14,14,14,11,5,20,14,15,7,15,10,11,9,10,6,14,7,12,13,9,7,6,11,6,D/WB L,1,1,1,8,10,1,1,20,1,10,9,13,1,18,1
19066752,Aleilson,1651,12/03/1985,31,0,0,0,0,173,64,4,1,2,2,4,1,3,1,2,1,1,6,8,11,9,10,8,6,7,4,4,10,11,2,11,11,9,11,9,10,9,10,11,12,9,11,3,10,10,13,14,12,6,9,14,14,20,12,4,12,5,14,8,11,4,16,13,11,13,9,14,9,S ,1,1,20,10,13,12,1,1,1,1,1,1,1,1,1
19066927,Weliton,1651,07/07/1985,30,0,0,0,0,185,0,3,2,2,1,1,3,2,3,1,3,3,4,3,12,12,12,4,12,1,1,3,3,1,3,12,8,9,2,2,3,5,10,1,13,10,8,2,4,6,12,12,5,11,8,11,12,20,11,6,8,8,4,8,8,8,14,9,12,12,5,16,1,S ,1,1,20,1,1,1,1,1,1,1,1,1,1,1,1
19067067,Paulo Roberto,1651,13/01/1987,29,0,0,0,0,169,0,1,3,3,2,3,2,2,2,2,2,3,5,5,7,1,10,1,5,4,5,9,9,1,9,9,8,8,6,7,7,7,9,7,3,3,6,8,8,9,15,14,8,3,20,10,14,9,13,8,8,8,3,8,8,8,11,10,13,13,1,10,2,D L,1,1,1,1,1,1,1,20,1,1,1,1,1,15,1
19067093,Alex Sandro,1651,26/01/1991,25,6,0,0,0,180,78,3,4,1,3,1,2,2,2,2,2,2,12,16,15,12,16,10,7,11,11,11,14,9,13,17,11,13,13,18,13,11,15,13,15,9,17,12,15,16,16,15,14,12,20,16,16,9,15,12,12,11,12,8,12,12,12,14,12,15,15,17,6,D/WB/M L,1,1,1,1,11,1,1,20,1,1,10,17,1,20,1
19067151,Uilton,1651,10/11/1982,33,0,0,0,0,195,0,14,10,10,3,14,8,8,11,4,9,9,4,2,1,1,2,7,1,3,2,1,3,3,3,6,8,10,9,8,9,7,14,9,2,8,3,9,8,7,10,11,8,15,6,12,8,20,3,10,5,9,5,9,8,15,11,11,13,13,2,17,5,GK ,20,1,1,1,1,1,1,1,1,1,1,1,1,1,1
19067169,Vanilson,1651,26/08/1990,25,0,0,0,0,190,80,3,3,3,1,1,1,3,1,1,2,1,6,3,13,13,11,4,12,7,1,6,5,9,2,13,9,9,4,9,6,6,12,9,13,13,10,5,6,6,13,10,5,14,10,15,13,20,11,11,8,9,9,9,8,10,8,11,13,9,4,13,2,S ,1,1,20,1,1,1,1,1,1,1,1,1,1,1,1
19067196,Enercino,1651,16/03/1987,29,0,0,0,0,173,79,1,2,2,2,1,1,1,2,3,2,2,8,9,14,8,14,5,7,9,4,7,9,2,10,13,7,10,4,10,6,11,13,8,13,6,10,7,8,10,14,14,9,7,20,12,13,10,11,7,10,5,10,10,10,11,14,13,9,13,3,12,1,M/AM LC,1,1,1,20,19,1,1,12,1,1,1,18,1,13,1
19067221,Silas,1651,14/07/1987,28,0,0,0,0,190,86,1,1,1,2,2,3,3,2,2,1,1,9,9,12,12,11,10,13,10,7,7,10,12,7,11,7,12,11,10,11,9,10,12,11,7,12,8,11,11,10,11,12,15,7,12,10,20,11,12,10,6,7,7,7,12,11,9,11,12,12,12,7,S ,1,1,20,1,1,1,1,1,1,1,1,1,1,1,1
19067368,Kléber,1651,23/10/1982,33,0,0,0,0,184,74,3,4,2,4,1,1,1,1,1,2,3,10,10,11,11,12,11,11,11,5,5,12,13,6,12,11,12,12,13,11,11,11,5,13,11,12,9,13,11,10,12,8,12,7,12,10,20,11,9,12,11,12,6,7,20,12,12,12,11,1,6,2,AM C,1,1,1,20,1,1,1,1,1,1,15,1,1,1,1
19067387,Artur,1651,22/10/1984,31,0,0,0,0,183,78,2,3,2,4,1,3,3,3,1,1,1,8,12,11,10,10,10,14,7,5,13,10,11,13,11,13,12,14,12,12,11,11,12,11,7,12,12,14,13,13,11,12,12,11,14,13,20,13,13,11,12,11,9,14,16,12,12,8,11,7,12,9,D R,1,12,1,1,1,1,13,1,20,1,1,1,1,1,1
19067396,Buiú,1651,14/01/1986,30,0,0,0,0,166,64,3,1,1,2,3,1,1,3,1,2,3,9,11,11,8,10,7,7,9,12,11,9,7,11,9,7,12,10,12,11,9,12,4,3,5,10,9,10,12,13,13,8,6,20,11,13,7,12,10,12,5,10,10,10,11,9,9,13,11,5,6,5,D/WB L,1,1,1,1,5,1,1,19,1,1,1,11,1,20,1
19067547,Jackson,1651,11/05/1990,26,0,0,0,0,182,85,2,1,4,1,1,1,2,1,1,2,2,10,10,10,11,10,9,10,9,9,10,10,8,11,11,12,11,12,11,10,10,10,12,12,12,12,11,12,12,13,9,11,10,10,13,12,20,10,10,10,12,9,7,12,20,9,9,10,10,6,11,10,D/WB R,1,1,1,1,1,1,10,1,20,10,7,1,1,1,18
19068132,Romario,1651,16/01/1989,27,0,0,0,0,181,79,2,2,3,2,1,1,3,2,2,3,2,9,10,9,8,10,9,14,10,9,15,9,14,15,9,18,13,16,12,11,11,10,11,9,10,9,13,13,12,11,10,11,13,10,14,11,20,12,14,12,10,13,10,11,14,9,10,9,11,8,8,12,DM/M C,1,1,1,1,1,1,13,1,1,20,17,1,1,1,1
19068148,Gilkley,1651,30/05/1985,31,0,0,0,0,168,64,3,1,3,1,3,3,1,2,2,2,1,6,6,6,8,13,7,7,15,2,11,9,5,14,9,8,13,8,8,9,9,10,8,4,6,7,10,8,12,8,9,8,5,5,14,6,20,8,11,4,3,8,8,8,12,9,12,11,9,6,16,4,DM ,1,1,1,1,1,1,1,1,1,20,11,1,1,1,1
19068155,Fred,1651,13/03/1988,28,0,0,0,0,170,68,1,1,1,2,1,4,3,2,2,3,4,6,2,6,6,11,6,3,6,6,13,12,1,11,10,9,9,5,9,7,12,12,5,9,14,7,8,7,11,13,13,7,3,20,10,13,9,13,4,9,9,9,6,9,13,12,14,12,12,8,4,1,M C,1,1,1,1,1,1,1,1,1,1,20,1,1,1,1
19068174,Vitor Caicó,1651,27/08/1982,33,0,0,0,0,178,75,1,2,1,1,2,4,1,3,2,1,3,9,5,5,10,15,9,9,10,4,11,11,4,15,11,10,15,10,9,10,13,10,7,6,14,10,11,10,13,8,9,10,5,10,11,12,20,8,10,10,10,8,10,10,19,11,11,10,10,2,2,2,DM/M C,1,1,1,1,1,1,1,1,1,20,16,1,1,1,1
19068266,Bruno Mataveli,1651,27/02/1988,28,0,0,0,0,180,0,1,1,2,4,3,2,3,2,2,1,1,2,1,3,1,7,1,13,4,1,10,7,2,9,6,9,9,9,7,11,6,13,9,1,14,4,13,6,8,13,13,7,10,9,8,13,20,12,9,9,9,9,7,9,9,12,13,11,8,7,13,5,D C,1,1,1,1,1,1,20,1,1,1,1,1,1,1,1
19068478,André,1651,01/10/1985,30,0,0,0,0,180,68,2,1,1,2,2,2,3,1,3,1,2,7,10,10,8,10,7,8,7,9,6,12,5,4,11,9,8,10,11,8,12,14,2,11,2,11,10,11,10,11,11,8,6,12,10,11,20,10,7,12,5,9,9,9,20,12,10,9,12,8,17,4,M/AM C,1,1,1,18,1,1,1,1,1,1,20,1,1,1,1
19068562,Guti,1651,29/06/1991,25,0,0,0,0,187,83,2,3,3,1,2,3,1,2,1,4,2,6,8,8,8,11,7,13,9,10,12,12,8,12,12,11,12,12,11,12,8,11,12,9,11,11,12,13,13,12,12,12,14,9,13,12,20,14,13,12,12,10,7,9,5,9,14,12,11,9,10,9,D C,1,1,1,1,1,1,20,1,5,15,10,1,1,1,1
19068564,Douglas,1651,06/08/1990,25,0,0,8,0,171,67,1,1,1,1,1,2,3,2,1,1,1,12,12,15,9,13,12,7,11,10,12,12,12,12,13,13,12,13,12,12,13,13,15,13,12,13,11,14,14,14,15,11,6,10,14,13,20,14,10,14,10,12,10,15,10,17,6,12,14,13,12,12,D/WB R,1,1,1,5,5,11,1,12,19,1,5,5,11,12,20
19068567,Ferreira,1651,06/04/1990,26,0,0,0,0,173,65,3,2,2,1,4,1,2,4,3,2,1,8,6,10,11,10,8,8,14,5,13,12,7,11,11,10,12,9,11,8,11,10,10,11,4,13,11,9,12,12,13,8,6,10,11,13,20,9,8,11,4,8,10,9,19,11,11,9,12,1,10,3,DM/M C,1,1,1,15,1,1,1,1,1,20,18,1,1,1,1
19068619,Levy,1651,22/07/1988,27,0,0,0,0,172,72,3,2,1,1,1,2,3,3,2,1,1,8,6,8,5,10,3,9,2,4,10,8,4,14,9,10,11,10,9,11,9,13,10,2,5,7,10,9,9,13,15,9,7,8,15,15,20,13,8,10,5,10,10,10,9,12,11,9,11,9,13,2,D/WB R,1,1,1,1,1,1,1,1,20,1,1,1,1,1,18
19068628,Da Silva,1651,25/04/1988,28,0,0,0,0,182,74,1,3,2,2,2,3,2,3,1,2,1,6,3,1,6,6,3,13,6,1,13,7,1,13,4,6,10,4,6,5,2,13,9,1,9,4,13,6,7,13,10,8,11,7,13,10,20,6,10,8,9,3,9,9,12,12,11,15,10,10,9,6,D C,1,1,1,1,1,1,20,1,1,1,1,1,1,1,1
19068631,Marlon,1651,14/09/1985,30,0,0,0,0,182,78,2,3,2,4,3,1,3,1,1,2,1,11,12,12,11,12,12,10,8,14,11,12,12,12,12,12,12,12,12,10,11,10,6,11,13,11,11,13,13,13,11,13,11,20,14,13,7,14,12,10,14,12,6,11,12,9,12,11,12,9,3,5,D/WB L,1,1,1,1,12,1,1,20,1,14,10,13,1,18,1
19068784,Cicinho,1651,04/08/1986,29,0,0,0,0,173,63,1,3,2,3,3,4,2,2,3,3,3,10,12,12,9,13,8,5,12,11,11,13,10,12,12,11,12,11,11,11,11,13,13,13,10,13,12,13,11,13,13,8,8,11,11,13,20,14,7,11,11,11,12,13,11,10,11,12,6,10,15,15,D/WB R,1,1,1,1,1,1,1,1,20,1,1,1,12,1,18
19068785,Gustavo,1651,16/05/1988,28,0,0,0,0,184,0,2,1,3,3,3,1,1,1,2,1,3,4,8,4,1,6,1,14,4,6,12,9,4,14,2,9,12,10,4,7,8,14,2,1,1,7,13,8,9,14,14,9,7,11,16,14,20,7,10,10,8,10,10,10,20,9,10,11,11,10,13,7,D C,1,1,1,1,1,1,20,1,1,1,1,1,1,1,1
19068787,Jonathan,1651,08/03/1987,29,0,0,0,0,177,71,3,3,2,2,2,3,3,1,2,1,1,7,6,11,12,13,8,14,6,4,8,13,3,5,10,10,13,4,10,9,4,12,1,10,11,14,9,8,9,13,14,11,10,10,11,13,20,12,12,10,9,6,6,8,10,11,11,9,13,1,3,5,S ,1,1,20,1,1,1,1,1,1,1,1,1,1,1,1
19068794,Diego Giaretta,1651,27/11/1983,32,0,0,0,0,184,82,3,3,1,1,3,2,3,2,1,1,3,5,9,7,6,11,11,13,12,6,13,11,10,13,11,12,13,12,13,12,8,12,13,11,14,9,13,14,13,13,12,8,13,20,12,13,8,13,14,13,10,13,11,14,14,15,12,12,14,13,12,7,D/DM LC,1,1,1,1,1,1,20,17,1,17,7,1,1,1,1
19068803,Luiz Paulo,1651,11/07/1992,23,0,0,0,0,186,75,3,1,1,1,3,1,3,3,2,3,1,3,1,1,4,4,6,13,6,4,13,7,3,13,5,9,12,9,7,10,4,13,9,2,6,5,13,6,7,13,11,7,7,6,12,12,20,4,9,9,5,9,8,9,12,12,10,12,12,2,4,6,D C,1,1,1,1,1,1,20,1,1,1,1,1,1,1,1
19068857,Roberto Firmino,1651,02/10/1991,24,11,4,0,0,181,76,1,2,1,3,2,2,1,3,1,2,2,11,13,16,15,16,11,11,14,4,8,14,11,11,17,12,15,10,15,14,15,13,14,16,7,17,11,16,16,14,15,15,10,11,16,13,20,15,13,13,5,14,8,12,15,15,13,14,14,11,13,12,AM/S RLC,1,1,20,18,16,16,1,1,1,1,1,1,1,1,1
19069009,Vander,1651,17/04/1990,26,0,0,0,0,173,65,1,1,3,1,1,3,3,3,3,1,1,11,11,15,12,14,11,7,14,2,6,11,13,5,14,12,13,7,11,7,11,11,11,16,4,13,6,5,8,15,16,12,7,5,13,15,20,13,8,11,11,12,8,12,11,16,8,13,7,7,13,13,M/AM RLC,1,1,10,15,20,17,1,1,1,1,13,17,12,1,1
19069035,Marlon,1651,14/01/1989,27,0,0,0,0,175,0,2,2,2,4,2,1,4,3,1,3,2,8,4,8,9,9,4,8,8,1,12,10,5,12,10,12,9,14,8,9,14,9,11,7,1,9,12,13,11,12,11,9,8,12,9,10,20,12,7,9,9,9,9,9,13,11,9,9,11,8,13,9,DM/M C,1,1,1,1,1,1,1,1,1,20,18,1,1,1,1
19069037,Thiago Régis,1651,27/09/1991,24,0,0,0,0,184,83,10,10,10,1,11,10,12,12,11,8,10,2,2,1,2,6,3,1,2,3,3,3,3,3,6,11,9,10,8,10,4,9,12,1,14,3,10,7,9,8,12,12,11,8,10,9,20,11,13,9,7,4,9,8,10,12,14,11,14,14,14,10,GK ,20,1,1,1,1,1,1,1,1,1,1,1,1,1,1
19069104,Igor,1651,08/12/1989,26,0,0,0,0,189,84,3,2,1,3,4,1,2,1,3,1,3,1,6,6,7,8,7,11,9,5,11,8,8,11,8,13,10,13,8,9,8,8,13,9,11,8,12,12,12,10,11,5,13,8,14,12,20,12,13,11,12,10,7,14,11,11,14,11,15,14,13,11,D/DM C,1,12,1,1,1,1,20,12,1,17,15,1,1,7,1
19069110,Ronaldo,1651,06/01/1990,26,0,0,0,0,176,67,3,3,3,2,2,2,3,2,1,1,1,9,12,11,8,9,6,8,9,12,9,10,9,11,10,13,8,13,8,8,8,7,3,9,5,8,10,12,12,13,12,9,10,20,12,13,7,13,8,12,9,6,5,9,18,7,12,9,10,8,1,1,D/WB L,1,1,1,1,5,1,1,18,1,1,1,10,1,20,1
19069217,Camilo,1651,28/06/1982,34,0,0,0,0,168,0,2,3,1,1,2,3,2,3,4,3,1,7,11,10,7,9,2,5,11,4,9,10,8,8,10,14,10,11,10,10,10,11,14,14,8,12,8,11,11,11,14,10,8,20,16,14,6,8,10,13,11,9,4,11,14,12,11,12,14,12,12,9,D/WB L,1,1,1,1,1,1,1,20,1,1,1,10,1,18,1
19069374,Willen,1651,10/01/1992,24,0,0,0,0,184,76,2,4,2,2,4,2,2,2,1,2,1,8,8,11,12,13,10,11,9,3,5,4,5,8,9,4,11,3,9,6,10,14,12,8,4,14,7,8,9,14,11,9,13,8,16,13,20,14,12,10,7,10,10,10,12,9,13,13,12,9,4,2,S ,1,1,20,1,1,1,1,1,1,1,1,1,1,1,1
19069449,Samuel Santos,1651,25/04/1990,26,0,0,0,0,176,63,3,2,2,2,2,2,2,4,2,2,3,9,12,11,10,12,8,7,7,12,12,11,11,11,12,13,11,13,9,12,9,10,13,10,8,10,9,12,12,13,13,9,7,10,12,14,20,11,10,12,5,5,7,12,18,14,12,12,11,7,8,3,D/WB R,1,1,1,1,1,5,1,1,20,1,1,1,10,1,19
19069507,João Marcos,1651,22/08/1991,24,0,0,0,0,181,72,3,2,2,1,3,2,3,1,3,2,1,8,6,14,11,14,8,14,10,3,4,10,7,5,14,10,11,9,11,10,13,12,2,13,7,11,5,8,10,14,14,9,9,2,9,14,20,14,8,10,14,10,10,10,7,11,4,10,11,6,9,2,AM/S C,1,1,20,18,1,1,1,1,1,1,5,1,1,1,1
19069561,Júnior Mendes,1651,24/06/1988,28,0,0,0,0,187,76,3,2,3,2,1,3,4,3,2,2,4,5,6,7,15,8,14,13,12,2,4,7,14,5,9,11,10,12,10,7,8,10,8,12,5,10,8,9,13,11,13,13,14,5,13,12,20,9,13,12,6,16,6,11,12,12,10,13,12,3,10,3,S ,1,1,20,12,1,1,1,1,1,1,1,1,1,1,1
19069585,Sidimar,1651,09/07/1992,23,0,0,0,0,185,82,1,3,2,2,3,3,2,1,1,3,1,7,5,6,8,11,10,12,9,7,12,10,5,12,10,10,11,7,12,10,7,8,6,7,7,10,12,10,11,13,14,11,13,11,8,14,20,8,12,9,9,8,7,10,8,10,13,10,13,9,11,4,D C,1,1,1,1,1,1,20,1,1,1,1,1,1,1,1
19069586,João Pedro,1651,09/03/1992,24,0,0,0,0,184,73,2,2,3,3,3,3,3,1,3,3,4,11,12,15,14,12,11,9,14,6,8,13,12,8,14,12,11,12,11,10,14,12,13,14,8,13,9,12,13,14,14,11,10,12,12,13,20,13,11,12,12,10,9,13,3,14,10,12,7,8,9,7,AM LC,1,1,10,20,15,11,1,1,1,1,14,1,1,1,1
19069587,Geovane,1651,09/01/1992,24,0,0,0,0,177,75,2,3,2,2,3,2,4,1,3,1,3,6,2,7,13,13,6,8,7,1,4,13,6,8,13,9,8,6,9,7,11,9,6,13,14,8,6,7,8,13,13,7,7,10,12,13,20,13,11,9,7,5,9,9,20,14,12,12,9,5,11,5,M/AM/S C,1,1,17,20,1,1,1,1,1,1,18,1,1,1,1
19069589,Guilherme Batata,1651,02/05/1992,24,0,0,0,0,175,77,1,3,3,3,3,4,2,3,2,3,1,9,11,9,10,11,10,7,11,10,11,12,3,10,12,12,11,10,11,8,11,10,13,11,11,10,10,10,12,13,11,7,6,14,11,11,20,11,6,10,10,10,9,14,20,13,10,13,13,9,8,7,D/WB/DM L,1,1,1,1,1,1,12,19,1,20,10,1,1,19,1
19069590,Marcelo Cirino,1651,22/01/1992,24,0,0,0,0,182,74,2,2,2,1,1,3,2,1,3,2,2,10,12,14,11,13,11,14,12,10,7,12,11,6,14,11,11,11,10,10,12,11,9,13,11,11,7,12,11,15,15,12,11,7,14,14,20,13,11,10,10,13,7,15,12,9,10,9,6,7,12,7,AM/S RC,1,1,19,15,8,20,1,1,12,1,12,1,14,1,14
19069808,Ciro,1651,18/04/1989,27,0,0,10,9,175,72,3,2,4,1,2,2,3,2,3,2,3,3,9,11,13,12,7,11,13,3,7,11,15,8,13,16,13,14,12,11,11,11,9,14,8,13,6,12,13,15,16,10,8,7,13,15,20,13,11,12,7,14,8,11,9,15,12,13,8,7,8,14,S ,1,1,20,11,12,13,1,1,1,1,1,1,6,1,3
19070100,Mílton Raphael,1651,11/05/1991,25,0,0,0,0,187,80,10,11,12,11,12,12,13,13,12,11,11,5,2,3,1,3,10,1,1,3,2,2,2,2,8,11,12,14,5,10,9,14,6,2,13,1,13,10,9,11,11,10,15,20,8,14,11,7,9,11,10,11,10,11,8,10,12,10,12,12,15,1,GK ,20,1,1,1,1,1,1,1,1,1,1,1,1,1,1
19070133,Douglas Pires,1651,30/01/1991,25,0,0,0,0,194,93,11,12,12,4,14,12,13,13,12,12,12,5,1,3,3,11,7,5,1,2,3,10,3,1,10,11,11,13,11,10,6,12,13,12,7,7,12,13,14,11,13,13,16,5,13,11,20,13,13,11,8,13,5,11,12,12,10,9,12,9,12,6,GK ,20,1,1,1,1,1,1,1,1,1,1,1,1,1,1
19070135,Eliandro,1651,23/04/1990,26,0,0,0,0,180,85,3,2,3,3,3,2,2,1,2,1,2,4,10,12,11,10,6,11,11,7,6,11,12,9,11,10,11,11,11,11,9,11,13,8,9,13,8,12,12,11,10,13,9,8,14,12,20,12,13,8,7,8,5,11,20,13,15,14,13,7,14,8,S ,1,1,20,13,10,10,1,1,1,1,1,1,1,1,1
19070177,Magno Cruz,1651,20/05/1988,28,0,0,0,0,176,76,1,1,2,1,2,1,2,3,1,1,1,12,11,13,11,13,10,8,12,6,8,12,12,7,13,12,12,12,11,10,12,12,12,11,7,13,7,9,9,14,15,12,7,8,12,14,20,13,10,12,8,2,11,12,18,12,12,9,8,8,4,6,M/AM/S RC,1,1,16,20,10,15,1,1,1,1,18,5,14,1,1
19070329,Zé Eduardo,1651,16/08/1991,24,0,0,14,0,185,88,1,3,2,1,3,4,4,3,3,3,1,9,9,12,4,11,6,12,8,5,12,11,12,13,11,14,10,15,11,10,10,10,15,5,10,11,14,13,14,13,13,13,13,10,15,14,20,13,14,12,8,11,6,16,12,16,10,10,8,12,6,15,M/AM RLC,1,1,1,16,16,17,1,1,1,14,20,10,16,1,1
19070371,Patrick,1651,14/12/1987,28,0,0,0,0,187,76,1,1,1,1,2,1,4,1,1,3,1,6,9,9,6,8,2,12,7,8,12,8,5,11,8,11,10,11,8,11,6,11,10,5,11,8,11,13,11,11,11,13,13,8,13,11,20,13,14,10,12,10,12,10,7,9,11,9,12,3,13,4,D C,1,1,1,1,1,1,20,1,1,1,1,1,1,1,1
19070376,Rogério Rios,1651,19/09/1981,34,0,0,0,0,175,75,3,3,3,1,4,1,3,2,1,2,3,12,11,12,10,10,12,7,9,12,8,11,11,8,11,11,9,11,10,8,10,8,12,15,5,11,8,10,10,11,13,8,8,8,13,12,20,10,8,14,9,12,5,16,11,12,12,13,14,15,15,8,D/WB/M RL,1,1,1,11,8,12,1,15,18,5,10,9,16,17,20
19070404,Muralha,1651,21/01/1993,23,0,0,0,0,173,69,3,4,4,2,1,2,3,2,3,2,2,8,10,10,9,12,11,7,10,1,14,13,9,13,12,12,13,11,13,10,12,13,8,10,8,12,14,13,11,12,13,11,7,10,17,12,20,14,10,11,10,10,9,11,20,12,5,13,9,6,12,8,DM/M C,1,1,1,1,1,1,1,1,1,20,16,1,1,1,1
19071308,Lessandro,1651,05/11/1984,31,0,0,0,0,171,0,2,3,1,1,3,1,1,2,3,2,1,8,8,8,9,11,6,9,15,8,12,12,7,13,11,14,9,13,10,10,11,11,13,4,7,9,12,13,11,9,10,9,7,9,9,11,20,10,6,6,9,8,9,9,10,10,11,10,11,12,12,8,DM C,1,1,1,1,1,1,1,1,1,20,15,1,1,1,1
19071364,Douglas,1651,29/10/1989,26,0,0,0,0,179,74,2,1,3,1,3,2,1,3,3,1,1,2,1,2,1,7,1,7,5,5,14,6,1,10,3,5,12,9,7,9,7,13,3,1,14,7,14,7,8,14,14,8,6,9,15,14,20,8,7,11,9,6,9,9,20,12,10,11,11,8,10,7,D C,1,1,1,1,1,1,20,1,1,1,1,1,1,1,1
19071429,Mauro Iguatu,1651,14/11/1987,28,0,0,0,0,190,80,14,8,11,1,14,12,7,13,10,3,7,4,1,1,2,2,6,1,2,3,2,2,1,3,7,10,11,15,6,10,8,12,12,3,10,3,10,8,8,12,14,9,12,10,13,11,20,8,13,9,7,10,5,10,16,8,18,11,12,7,14,8,GK ,20,1,1,1,1,1,1,1,1,1,1,1,1,1,1
19071581,Tarabai,1651,09/12/1985,30,0,0,0,0,170,68,2,3,2,3,1,2,2,1,1,2,1,9,14,12,12,15,9,14,7,4,9,10,12,8,11,12,15,12,13,10,9,15,10,13,15,13,8,9,14,13,13,10,4,8,13,13,20,10,12,14,6,10,16,10,15,11,8,9,12,1,10,3,S R,1,1,20,10,10,15,1,1,1,1,1,1,1,1,1
19071736,Dairo,1651,01/04/1989,27,0,0,0,0,183,76,2,2,1,3,1,1,1,4,3,3,2,4,11,12,10,12,8,10,8,5,4,11,13,5,12,12,9,14,9,7,10,11,12,15,8,13,9,8,13,12,12,10,11,10,14,12,20,11,10,11,8,15,6,10,8,11,14,11,13,8,12,10,S ,1,1,20,1,1,1,1,1,1,1,1,1,1,1,1
19072020,Reiner Ferreira,1651,17/11/1985,30,0,0,0,0,185,74,1,1,1,3,2,1,1,2,1,1,2,8,7,6,6,11,8,13,8,6,12,11,12,13,11,11,12,10,11,8,5,10,12,6,10,9,11,9,12,12,12,10,14,20,14,12,11,10,12,11,8,10,6,10,12,10,13,12,14,13,14,5,D C,1,1,1,1,1,1,20,1,1,1,1,1,1,1,1
19072024,Arthur,1651,20/02/1990,26,0,0,0,0,187,79,1,3,3,2,1,2,2,1,2,3,2,6,4,5,4,6,3,13,4,1,9,7,2,13,3,9,13,9,7,8,4,9,4,6,9,6,11,6,8,13,13,7,15,9,14,13,20,12,8,8,9,3,3,9,18,12,10,11,10,7,11,8,D C,1,1,1,1,1,1,20,1,1,1,1,1,1,1,1
19072069,Douglas,1651,04/04/1990,26,0,0,0,0,190,84,3,3,2,3,1,1,2,3,1,2,2,6,7,7,7,10,6,13,6,7,14,9,6,16,11,15,13,15,12,13,8,12,12,7,9,8,16,14,14,13,12,16,17,4,14,13,20,14,16,15,10,14,13,8,9,11,8,10,11,11,9,10,D C,1,1,1,1,1,1,20,1,1,1,1,1,1,1,1
19072406,Weriton,1651,28/02/1992,24,0,0,0,0,170,60,1,2,1,1,2,3,1,3,3,1,1,8,11,8,5,11,3,6,7,4,6,9,5,5,10,6,12,10,9,12,4,15,3,9,8,10,5,9,9,12,16,14,5,10,10,15,20,7,3,9,9,7,9,9,20,10,12,12,11,6,6,2,D R,1,1,1,1,1,1,1,1,20,1,1,1,1,1,15
19072408,Guaraci,1651,02/03/1992,24,0,0,0,0,175,0,1,1,2,2,1,2,3,3,1,2,1,5,8,4,6,14,8,6,14,1,12,14,1,11,11,10,11,9,12,11,12,14,6,6,5,8,11,9,14,8,8,11,9,7,14,9,20,14,11,10,15,10,9,10,9,10,12,10,13,6,15,2,DM/M C,1,1,1,1,1,1,1,1,1,20,20,1,1,1,1
19072444,Lucas Viccari,1651,11/06/1990,26,0,0,0,0,174,74,2,1,4,4,2,1,1,3,3,1,2,6,5,7,7,13,6,6,12,3,9,13,6,13,13,5,9,8,13,7,11,13,14,7,6,10,10,7,10,13,13,7,4,7,12,13,20,13,8,9,12,1,9,9,14,14,12,13,12,13,13,13,M C,1,1,1,1,1,1,1,1,1,1,20,1,1,1,1
19072446,Müller Brenner,1651,25/07/1991,24,0,0,0,0,184,71,2,1,1,1,2,2,1,3,1,3,2,8,4,11,10,15,7,10,9,3,8,9,3,6,15,5,9,8,7,9,9,9,4,13,11,15,9,8,10,11,12,8,11,9,11,11,20,14,7,11,4,9,8,9,18,11,14,10,13,7,12,1,S ,1,1,20,1,1,1,1,1,1,1,1,1,1,1,1
19072496,Gilberto Alemão,1651,01/02/1990,26,0,0,0,0,185,82,3,1,4,2,3,4,3,1,1,2,3,1,5,6,7,8,1,13,7,10,11,9,9,12,9,12,9,12,7,11,10,16,5,5,13,5,11,13,11,10,10,11,14,9,11,10,20,16,12,10,13,4,7,10,7,11,10,11,8,3,3,2,D C,1,1,1,1,1,1,20,1,10,1,1,1,1,1,1
19072525,Israel,1651,09/05/1985,31,0,0,0,0,170,65,1,3,3,2,1,2,3,3,1,2,3,3,4,7,7,12,6,6,8,1,8,11,2,14,12,7,8,7,8,12,7,14,5,4,7,7,7,8,12,10,9,4,5,9,8,11,20,7,5,8,8,8,8,8,8,12,8,13,10,10,8,7,DM RC,1,1,1,1,1,1,1,1,15,20,15,1,1,1,12
19073052,Netinho,1651,10/04/1991,25,0,0,0,0,184,0,2,1,2,3,2,2,2,2,2,2,4,6,3,2,7,11,6,6,8,1,7,12,5,12,13,5,6,8,7,6,7,13,6,3,10,4,12,7,11,13,13,7,6,14,9,12,20,10,11,9,9,6,9,9,8,10,10,11,9,5,3,1,DM ,1,1,1,1,1,1,1,1,1,20,10,1,1,1,1
19073263,Jean,1651,23/10/1989,26,0,0,0,0,186,79,3,3,2,3,3,3,3,4,3,2,1,5,2,2,1,8,2,13,3,3,13,8,2,13,5,10,10,10,8,7,6,13,10,2,9,3,13,7,8,13,11,8,8,8,14,12,20,9,12,10,6,10,7,10,17,13,10,9,13,10,5,2,D C,1,1,1,1,1,1,20,1,1,1,1,1,1,1,1
19073313,Diego Teodoro,1651,13/05/1992,24,0,0,0,0,189,0,1,2,3,3,2,2,1,2,2,2,1,1,6,5,1,11,1,6,5,4,7,7,4,11,7,8,6,8,6,7,6,8,8,7,12,2,7,6,7,13,13,6,7,20,15,13,9,12,8,8,8,2,8,8,13,13,11,10,10,6,1,8,D/WB L,1,1,1,1,1,1,1,20,1,1,1,1,1,18,1
19073337,Alex,1651,20/05/1990,26,0,0,0,0,182,76,2,2,1,2,2,2,1,2,2,3,1,10,9,10,11,11,9,11,12,10,10,10,10,9,11,13,11,11,11,11,9,10,14,10,11,11,10,9,9,10,12,11,11,10,12,10,20,11,11,12,8,10,8,10,8,14,13,13,13,12,7,1,AM/S RL,1,1,20,14,16,16,1,1,1,1,1,1,1,1,1
19073347,Marcos Paulo,1651,03/02/1990,26,0,0,0,0,186,72,2,3,1,3,3,1,2,1,1,2,2,8,8,10,9,10,5,9,10,9,11,10,8,11,10,16,12,13,9,10,11,9,10,9,9,11,10,12,12,12,11,12,12,7,11,12,20,12,10,10,8,13,6,11,11,13,14,13,10,5,12,5,DM/M C,1,1,1,10,1,1,1,1,1,20,18,1,1,1,1
19073353,Thiaguinho,1651,01/03/1991,25,0,0,0,0,170,67,2,2,4,2,4,3,1,3,1,1,3,6,12,14,12,13,12,7,8,5,2,13,15,3,14,7,11,8,10,11,13,11,15,16,6,12,3,10,12,15,14,8,6,20,13,16,5,10,7,11,10,11,10,10,16,15,14,11,13,6,16,3,AM/S RLC,1,1,20,18,19,15,1,1,1,1,1,1,1,1,1
19073365,Romário,1651,10/08/1985,30,0,0,0,0,174,74,3,4,1,3,2,3,1,4,1,3,1,11,10,15,9,14,11,7,14,5,7,12,11,8,14,7,10,13,12,9,14,9,9,16,6,12,10,7,11,13,14,9,8,10,14,12,20,12,7,10,5,10,6,13,10,9,8,9,12,9,10,6,M/AM C,1,1,12,18,10,12,1,1,1,1,20,1,1,1,1
19073415,Fábio,1651,02/06/1981,35,0,0,0,0,188,0,13,9,8,8,13,13,7,10,9,5,4,1,1,3,3,2,3,1,2,1,2,1,3,2,1,9,9,11,4,11,5,13,9,3,6,2,7,7,6,13,9,6,13,5,12,9,20,4,10,9,5,9,9,9,14,8,10,11,11,1,19,3,GK ,20,1,1,1,1,1,1,1,1,1,1,1,1,1,1
19073476,Lucas Mendes,1651,03/09/1990,25,0,0,0,0,184,80,3,1,2,1,1,1,2,2,3,1,1,7,11,9,8,11,10,16,9,11,14,10,10,13,11,11,13,15,14,13,11,13,11,10,11,12,14,17,13,14,13,15,13,20,14,13,5,16,14,14,11,12,8,13,12,10,12,12,14,7,12,9,D/WB LC,1,1,1,1,1,1,20,17,1,1,1,1,1,17,1
19073498,Edgar,1651,26/01/1986,30,0,0,0,0,178,73,3,3,4,2,3,3,3,1,1,2,2,6,10,13,11,9,7,8,10,5,6,10,7,5,13,11,10,8,12,8,7,7,10,14,7,13,5,10,14,15,15,13,9,9,14,16,20,14,13,14,11,10,5,12,18,12,9,12,7,10,7,14,AM/S L,1,1,20,1,19,1,1,1,1,1,1,1,1,1,1
19073504,Diego Palhinha,1651,14/09/1985,30,0,0,0,0,178,74,4,3,1,1,1,2,2,3,2,1,2,11,12,12,11,13,11,7,10,8,6,12,11,6,13,9,12,10,11,10,12,11,3,13,10,12,10,12,13,13,13,7,9,20,12,11,11,12,9,12,10,11,9,12,18,11,10,12,9,9,6,5,M/AM C,1,1,1,20,1,1,1,1,1,1,17,1,1,1,1
19073528,Roniery,1651,23/11/1987,28,0,0,0,0,168,62,2,2,3,2,3,2,1,2,3,3,2,11,12,12,11,13,11,8,10,9,12,12,8,11,12,12,12,13,10,11,10,11,8,14,6,14,11,13,13,13,14,8,5,10,13,13,20,14,8,12,12,10,5,11,13,9,11,12,10,7,12,7,D/WB R,1,1,1,1,1,1,1,1,20,1,1,1,1,1,17
19073529,Somália,1651,18/07/1986,29,0,0,0,0,188,0,2,3,1,3,3,2,1,2,2,2,3,4,6,13,13,13,6,13,7,4,4,7,3,1,12,9,9,5,7,6,7,13,9,12,10,11,7,6,7,13,13,7,11,1,6,13,20,10,13,9,9,4,8,9,14,12,11,12,10,9,7,5,S ,1,1,20,1,1,1,1,1,1,1,1,1,1,1,1
19073540,Célio Codó,1651,07/10/1987,28,0,0,0,0,191,82,3,2,3,3,3,2,3,2,3,1,1,5,7,9,12,11,6,13,8,5,6,10,6,6,11,10,9,10,10,8,11,12,1,9,6,10,9,11,9,10,10,13,16,20,14,12,9,11,12,15,10,9,8,10,10,10,9,12,10,9,3,1,S ,1,1,20,1,1,1,1,1,1,1,1,1,1,1,1
19073559,Allan Cloth,1651,19/04/1991,25,0,0,0,0,185,71,1,3,3,2,1,3,3,2,2,2,1,3,6,3,3,12,6,6,7,4,6,11,1,11,13,9,11,8,8,8,8,8,9,9,3,7,13,7,12,13,10,7,12,7,15,11,20,13,7,9,9,8,9,9,9,11,13,13,14,9,9,8,DM C,1,1,1,1,1,1,1,1,1,20,15,1,1,1,1
19073562,Jackson,1651,01/05/1989,27,0,0,0,0,186,80,3,2,3,2,3,4,1,4,3,2,2,5,7,8,7,10,7,13,7,6,14,9,12,13,10,14,13,13,13,12,9,12,12,12,12,8,12,13,13,12,11,9,13,13,14,12,20,14,14,12,11,11,7,8,8,12,13,12,10,9,12,11,D C,1,1,1,1,1,1,20,1,11,1,1,1,1,1,8
19073564,Lucas Moura,1651,13/08/1992,23,35,4,9,4,172,66,1,1,2,1,2,2,3,2,1,1,4,12,14,16,12,16,13,8,10,11,7,15,12,8,16,12,14,12,13,14,13,13,13,14,6,15,7,14,16,17,16,10,8,8,15,16,20,14,9,14,8,9,6,16,8,13,12,12,14,9,12,6,AM RC,1,1,12,15,13,20,1,1,1,1,8,12,12,1,1
19073567,Willian Arão,1651,12/03/1992,24,0,0,0,0,181,74,1,2,4,1,1,3,3,3,3,1,1,5,8,12,12,14,8,14,13,7,13,14,7,13,12,13,13,14,14,14,14,13,13,10,13,13,13,13,13,14,13,14,10,10,12,15,20,13,15,15,10,13,10,9,19,11,6,11,8,9,11,6,DM/M C,1,1,1,1,1,1,1,1,1,20,18,1,1,1,1
19073577,Almir,1651,03/03/1991,25,0,0,0,0,175,74,2,1,3,1,3,3,2,1,3,1,2,11,8,10,9,12,12,7,11,1,7,10,6,6,8,9,8,3,7,7,11,13,9,10,5,9,8,8,13,11,12,7,7,20,8,11,9,10,7,9,12,8,9,13,8,12,12,7,11,7,6,7,AM RC,1,1,1,20,10,17,1,7,1,1,14,9,10,8,1
19073581,Leozão,1651,06/06/1991,25,0,0,0,0,184,77,1,3,3,3,1,3,3,3,2,2,2,5,4,5,4,5,4,12,5,4,10,6,5,11,6,15,11,14,10,9,7,9,4,7,8,7,10,13,14,13,13,12,12,5,18,12,20,12,13,9,15,15,5,5,16,15,6,11,13,4,10,2,D C,1,1,1,1,1,1,20,1,13,1,1,1,1,1,1
19073583,Pedro Henrique,1651,28/03/1991,25,0,0,0,0,188,78,1,1,1,2,1,1,2,3,4,1,1,7,8,13,10,12,11,12,9,5,6,11,11,7,12,11,13,11,14,10,11,12,5,13,6,15,7,11,5,10,7,16,14,5,7,12,20,7,16,13,6,11,11,6,12,5,6,13,4,10,9,12,S ,1,1,20,1,1,1,1,1,1,1,1,1,1,1,1
19073631,Renan,1651,07/04/1990,26,0,0,0,0,167,58,3,1,1,3,2,2,4,1,1,2,2,2,5,7,5,12,5,2,12,1,6,8,3,7,12,8,7,7,5,5,11,11,9,13,11,7,7,6,3,12,12,6,3,16,9,12,20,8,7,9,9,3,6,8,9,12,11,10,10,1,5,7,AM C,1,1,1,20,1,1,1,1,1,1,15,1,1,1,1
19073637,Wellington,1651,21/02/1990,26,0,0,0,0,191,83,3,1,1,1,2,2,1,1,1,4,1,3,4,10,4,11,12,13,4,7,10,10,1,11,5,8,12,10,7,12,6,11,9,1,6,3,10,12,13,11,12,11,14,11,12,11,20,12,12,9,8,5,9,9,15,13,11,11,11,13,13,5,D C,1,1,1,1,1,1,20,1,1,1,1,1,1,1,1
19073705,Jorge Luiz,1651,30/06/1989,27,0,0,0,0,179,81,2,3,4,3,3,1,1,3,3,3,4,7,7,11,10,12,6,8,7,3,3,9,10,4,12,11,11,10,11,10,11,11,12,14,6,11,4,10,11,12,11,7,7,8,13,11,20,11,7,12,7,10,7,13,17,13,6,13,13,9,10,7,M/AM/S C,1,1,20,17,1,1,1,1,1,1,18,1,1,1,1
19073744,Daniel,1651,31/01/1990,26,0,0,0,0,177,0,3,1,3,4,2,3,2,3,2,3,3,11,13,7,5,8,8,5,1,5,6,7,1,6,8,8,8,7,7,7,4,10,5,8,12,6,7,6,8,13,13,7,7,20,11,13,9,12,5,8,8,8,8,12,7,10,10,11,14,7,12,2,D/WB/M/AM LC,1,1,1,15,16,1,1,17,1,1,7,16,1,20,1
19073746,Igor Maranhão,1651,23/01/1990,26,0,0,0,0,182,0,1,2,2,4,1,1,3,3,3,3,2,5,8,8,8,10,8,10,9,7,12,11,6,10,9,13,11,11,10,12,9,11,12,8,13,8,12,11,12,11,10,12,11,8,14,10,20,12,13,11,10,10,6,14,10,12,12,10,13,9,12,10,D/DM C,1,18,1,1,1,1,20,1,1,17,13,1,1,1,1
19073750,Thiago Cardoso,1651,04/08/1991,24,0,0,0,0,185,80,3,3,3,1,3,3,2,1,2,3,3,3,5,6,5,8,7,11,6,10,12,8,3,13,10,9,11,10,9,13,6,12,10,5,10,8,12,13,13,12,11,12,13,6,12,12,20,11,12,10,10,11,10,5,11,10,10,11,11,4,6,2,D C,1,1,1,1,1,1,20,1,1,1,1,1,1,1,1
19073767,Giovanni Augusto,1651,05/09/1989,26,0,0,0,0,175,70,1,1,1,4,3,4,3,1,2,3,3,14,13,14,11,14,10,11,13,8,10,13,12,11,13,12,12,11,10,11,13,12,11,15,12,13,10,12,12,15,14,11,9,13,14,14,20,13,10,13,13,12,8,14,17,13,12,13,12,8,12,7,M/AM RC,1,1,1,19,14,20,1,1,1,1,11,12,16,1,1
19073773,Jackson,1651,20/06/1988,28,0,0,0,0,175,75,3,3,3,3,1,2,3,3,3,2,3,3,6,1,7,9,7,10,5,2,14,8,3,14,7,13,7,9,7,10,8,12,9,4,15,8,9,7,9,14,14,8,8,20,14,11,12,6,7,9,11,9,9,9,18,12,10,11,10,10,11,6,D C,1,1,1,1,1,1,20,1,1,15,1,1,1,1,1
19073776,Ismael,1651,08/06/1984,32,0,0,0,0,181,73,3,2,2,1,3,1,2,3,1,1,3,5,5,2,11,13,5,5,13,2,8,13,4,12,9,7,9,7,7,7,9,8,3,8,16,6,7,7,10,9,10,8,10,10,14,8,20,9,9,8,7,7,8,8,17,10,13,11,10,10,3,7,DM C,1,1,1,12,1,1,1,1,1,20,15,1,1,1,1
19073805,Negueba,1651,16/01/1988,28,0,0,0,0,177,67,3,2,2,3,2,3,3,1,3,2,3,6,4,13,11,13,6,13,7,3,6,7,5,6,13,9,10,8,9,8,3,10,9,13,7,12,7,6,7,12,12,7,6,10,10,12,20,6,13,12,9,7,6,8,14,12,8,12,10,5,14,1,S ,1,1,20,1,1,1,1,1,1,1,1,1,1,1,1
19073806,Adham,1651,16/06/1988,28,0,0,0,0,195,0,2,1,1,3,2,3,1,1,2,1,1,5,5,7,6,12,5,2,5,4,6,12,2,7,12,3,6,5,6,4,10,11,4,13,1,11,7,6,10,12,8,6,14,13,6,10,20,6,10,9,9,7,9,9,17,12,11,12,13,9,8,5,M/AM C,1,1,1,20,1,1,1,1,1,1,16,1,1,1,1
19073813,Bruno Nascimento,1651,30/05/1991,25,0,0,0,0,188,72,2,3,1,3,2,1,2,3,1,2,3,6,9,9,6,10,8,13,11,14,14,12,6,13,11,11,10,14,9,8,10,9,12,7,7,6,13,15,14,13,13,12,14,8,12,14,20,13,13,7,8,8,7,12,12,8,8,7,16,13,14,5,D C,1,10,1,1,1,1,20,1,12,1,1,1,1,1,8
19073830,Alex Lima,1651,02/10/1988,27,0,0,0,0,191,0,2,2,2,2,1,1,1,2,2,1,3,4,4,3,7,10,4,14,8,5,13,10,2,13,9,10,11,10,10,9,1,8,13,4,10,7,14,8,9,14,12,14,14,2,12,14,20,14,15,10,14,10,10,10,13,9,12,11,12,9,6,7,D C,1,11,1,1,1,1,20,1,1,1,1,1,1,1,1
19073838,Éder,1651,10/06/1988,28,0,0,0,0,171,69,1,3,2,3,2,1,1,3,1,3,4,8,11,10,7,9,10,9,11,12,13,11,8,13,11,12,14,13,11,10,9,9,15,4,12,9,13,13,12,13,13,11,8,3,12,13,20,14,8,10,10,8,3,15,12,12,14,12,15,13,13,7,D/WB/DM/M RC,1,1,1,6,1,8,1,1,16,20,17,1,12,1,18
19073914,João Marcos,1651,05/01/1993,23,0,0,0,0,173,0,3,1,2,2,1,3,3,3,1,1,2,3,11,11,7,9,10,5,8,12,8,12,4,10,11,10,9,10,8,9,9,11,11,11,2,9,9,8,11,13,14,7,6,12,12,14,20,12,7,10,5,10,5,12,11,10,12,10,13,10,14,7,D/WB R,1,1,1,1,1,5,1,8,18,1,1,1,10,9,20
19073917,Madson,1651,13/01/1992,24,0,0,0,0,182,69,2,3,1,1,1,2,3,1,1,1,2,10,12,13,11,13,11,10,11,13,7,12,12,9,13,10,11,10,10,11,13,11,12,15,4,12,11,10,12,15,16,7,11,9,13,15,20,13,7,14,10,8,7,13,10,13,10,10,11,8,11,13,D/WB/M R,1,1,10,13,4,15,1,10,20,1,14,6,16,8,19
19073930,Rafael,1651,13/07/1992,23,0,0,0,0,183,84,3,2,1,1,3,1,1,1,1,1,3,5,7,11,12,11,8,11,10,3,5,10,12,5,10,11,9,13,11,10,10,10,14,14,5,12,7,11,10,12,11,7,12,11,10,12,20,13,14,8,8,11,7,8,10,12,12,10,14,9,12,6,S ,1,1,20,11,1,1,1,1,1,1,1,1,1,1,1
19074110,Clayton,1651,27/03/1992,24,0,0,0,0,185,0,3,1,1,1,3,3,1,3,2,1,2,2,7,8,8,9,5,12,6,7,13,11,9,13,10,11,10,13,8,11,6,9,12,6,5,9,12,14,12,12,12,13,12,9,13,12,20,12,12,12,11,5,6,6,13,10,14,9,14,8,13,9,D C,1,11,1,1,1,1,20,1,1,15,8,1,1,1,1
19074111,Dankler,1651,24/01/1992,24,0,0,0,0,185,80,2,1,1,3,1,1,2,3,3,1,2,4,7,5,8,8,5,14,5,5,13,11,8,11,5,11,14,14,12,10,5,12,13,10,10,12,11,13,13,13,13,12,14,8,14,13,20,13,14,11,10,11,11,5,9,16,7,10,11,5,8,13,D C,1,1,1,1,1,1,20,1,13,1,1,1,1,1,1
19074113,Dimas,1651,22/01/1992,24,0,0,0,0,178,74,2,1,2,2,2,1,3,1,2,4,2,8,9,10,9,10,6,7,8,11,9,10,11,8,10,12,11,10,9,8,10,9,13,13,5,11,9,13,11,12,13,11,8,8,13,13,20,13,9,11,8,11,6,11,14,11,10,12,13,1,9,5,D/WB R,1,1,1,1,1,5,1,1,20,1,1,1,10,1,19
19074114,Eduardo,1651,05/02/1991,25,0,0,0,0,178,0,3,2,2,1,1,1,2,3,2,3,1,5,2,7,7,13,5,2,13,1,6,13,1,6,13,8,7,1,7,6,10,10,8,13,6,5,6,6,8,13,13,6,3,8,11,13,20,7,8,8,5,3,8,8,10,9,12,11,11,8,14,1,M/AM C,1,1,1,20,10,10,1,1,1,1,16,5,5,1,1
19074115,Muller,1651,27/09/1991,24,0,0,0,0,174,68,1,2,2,4,3,1,1,2,2,1,3,5,11,11,8,9,2,8,9,11,8,11,5,8,11,9,7,7,6,9,9,7,9,8,3,10,9,8,11,12,13,7,7,20,13,13,7,9,7,9,8,9,9,9,16,10,12,13,11,4,11,6,D/WB L,1,1,1,1,11,1,1,18,1,1,1,14,1,20,1
19074211,Alexandre,1651,11/12/1987,28,0,0,0,0,178,73,1,3,3,1,2,1,2,2,1,2,3,3,6,8,8,9,8,11,9,7,12,10,9,11,9,13,12,13,8,10,8,10,12,9,8,6,11,11,11,12,12,10,10,9,13,12,20,12,10,11,10,10,7,9,8,10,8,10,10,10,11,10,D C,1,16,1,1,1,1,20,1,1,11,5,1,1,1,1
19074301,Vítor Flora,1651,21/02/1990,26,0,0,0,0,179,80,3,2,3,1,1,2,2,1,2,2,1,7,9,12,8,7,10,11,9,6,3,8,9,4,10,10,7,10,8,6,8,7,15,14,3,11,3,7,9,11,10,12,10,14,13,13,20,11,13,12,6,12,9,12,4,15,9,9,11,7,10,7,S ,1,1,20,9,14,13,1,1,1,1,5,10,8,1,1
19074539,Rodrigo Dinamite,1651,25/08/1992,23,0,0,0,0,175,61,3,4,1,2,2,2,2,2,3,1,2,6,8,14,9,15,7,7,9,4,3,8,5,5,11,6,14,4,9,8,6,8,15,9,11,12,3,8,9,11,15,9,9,8,11,15,20,10,11,9,6,9,9,9,20,19,15,11,12,1,13,10,S ,1,1,20,1,1,1,1,1,1,1,1,1,1,1,1
19074655,Júnior,1651,18/12/1988,27,0,0,0,0,181,0,3,1,3,2,2,1,2,2,1,2,1,4,2,4,3,7,1,13,2,4,9,6,5,9,5,9,7,9,7,9,6,13,3,5,1,5,13,6,6,11,13,7,10,11,9,10,20,11,10,9,9,4,7,9,8,11,11,11,8,1,11,2,D C,1,1,1,1,1,1,20,1,1,1,1,1,1,1,1
19074781,Hélder,1651,24/05/1990,26,0,0,0,0,188,82,4,3,2,2,2,1,1,3,2,2,2,3,1,6,2,6,6,13,3,7,13,8,3,11,5,6,10,10,5,6,5,13,4,1,3,6,13,7,8,13,13,6,13,10,7,13,20,13,12,10,10,10,10,10,7,14,12,11,9,11,2,4,D C,1,1,1,1,1,1,20,1,1,1,1,1,1,1,1
19074783,Jefferson Araújo,1651,30/04/1989,27,0,0,0,0,179,78,3,3,3,3,1,3,3,2,3,1,2,3,5,13,11,12,7,14,7,2,6,8,7,1,14,6,10,6,10,8,8,11,3,13,8,14,5,7,9,14,10,8,6,3,14,13,20,13,8,5,9,5,9,8,7,12,12,13,13,9,12,4,S ,1,1,20,1,1,1,1,1,1,1,1,1,1,1,1
19074784,Júnior Caiçara,1651,27/04/1989,27,0,0,0,0,172,62,4,2,1,2,2,3,2,2,2,2,3,9,14,12,7,13,9,7,10,15,11,12,9,12,13,16,10,14,12,10,12,10,16,14,6,13,8,10,17,16,15,10,8,12,19,14,20,17,7,17,12,17,5,14,16,14,13,11,15,8,8,5,D/WB RL,1,1,1,1,10,10,1,15,20,1,1,10,10,15,20
19074785,Júnior Urso,1651,10/03/1989,27,0,0,0,0,177,72,2,1,2,1,3,2,3,1,1,1,3,6,12,14,10,11,11,14,12,6,15,11,11,13,12,12,14,14,13,13,9,12,12,11,12,12,14,12,13,15,12,12,12,10,14,14,20,12,14,14,15,12,11,13,13,12,13,12,9,7,8,10,D/DM L,1,1,9,1,1,1,12,18,1,20,12,10,1,15,1
19074789,Ricardo Goulart,1651,05/06/1991,25,1,0,0,0,181,80,2,2,3,1,1,3,4,2,1,1,3,7,13,13,14,14,11,14,12,5,9,14,12,11,14,14,14,14,14,14,13,14,14,15,10,16,8,14,16,14,15,11,12,12,12,14,20,14,12,14,11,14,7,16,9,10,11,11,12,8,10,12,M/AM/S C,1,1,17,20,10,10,1,1,1,1,19,5,5,1,1
19074791,Richard,1651,20/03/1989,27,0,0,0,0,177,68,4,3,3,3,1,1,1,1,3,1,3,12,13,12,13,13,11,7,14,6,8,11,12,11,12,12,13,14,12,11,11,11,13,13,10,14,10,10,13,12,13,11,10,20,12,13,5,11,12,11,8,12,10,12,13,14,12,13,13,11,11,8,AM C,1,1,5,20,10,1,1,10,1,10,15,14,1,12,1
19074792,Jean Cléber,1651,29/04/1990,26,0,0,0,0,180,73,3,2,3,2,2,3,2,1,2,2,1,9,9,11,7,14,8,9,12,7,11,12,10,13,12,13,14,13,11,14,11,13,13,15,10,12,9,14,14,13,12,13,10,7,13,13,20,14,12,13,11,9,3,12,12,13,7,12,11,6,12,7,DM C,1,1,1,1,1,1,1,1,1,20,15,1,1,1,1
19074828,André Vinícius,1651,30/07/1991,24,0,0,0,0,189,80,1,1,3,2,2,3,1,1,3,3,2,6,8,7,7,9,4,12,5,6,11,8,4,13,7,13,12,12,5,10,7,14,6,7,10,8,12,14,12,11,10,12,14,8,12,10,20,14,13,12,10,8,10,10,20,11,13,12,9,6,10,6,D C,1,1,1,1,1,1,20,1,1,1,1,1,1,1,1
19074830,Cléber,1651,21/04/1991,25,0,0,0,0,190,0,13,7,6,1,11,12,7,13,9,5,12,6,2,3,3,1,8,1,3,1,2,1,3,3,3,9,10,9,7,10,6,13,9,3,7,1,5,7,6,12,8,7,12,16,9,11,20,6,8,9,8,8,7,9,8,9,13,13,10,10,15,6,GK ,20,1,1,1,1,1,1,1,1,1,1,1,1,1,1
19074833,Jádson,1651,22/08/1991,24,0,0,0,0,173,68,2,4,2,3,2,3,1,3,1,1,3,13,12,12,10,11,8,5,10,3,4,11,8,3,12,9,12,4,8,10,13,10,14,13,1,11,4,11,11,14,12,5,6,9,10,13,20,11,5,11,4,9,9,9,18,12,10,12,9,6,8,7,AM RC,1,1,10,20,12,15,1,1,1,1,15,1,1,1,1
19074834,Dodô,1651,06/02/1992,24,0,0,3,0,177,69,2,1,3,4,2,1,3,3,1,1,2,14,12,13,8,12,7,7,11,13,10,13,9,10,15,13,10,9,11,10,12,10,13,14,6,16,8,12,16,15,15,12,9,20,13,15,8,13,9,12,8,11,14,13,12,15,8,12,15,11,10,9,D/WB/M L,1,1,1,1,10,1,1,16,1,1,1,19,1,20,1
19074835,Marcos Vinícius,1651,27/06/1991,25,0,0,0,0,190,84,3,4,3,3,2,2,3,2,2,1,2,7,3,3,3,10,3,14,5,5,8,9,3,14,5,10,10,10,9,11,6,14,10,6,7,8,13,8,9,13,11,9,14,20,10,13,4,13,13,10,10,10,6,10,7,10,10,11,9,11,16,1,D C,1,1,1,1,1,1,20,13,1,1,1,1,1,1,1
19074837,Paulo Vítor,1651,26/02/1991,25,0,0,0,0,180,77,3,3,1,1,3,3,1,3,1,3,3,7,7,4,5,9,3,9,7,5,13,7,2,13,9,9,12,8,9,9,7,11,9,5,6,7,10,8,13,14,14,11,10,10,15,14,20,13,10,9,4,4,6,9,12,11,10,11,13,1,1,4,D/DM C,1,1,1,1,1,1,17,1,1,20,1,1,1,1,1
19074910,Danilo Lopes,1651,21/08/1988,27,0,0,0,0,172,75,3,3,3,1,1,1,2,1,2,2,3,8,9,11,11,10,7,7,12,5,11,12,5,11,11,9,9,8,9,7,11,8,8,9,4,8,12,8,13,12,12,9,9,8,11,12,20,14,10,9,9,9,9,16,10,10,8,9,11,13,12,12,DM/M/AM C,1,1,1,18,1,1,1,1,1,19,20,1,1,1,1
19074913,Edson,1651,01/07/1991,25,0,0,0,0,182,74,1,1,2,3,1,3,1,1,2,1,2,7,8,11,12,11,11,16,14,8,13,11,9,15,11,11,13,14,14,13,12,14,12,10,8,9,13,13,14,13,12,14,16,8,13,12,20,13,16,13,8,14,8,13,8,10,15,10,11,8,10,10,DM/M C,1,10,1,1,1,1,10,1,12,20,19,1,1,1,10
19074922,João Paulo,1651,02/06/1988,28,0,0,0,0,170,65,1,4,2,1,2,1,3,2,1,1,2,12,11,12,13,12,15,9,13,3,3,12,13,3,12,12,11,14,11,12,9,13,12,14,8,14,7,12,10,13,13,12,8,14,12,14,20,11,10,12,7,9,8,13,9,12,14,9,14,15,12,9,AM/S RL,1,1,20,11,15,18,1,1,1,1,1,1,1,1,1
19074930,Pedrinho Mossoró,1651,19/11/1987,28,0,0,0,0,169,0,2,2,3,1,2,1,3,2,1,1,1,10,12,13,8,11,6,6,9,12,9,11,5,9,12,5,7,9,7,9,10,7,3,12,10,12,8,10,11,13,15,8,6,8,15,14,20,12,6,9,9,1,9,16,9,11,11,12,10,7,10,4,D/WB/AM RC,1,1,1,20,1,5,1,10,18,1,1,1,10,11,18
19074937,Rodriguinho,1651,27/03/1988,28,0,0,0,0,179,63,3,2,2,1,4,1,3,1,3,1,3,14,12,14,13,14,14,9,14,9,9,14,13,7,14,11,12,11,11,11,13,14,11,15,4,14,10,9,11,15,15,8,9,11,14,14,20,12,8,10,5,13,9,9,10,14,15,12,10,12,11,14,M/AM C,1,1,6,17,10,13,1,1,1,1,20,7,7,1,1
19074942,Wellington,1651,21/04/1990,26,0,0,0,0,191,86,14,9,11,10,13,11,11,12,10,11,12,3,3,2,2,9,7,1,2,1,2,3,2,1,7,10,11,11,11,12,10,9,10,1,11,3,12,11,10,7,13,13,15,5,11,8,20,9,14,6,5,2,10,10,16,9,9,10,12,8,11,7,GK ,20,1,1,1,1,1,1,1,1,1,1,1,1,1,1
19075146,Jô,1651,05/01/1989,27,0,0,0,0,184,78,2,1,2,3,3,1,3,3,2,3,3,5,7,9,9,9,9,12,11,7,13,10,9,12,10,14,11,13,8,10,9,9,11,7,7,9,11,13,12,11,11,11,12,9,15,11,20,13,13,11,12,11,7,10,8,13,9,10,10,10,10,13,DM/M C,1,1,1,1,1,1,1,1,13,18,20,1,1,1,14
19075148,Pio,1651,23/01/1988,28,0,0,0,0,172,65,2,2,2,1,2,4,2,1,2,1,3,13,13,11,8,9,13,9,13,12,10,11,15,11,12,11,8,9,7,9,9,11,3,14,13,12,10,12,11,12,12,13,6,13,12,13,20,10,6,10,8,13,5,14,19,8,9,13,11,6,1,3,D/WB/DM/M RC,1,1,1,1,1,1,1,10,18,20,17,1,17,10,17
19075224,Elivelto,1651,25/07/1991,24,0,0,0,0,173,64,1,3,2,1,3,1,3,3,3,4,2,4,5,7,7,11,6,13,6,5,8,4,5,8,8,6,7,8,7,6,3,13,3,9,6,8,7,7,8,13,13,6,5,20,12,13,6,12,6,9,9,6,4,9,8,11,12,12,10,10,9,3,D/WB/S L,1,1,18,1,1,1,1,20,1,1,1,1,1,17,1
19075302,Danilo Goiano,1651,12/02/1983,33,0,0,0,0,179,76,1,2,3,3,1,3,1,3,1,3,1,6,6,10,5,11,6,6,13,4,11,13,3,12,12,9,7,5,4,7,8,13,6,13,12,10,10,8,10,10,11,10,12,5,14,12,20,6,10,9,3,6,5,9,16,10,10,12,11,3,11,1,DM/M C,1,1,1,10,1,1,1,1,1,20,17,1,1,1,1
19075369,Tomás,1651,07/04/1985,31,0,0,0,0,180,82,3,3,3,2,2,3,1,2,1,2,1,4,2,4,7,7,2,14,8,1,15,9,1,12,8,6,12,11,8,12,7,11,1,2,14,6,12,7,9,10,8,9,12,4,14,9,20,9,12,9,9,8,9,9,19,14,13,9,13,8,14,1,D C,1,1,1,1,1,1,20,1,1,1,1,1,1,1,1
19075564,Lusmar,1651,30/07/1990,25,0,0,0,0,175,76,3,1,1,4,2,3,2,3,4,1,1,4,5,7,7,9,7,8,9,6,11,10,7,9,10,13,9,13,7,9,9,8,13,8,10,8,12,12,12,12,11,12,6,20,14,13,10,12,13,11,10,10,9,10,10,14,11,13,13,14,15,11,DM/M C,1,1,1,1,1,1,1,1,1,20,17,1,1,1,1
19075630,Uander,1651,23/12/1990,25,0,0,0,0,172,62,2,1,2,1,2,2,3,3,3,2,1,3,2,7,7,13,4,5,8,1,4,12,1,4,13,8,8,7,12,6,7,13,8,13,11,10,7,6,7,13,9,6,1,8,11,10,20,12,5,8,3,8,8,8,12,9,13,12,10,5,5,2,AM C,1,1,1,20,1,1,1,1,1,1,15,1,1,1,1
19075821,Alexandre,1651,28/04/1992,24,0,0,0,0,187,78,3,3,3,3,3,2,3,1,2,2,3,4,9,7,7,10,4,4,8,4,9,12,4,9,12,7,9,7,10,10,11,10,9,12,4,8,11,11,8,12,12,12,9,20,12,11,11,12,12,12,10,12,5,7,14,10,12,13,9,8,5,7,M/AM C,1,1,1,20,10,10,1,1,1,11,19,5,5,1,1
19075825,Borges,1651,31/01/1991,25,0,0,0,0,179,0,13,11,10,8,13,12,13,15,11,10,14,2,2,2,1,6,3,3,3,3,3,6,2,1,8,13,9,12,7,10,4,9,11,5,5,5,11,8,10,9,13,11,11,2,12,9,20,9,14,10,11,10,7,8,9,14,15,10,14,7,12,11,GK ,20,1,1,1,1,1,1,1,1,1,1,1,1,1,1
19075839,Miguel,1651,14/05/1992,24,0,0,0,0,190,84,3,1,1,1,2,3,2,2,2,3,3,3,4,9,12,11,11,13,9,3,4,9,13,6,9,12,10,12,10,11,9,10,10,9,10,11,8,12,12,10,9,13,15,9,14,9,20,12,11,12,8,12,5,7,14,13,13,9,14,11,15,6,S ,1,1,20,1,1,1,1,1,1,1,1,1,1,1,1
19075841,Paulo Miranda,1651,16/08/1988,27,0,0,0,0,185,84,1,1,2,2,2,1,3,3,2,2,1,5,10,11,10,12,13,13,8,8,13,12,8,14,12,12,14,13,14,12,9,13,13,8,4,11,13,14,13,13,13,14,12,8,14,13,20,15,14,10,7,12,4,12,5,9,10,9,13,8,6,7,D RC,1,12,1,1,1,1,20,1,15,14,10,1,1,1,13
19076427,Aderllan Santos,1651,09/04/1989,27,0,0,0,0,192,89,1,2,2,3,3,3,3,1,2,3,4,3,6,6,8,8,9,15,11,10,14,12,10,16,11,12,13,13,10,11,8,13,14,6,12,8,14,14,14,14,9,10,16,7,12,15,20,14,16,14,10,9,7,7,12,13,11,12,11,15,13,9,D C,1,11,1,1,1,1,20,1,1,1,1,1,1,1,1
19076432,Moreilândia,1651,13/04/1989,27,0,0,0,0,174,70,3,1,1,3,2,2,3,2,1,1,3,10,7,9,9,10,11,9,12,5,14,11,10,13,10,15,13,14,9,11,9,11,4,9,10,13,13,15,13,13,14,12,9,6,9,12,20,13,9,10,10,10,10,10,17,11,11,12,12,10,13,5,DM/M C,1,1,1,1,1,1,1,1,1,17,20,12,1,1,1
19076472,Cirilo,1651,13/03/1980,36,0,0,0,0,185,81,3,2,2,2,2,1,2,1,4,1,1,5,4,2,4,9,8,15,4,6,15,10,3,15,9,10,14,10,9,12,5,15,10,5,14,7,15,9,10,12,8,10,9,2,11,10,20,7,11,10,10,8,8,10,14,12,10,10,12,10,10,1,D C,1,1,1,1,1,1,20,1,1,1,1,1,1,1,1
19076515,Maurício Leal,1651,11/06/1987,29,0,0,0,0,186,85,1,2,1,3,1,1,3,3,4,2,3,1,3,6,5,7,2,13,5,8,10,8,2,12,8,14,10,13,9,10,4,12,9,3,11,3,13,12,9,9,8,12,13,6,13,10,20,13,12,12,12,9,6,9,9,14,9,11,11,9,11,1,D C,1,1,1,1,1,1,20,1,1,1,1,1,1,1,1
19079215,Granjinha,1651,12/07/1989,26,0,0,0,0,175,71,2,3,4,2,1,1,3,3,3,3,3,5,5,10,12,12,5,12,6,1,4,6,5,1,8,5,9,4,8,2,5,10,9,9,8,10,4,5,7,12,12,11,5,9,9,12,20,11,5,9,6,9,6,9,9,11,12,13,10,3,13,6,S ,1,1,20,1,1,1,1,1,1,1,1,1,1,1,1
19080206,Túlio Renan,1651,18/03/1989,27,0,0,0,0,181,73,2,2,2,3,1,1,3,2,2,1,1,6,4,14,8,14,8,11,6,5,8,9,6,4,13,10,11,6,10,7,9,12,4,12,12,14,9,8,9,14,14,9,8,20,14,14,10,12,8,10,7,10,5,10,16,12,11,9,12,1,8,7,S ,1,1,20,1,1,1,1,1,1,1,1,1,1,1,1
19080207,Alan Costa,1651,30/10/1990,25,0,0,0,0,194,82,4,3,2,3,3,1,3,1,1,2,1,3,4,4,5,11,7,14,10,5,13,12,7,13,8,10,13,12,10,12,8,15,16,1,14,9,11,10,13,14,12,11,16,7,15,13,20,10,10,16,10,13,11,11,15,11,11,10,10,3,16,7,D C,1,1,1,1,1,1,20,1,1,1,1,1,1,1,1
19080470,Pink,1651,18/05/1990,26,0,0,0,0,176,65,1,2,2,1,2,2,3,3,4,3,3,5,8,9,8,11,7,8,11,8,13,11,8,12,10,13,11,13,9,10,9,9,13,11,11,11,12,14,13,12,13,9,8,12,15,13,20,13,10,13,11,11,8,8,8,14,9,12,10,6,7,14,DM/M C,1,1,1,1,1,1,1,1,1,20,16,1,1,1,1
19080661,Rafael Broetto,1651,18/08/1990,25,0,0,0,0,195,81,14,11,12,1,14,14,9,11,10,10,13,3,1,1,2,1,7,1,3,1,3,2,1,1,4,10,10,11,9,14,8,14,2,3,11,1,10,9,8,14,9,9,17,11,17,10,20,7,14,10,10,10,9,10,14,10,10,10,12,8,8,2,GK ,20,1,1,1,1,1,1,1,1,1,1,1,1,1,1
19080665,Marcão,1651,25/09/1985,30,0,0,0,0,190,83,3,3,3,2,1,2,1,3,4,3,1,7,8,10,14,11,9,14,12,8,6,10,14,5,11,12,12,12,13,11,9,12,14,13,10,11,7,12,11,13,11,12,15,13,14,13,20,13,14,10,12,11,8,11,7,14,14,12,11,15,13,11,S ,1,1,20,1,1,1,1,1,1,1,1,1,1,1,1
19080674,Marcelo,1651,27/07/1989,26,0,0,0,0,182,74,2,1,2,1,1,1,2,3,2,3,1,7,7,8,8,11,6,13,5,6,15,15,8,15,13,13,14,15,13,14,11,13,15,7,12,8,14,14,14,12,14,14,13,8,14,13,20,14,13,13,10,13,13,8,15,14,13,12,15,13,12,7,D C,1,5,1,1,1,1,20,1,1,8,1,1,1,1,1
19080742,Jair,1651,10/01/1991,25,0,0,0,0,174,69,2,2,3,3,2,3,3,2,1,2,3,5,2,1,6,11,4,5,8,3,10,9,1,10,7,6,8,3,5,7,8,13,6,6,9,5,10,7,11,13,13,6,5,5,14,13,20,7,6,8,8,8,8,8,11,13,11,11,8,3,14,3,DM ,1,1,1,1,1,1,1,1,1,20,13,1,1,1,1
19080849,Boka,1651,12/05/1988,28,0,0,0,0,190,86,1,4,3,3,2,1,2,2,1,3,1,6,8,10,14,10,9,12,7,6,5,8,10,6,10,12,11,12,11,7,11,12,7,10,8,12,7,7,10,12,9,12,15,9,10,11,20,12,13,9,5,8,10,6,7,8,10,8,10,7,10,7,S ,1,1,20,1,1,1,1,1,1,1,1,1,1,1,1
19080851,Juninho,1651,05/04/1985,31,0,0,0,0,167,58,1,1,3,4,2,2,3,2,4,3,2,9,11,12,11,12,9,7,9,4,3,11,12,3,13,10,10,12,10,11,11,13,12,15,7,14,6,8,10,15,15,15,3,10,13,14,20,12,1,13,7,13,7,11,8,11,11,12,11,8,8,5,S ,1,1,20,11,13,14,1,1,1,1,1,1,1,1,1
19081023,Felipe Alberto,1651,01/01/1989,27,0,0,0,0,178,72,3,1,3,1,1,1,3,2,1,2,3,8,11,9,8,11,4,6,3,4,4,5,3,1,10,4,7,4,11,5,6,11,3,11,5,7,4,5,7,12,12,5,2,20,11,12,9,11,5,5,8,8,8,8,8,11,11,12,9,9,7,9,AM L,1,1,15,1,20,1,1,1,1,1,1,13,1,1,1
19081024,Luan,1651,08/11/1990,25,0,0,0,0,170,69,1,3,1,3,2,1,1,3,3,3,3,8,12,13,14,14,11,12,14,7,13,15,11,11,15,12,14,13,12,13,15,13,16,15,10,15,6,13,15,15,13,8,6,11,15,13,20,13,8,13,7,14,11,18,18,10,10,14,15,8,14,5,AM/S RLC,1,1,18,16,17,20,1,1,1,1,15,13,15,1,1
19081025,Ramos,1651,03/06/1991,25,0,0,0,0,172,68,1,3,1,3,1,3,1,2,2,3,2,14,12,11,11,12,13,6,12,2,2,12,13,2,15,7,8,7,12,9,12,12,10,13,10,10,5,9,7,10,10,9,6,20,14,10,16,9,11,14,6,10,13,11,10,12,15,8,14,10,15,6,M/AM C,1,1,8,20,14,11,1,1,1,1,16,13,10,1,1
19081032,Sassá,1651,26/01/1988,28,0,0,0,0,177,73,2,3,1,2,1,3,2,3,1,2,4,8,9,10,10,10,9,8,9,2,6,8,11,5,11,11,9,10,9,9,7,7,11,13,7,11,7,8,9,14,14,11,7,9,14,14,20,10,8,12,8,10,9,11,11,11,11,11,11,4,3,1,AM L,1,1,15,7,20,13,1,1,1,1,1,1,1,1,1
19081040,Somália,1651,28/09/1988,27,0,0,0,0,180,73,1,3,2,3,2,1,1,3,3,1,1,6,10,12,10,7,5,11,5,10,11,10,12,9,12,10,12,14,11,10,10,10,14,10,5,10,9,13,13,16,14,13,11,5,13,18,20,13,10,9,8,7,7,12,17,13,11,14,14,12,13,7,M/AM RC,1,1,10,15,13,20,1,7,15,15,17,13,15,1,15
19081047,Daniel Damião,1651,05/05/1988,28,0,0,0,0,172,68,2,2,3,1,2,1,2,3,1,1,2,9,13,4,8,14,5,5,12,15,11,12,8,11,10,10,11,11,11,9,8,15,10,10,4,7,13,11,11,14,13,8,7,11,7,13,20,15,8,10,10,10,10,10,18,9,9,14,12,1,11,1,D/WB R,1,1,1,1,1,1,1,1,20,1,1,1,1,1,19
19081264,Silézio,1651,03/01/1993,23,0,0,0,0,188,87,10,11,10,5,11,12,10,11,11,4,8,3,1,2,3,3,7,1,2,2,2,1,3,2,1,7,9,11,7,7,6,13,4,3,11,1,11,6,2,11,15,7,9,1,13,11,20,4,10,9,9,9,4,9,20,11,13,12,10,9,12,1,GK ,20,1,1,1,1,1,1,1,1,1,1,1,1,1,1
19081620,Alexandre,1651,25/03/1990,26,0,0,0,0,179,81,2,2,4,2,4,3,2,1,3,2,1,6,4,8,1,12,2,9,6,3,12,8,3,14,8,10,8,10,6,11,6,14,10,4,10,7,9,9,9,14,14,9,6,20,11,14,10,14,9,10,7,2,9,10,18,10,10,12,10,8,2,2,D L,1,1,1,1,1,1,1,20,1,1,1,1,1,10,1
19081650,Diogo,1651,08/07/1985,30,0,0,0,0,181,80,1,1,3,1,1,1,3,1,2,3,3,7,7,9,8,13,7,7,9,2,7,12,5,8,9,10,7,8,8,8,13,13,10,10,10,7,9,8,12,13,13,8,9,9,10,13,20,8,6,12,4,10,10,10,7,10,12,12,13,4,9,3,AM C,1,1,1,20,1,1,1,1,1,1,15,1,1,1,1
19081674,Rafael Assis,1651,31/10/1990,25,0,0,0,0,170,70,1,3,4,3,1,3,2,1,2,2,1,9,9,10,10,10,5,12,13,7,13,13,9,14,11,14,14,15,9,15,10,12,14,9,11,9,17,13,17,14,15,13,12,7,15,13,20,15,13,14,10,12,9,11,11,13,14,13,14,14,14,5,DM/M C,1,1,1,7,1,1,10,1,1,20,18,1,1,1,1
19081676,Bruno Chocolate,1651,22/03/1989,27,0,0,0,0,176,76,3,1,2,2,1,1,3,2,3,3,2,12,11,12,11,10,11,9,10,5,1,12,12,6,11,10,11,10,11,11,11,11,2,10,7,11,6,9,10,13,12,11,8,20,12,12,4,12,11,10,4,10,8,9,15,12,13,10,10,10,15,6,S C,1,1,20,15,1,1,1,1,1,1,10,1,1,1,1
19081682,Maicon Assis,1651,04/03/1990,26,0,0,0,0,169,65,2,4,3,3,2,2,1,2,1,2,3,8,10,12,9,10,9,7,8,6,5,10,9,6,11,11,11,10,9,9,12,10,14,12,8,10,7,12,13,12,11,12,7,8,12,12,20,11,9,9,8,10,10,13,9,13,12,13,14,13,13,8,M/AM/S C,1,1,18,20,14,14,1,1,1,1,19,13,13,1,1
19081789,Diogo Sodré,1651,21/03/1991,25,0,0,0,0,181,78,3,1,1,3,2,3,2,2,3,3,1,9,11,11,9,11,12,5,10,3,7,14,2,9,11,10,11,5,6,8,12,14,10,10,13,10,9,9,13,14,14,11,11,11,14,14,20,8,11,10,6,4,10,10,16,12,12,11,11,5,14,4,AM RC,1,1,1,20,13,16,1,1,1,1,15,13,14,1,1
19081796,Rhayner,1651,05/09/1990,25,0,0,0,0,172,64,2,3,2,2,2,3,1,3,2,3,3,11,12,12,8,13,11,4,7,4,11,11,9,13,11,17,12,16,7,11,12,11,14,15,7,12,15,11,16,16,15,13,6,3,14,16,20,14,6,15,15,15,8,15,12,11,11,13,12,8,11,8,AM/S RLC,1,1,18,15,17,20,1,1,8,9,15,12,13,1,8
19081798,Willian José,1651,23/11/1991,24,0,0,15,8,186,87,2,3,3,1,2,1,1,2,2,2,1,10,10,14,14,17,15,14,17,7,5,14,15,8,16,12,12,13,14,7,13,12,15,15,9,14,13,12,12,12,12,11,14,13,12,12,20,12,17,13,15,12,10,7,10,14,7,12,11,9,8,12,AM/S C,1,1,20,18,9,8,1,1,1,1,1,1,1,1,1
19081808,Geovane Maranhão,1651,04/02/1989,27,0,0,0,0,174,73,1,3,3,1,2,2,2,2,3,2,3,8,13,13,10,11,7,9,6,7,7,8,3,5,13,12,11,9,9,6,7,9,14,12,10,10,4,8,10,13,13,4,5,8,13,13,20,12,7,10,9,10,10,10,20,11,9,12,13,7,19,6,AM/S RL,1,1,19,10,17,20,1,1,1,1,1,1,1,1,1
19081868,Laio,1651,02/05/1989,27,0,0,0,0,184,73,3,3,1,3,2,2,2,3,2,2,2,3,9,9,10,9,6,10,8,7,5,10,10,4,11,11,12,11,12,12,10,8,14,11,8,11,6,12,12,10,10,8,13,13,14,13,20,13,12,12,6,10,7,10,11,13,9,12,12,7,11,7,S ,1,1,20,1,1,1,1,1,1,1,1,1,1,1,1
19081949,Thiago Miracema,1651,08/12/1987,28,0,0,0,0,172,75,1,2,3,3,3,1,3,2,3,1,3,8,10,12,9,11,8,4,10,7,2,11,8,3,12,9,6,8,7,6,9,6,13,12,3,10,2,8,8,15,15,9,5,10,12,14,20,10,11,11,10,10,10,10,11,11,8,8,14,7,15,2,AM RL,1,1,14,13,20,15,1,1,1,1,1,15,13,1,1
19082268,Danielzinho,1651,21/02/1988,28,0,0,0,0,178,68,1,3,1,4,1,2,2,1,2,3,1,11,12,13,7,12,9,7,8,5,8,10,9,5,12,9,11,6,11,9,7,15,13,14,9,11,7,6,11,14,14,6,10,10,10,13,20,9,4,11,5,9,9,10,11,12,13,12,7,5,12,7,AM/S RL,1,1,20,1,17,15,1,1,1,1,1,12,10,1,1
19082269,Marquinhos Gabriel,1651,21/07/1990,25,0,0,0,0,174,69,2,1,1,2,3,4,2,3,2,2,3,12,13,14,13,14,11,8,13,6,5,14,11,5,14,12,14,13,13,12,14,12,15,14,7,13,6,12,13,15,15,13,7,20,15,15,9,13,8,13,11,12,3,12,13,14,11,14,11,7,13,7,AM RL,1,1,10,13,20,16,1,1,1,1,12,14,1,1,1
19082281,Pedro Bambu,1651,06/06/1987,29,0,0,0,0,175,72,1,3,4,2,3,2,1,2,1,2,1,8,10,11,9,10,7,10,8,8,10,11,3,11,11,11,11,11,10,11,12,14,12,12,8,10,10,13,11,14,12,10,7,12,10,13,20,11,10,11,10,6,9,11,17,8,10,12,10,6,7,7,DM R,1,1,1,1,1,1,1,1,15,20,10,1,1,1,15
19082366,Willian Leandro,1651,31/07/1985,30,0,0,0,0,177,0,4,3,1,3,1,1,2,2,1,3,1,6,3,13,13,13,7,9,5,3,3,13,6,7,13,6,7,7,13,7,8,13,4,13,11,11,6,8,9,13,13,8,6,9,11,13,20,11,9,10,9,10,4,10,8,11,11,12,12,7,9,8,AM C,1,1,14,20,1,1,1,1,1,1,1,1,1,1,1
19082390,Bruno Santos,1651,22/11/1987,28,0,0,0,0,175,76,3,1,1,3,1,2,4,1,1,3,2,4,11,3,4,8,1,5,3,5,6,7,1,9,7,8,9,8,6,8,6,11,3,8,10,5,10,6,7,13,12,6,7,20,15,13,9,12,6,8,8,7,8,8,8,11,9,10,12,1,15,4,D L,1,1,1,1,1,1,1,20,1,1,1,1,1,15,1
19082479,Diego Ivo,1651,06/04/1989,27,0,0,0,0,188,84,2,3,1,3,2,3,3,3,3,1,1,3,5,5,3,7,4,15,3,8,13,8,1,14,6,13,10,15,4,12,7,9,14,4,11,6,13,14,15,14,9,15,15,8,16,15,20,15,16,13,11,12,11,3,11,12,11,12,14,12,14,5,D C,1,1,1,1,1,1,20,1,1,1,1,1,1,1,1
19082482,Laércio,1651,03/02/1990,26,0,0,0,0,170,64,4,1,2,1,1,3,3,2,3,2,4,8,7,13,13,14,8,8,6,1,7,9,6,3,14,6,13,6,8,6,8,14,7,13,3,14,6,8,9,14,14,9,6,11,14,14,20,14,8,10,7,10,10,10,14,10,13,11,10,6,14,8,S ,1,1,20,1,1,1,1,1,1,1,1,1,1,1,1
19082484,Cleyton,1651,12/04/1989,27,0,0,0,0,186,84,1,2,1,1,1,4,2,1,2,3,2,4,2,1,2,7,1,13,1,1,9,7,1,13,5,5,11,9,4,10,4,12,9,3,6,6,13,6,7,13,12,8,12,10,13,12,20,12,12,9,13,9,9,9,13,12,10,10,12,8,8,5,D C,1,1,1,1,1,1,20,1,6,1,1,1,1,1,3
19082485,Cristian,1651,07/08/1990,25,0,0,0,0,175,69,1,3,2,3,3,1,3,2,1,2,1,3,4,13,12,9,7,11,8,2,5,10,12,1,10,6,12,2,10,8,10,13,6,10,10,13,7,6,8,12,12,8,7,9,16,13,20,14,10,12,10,10,5,10,16,12,11,11,14,8,7,4,S ,1,1,20,1,1,1,1,1,1,1,1,1,1,1,1
19082499,Medina,1651,23/04/1990,26,0,0,0,0,171,68,4,2,1,1,2,3,2,2,1,1,2,11,11,12,8,11,9,6,9,11,9,11,9,10,11,11,11,11,11,10,11,11,13,12,4,11,11,11,11,13,13,7,5,7,15,12,20,12,7,12,11,10,6,12,12,13,13,13,11,8,11,10,D/WB/AM RC,1,1,1,20,1,17,1,1,19,1,8,1,13,1,19
19082502,Remerson,1651,07/02/1989,27,0,0,0,0,188,83,14,7,8,1,13,12,9,12,10,9,9,7,1,2,3,8,10,1,1,3,1,2,1,3,6,10,11,15,6,14,8,14,8,3,4,2,11,9,8,11,13,9,10,20,12,13,1,8,12,10,10,8,9,10,16,9,11,11,12,2,14,6,GK ,20,1,1,1,1,1,1,1,1,1,1,1,1,1,1
19082550,João Ricardo,1651,06/09/1988,27,0,0,0,0,185,78,12,12,13,10,14,12,12,13,12,12,13,7,2,2,3,3,11,1,3,1,1,6,3,3,6,11,12,16,12,14,11,11,11,3,8,3,12,12,13,14,14,10,11,12,8,13,20,8,10,12,5,11,7,11,17,11,11,10,11,11,6,5,GK ,20,1,1,1,1,1,1,1,1,1,1,1,1,1,1
19082556,Valdo,1651,08/02/1988,28,0,0,0,0,183,75,1,3,2,3,2,3,2,2,2,1,3,11,13,13,10,9,7,9,9,7,7,7,6,5,12,10,8,8,8,8,9,8,7,10,6,8,7,8,9,12,12,9,10,5,13,13,20,13,8,10,10,10,5,10,13,13,12,11,9,3,6,3,AM/S RL,1,1,17,1,20,18,1,1,1,1,1,15,14,1,1
19082598,Lucas,1651,06/05/1990,26,0,0,0,0,184,91,2,2,1,3,2,1,3,1,2,3,3,5,3,8,13,13,5,13,6,1,6,7,7,3,13,7,6,6,8,6,5,11,1,13,2,13,7,6,8,13,11,6,10,5,9,12,20,12,9,9,7,8,9,9,10,11,13,13,10,10,11,2,S ,1,1,20,1,1,1,1,1,1,1,1,1,1,1,1
19082599,Paganelli,1651,19/08/1988,27,0,0,0,0,190,84,3,3,2,1,1,3,4,3,1,3,1,1,1,2,1,6,1,10,5,1,8,6,1,9,4,8,9,8,6,6,4,9,7,1,7,5,13,5,6,13,10,6,14,9,9,13,20,4,12,8,8,6,8,8,20,7,13,10,13,12,12,4,D C,1,1,1,1,1,1,20,1,1,1,1,1,1,1,1
19082602,Tiago Xitão,1651,02/07/1989,27,0,0,0,0,191,77,13,8,9,2,13,10,8,12,3,8,8,1,2,1,3,1,3,1,3,3,3,1,2,2,1,8,7,12,6,8,4,7,4,1,9,1,9,6,5,12,12,6,15,9,10,7,20,2,9,8,7,6,7,7,8,10,10,10,9,10,2,7,GK ,20,1,1,1,1,1,1,1,1,1,1,1,1,1,1
19082671,Leandro Damião,1651,22/07/1989,26,17,3,0,0,188,81,2,1,3,3,3,3,2,2,4,2,4,8,7,14,14,13,8,16,10,6,7,12,12,7,13,10,11,15,12,12,12,12,16,13,8,12,7,12,11,13,11,15,15,9,12,14,20,15,15,8,7,15,13,7,14,16,18,12,10,12,10,10,S ,1,1,20,1,1,1,1,1,1,1,1,1,1,1,1
19082739,Douglas Pedroso,1651,03/06/1989,27,0,0,0,0,182,70,3,1,4,3,3,1,1,2,1,3,2,7,6,2,7,12,6,6,11,1,9,14,1,12,11,1,14,8,8,10,10,12,3,3,11,6,8,7,10,13,11,8,8,8,11,10,20,7,11,9,9,2,6,9,10,11,11,8,11,1,19,6,DM ,1,1,1,1,1,1,1,1,1,20,10,1,1,1,1
19082743,Ferrugem,1651,28/03/1988,28,0,0,0,0,183,70,2,1,2,1,2,1,3,2,3,3,2,9,10,12,11,11,10,10,13,6,11,11,10,12,12,14,12,14,12,11,12,11,12,12,9,12,11,13,15,14,14,12,11,7,16,13,20,11,8,12,14,10,9,14,19,12,13,12,12,7,11,5,D/DM/M RC,1,1,1,1,1,9,7,1,16,20,17,1,12,1,15
19082744,Georginho,1651,25/03/1991,25,0,0,0,0,186,76,3,2,3,1,1,1,3,3,2,1,4,11,11,12,10,11,14,12,13,10,8,12,12,8,12,9,12,11,12,8,13,11,12,12,7,13,9,13,12,13,10,13,12,12,12,11,20,14,11,11,7,11,7,13,15,16,6,9,10,12,7,7,AM C,1,1,12,20,1,1,1,1,1,10,15,1,1,1,1
19082748,Jessé,1651,30/03/1992,24,0,0,0,0,184,80,3,1,2,1,1,3,1,2,1,2,3,6,4,3,4,12,6,6,8,5,8,11,4,13,12,9,10,13,6,9,10,12,4,8,12,6,9,7,10,13,13,8,11,14,6,13,20,9,10,9,7,9,8,9,16,11,12,10,14,3,11,8,DM ,1,1,1,1,1,1,10,1,1,20,10,1,1,1,1
19082750,Lucas Lima,1651,10/10/1991,24,0,0,0,0,178,73,1,1,3,3,1,2,3,2,3,1,2,8,13,13,11,12,12,10,12,11,12,13,5,8,13,5,12,9,12,12,12,11,15,12,5,12,7,13,12,15,15,11,9,20,12,15,8,14,11,11,12,12,6,13,13,14,9,10,9,6,9,6,D/WB L,1,1,1,1,14,1,1,20,1,1,1,15,1,19,1
19082753,Marcel,1651,28/03/1992,24,0,0,0,0,178,66,3,3,1,1,1,2,3,1,2,1,3,6,5,13,13,8,6,13,6,5,4,7,3,2,10,8,13,8,10,7,3,13,9,10,13,13,7,6,7,13,12,7,9,20,9,10,9,5,10,9,9,5,9,9,6,13,13,10,9,1,13,8,S ,1,1,20,1,1,1,1,1,1,1,1,1,1,1,1
19082803,Guilherme,1651,01/07/1988,28,0,0,0,0,179,0,3,3,1,3,1,1,3,3,2,2,1,5,7,10,13,13,6,13,7,4,2,7,4,1,9,9,12,3,8,7,6,13,9,9,6,13,7,6,7,13,13,7,3,11,13,13,20,12,5,7,9,3,7,9,14,12,14,10,11,3,8,6,S ,1,1,20,1,1,1,1,1,1,1,1,1,1,1,1
19082804,Rodrigo Moledo,1651,27/10/1987,28,0,0,0,0,188,91,3,1,4,2,2,1,3,1,1,1,2,4,8,9,9,10,7,15,8,9,15,12,9,14,11,19,12,16,12,13,8,12,16,7,12,10,14,14,15,13,12,14,15,8,12,13,20,13,16,16,13,13,12,6,13,14,13,12,13,8,10,8,D C,1,1,1,1,1,1,20,1,1,1,1,1,1,1,1
19082805,Ruan,1651,07/10/1987,28,0,0,0,0,172,0,2,2,1,1,2,4,3,2,2,2,2,5,6,13,4,10,2,5,4,6,8,10,8,7,10,7,10,10,9,9,8,9,3,4,13,7,9,9,9,14,14,14,6,20,12,14,10,12,7,9,5,9,6,9,14,10,12,11,10,8,7,8,D/WB L,1,1,1,1,1,1,1,20,1,1,1,1,1,16,1
19083100,Aldair,1651,07/11/1991,24,0,0,0,0,174,64,1,1,2,3,3,3,3,3,3,1,1,10,11,12,11,11,10,11,10,6,5,11,12,6,11,10,10,10,10,10,9,10,13,12,5,11,10,10,10,13,13,14,7,9,13,14,20,11,8,12,10,11,8,9,10,14,15,10,13,7,8,14,S ,1,1,20,14,10,10,1,1,1,1,9,5,5,1,1
19083108,Marcelão,1651,07/06/1988,28,0,0,0,0,192,84,1,1,2,2,2,2,2,1,2,2,2,1,3,1,4,7,1,12,6,1,9,7,4,11,3,9,11,9,6,9,2,13,2,1,7,6,10,6,8,13,9,7,15,9,13,10,20,12,12,9,6,9,9,9,10,11,11,7,13,11,8,2,D C,1,1,1,1,1,1,20,1,1,1,1,1,1,1,1
19083115,Jocinei,1651,04/02/1990,26,0,0,0,0,182,83,2,2,3,1,3,2,2,3,1,1,3,6,10,12,11,10,13,8,14,9,12,13,10,12,12,11,11,13,11,10,12,12,14,10,12,10,12,11,13,12,10,10,11,20,13,12,9,14,15,10,12,11,5,11,8,10,12,9,18,8,12,5,DM/M C,1,1,1,1,1,1,1,1,1,19,20,1,1,1,1
19083281,Dudu,1651,24/06/1979,37,0,0,0,0,177,67,1,2,2,1,3,1,2,1,3,1,2,7,8,7,11,14,8,10,4,7,8,10,3,10,10,4,9,9,10,11,7,14,3,9,14,10,9,7,9,14,12,8,6,9,12,11,20,7,7,9,5,10,4,10,14,12,9,7,14,4,13,8,D/WB R,1,1,15,1,1,1,1,1,20,1,1,1,1,1,19
19083339,Romário,1651,27/10/1992,23,0,0,0,0,186,85,2,2,4,2,3,1,2,3,3,2,3,7,8,13,14,13,10,13,12,6,5,12,13,7,13,10,9,12,13,12,14,14,13,14,10,11,13,12,11,8,12,14,10,10,8,8,20,10,15,10,13,11,9,6,14,14,9,14,5,9,7,11,S ,1,1,20,1,1,1,1,1,1,1,1,1,1,1,1
19083455,Tony,1651,04/08/1989,26,0,0,0,0,177,72,1,1,2,4,2,3,2,3,3,2,1,11,12,11,10,12,10,8,11,12,11,12,12,10,12,12,10,14,8,8,9,8,6,12,5,12,12,15,13,14,14,11,9,11,12,13,20,14,11,12,10,13,5,12,15,10,10,10,12,7,16,5,D/WB R,1,1,1,1,1,5,1,1,18,1,1,1,10,1,20
19083592,Bruno Silva,1651,14/09/1992,23,0,0,0,0,170,67,3,1,3,3,2,1,1,1,2,3,1,14,10,11,7,12,13,7,7,12,11,13,10,14,12,12,12,12,9,11,11,10,15,10,8,12,9,13,13,14,12,9,7,20,12,14,9,12,11,12,8,13,12,14,14,14,12,13,13,12,12,8,D LC,1,1,1,8,1,1,1,20,1,13,15,1,1,14,1
19084056,Alan Patrick,1651,13/05/1991,25,0,0,10,2,177,68,3,2,3,3,3,2,1,1,1,3,2,13,13,14,13,15,15,8,12,7,7,15,12,6,16,12,12,11,13,12,15,12,13,15,8,13,7,13,13,15,14,8,7,7,12,15,20,13,8,10,6,7,7,13,13,15,13,13,13,7,11,12,M/AM RLC,1,1,1,20,19,19,1,1,1,1,18,14,16,1,1
19084175,Felipe Azevedo,1651,10/01/1987,29,0,0,0,0,174,74,1,3,3,2,3,2,3,4,1,1,3,9,10,13,13,12,9,11,9,9,8,12,13,7,13,8,13,9,13,13,12,12,10,13,10,14,10,13,12,14,14,12,7,12,10,13,20,14,10,11,7,12,9,13,6,4,8,9,7,12,4,9,AM/S RL,1,1,17,7,20,19,1,1,1,1,1,1,1,1,1
19084184,Liel,1651,22/05/1989,27,0,0,0,0,181,0,1,3,2,2,2,1,1,2,1,3,3,7,7,5,8,13,6,7,8,3,11,13,6,13,13,5,13,9,8,7,9,13,8,10,13,5,13,8,12,13,13,8,9,7,10,12,20,7,13,10,5,4,10,10,14,10,10,10,10,10,7,6,DM ,1,1,1,1,1,1,10,1,1,20,1,1,1,1,1
19084206,Wesley,1651,02/07/1990,26,0,0,0,0,193,0,3,4,1,2,3,1,2,1,1,1,3,3,2,1,4,7,1,13,5,2,9,7,3,13,6,9,9,9,7,7,5,12,5,8,13,6,12,6,7,13,11,7,13,10,11,11,20,11,9,5,9,2,9,9,9,11,13,11,14,8,5,3,D C,1,1,1,1,1,1,20,1,1,1,1,1,1,1,1
19084256,Peterson,1651,17/02/1992,24,0,0,0,0,171,0,3,1,1,3,1,2,3,4,2,1,2,3,8,12,9,9,7,6,11,3,3,9,7,4,14,4,16,10,9,7,8,8,11,11,3,16,6,10,12,13,14,7,5,7,16,14,20,13,5,10,10,10,8,10,17,10,9,11,12,6,14,7,S ,1,1,20,9,8,12,1,1,1,1,1,1,1,1,1
19084261,Luís Felipe,1651,08/04/1991,25,0,0,0,0,178,73,2,2,1,1,3,1,3,2,1,2,1,10,12,12,9,11,11,6,11,12,8,11,12,8,12,13,11,12,10,11,10,11,14,13,6,12,9,11,12,14,14,7,7,16,16,14,20,11,8,13,11,12,6,16,12,14,8,14,11,9,13,13,D/WB R,1,1,1,8,3,10,1,12,20,7,11,6,12,11,19
19084325,Alex Amado,1651,29/04/1987,29,0,0,0,0,167,0,1,3,3,1,2,3,1,1,3,3,3,11,10,11,10,12,9,9,10,7,7,11,12,5,12,10,10,9,11,10,11,10,4,14,9,11,5,10,10,14,11,10,6,10,12,14,20,11,11,11,9,10,8,12,14,12,9,12,8,5,5,5,AM/S L,1,1,20,1,16,1,1,1,1,1,1,1,1,1,1
19084349,Gerley,1651,11/09/1990,25,0,0,0,0,182,0,2,2,2,2,3,1,1,3,3,2,1,11,12,12,11,12,10,13,9,9,10,12,12,10,11,15,12,13,12,10,12,12,5,12,8,12,12,13,13,14,12,13,11,20,13,14,7,13,13,12,14,11,10,10,11,9,9,9,5,4,5,2,D/WB L,1,1,1,1,1,1,7,20,1,10,1,1,1,16,1
19084534,Diego Rosa,1651,17/04/1989,27,0,0,0,0,189,0,3,3,3,1,3,1,1,3,3,3,1,9,5,7,6,10,5,9,7,4,10,7,8,11,9,9,11,10,10,10,9,10,9,5,2,9,11,9,10,10,11,10,13,9,10,9,20,13,11,9,9,2,5,9,7,14,11,11,13,10,15,5,D C,1,1,1,1,1,1,20,1,1,1,1,1,1,1,1
19084539,Lenine,1651,15/04/1991,25,0,0,0,0,185,77,1,2,3,2,3,1,3,1,1,1,3,6,7,7,8,8,8,10,11,8,14,8,13,14,8,13,10,15,8,8,8,8,12,11,10,9,15,15,14,12,12,15,12,13,14,12,20,14,16,12,11,10,6,11,8,11,7,9,11,9,10,10,DM/M C,1,1,1,1,1,1,12,1,1,20,18,1,1,1,1
19084593,Leandro Silva,1651,22/09/1988,27,0,0,0,0,181,76,3,2,2,1,2,1,3,1,1,2,1,10,11,11,8,9,9,9,8,11,11,11,9,13,10,15,12,11,11,11,11,11,2,11,11,14,9,12,12,14,12,11,10,10,14,13,20,14,10,11,15,11,13,9,7,10,10,8,11,6,6,8,D/WB R,1,1,1,1,1,1,1,1,20,1,1,1,1,1,19
19084638,André Recife,1651,27/08/1989,26,0,0,0,0,181,66,3,3,2,2,4,2,3,1,1,2,3,3,6,10,13,9,8,12,10,4,4,9,14,4,10,11,10,11,12,10,9,10,12,15,5,13,12,8,10,11,10,11,11,20,13,11,8,9,11,12,8,10,8,15,11,12,14,10,14,14,13,10,S ,1,1,20,14,1,1,1,1,1,1,11,1,1,1,1
19084713,Caio Secco,1651,22/12/1990,25,0,0,0,0,192,76,12,11,11,8,12,12,11,13,10,10,11,3,3,3,2,5,7,1,2,3,2,7,3,2,5,8,10,11,11,11,4,10,10,3,5,5,10,9,10,10,12,11,15,5,13,10,20,13,13,11,7,10,9,9,18,11,14,12,9,10,15,3,GK ,20,1,1,1,1,1,1,1,1,1,1,1,1,1,1
19084715,Leonardo,1651,09/03/1990,26,0,0,0,0,189,82,11,8,12,4,11,12,14,15,6,10,11,4,2,1,1,3,9,1,1,2,3,3,1,2,7,10,9,13,7,10,9,9,5,1,9,2,15,10,9,8,11,13,14,9,9,9,20,13,13,10,5,1,9,10,15,9,9,9,10,10,17,6,GK ,20,1,1,1,1,1,1,1,1,1,1,1,1,1,1
19084723,Lúcio,1651,18/04/1990,26,0,0,0,0,188,88,13,12,8,1,13,13,6,13,8,9,7,6,1,2,3,6,9,1,2,1,1,1,4,2,4,9,9,13,6,13,6,8,5,3,9,1,7,7,6,12,11,5,14,9,9,8,20,6,14,9,9,9,9,9,15,11,12,9,10,2,8,8,GK ,20,1,1,1,1,1,1,1,1,1,1,1,1,1,1
19084775,Dinda,1651,03/04/1989,27,0,0,0,0,180,75,3,3,1,1,2,1,2,2,2,3,3,9,8,11,10,10,10,6,10,2,4,10,12,5,10,16,11,12,11,10,9,9,13,14,6,11,6,10,11,13,12,12,10,10,12,12,20,12,9,11,9,10,9,13,9,15,11,11,13,6,6,9,M/AM/S C,1,1,16,20,10,10,1,1,1,1,19,5,5,1,1
19084777,Fábio Martins,1651,27/03/1989,27,0,0,0,0,186,82,3,2,1,3,3,1,4,3,2,2,2,7,9,11,11,10,7,10,11,4,6,8,11,7,10,13,12,9,10,12,12,9,6,12,8,12,5,11,11,12,10,11,12,3,7,11,20,8,12,11,11,13,5,13,15,9,12,11,10,5,8,1,S ,1,1,20,1,1,1,1,1,1,1,1,1,1,1,1
19084785,Levi,1651,29/05/1990,26,0,0,0,0,181,78,3,3,3,1,3,3,1,3,1,4,2,2,7,8,8,9,5,8,7,8,11,11,9,11,10,12,9,11,8,11,9,9,11,8,5,9,12,12,12,11,11,11,10,10,12,11,20,12,11,9,10,9,7,8,13,11,8,13,11,9,19,6,DM C,1,1,1,1,1,1,1,1,1,20,15,1,1,1,1
19084897,Dieguinho,1651,16/04/1990,26,0,0,0,0,171,62,1,2,2,3,3,3,2,2,3,2,1,10,10,13,11,11,9,6,6,1,4,12,10,5,13,10,10,8,8,8,11,11,16,15,8,11,5,8,13,17,13,7,5,8,13,14,20,13,7,10,10,7,8,9,18,15,10,12,12,9,4,1,M/AM C,1,1,1,20,1,1,1,1,1,1,19,1,1,1,1
19084915,Marcos Paullo,1651,28/03/1990,26,0,0,0,0,174,66,1,2,1,3,3,1,1,2,1,2,2,12,11,12,9,10,12,6,9,11,7,10,12,7,11,11,7,11,8,8,9,8,11,14,5,10,8,9,9,12,13,7,6,20,13,12,9,11,5,9,6,9,6,15,11,12,14,9,13,12,14,9,D/WB/M/AM LC,1,1,1,20,16,1,1,17,1,1,13,19,1,19,1
19084948,Henrique Santos,1651,15/12/1990,25,0,0,0,0,171,67,3,1,2,1,1,3,1,1,2,1,3,8,8,12,11,12,10,7,7,11,9,13,5,7,12,10,11,11,11,11,13,10,13,13,8,13,8,12,12,13,13,8,5,11,13,13,20,12,7,13,7,11,6,13,13,12,12,10,13,10,11,6,AM RC,1,1,12,20,1,17,1,1,1,1,13,1,1,1,1
19085044,Omar Santos,1651,22/01/1989,27,0,0,0,0,195,89,13,11,12,5,12,12,13,14,13,10,12,2,3,3,3,10,5,10,4,5,6,9,7,8,8,14,12,13,11,10,5,11,16,4,9,5,12,13,13,10,13,13,17,8,13,10,20,14,13,12,10,14,9,3,11,14,17,17,17,11,14,7,GK ,20,1,1,1,1,1,1,1,1,1,1,1,1,1,1
19086115,Axel,1651,18/07/1991,24,0,0,0,0,195,80,12,10,10,1,12,11,11,13,12,9,12,4,1,3,2,6,8,5,1,3,3,7,2,2,6,10,9,10,9,11,8,10,4,1,7,1,10,7,8,8,11,11,17,6,11,8,20,9,12,6,8,4,9,10,14,12,12,11,10,6,11,4,GK ,20,1,1,1,1,1,1,1,1,1,1,1,1,1,1
19086163,Romário Luiz,1651,05/03/1990,26,0,0,0,0,177,68,2,2,2,1,1,1,3,1,4,2,1,5,3,12,13,13,5,13,6,3,4,6,2,1,9,7,11,1,8,6,5,9,8,9,10,13,5,5,6,12,10,6,7,20,15,12,9,6,5,8,7,8,8,8,10,11,10,12,9,8,10,5,S ,1,1,20,1,1,1,1,1,1,1,1,1,1,1,1
19086204,Tiago Portuga,1651,20/10/1991,24,0,0,0,0,179,74,2,3,2,2,2,1,3,1,2,2,2,6,8,6,5,10,3,9,7,6,9,9,4,15,9,9,10,9,7,7,3,10,14,9,5,8,7,8,8,14,14,8,5,20,11,14,9,10,8,9,9,1,7,9,11,11,11,11,10,3,7,6,D/WB L,1,1,1,1,1,1,1,20,1,1,1,1,1,18,1
19086257,Rafael,1651,24/10/1990,25,0,0,0,0,189,85,13,9,7,1,13,13,6,13,6,5,6,7,3,2,1,1,9,1,1,2,3,1,3,3,2,1,9,13,6,5,6,13,5,2,10,1,10,7,6,13,15,8,13,10,14,12,20,3,13,9,7,9,9,9,9,12,13,13,11,6,9,5,GK ,20,1,1,1,1,1,1,1,1,1,1,1,1,1,1
19086275,Rogério,1651,24/12/1990,25,0,0,0,0,174,76,2,4,2,1,1,4,2,1,3,3,3,10,11,14,13,12,3,9,12,3,5,12,9,4,13,10,11,9,10,9,11,11,15,16,7,14,9,10,11,14,16,8,5,10,13,13,20,15,7,12,10,14,8,12,13,16,3,12,9,6,8,15,AM/S RL,1,1,20,9,15,19,1,1,1,1,1,1,1,1,1
19086339,Wellington Silva,1651,06/01/1993,23,0,0,2,0,170,68,3,1,3,1,3,3,3,2,1,1,2,8,14,16,11,14,9,7,10,9,4,14,9,4,15,11,13,8,12,13,12,9,12,18,4,15,7,11,14,15,16,14,5,12,13,14,20,12,5,10,6,9,10,12,7,18,6,12,5,7,8,13,M/AM RL,1,1,15,10,20,19,1,1,1,1,1,16,16,1,1
19086370,Adriano Lara,1651,09/12/1987,28,0,0,0,0,185,85,1,2,3,3,3,3,3,3,2,2,1,9,7,6,6,8,8,10,8,3,11,9,3,10,9,13,8,13,11,10,9,10,10,10,10,9,10,12,12,11,10,13,12,10,12,11,20,11,13,12,10,9,9,13,15,11,12,11,9,9,9,12,D/WB R,1,1,1,1,1,1,1,1,20,13,13,1,1,1,18
19086382,Harrison,1651,09/07/1992,23,0,0,0,0,163,63,1,3,2,1,2,2,3,4,3,2,3,10,10,13,12,12,13,6,12,10,10,12,12,7,13,5,11,10,7,11,11,11,16,15,10,11,10,10,11,13,15,9,2,7,13,13,20,14,7,12,11,12,11,8,11,15,12,13,13,6,12,6,M/AM C,1,1,1,20,1,1,1,1,1,1,18,1,1,1,1
19086406,Romarinho,1651,12/12/1990,25,0,0,0,0,176,72,2,3,2,1,3,2,2,2,1,2,2,12,11,14,11,13,13,10,9,12,7,12,11,5,14,11,11,11,11,9,13,9,12,13,9,12,9,10,14,15,16,10,9,11,13,14,20,12,9,12,8,15,11,13,10,12,12,15,12,8,9,6,AM/S RL,1,1,20,13,16,17,1,1,1,1,5,1,1,1,1
19086435,Bruno Aquino,1651,21/06/1991,25,0,0,0,0,175,0,3,2,2,1,3,1,3,1,1,2,3,8,5,14,14,7,7,14,8,4,6,9,7,1,10,8,12,6,7,9,5,9,10,9,6,14,7,8,9,14,14,9,9,12,13,14,20,14,12,10,10,6,10,10,16,9,10,9,10,6,14,1,S ,1,1,20,1,1,1,1,1,1,1,1,1,1,1,1
19086517,Diogo Kachuba,1651,16/02/1990,26,0,0,0,0,186,83,2,1,2,3,3,1,1,3,1,2,3,7,8,6,10,13,8,8,12,4,8,9,3,14,13,8,13,13,10,8,10,14,10,7,4,12,12,11,13,14,14,6,14,9,11,14,20,14,8,10,6,10,10,10,19,14,11,11,9,6,9,8,DM/M C,1,1,1,13,1,1,1,1,1,17,20,1,1,1,1
19086539,Lucca,1651,14/02/1990,26,0,0,0,0,178,72,2,2,1,2,1,4,2,3,1,4,2,14,13,13,13,14,13,12,12,8,7,12,12,10,13,12,12,11,12,12,13,13,12,14,11,12,6,13,13,14,13,11,13,12,13,14,20,13,10,12,10,13,12,14,10,13,8,12,12,6,7,6,AM/S L,1,1,18,11,20,14,1,1,1,1,1,1,1,1,1
19086572,Jéferson Silva,1651,03/05/1990,26,0,0,0,0,167,0,2,1,2,3,1,3,3,2,2,3,1,6,6,13,13,13,2,13,6,3,6,7,7,3,14,7,11,1,9,7,3,13,9,12,9,13,4,3,6,12,12,6,5,8,6,13,20,11,5,9,4,9,7,9,13,11,12,12,13,1,18,8,S ,1,1,20,1,1,1,1,1,1,1,1,1,1,1,1
19086644,Roberto Jacaré,1651,02/04/1982,34,0,0,0,0,175,70,3,1,1,4,3,3,1,2,3,1,3,7,9,10,12,11,6,9,10,6,4,11,11,4,11,10,11,11,11,11,10,10,12,12,6,12,8,12,11,11,13,13,8,14,13,12,20,11,7,10,11,11,9,8,8,10,11,11,9,5,7,11,S ,1,1,20,1,1,1,1,1,1,1,1,1,1,1,1
19086668,Pegorari,1651,12/07/1991,24,0,0,0,0,191,88,15,11,10,8,10,15,12,12,9,12,15,3,3,3,3,2,7,1,1,2,2,3,3,2,5,6,11,16,10,13,9,12,12,3,11,2,11,10,9,9,10,12,14,1,14,8,20,12,14,10,9,6,7,10,18,9,11,13,12,8,4,8,GK ,20,1,1,1,1,1,1,1,1,1,1,1,1,1,1
19086737,João Paulo,1651,18/03/1988,28,0,0,0,0,185,81,3,1,2,3,2,4,1,3,1,1,1,4,4,13,13,13,6,13,6,1,6,7,7,5,10,9,11,8,10,7,7,12,3,10,1,11,6,6,8,13,13,7,13,1,15,13,20,12,9,8,9,6,4,9,12,11,11,11,13,2,12,7,S ,1,1,20,1,1,1,1,1,1,1,1,1,1,1,1
19086739,Juan Felipe,1651,05/12/1987,28,0,0,0,0,176,67,1,3,2,3,2,4,1,2,1,2,3,14,14,14,10,12,14,6,13,3,10,14,10,10,14,11,11,11,12,10,14,10,2,16,7,13,10,11,12,13,16,11,7,20,14,12,10,12,7,13,7,13,11,11,17,12,13,12,10,5,4,1,M/AM C,1,1,1,20,1,1,1,1,1,10,19,1,1,1,1
19086744,William,1651,03/12/1984,31,0,0,0,0,180,75,3,2,3,3,2,3,1,4,2,1,1,8,8,9,9,15,8,8,11,4,7,12,5,7,11,9,10,2,10,10,14,10,3,8,11,12,9,7,12,13,10,9,10,2,13,11,20,8,10,9,3,4,7,9,7,11,10,12,12,1,7,4,M/AM C,1,1,1,18,10,10,1,1,1,5,20,7,7,1,1
19086775,Thiago Henrique,1651,20/02/1989,27,0,0,0,0,180,65,4,3,2,2,2,1,1,1,2,4,1,9,10,12,9,11,9,8,10,5,7,12,6,7,11,5,9,8,9,9,10,10,9,11,3,10,9,8,8,12,14,8,10,9,9,13,20,9,6,9,4,9,9,9,18,12,12,12,8,10,14,7,M/AM C,1,1,1,18,10,10,1,1,1,6,20,8,8,1,1
19086787,Yuri Savaroni,1651,02/12/1990,25,0,0,0,0,180,73,1,3,1,3,1,1,3,3,1,2,2,5,8,11,10,9,9,10,9,5,4,9,13,5,10,10,8,8,9,7,9,9,12,13,3,11,7,9,9,13,15,9,10,8,13,13,20,10,9,10,7,9,5,5,10,13,10,11,13,13,14,11,S ,1,1,20,10,10,10,1,1,1,1,1,1,1,1,1
19086947,Abuda,1651,29/08/1987,28,0,0,0,0,190,0,2,2,1,2,1,1,3,2,3,1,2,7,7,5,8,13,7,6,13,1,9,9,2,13,9,5,12,9,7,8,9,11,4,8,4,7,13,8,11,13,11,8,14,12,14,11,20,13,11,10,10,1,10,10,8,13,10,12,9,7,13,8,DM ,1,1,1,1,1,1,1,1,1,20,10,1,1,1,1
19087134,Romário,1651,23/09/1988,27,0,0,0,0,175,73,4,2,1,1,2,1,2,1,3,3,1,4,6,4,6,9,3,8,11,5,12,10,4,14,13,8,11,9,10,9,9,14,5,6,6,9,13,9,13,14,14,9,5,3,17,14,20,13,6,10,10,1,9,10,7,11,12,12,10,13,18,8,DM/M C,1,1,1,1,1,1,1,1,1,20,16,1,1,1,1
19087214,Jonathan Cafu,1651,10/07/1991,24,0,0,0,0,173,64,2,2,2,2,1,1,3,2,2,1,1,11,11,16,14,12,12,6,11,4,3,11,11,5,14,11,11,13,13,9,13,11,14,15,8,15,6,10,11,17,18,13,7,8,13,15,20,13,10,12,11,14,6,16,13,13,17,14,14,9,9,8,AM/S R,1,1,18,10,14,20,1,1,1,1,1,1,10,1,1
19087348,Bruno Soares,1651,21/08/1988,27,0,0,0,0,194,85,3,2,2,2,2,1,1,2,2,1,2,3,5,8,5,9,6,14,7,12,14,9,8,14,7,12,12,11,9,12,6,10,10,8,8,6,13,13,9,9,8,13,16,12,12,12,20,15,16,12,12,10,12,6,14,10,12,10,9,11,10,6,D C,1,1,1,1,1,1,20,1,10,1,1,1,1,1,8
19087401,Rodolfo,1651,19/03/1991,25,0,0,0,0,189,86,15,12,11,1,13,15,12,15,11,9,15,5,2,3,2,3,9,1,2,3,1,3,2,2,6,11,13,12,11,10,10,10,3,10,11,10,12,11,8,10,10,10,14,20,11,11,8,4,12,11,7,5,13,10,7,13,10,10,9,8,4,2,GK ,20,1,1,1,1,1,1,1,1,1,1,1,1,1,1
19087404,Maicon Esquerda,1651,14/02/1990,26,0,0,0,0,175,75,1,1,2,1,3,3,1,2,3,1,3,5,4,12,13,13,6,9,8,3,6,13,9,6,12,6,6,6,10,6,8,13,14,15,11,12,6,7,8,14,10,3,4,20,12,13,8,12,4,11,9,9,9,9,18,13,12,14,13,8,14,8,AM/S C,1,1,18,20,1,1,1,1,1,1,10,1,1,1,1
19087564,Nando Carandina,1651,30/04/1990,26,0,0,0,0,173,68,3,3,3,2,1,2,3,1,1,2,3,9,5,9,8,12,9,10,9,9,11,10,7,9,15,9,12,6,8,11,12,15,5,9,10,9,8,14,13,12,12,6,8,10,13,12,20,13,6,10,10,10,9,10,10,11,12,10,10,12,3,5,DM ,1,1,1,1,1,1,1,1,1,20,13,1,1,1,1
19087585,Kuriri,1651,11/05/1986,30,0,0,0,0,179,0,3,3,1,2,3,2,3,2,2,1,3,4,3,13,13,13,5,13,7,1,1,7,6,2,10,6,8,6,8,6,6,10,8,10,3,11,6,6,8,13,13,7,7,9,8,13,20,12,13,9,4,4,8,9,7,11,11,11,9,4,13,4,S ,1,1,20,1,1,1,1,1,1,1,1,1,1,1,1
19087781,Kiros,1651,21/08/1988,27,0,0,0,0,195,86,2,1,1,4,2,2,2,3,1,3,3,6,5,11,12,14,7,12,8,6,8,9,6,6,14,3,14,5,14,8,8,11,2,13,2,14,9,8,9,12,12,15,17,11,10,12,20,6,16,10,7,4,4,10,13,10,11,11,10,1,18,4,S ,1,1,20,1,1,1,1,1,1,1,1,1,1,1,1
19088214,Kieza,1651,24/09/1986,29,0,0,0,0,178,72,3,3,1,3,2,3,2,1,3,3,3,7,10,14,13,14,7,11,12,4,6,12,14,6,15,12,13,11,13,10,12,12,12,14,11,14,6,12,13,14,15,13,9,11,15,14,20,14,9,11,7,11,8,12,5,13,13,13,12,8,8,11,S L,1,1,20,8,15,1,1,1,1,1,1,1,1,1,1
19088262,Lucas Sasha,1651,01/03/1990,26,0,0,0,0,177,72,1,2,1,1,4,1,3,1,3,3,2,9,10,11,9,10,13,11,10,11,11,12,11,13,11,16,11,17,13,11,12,10,16,8,9,13,13,15,15,14,14,13,10,9,16,13,20,14,13,11,9,11,6,16,15,13,13,7,14,10,13,3,DM/M RC,1,1,1,10,1,1,9,12,14,20,20,1,10,10,15
19088275,João Gabriel,1651,09/06/1989,27,0,0,0,0,187,74,2,2,3,1,2,3,2,1,2,2,1,2,1,1,2,7,1,13,5,3,9,7,4,13,2,9,13,9,7,7,4,13,9,5,3,3,9,6,7,13,13,7,14,1,14,12,20,10,12,9,7,2,9,9,12,12,11,15,14,5,6,6,D C,1,1,1,1,1,1,20,1,1,1,1,1,1,1,1
19088276,Renan Ribeiro,1651,31/03/1989,27,0,0,0,0,183,68,1,2,1,2,3,2,2,4,2,3,2,8,6,4,5,7,6,14,2,3,14,8,5,14,3,10,10,10,6,11,6,14,7,2,10,8,12,8,9,14,11,9,1,17,11,13,20,10,9,10,7,5,9,10,11,12,12,12,12,10,11,3,D C,1,1,1,1,1,1,20,1,1,1,1,1,1,1,1
19088280,Romário,1651,09/11/1990,25,0,0,0,0,177,73,2,1,1,1,2,4,3,2,3,2,2,4,2,12,12,10,5,12,3,2,5,6,6,1,12,9,9,6,12,6,3,12,1,13,13,12,6,2,6,12,12,6,6,16,9,12,20,10,6,9,9,4,7,9,9,12,11,10,9,10,15,2,S ,1,1,20,1,1,1,1,1,1,1,1,1,1,1,1
19088285,Henrique Choco,1651,29/05/1989,27,0,0,0,0,178,73,3,3,3,1,3,2,2,2,3,2,1,5,9,9,9,9,7,10,9,4,13,10,8,12,10,14,10,13,9,10,9,9,15,5,13,9,12,13,12,12,11,11,9,10,15,12,20,12,11,9,8,8,9,9,11,13,10,9,11,10,9,11,D/DM RC,1,1,1,1,1,1,1,1,18,20,15,1,1,1,15
19088288,Wendell,1651,04/04/1989,27,0,0,0,0,170,66,2,1,3,2,2,2,3,2,1,2,2,7,8,11,11,10,9,10,9,4,6,10,8,6,10,9,11,9,11,10,10,12,2,13,1,11,10,9,9,13,14,14,6,11,3,13,20,14,6,10,9,9,9,8,13,12,12,11,11,8,2,7,S ,1,1,20,1,1,1,1,1,1,1,1,1,1,1,1
19088292,Lucas Limão,1651,11/08/1990,25,0,0,0,0,170,67,1,2,2,4,1,1,3,2,2,1,2,6,7,9,9,13,7,7,13,1,5,13,2,9,13,6,9,7,9,8,9,13,7,13,13,11,6,8,9,13,13,7,4,9,4,13,20,13,9,9,10,1,10,10,11,12,9,11,9,2,10,3,AM C,1,1,1,20,1,1,1,1,1,1,15,1,1,1,1
19088392,Juninho Caieiras,1651,11/12/1990,25,0,0,0,0,180,71,2,1,3,1,1,1,3,2,1,2,3,4,6,7,7,13,6,6,9,1,8,11,5,13,10,9,9,8,8,7,11,8,6,10,13,8,9,7,8,13,13,7,8,20,11,13,9,8,7,9,9,9,9,9,20,10,8,13,12,2,14,5,M LC,1,1,1,15,1,1,1,15,1,1,20,1,1,1,1
19088397,Mika,1651,27/04/1988,28,0,0,0,0,172,68,3,3,1,1,2,1,3,1,3,3,3,8,6,6,9,14,6,8,7,1,13,14,2,14,9,8,11,9,10,9,10,14,4,9,9,9,14,9,11,14,14,8,2,8,6,14,20,8,9,10,4,5,9,10,8,11,10,11,11,10,8,6,DM C,1,1,1,1,1,1,1,1,1,20,15,1,1,1,1
19088570,Neto,1651,02/09/1991,24,0,0,0,0,181,75,2,1,1,3,1,2,1,3,2,3,1,11,11,12,11,12,8,8,10,8,9,15,8,11,14,12,11,12,14,13,13,13,12,8,10,12,13,14,11,12,13,13,11,9,10,13,20,12,12,13,6,12,6,8,13,11,12,15,14,14,13,6,DM/M C,1,1,1,1,1,1,1,1,1,18,20,1,1,1,1
19088582,William Henrique,1651,28/01/1992,24,0,0,0,0,178,74,1,1,1,1,3,3,3,3,4,3,3,6,10,14,9,13,6,5,9,7,5,10,13,5,12,12,12,10,7,7,11,10,13,17,4,13,6,7,12,16,15,10,7,20,13,16,4,13,6,10,9,12,4,12,11,13,12,12,13,7,10,6,AM RL,1,1,15,10,20,18,1,1,1,1,6,14,12,1,1
19088674,Lucas Mendes,1651,19/02/1992,24,0,0,0,0,188,0,1,1,1,3,3,1,3,1,3,1,2,3,6,7,5,13,1,8,5,5,8,8,2,12,9,9,10,9,6,5,12,14,6,4,4,4,10,9,9,14,14,9,13,6,10,14,20,8,11,9,9,5,8,9,20,12,10,15,10,12,9,5,D/WB R,1,1,10,10,1,1,1,1,20,1,10,1,1,1,19
19088675,Marcel,1651,16/10/1992,23,0,0,0,0,196,73,1,2,3,4,2,3,2,3,4,3,3,4,6,11,7,11,8,13,11,7,13,12,7,15,12,14,11,12,12,12,10,11,12,8,10,9,11,11,10,13,12,10,18,11,10,12,20,12,10,12,12,10,6,14,13,11,11,12,11,11,12,7,DM C,1,1,1,7,1,1,15,1,1,20,15,1,1,1,1
19088676,Régis,1651,30/11/1992,23,0,0,0,0,170,72,2,1,1,1,2,2,1,3,3,2,2,12,11,13,12,13,13,10,13,10,6,14,12,7,13,9,13,9,11,11,13,12,12,12,11,13,7,12,12,14,14,10,5,20,13,13,10,13,10,11,9,11,6,10,16,15,10,12,6,9,10,9,AM RC,1,1,1,20,1,18,1,1,1,1,15,1,13,1,1
19088877,Diego Renan,1651,26/01/1990,26,0,0,0,0,172,71,2,1,2,3,3,3,3,2,2,2,1,11,12,12,13,13,12,4,13,10,9,13,16,10,13,15,11,11,13,8,11,11,12,14,13,14,9,13,12,13,13,12,6,14,13,13,20,14,9,11,11,13,9,14,10,12,12,11,14,10,15,8,D/WB RL,1,1,1,10,12,9,1,20,16,11,10,10,9,19,15
19088878,Douglas Borges,1651,30/03/1990,26,0,0,0,0,188,0,11,10,10,4,10,9,11,11,13,11,10,3,1,1,3,6,5,2,1,2,3,7,1,1,7,11,8,11,9,10,3,9,1,1,9,3,10,9,8,11,12,6,13,3,13,10,20,9,13,12,6,11,7,9,6,10,8,11,12,11,12,2,GK ,20,1,1,1,1,1,1,1,1,1,1,1,1,1,1
19088879,Mateus,1651,26/03/1990,26,0,0,0,0,178,72,3,1,1,1,3,1,2,1,1,4,2,1,8,10,11,10,1,11,12,9,11,11,12,12,11,13,11,11,10,11,7,11,5,10,10,8,11,10,11,11,10,10,11,5,13,11,20,11,9,11,11,11,4,13,10,11,8,10,13,4,11,3,DM C,1,1,1,1,1,1,1,1,1,20,15,1,1,1,1
19088883,Fabrício Isidoro,1651,28/01/1992,24,0,0,0,0,172,68,3,2,3,3,2,3,3,2,1,2,3,9,10,10,8,9,8,7,8,8,9,10,11,10,10,12,11,12,10,10,10,9,6,10,9,12,11,12,13,12,13,11,6,5,14,13,20,12,10,9,5,10,4,10,10,13,11,13,12,7,9,6,DM/M RC,1,1,1,1,1,1,13,1,12,19,20,1,14,1,15
19088884,Bebeto,1651,01/01/1990,26,0,0,0,0,174,70,3,2,2,2,1,1,1,1,2,2,3,10,9,13,8,11,13,9,8,10,9,9,11,9,11,12,12,10,9,11,10,8,8,10,9,12,10,11,9,13,14,11,7,8,13,14,20,12,8,10,8,11,5,9,10,9,9,7,11,9,13,4,D/WB R,1,1,1,1,1,7,1,1,19,1,1,1,11,1,20
19089144,Régis,1651,03/06/1989,27,0,0,0,0,182,0,2,2,2,1,3,2,4,3,2,1,1,7,13,12,8,9,11,9,9,11,8,13,1,9,9,2,12,12,12,11,11,9,17,12,9,11,11,12,9,14,14,13,10,7,14,12,20,12,11,12,5,11,2,10,11,13,11,12,10,3,19,1,D/WB R,1,1,1,1,1,5,1,1,20,1,1,1,10,1,17
19089149,Luan,1651,28/06/1987,29,0,0,0,0,185,82,2,3,1,1,2,3,3,2,3,2,2,4,1,1,4,7,1,13,8,5,14,9,6,14,5,7,9,10,8,13,2,11,3,4,10,6,14,8,9,14,14,9,13,10,12,13,20,7,10,10,1,2,10,10,13,13,10,11,12,1,10,7,D C,1,1,1,1,1,1,20,1,1,1,1,1,1,1,1
19089151,Ramon,1651,15/06/1988,28,0,0,0,0,184,0,1,2,1,3,3,2,2,1,2,1,1,6,4,2,6,13,2,6,6,6,7,10,1,13,13,7,13,8,4,6,8,13,5,3,12,6,11,7,10,13,11,5,9,9,14,13,20,11,7,9,7,6,9,9,19,11,9,8,10,10,1,2,DM ,1,1,1,1,1,1,1,1,1,20,10,1,1,1,1
19089152,Marquinhos,1651,14/05/1987,29,0,0,0,0,171,0,3,3,2,3,2,4,4,3,1,2,1,6,5,12,13,12,6,6,8,2,5,13,8,7,13,9,7,2,9,6,13,13,4,13,10,11,6,7,8,13,13,7,2,9,6,13,20,13,5,8,9,3,6,9,11,10,10,10,11,3,15,5,AM C,1,1,12,20,1,1,1,1,1,1,10,1,1,1,1
19089153,Lucas Dantas,1651,22/02/1989,27,0,0,0,0,172,72,3,3,3,3,1,3,2,2,3,2,1,7,5,13,13,13,7,13,6,6,6,5,6,7,13,9,10,9,6,8,7,13,5,13,13,13,6,7,8,13,13,8,4,10,11,13,20,13,5,6,4,5,6,10,16,12,8,12,10,10,8,5,S ,1,1,20,1,1,1,1,1,1,1,1,1,1,1,1
19089231,André Luiz,1651,01/01/1989,27,0,0,0,0,197,87,14,11,13,1,14,11,9,8,10,7,8,8,1,3,2,6,10,1,2,3,1,3,3,2,1,10,9,15,9,10,8,14,7,1,4,1,14,9,8,14,12,6,12,7,12,11,20,7,12,10,10,9,10,10,16,11,11,10,10,10,1,5,GK ,20,1,1,1,1,1,1,1,1,1,1,1,1,1,1
19089286,Gabriel Silva,1651,13/05/1991,25,0,0,9,1,179,75,1,1,2,1,2,1,4,1,2,3,2,13,13,12,10,12,11,6,11,10,10,12,12,11,13,11,12,11,11,11,11,11,16,14,3,13,12,12,14,14,14,11,10,20,16,15,12,15,11,14,8,13,7,14,9,14,15,14,16,9,14,9,D/WB/M L,1,1,1,1,5,1,1,20,1,1,1,18,1,19,1
19089298,Rafael Copetti,1651,04/04/1991,25,0,0,0,0,193,87,10,7,12,1,11,12,9,14,11,10,13,4,1,2,2,3,7,1,1,1,3,3,1,2,6,8,9,13,8,11,8,13,10,1,5,2,14,9,7,13,12,5,14,20,13,14,10,6,13,10,3,10,9,10,12,13,10,12,12,1,6,3,GK ,20,1,1,1,1,1,1,1,1,1,1,1,1,1,1
19089301,Vitor,1651,03/08/1990,25,0,0,0,0,172,67,2,3,1,4,2,2,2,3,1,3,2,8,12,9,7,12,7,5,9,7,8,14,1,9,14,9,9,6,10,7,9,14,9,8,8,9,8,8,12,9,13,8,3,10,9,14,20,7,7,9,6,8,9,9,17,11,9,9,10,12,12,3,M RC,1,1,1,1,1,1,1,1,1,1,16,1,20,1,1
19089302,Romário Leiria,1651,28/06/1992,24,0,0,4,0,184,81,2,2,1,3,2,1,1,3,3,1,3,5,4,7,5,10,13,12,12,8,13,11,6,13,12,11,12,11,12,11,8,11,12,5,9,8,13,13,12,11,11,14,11,20,13,10,11,12,13,12,6,11,5,10,15,11,12,12,12,8,6,8,D C,1,1,1,1,1,1,20,14,1,1,1,1,1,9,1
19089304,Edson,1651,12/12/1991,24,0,0,0,0,189,88,14,12,12,1,12,12,12,13,12,14,12,6,1,6,3,6,10,7,1,3,1,7,1,3,6,8,12,11,12,12,9,12,10,1,8,3,13,15,14,10,12,7,16,5,12,9,20,14,16,12,11,8,10,9,12,9,10,14,10,1,16,3,GK ,20,1,1,1,1,1,1,1,1,1,1,1,1,1,1
19089306,Djair,1651,10/02/1991,25,0,0,0,0,172,72,3,1,1,1,1,1,1,3,3,3,1,8,8,4,6,14,8,8,10,1,12,12,3,11,9,6,12,9,7,10,9,14,5,10,11,8,11,9,13,14,14,12,5,10,15,14,20,9,12,10,7,1,4,10,11,11,10,13,9,6,10,8,DM ,1,1,1,1,1,1,1,1,1,20,10,1,1,1,1
19089309,Milton Júnior,1651,27/03/1991,25,0,0,0,0,185,75,2,2,1,1,2,3,1,1,4,1,3,10,8,9,9,10,10,10,10,9,11,11,10,12,9,10,11,10,10,10,13,13,5,4,13,13,14,11,12,10,9,12,15,11,14,9,20,15,11,10,9,12,10,10,20,13,13,13,10,7,11,8,DM C,1,1,1,10,1,1,1,1,8,20,15,1,8,1,12
19089312,Igor Rossi,1651,10/03/1989,27,0,0,0,0,189,77,3,1,3,2,4,3,4,2,2,3,3,6,7,8,8,10,7,15,6,8,13,8,10,15,8,15,12,12,12,14,8,10,14,5,12,9,14,14,15,10,10,14,14,20,11,9,5,12,15,13,15,10,11,7,13,10,13,10,13,11,11,6,D LC,1,1,1,1,1,1,20,17,1,10,1,1,1,1,1
19089313,Eduardo Sasha,1651,24/02/1992,24,0,0,0,0,173,65,2,3,1,2,3,2,1,2,2,2,1,6,10,13,13,14,8,13,11,6,6,10,11,6,13,12,13,10,13,13,13,13,14,14,9,13,6,14,13,16,15,10,8,10,12,15,20,12,11,14,5,11,6,12,20,13,13,12,11,6,10,6,AM/S RLC,1,1,20,16,16,18,1,1,1,1,1,1,1,1,1
19089385,Hugo,1651,06/09/1988,27,0,0,0,0,180,77,3,3,1,3,3,3,1,1,2,1,2,9,6,14,14,14,8,14,7,6,9,14,7,8,14,5,14,10,11,9,11,14,8,13,5,14,11,10,9,14,14,10,10,11,11,14,20,14,8,12,11,11,4,11,14,10,10,10,11,4,9,3,AM/S C,1,1,20,18,1,1,1,1,1,1,15,1,1,1,1
19089389,Serginho,1651,27/04/1988,28,0,0,0,0,183,77,2,2,2,4,1,2,2,1,3,3,2,7,8,9,7,12,7,8,8,7,14,9,9,13,9,11,12,10,11,13,9,12,12,7,12,7,14,14,12,10,12,16,11,5,8,9,20,14,15,9,11,10,10,10,12,13,7,11,12,10,9,4,D/DM RC,1,1,1,10,1,1,1,1,17,20,15,1,1,1,14
19089456,Renan,1651,12/12/1990,25,0,0,0,0,191,78,12,12,12,9,15,12,13,14,13,15,13,8,1,2,2,8,10,3,2,2,1,11,2,2,8,11,13,14,12,12,7,13,14,12,10,3,12,15,13,4,14,14,16,20,16,6,5,13,14,12,8,16,9,11,12,14,14,14,12,8,14,12,GK ,20,1,1,1,1,1,1,1,1,1,1,1,1,1,1
19089457,Renan Oliveira,1651,17/11/1990,25,0,0,0,0,176,73,3,3,3,1,1,3,2,3,2,4,2,8,9,10,5,8,4,9,7,9,11,7,3,8,11,6,13,9,5,7,11,15,12,2,6,9,12,11,11,15,15,11,8,20,11,15,6,14,7,10,7,4,10,10,12,10,12,9,12,12,11,8,D/WB L,1,1,1,1,1,1,1,17,1,1,1,1,1,20,1
19089509,Gabriel,1651,04/03/1989,27,0,0,0,0,183,72,1,1,2,2,2,1,2,4,3,3,1,10,12,14,9,9,4,5,8,7,8,10,8,11,11,12,9,12,10,10,13,9,16,12,8,12,8,12,12,14,14,4,10,20,13,13,7,15,9,13,5,12,8,12,8,14,14,15,14,7,14,6,D/WB L,1,1,1,1,1,1,1,20,1,1,1,1,1,19,1
19089585,Reinaldo Peres,1651,22/10/1980,35,0,0,0,0,191,87,3,1,2,1,2,3,1,2,3,2,1,6,4,8,13,13,4,13,6,6,5,4,4,1,11,9,13,8,8,7,7,6,3,11,14,9,7,6,7,12,9,2,13,9,14,10,20,6,10,9,9,4,3,9,8,10,12,11,10,10,3,3,S ,1,1,20,1,1,1,1,1,1,1,1,1,1,1,1
19089928,Daniel Barros,1651,21/08/1988,27,0,0,0,0,168,71,3,1,3,2,3,1,3,2,3,2,1,7,6,7,11,12,11,5,12,1,8,10,5,8,12,12,10,8,10,8,13,13,3,12,3,7,9,8,10,13,13,8,4,9,8,13,20,11,7,10,10,8,6,10,10,9,9,13,10,8,9,5,M/AM C,1,1,1,20,1,1,1,1,1,1,18,1,1,1,1
19089959,Danilo Pires,1651,21/03/1992,24,0,0,0,0,178,76,1,1,2,3,2,1,2,1,3,2,2,8,10,12,11,12,5,12,12,8,13,13,7,12,11,14,12,13,8,10,11,11,12,13,7,12,12,13,13,13,12,13,9,4,13,14,20,14,13,11,14,12,6,14,11,13,12,11,13,12,13,10,DM/M RLC,1,1,1,12,13,11,1,1,1,18,20,15,15,1,1
19089972,Otávio,1651,19/08/1990,25,0,0,0,0,183,79,3,2,1,2,1,2,2,3,1,3,3,3,8,7,3,10,6,7,3,6,10,10,1,12,8,9,9,8,8,8,8,7,1,4,8,6,12,7,8,13,11,8,11,20,11,13,9,10,9,9,6,6,9,9,9,8,9,9,11,6,19,3,D/WB/DM/M LC,1,1,1,1,1,1,18,17,1,20,18,19,1,18,1
19090211,Tinga,1651,12/10/1990,25,0,0,2,1,173,65,1,1,1,1,3,1,1,1,1,3,3,11,11,13,9,13,11,7,11,6,9,12,10,9,13,12,11,10,11,10,11,11,12,13,3,12,11,12,11,14,15,15,6,10,13,14,20,13,6,10,12,11,8,15,10,13,12,13,11,9,12,10,M/AM RLC,1,1,6,19,15,17,1,1,5,10,20,12,18,1,8
19090223,Frauches,1651,28/09/1992,23,0,0,0,0,185,77,3,3,1,3,3,1,4,2,1,3,1,4,5,7,8,9,8,15,8,5,14,10,11,13,10,13,13,13,12,12,6,13,11,8,14,6,14,12,14,10,9,11,13,8,14,10,20,14,10,10,10,12,10,15,17,12,13,11,10,9,10,6,D C,1,1,1,1,1,1,20,13,1,13,1,1,1,1,1
19090224,Elivelto,1651,02/01/1992,24,0,0,0,0,170,66,3,3,3,4,3,1,3,3,2,2,2,12,12,14,13,13,10,5,10,5,5,13,10,5,13,5,13,5,10,8,14,8,13,14,8,13,5,13,10,13,13,13,5,11,13,13,20,10,12,10,8,10,8,10,12,14,10,12,12,13,8,8,M/AM C,1,1,14,20,14,14,1,1,1,1,17,13,13,1,1
19090231,Anderson,1651,10/06/1992,24,0,0,0,0,175,60,1,1,2,2,3,4,1,3,3,1,2,12,12,12,10,10,12,9,9,7,9,9,12,9,12,8,9,8,10,9,11,9,10,14,12,13,10,10,12,13,11,9,9,20,14,13,8,14,9,12,7,10,10,12,11,13,7,11,11,8,15,2,D/WB/M L,1,1,1,1,14,1,1,20,1,1,1,16,1,18,1
19090233,Rafael Kneif,1651,24/04/1992,24,0,0,0,0,172,67,3,2,3,1,1,3,2,1,2,2,2,7,11,6,3,11,2,5,2,5,6,7,2,12,7,8,5,7,7,9,3,12,1,4,12,6,7,6,8,13,13,6,5,20,14,13,8,12,4,8,8,8,8,8,13,11,13,13,8,11,13,3,D L,1,1,1,1,11,1,1,20,1,1,1,15,1,15,1
19090234,Ricardinho,1651,09/02/1992,24,0,0,0,0,175,74,2,1,1,1,3,3,3,1,4,2,4,10,10,9,8,11,10,8,10,4,5,10,4,8,12,6,7,6,7,8,10,8,7,12,6,9,4,10,9,11,12,8,8,10,9,11,20,9,8,7,7,9,7,9,7,8,10,8,12,11,17,3,M/AM RC,1,1,10,17,14,20,1,1,1,10,16,7,16,1,1
19090339,Marco Antônio,1651,22/01/1991,25,0,0,0,0,177,67,1,2,2,2,1,4,3,3,2,1,2,6,6,11,8,9,6,6,9,6,5,9,5,8,10,9,7,1,10,7,10,13,5,9,13,10,8,7,11,12,10,12,7,10,8,11,20,10,6,9,7,9,9,8,20,11,15,10,11,13,2,6,AM C,1,1,10,20,1,1,1,1,1,10,15,1,1,1,1
19090340,Samuel,1651,25/02/1991,25,0,0,0,0,186,87,3,2,1,1,2,2,3,3,3,2,3,5,5,12,13,9,10,14,9,6,8,11,13,6,10,14,12,14,13,13,11,12,14,10,11,13,9,13,13,13,12,14,13,10,12,13,20,13,17,13,5,11,6,6,14,12,7,12,9,9,7,6,S ,1,1,20,1,14,8,1,1,1,1,1,1,1,1,1
19090354,Edenílson,1651,18/12/1989,26,0,0,0,0,175,76,2,2,1,1,3,3,3,2,3,3,3,12,12,13,6,12,9,8,8,10,12,13,10,13,14,12,12,11,12,12,11,11,13,12,8,12,11,13,13,15,13,8,8,11,13,15,20,14,7,13,7,12,6,15,8,10,11,13,11,8,12,11,D/WB/DM/M RC,1,1,1,1,1,8,1,8,18,16,18,9,20,12,19
19090356,Sidivan,1651,18/09/1992,23,0,0,0,0,186,86,13,10,8,6,13,11,8,13,9,4,10,1,2,1,1,1,6,1,3,1,3,1,1,2,5,9,8,11,5,7,6,13,3,1,1,3,9,7,6,13,8,7,13,9,10,10,20,4,7,9,7,8,9,9,10,12,11,11,9,9,8,5,GK ,20,1,1,1,1,1,1,1,1,1,1,1,1,1,1
19090358,Tinga,1651,22/12/1992,23,0,0,0,0,178,79,4,1,1,1,3,1,1,3,3,1,1,7,9,9,9,14,7,8,9,4,6,12,5,5,13,9,9,8,13,8,12,9,3,10,5,11,6,8,10,12,13,9,7,20,14,13,10,7,9,9,9,4,9,9,13,13,13,9,11,8,11,2,M/AM C,1,1,1,20,1,1,1,1,1,1,19,1,1,1,1
19090360,Vinícius Reis,1651,02/07/1990,26,0,0,0,0,175,69,2,1,1,2,1,2,1,2,2,2,3,6,9,14,10,11,10,8,9,5,6,9,10,6,11,10,13,7,12,11,9,10,5,14,7,13,8,7,14,14,14,9,9,20,10,14,7,12,9,10,6,10,10,10,9,10,12,11,13,1,15,1,M/AM LC,1,1,1,17,17,13,1,1,1,1,20,1,1,1,1
19090441,Wesley,1651,24/04/1990,26,0,0,0,0,178,70,2,1,3,1,1,2,3,3,3,1,1,7,3,13,12,12,7,13,6,2,6,10,6,6,13,10,10,9,9,7,5,11,1,13,11,13,7,7,8,13,13,8,8,10,12,13,20,13,7,9,10,10,6,10,19,8,10,11,11,2,10,4,S ,1,1,20,1,1,1,1,1,1,1,1,1,1,1,1
19090499,Nádson,1651,21/02/1992,24,0,0,0,0,179,74,2,1,2,3,2,2,3,1,2,1,1,11,11,12,10,9,8,12,12,9,6,8,9,7,11,11,11,10,10,8,9,9,3,11,8,10,9,9,12,13,12,10,12,6,11,12,20,11,12,10,7,9,9,10,15,11,10,10,12,1,6,3,S ,1,1,20,10,10,10,1,1,1,1,1,1,1,1,1
19090539,Edinaldo,1651,11/11/1988,27,0,0,0,0,180,0,2,3,3,1,3,1,2,3,2,3,4,8,6,8,2,13,5,6,1,4,8,10,5,13,8,10,9,10,9,9,8,14,1,5,9,5,10,9,9,14,14,9,10,20,11,14,9,14,8,10,5,6,7,10,19,10,10,11,7,7,12,2,D/WB L,1,1,1,1,1,1,1,20,1,1,1,1,1,18,1
19090544,Ramón,1651,06/12/1987,28,0,0,0,0,175,0,2,2,2,3,2,1,2,1,1,3,2,7,5,8,8,13,5,7,7,1,9,5,5,14,9,9,8,8,7,7,11,14,9,5,10,6,13,8,12,14,14,8,9,5,10,14,20,8,6,9,9,2,3,9,11,10,10,10,12,7,5,8,DM ,1,1,1,1,1,1,1,1,1,20,10,1,1,1,1
19090891,Jackson,1651,12/04/1991,25,0,0,0,0,169,67,3,3,3,2,4,2,1,1,3,2,1,15,12,13,10,10,14,7,12,12,9,10,13,9,13,12,8,11,9,9,9,9,11,11,10,12,9,12,12,14,14,8,5,20,12,14,5,13,8,12,10,12,8,6,11,12,10,11,12,10,14,8,D/WB/M L,1,1,1,1,10,1,1,20,1,1,1,16,1,19,1
19090892,Alisson,1651,01/07/1989,27,0,0,0,0,187,77,3,1,1,3,1,1,1,3,1,2,1,6,6,7,4,8,7,12,8,1,12,9,4,11,8,9,12,14,8,6,8,13,4,4,13,9,10,12,9,9,7,12,14,20,10,8,10,12,12,9,8,10,9,10,10,8,11,9,10,2,9,4,D/DM C,1,1,1,1,1,1,20,1,1,16,10,1,1,1,1
19090894,Kaká,1651,10/09/1988,27,0,0,0,0,181,74,3,1,1,4,3,3,1,2,3,1,1,8,10,12,12,12,12,10,12,5,6,11,12,5,12,11,9,12,11,9,10,12,12,15,5,13,9,11,11,14,13,11,10,3,13,13,20,12,11,14,7,12,5,11,12,13,11,12,17,15,12,10,M/AM C,1,1,10,20,10,10,1,1,1,1,18,5,5,1,1
19090895,Soares,1651,17/01/1991,25,0,0,0,0,187,89,2,2,1,3,3,2,2,1,3,3,2,4,6,13,16,14,5,14,10,6,5,13,11,5,14,14,13,12,14,13,13,14,12,12,9,13,9,13,14,12,12,13,15,12,14,13,20,11,17,14,2,13,12,6,11,9,14,9,12,15,15,5,S ,1,1,20,5,1,1,1,1,1,1,1,1,1,1,1
19091024,Gil Mineiro,1651,07/05/1990,26,0,0,0,0,176,70,3,2,1,1,3,1,3,2,2,3,3,9,10,10,7,8,9,6,9,10,8,10,4,7,10,13,7,12,8,7,8,7,15,10,5,9,9,13,11,13,11,8,7,15,15,13,20,12,6,10,10,3,5,15,10,12,15,10,12,8,12,10,D/WB/M/AM RLC,1,1,1,16,16,18,1,19,20,1,18,16,18,17,19
19091027,França,1651,31/07/1990,25,0,0,0,0,187,0,1,2,2,2,1,3,2,1,1,3,2,2,7,10,11,9,10,10,10,2,3,9,13,4,11,13,9,11,10,7,7,8,15,12,3,10,7,8,10,13,11,11,13,10,15,13,20,11,13,12,8,11,5,10,10,13,15,11,14,12,11,10,S ,1,1,20,1,1,1,1,1,1,1,1,1,1,1,1
19091032,Juninho,1651,04/01/1992,24,0,0,0,0,179,72,2,3,3,1,1,3,1,1,2,2,3,5,9,12,12,9,9,5,11,5,3,16,7,3,13,9,7,5,8,6,10,8,3,13,5,11,11,8,12,13,13,7,5,5,11,13,20,10,5,9,8,9,9,9,13,12,12,11,13,4,11,6,M/AM C,1,1,1,20,1,1,1,1,1,1,17,4,4,1,1
19091492,Lucas Mineiro,1651,16/06/1992,24,0,0,0,0,173,67,3,1,2,3,2,1,2,3,2,1,1,7,12,13,11,12,8,10,11,8,10,13,8,10,13,13,13,11,11,12,12,13,15,13,4,13,12,11,12,13,14,7,6,8,13,14,20,12,7,11,8,11,5,12,12,14,14,12,15,9,11,10,DM/M C,1,1,1,15,1,10,1,1,10,18,20,1,10,1,10
19091494,Romário,1651,18/12/1993,22,0,0,0,0,178,0,2,2,3,3,2,3,2,1,1,3,2,11,12,12,11,13,8,7,11,11,11,12,10,11,13,12,12,11,10,8,11,9,14,14,4,13,10,12,12,13,13,11,6,7,13,13,20,13,10,12,5,11,8,12,8,15,6,7,8,6,16,13,D/WB R,1,1,1,1,1,9,1,12,20,1,1,1,13,10,19
19091495,Léo,1651,03/10/1991,24,0,0,0,0,171,62,2,3,4,3,3,3,1,2,1,3,1,12,13,13,11,14,11,8,12,11,9,14,8,10,14,12,13,12,13,13,14,12,13,15,6,13,10,14,12,15,16,9,7,13,10,14,20,13,8,12,8,9,18,10,12,13,12,11,12,8,10,11,D/WB R,1,1,1,1,1,5,1,11,20,1,1,1,10,9,19
19091496,Alan Henrique,1651,19/06/1991,25,0,0,0,0,189,82,2,2,1,4,2,3,2,3,3,1,3,3,6,7,6,9,6,13,10,6,13,10,8,12,8,13,12,13,10,11,5,11,15,11,7,7,13,14,13,12,12,12,14,7,14,12,20,14,13,12,11,11,14,8,7,13,15,12,13,9,12,10,D C,1,11,1,1,1,1,20,1,1,1,1,1,1,1,1
19091497,Elenílson,1651,13/03/1992,24,0,0,0,0,167,69,2,2,1,2,3,1,2,3,1,3,3,10,12,13,13,13,7,6,7,1,6,6,4,4,10,9,8,5,7,7,5,8,9,10,5,9,5,7,8,13,13,7,3,20,6,13,5,13,5,9,9,9,8,9,7,9,9,9,10,9,14,13,AM/S RLC,1,1,19,16,20,16,1,1,1,1,10,6,6,1,1
19091644,Nerylon,1651,15/01/1988,28,0,0,0,0,174,68,3,1,2,3,3,2,1,2,4,1,2,12,10,11,9,9,10,7,9,11,9,10,9,9,10,12,8,13,7,8,8,8,12,11,7,11,9,11,11,12,13,9,6,7,14,13,20,11,6,10,8,9,6,12,11,11,13,10,12,14,14,10,D/WB/M/AM R,1,1,1,1,1,16,1,11,18,1,1,1,20,8,20
19091652,Erivélton,1651,16/10/1992,23,0,0,0,0,189,78,16,16,10,1,10,16,11,11,10,6,11,3,2,3,1,6,5,3,1,3,1,2,3,2,6,5,10,11,11,14,10,8,2,3,8,1,9,7,7,14,14,12,14,3,15,13,20,8,12,10,9,10,10,10,19,11,11,10,10,7,1,6,GK ,20,1,1,1,1,1,1,1,1,1,1,1,1,1,1
19091654,Leandro Mendes,1651,26/01/1991,25,0,0,0,0,170,69,1,1,1,3,2,3,1,4,3,4,1,7,10,11,9,10,8,6,10,3,6,11,5,7,11,8,10,8,9,7,10,9,6,8,5,9,8,8,10,11,11,9,5,20,14,12,7,10,8,8,8,5,8,8,14,11,9,9,12,11,17,7,D/WB/M LC,1,1,1,1,1,1,1,20,1,1,18,16,1,18,1
19091655,Reginaldo Júnior,1651,07/09/1990,25,0,0,0,0,179,69,1,1,1,1,2,1,2,3,2,2,3,3,8,11,11,10,6,9,9,2,2,8,8,2,11,12,9,11,9,7,7,9,13,13,4,12,6,9,11,13,13,1,9,8,15,13,20,11,8,11,9,7,7,9,10,14,14,13,6,8,9,14,AM/S R,1,1,20,10,5,16,1,1,1,1,1,1,1,1,1
19091658,Duylio,1651,15/01/1992,24,0,0,0,0,174,0,2,3,3,3,3,1,1,2,3,2,3,6,8,9,8,10,7,7,10,4,12,11,9,12,10,12,10,13,8,10,8,10,11,10,10,7,11,12,12,11,12,11,10,10,14,11,20,12,11,13,11,11,7,9,13,14,8,10,16,10,10,5,DM/M C,1,6,1,5,1,1,9,1,1,20,18,1,1,1,1
19091999,Alex Silva,1651,06/04/1990,26,0,0,0,0,169,58,2,3,2,2,2,3,1,2,3,3,2,12,12,14,10,11,13,5,9,5,5,13,13,6,14,13,10,11,11,9,12,12,11,14,2,12,8,7,9,14,14,5,4,20,14,13,8,10,4,12,6,11,6,14,11,14,12,11,11,15,17,12,M/AM RLC,1,1,13,20,17,19,1,1,1,5,18,12,16,1,1
19092117,Alexandre Carvalho,1651,12/06/1985,31,0,0,0,0,185,79,3,4,1,1,2,2,2,2,2,1,2,5,3,6,4,7,3,11,3,4,11,7,5,13,6,9,10,9,8,11,6,13,9,1,5,7,8,7,8,10,9,11,13,8,16,9,20,11,10,9,12,9,9,9,14,10,11,10,9,7,9,5,D RC,1,1,1,1,1,1,20,1,15,1,1,1,1,1,11
19092119,Éder Lima,1651,05/02/1986,30,0,0,0,0,187,78,2,3,2,3,1,2,2,1,4,1,3,9,7,7,8,9,6,12,8,11,12,10,7,13,8,8,10,12,10,10,8,13,18,7,14,10,10,10,11,12,12,9,14,20,10,12,14,12,13,10,8,10,9,13,14,10,12,10,11,9,3,2,D C,1,1,1,1,1,1,20,13,1,1,1,1,1,12,1
19094793,Jucilei,1651,06/04/1988,28,2,0,0,0,185,79,1,1,1,3,1,2,3,3,2,3,3,10,11,13,11,13,9,14,11,7,14,14,8,14,14,12,14,13,13,13,13,13,15,11,11,13,14,14,13,13,12,15,12,8,18,10,20,17,13,13,13,12,6,16,11,13,13,15,13,11,14,5,DM/M C,1,1,1,7,1,1,10,1,7,20,17,1,7,1,10
19094970,Rafael Grampola,1651,09/04/1988,28,0,0,0,0,182,80,3,3,1,1,2,2,1,3,3,1,3,3,3,13,8,10,6,13,3,3,6,6,7,2,13,8,13,9,10,5,7,10,10,13,12,9,7,7,10,13,12,8,12,9,13,10,20,13,9,10,9,10,4,10,9,9,9,12,12,1,6,6,S ,1,1,20,1,1,1,1,1,1,1,1,1,1,1,1
19094979,Mattheus,1651,07/07/1994,21,0,0,4,0,182,75,3,2,3,4,2,2,3,2,1,3,1,14,15,14,11,14,14,8,14,6,10,15,13,11,16,6,14,8,15,12,14,14,11,13,10,11,11,15,11,11,12,12,12,20,12,11,9,11,7,12,3,8,5,12,10,15,11,13,16,11,13,4,M/AM LC,1,1,1,17,20,1,1,1,1,13,20,10,1,1,1
19094984,Juninho,1651,20/03/1986,30,0,0,0,0,172,65,3,3,2,3,3,2,3,3,1,1,3,14,12,12,13,13,14,8,15,7,11,14,12,13,14,13,13,13,13,12,13,12,13,13,13,13,13,13,14,12,13,11,7,9,13,12,20,14,11,14,11,12,7,13,13,9,12,14,12,7,11,8,M/AM C,1,1,1,18,1,1,1,1,1,15,20,1,1,1,1
19095052,Keninha,1651,25/11/1985,30,0,0,0,0,174,70,3,3,3,2,2,1,3,3,1,1,3,10,10,12,10,11,9,6,9,6,3,13,10,4,12,12,10,8,11,11,13,11,12,14,6,13,5,7,9,14,14,7,6,8,13,14,20,12,7,11,10,12,14,12,9,12,4,10,9,8,10,7,M/AM C,1,1,14,20,13,14,1,1,1,1,18,10,11,1,1
19095068,Paulinho,1651,05/05/1988,28,0,0,0,0,174,70,1,1,1,3,1,3,1,1,2,1,1,11,11,12,7,10,11,6,6,10,12,12,10,13,11,13,9,12,11,13,9,11,13,8,7,10,12,13,12,13,11,12,9,20,11,12,9,12,9,13,8,12,10,11,12,11,7,11,15,12,10,10,D/WB L,1,1,1,1,1,1,1,20,1,1,1,12,1,19,1
19095154,Willian Favoni,1651,25/06/1987,29,0,0,0,0,185,75,2,2,2,3,3,1,2,3,1,1,3,8,7,7,9,11,8,8,8,5,12,14,6,13,14,10,12,9,10,10,13,10,5,10,10,6,11,9,12,12,12,11,12,9,11,12,20,10,12,12,6,5,10,10,9,10,11,11,13,3,1,3,DM ,1,1,1,1,1,1,1,1,1,20,12,1,1,1,1
19095174,Johnathan Goiano,1651,29/03/1990,26,0,0,0,0,184,74,1,3,2,1,1,4,2,4,3,2,2,6,12,13,14,13,11,10,12,6,5,12,7,3,10,16,11,14,11,16,10,13,18,13,6,14,6,15,12,16,15,16,12,5,14,15,20,12,12,12,9,10,8,7,16,14,10,16,18,17,13,13,S ,1,1,20,10,1,1,1,1,1,1,1,1,1,1,1
19095200,Carlos Eduardo,1651,17/10/1989,26,0,0,0,0,183,73,2,1,2,2,3,1,4,1,2,2,1,11,12,13,10,15,10,8,12,9,8,14,13,8,14,13,10,10,9,11,13,9,13,11,6,12,10,11,13,12,14,11,10,10,11,11,20,13,12,12,5,10,8,11,12,13,10,11,11,9,11,9,M/AM C,1,1,1,20,1,10,1,1,1,1,17,10,10,1,1
19095228,João Filipe,1651,11/06/1988,28,0,0,0,0,190,78,2,3,1,1,2,1,2,2,1,4,2,4,8,10,6,11,10,13,10,10,12,12,5,13,10,13,12,12,12,12,9,10,12,10,8,9,13,13,12,12,12,7,15,6,11,11,20,13,12,10,13,10,14,11,17,9,10,10,12,10,9,11,D/DM C,1,7,1,1,1,1,20,1,10,18,1,1,1,1,4
19095247,Aderlan,1651,18/08/1990,25,0,0,0,0,180,74,2,3,1,3,3,1,3,2,2,3,3,10,13,12,8,11,10,10,11,12,7,10,7,14,12,12,12,11,11,8,10,8,12,12,5,11,7,12,11,14,13,9,10,8,13,14,20,13,9,10,10,5,8,10,10,11,17,9,12,14,15,7,D/WB R,1,1,1,1,1,1,1,1,20,1,1,1,15,1,19
19095295,Marcelo,1651,28/11/1991,24,0,0,0,0,185,76,3,2,1,3,1,1,1,1,2,1,2,7,6,4,5,12,7,10,5,4,13,11,2,13,9,14,10,9,7,10,8,11,2,7,12,9,13,8,9,13,11,8,9,10,11,12,20,9,12,10,8,10,8,10,13,12,5,12,11,10,9,2,D/DM C,1,1,1,1,1,1,20,1,1,19,15,1,1,1,1
19095361,Raphael Augusto,1651,06/03/1991,25,0,0,0,0,181,79,1,2,1,2,3,2,3,2,1,2,2,9,7,14,8,13,10,7,9,7,5,10,5,4,13,5,11,9,10,11,11,9,13,15,9,13,5,9,11,13,13,9,10,11,8,13,20,7,9,10,5,10,3,10,20,12,13,10,12,10,10,7,M/AM C,1,1,1,20,1,1,1,1,1,1,18,1,1,1,1
19095383,Diego Bispo,1651,05/01/1989,27,0,0,0,0,184,82,3,1,3,2,2,2,2,1,2,3,4,3,8,8,8,9,5,13,9,8,12,8,10,12,9,13,12,13,12,13,9,10,15,7,9,10,13,12,12,12,12,11,13,10,15,11,20,12,12,12,14,11,7,7,11,13,13,11,12,7,7,14,D C,1,11,1,1,1,1,20,1,1,1,1,1,1,1,1
19095409,Cesinha,1651,16/09/1986,29,0,0,0,0,170,64,3,2,3,1,2,3,1,1,1,3,2,4,7,7,3,9,1,5,7,6,10,10,2,13,8,10,10,10,9,10,8,14,10,6,1,8,10,9,9,14,14,9,6,20,12,14,9,14,10,10,10,10,10,10,8,10,10,11,9,10,8,4,D/WB L,1,1,1,1,1,1,1,20,1,1,1,1,1,18,1
19095451,Édson,1651,20/01/1988,28,0,0,0,0,167,66,1,1,1,3,3,3,1,2,2,2,4,10,10,9,12,13,5,8,6,7,9,12,8,9,10,8,12,9,9,9,9,12,9,4,9,6,9,15,10,11,11,14,4,9,11,12,20,12,6,9,9,4,9,9,19,11,11,10,10,10,19,6,D/WB R,1,1,1,1,1,1,1,1,19,1,1,1,1,1,20
19095510,Linno,1651,04/04/1982,34,0,0,0,0,187,92,1,1,3,1,1,2,1,4,2,3,1,4,1,2,5,8,1,12,5,2,10,8,4,14,6,9,10,9,7,7,2,14,6,1,4,5,14,7,8,8,11,6,14,8,14,10,20,10,14,9,10,6,13,9,7,10,11,12,11,10,14,5,D C,1,1,1,1,1,1,20,1,1,1,1,1,1,1,1
19095515,André Nunes,1651,11/01/1989,27,0,0,0,0,188,83,3,1,3,1,1,3,3,2,1,1,3,4,1,1,1,7,2,10,4,5,10,7,1,13,4,7,9,5,6,8,1,13,5,3,11,4,9,6,7,13,11,6,13,8,13,12,20,11,12,9,7,9,5,9,16,11,11,11,10,10,16,3,D C,1,1,1,1,1,1,20,1,1,1,1,1,1,1,1
19095516,Emílio,1651,01/10/1989,26,0,0,0,0,176,73,2,2,1,1,2,3,1,2,3,3,3,6,5,7,8,13,6,6,9,5,5,13,8,7,13,7,9,5,12,5,13,13,9,13,7,7,7,8,12,13,13,8,8,5,10,12,20,13,5,9,5,6,9,9,8,11,10,10,11,10,9,8,M/AM C,1,1,1,20,1,1,1,1,1,1,17,1,1,1,1
19095606,Flavinho,1651,04/03/1985,31,0,0,0,0,163,58,2,1,3,3,2,3,1,2,1,1,3,5,7,5,5,13,3,8,7,8,8,7,1,14,12,9,10,8,8,12,5,14,2,9,11,9,9,9,10,14,12,9,1,20,11,13,9,14,7,9,7,9,9,14,8,13,10,9,11,13,10,4,D/WB L,1,1,1,12,11,1,1,17,1,1,10,13,1,20,1
19095614,Diego Sales,1651,13/07/1987,28,0,0,0,0,181,0,1,3,4,2,1,3,2,1,3,3,1,8,5,10,9,9,8,6,12,4,9,10,8,8,13,7,11,2,7,8,9,14,7,12,13,13,10,10,13,14,14,10,9,9,14,14,20,14,6,5,10,10,10,10,12,11,9,12,11,3,1,4,M/AM C,1,1,1,20,1,1,1,1,1,1,19,1,1,1,1
19095700,Cássio,1651,21/11/1989,26,0,0,0,0,186,81,1,1,1,2,4,4,2,2,1,1,1,6,7,5,3,7,7,13,7,4,13,9,2,13,8,10,11,10,8,10,6,10,3,6,14,7,13,7,9,13,12,8,10,9,17,13,20,13,12,12,8,6,9,10,12,10,10,10,12,6,8,4,D/DM C,1,1,1,1,1,1,20,1,1,16,10,1,1,1,1
19095711,Jaílton,1651,18/06/1990,26,0,0,0,0,180,75,3,2,3,1,1,1,4,1,4,1,4,10,10,12,11,11,10,9,10,4,5,11,6,5,12,10,13,2,11,9,9,11,10,12,6,12,12,11,12,13,11,11,10,9,10,13,20,16,9,10,7,10,9,15,8,11,14,8,11,13,13,6,AM/S C,1,1,19,20,10,10,1,1,1,1,15,5,5,1,1
19095745,Cristian,1651,14/03/1991,25,0,0,0,0,174,60,3,2,1,4,2,4,2,3,3,2,3,6,2,1,4,7,12,13,1,1,9,7,1,13,4,9,10,9,5,7,5,13,9,1,12,5,13,6,7,13,13,7,7,20,16,13,9,7,13,12,6,7,9,9,10,12,12,9,12,11,8,7,D C,1,1,1,1,1,1,20,1,1,1,1,1,1,1,1
19095753,Rafinha,1651,01/02/1986,30,0,0,0,0,171,69,1,1,1,2,2,3,1,3,3,1,4,4,6,7,3,13,6,6,13,2,12,13,1,13,12,9,11,8,7,8,11,13,5,6,14,7,9,7,12,13,13,7,6,9,14,13,20,12,5,9,8,5,8,9,8,12,11,12,12,3,10,1,DM/M C,1,1,1,1,1,1,1,1,1,20,16,1,1,1,1
19095836,David,1651,18/02/1990,26,0,0,0,0,187,0,2,1,2,3,3,2,1,2,1,1,1,5,4,4,6,10,5,5,4,4,9,12,4,12,12,9,9,8,7,7,6,9,4,9,11,6,10,6,10,12,10,6,12,8,15,12,20,12,9,9,9,8,9,9,7,12,9,11,10,10,2,2,DM C,1,1,1,1,1,1,1,1,1,20,15,1,1,1,1
19095910,Éder,1651,01/11/1988,27,0,0,0,0,179,0,1,3,3,1,3,2,4,1,3,3,3,7,5,12,11,12,4,13,6,3,4,8,9,5,8,3,8,9,12,8,6,13,10,10,4,13,8,7,8,13,13,8,5,20,15,13,9,13,8,10,6,8,8,10,20,12,11,12,12,7,7,7,S ,1,1,20,1,1,1,1,13,1,1,1,1,1,7,1
19096124,Glaycon,1651,07/09/1988,27,0,0,0,0,192,87,14,11,12,1,12,8,10,14,10,9,11,8,1,2,2,6,10,1,3,3,2,1,3,2,4,10,8,12,9,14,8,11,4,3,11,2,11,9,8,12,13,13,15,10,13,11,20,7,13,12,9,5,6,10,12,7,11,10,10,9,11,2,GK ,20,1,1,1,1,1,1,1,1,1,1,1,1,1,1
19096129,Otávio,1651,10/10/1990,25,0,0,0,0,183,78,3,3,3,2,4,2,3,3,2,1,3,4,2,1,5,9,8,14,7,5,11,9,5,13,5,10,14,10,9,9,8,14,13,1,8,8,12,8,9,13,11,12,11,8,11,12,20,7,12,10,6,10,5,10,14,10,9,12,9,10,9,4,D C,1,1,1,1,1,1,20,1,1,1,1,1,1,1,1
19096176,Patrick,1651,23/08/1990,25,0,0,0,0,180,81,3,1,2,3,3,1,2,3,3,3,3,3,7,6,13,9,7,13,8,3,5,9,11,7,11,11,10,12,12,9,11,9,14,12,6,10,12,10,10,12,11,9,12,10,14,13,20,12,13,12,11,11,10,12,8,12,15,11,13,8,12,10,S ,1,1,20,1,1,1,1,1,1,1,1,1,1,1,1
19096381,Leonardo Piaia,1651,07/05/1992,24,0,0,0,0,186,91,3,2,2,1,3,1,2,3,3,4,4,3,3,3,1,9,1,13,6,3,13,9,4,13,8,7,11,10,9,10,7,10,6,4,9,6,12,7,9,13,13,8,10,9,14,12,20,13,9,10,8,10,10,10,15,8,11,11,12,6,14,2,D C,1,1,1,1,1,1,20,1,1,13,12,1,1,1,1
19096411,Murilo,1651,29/09/1989,26,0,0,0,0,173,70,1,2,3,1,1,1,1,2,1,1,4,10,13,13,9,13,5,9,8,11,11,12,4,10,11,9,12,11,6,11,8,13,14,13,10,12,10,13,12,13,13,10,9,10,12,13,20,11,10,10,10,6,7,10,11,14,11,10,12,8,1,4,D/WB R,1,1,1,1,1,1,1,1,20,1,1,1,1,1,19
19096445,Dedé,1651,01/07/1988,28,9,1,0,0,193,87,1,3,2,1,3,3,2,2,4,2,1,7,10,11,9,12,12,15,5,3,14,12,7,14,12,14,12,15,12,12,11,11,12,10,14,12,14,12,14,14,12,10,18,4,10,13,20,11,13,11,9,14,17,16,8,12,15,14,13,14,12,10,D C,1,1,1,1,1,1,20,1,1,1,1,1,1,1,1
19096541,John César,1651,19/03/1988,28,0,0,0,0,170,86,2,3,3,2,2,3,1,2,1,2,3,7,3,13,11,13,7,13,8,2,7,11,2,3,13,10,9,9,6,6,6,12,6,13,4,12,8,8,9,13,13,8,5,8,10,13,20,13,7,10,8,1,10,10,9,10,12,11,12,3,4,2,AM/S C,1,1,18,20,1,1,1,1,1,1,1,1,1,1,1
19096543,Kaká,1651,06/03/1989,27,0,0,0,0,177,0,3,2,2,2,1,3,1,2,2,2,3,6,4,13,13,13,6,13,7,1,3,7,6,1,13,9,12,1,7,4,5,12,6,13,8,12,7,2,8,13,13,7,7,9,10,13,20,12,7,12,8,9,9,9,18,10,11,11,8,8,11,6,S ,1,1,20,1,1,1,1,1,1,1,1,1,1,1,1
19096552,Manoel,1651,26/02/1990,26,0,0,0,0,181,82,3,3,2,1,3,1,1,2,3,1,2,6,8,10,8,12,7,16,8,11,14,12,10,15,13,16,12,18,11,9,11,10,15,11,12,12,14,12,16,14,13,12,10,8,18,13,20,15,18,10,10,10,10,12,7,14,13,14,13,12,9,9,D C,1,11,1,1,1,1,20,7,12,1,1,1,1,1,12
19096561,Henrique,1651,09/05/1983,33,0,0,0,0,165,60,1,3,1,3,2,1,3,3,2,2,3,3,7,15,11,12,8,8,11,4,8,11,14,7,13,5,12,9,14,10,11,12,13,18,5,14,11,11,18,12,15,10,5,5,11,12,20,11,6,13,12,11,9,12,18,14,5,10,10,9,12,9,M/AM/S RC,1,1,16,20,14,19,1,1,1,1,14,12,19,1,1
19096786,Gil,1651,13/04/1991,25,0,0,0,0,174,67,1,4,2,2,3,4,1,1,4,2,1,5,11,13,12,13,9,8,8,7,7,10,13,7,13,7,13,7,10,11,12,12,11,15,8,13,6,11,13,16,15,6,6,10,12,15,20,13,6,10,5,7,10,10,14,10,13,11,12,7,13,15,S ,1,1,20,1,1,1,1,1,1,1,1,1,1,1,1
19096971,Rafael Martins,1651,29/11/1991,24,0,0,0,0,190,79,14,13,12,1,12,11,10,14,7,10,14,7,1,3,3,4,10,1,2,2,1,3,1,2,5,10,12,15,8,9,8,14,6,3,10,3,11,9,8,12,8,7,15,8,17,13,20,8,13,10,8,10,10,10,16,13,12,13,13,8,16,1,GK ,20,1,1,1,1,1,1,1,1,1,1,1,1,1,1
19096974,Timbó,1651,29/05/1990,26,0,0,0,0,186,73,2,2,1,1,2,1,4,1,3,2,2,10,9,8,7,10,12,12,13,9,10,10,6,12,11,7,12,10,8,12,9,9,8,8,7,8,11,10,8,11,10,7,12,20,10,11,10,9,10,9,7,9,6,9,17,8,7,8,9,12,13,7,D LC,1,1,1,1,1,1,20,20,1,1,1,7,1,10,1
19096976,Luccas Claro,1651,02/10/1991,24,0,0,0,0,179,83,4,4,1,2,2,1,1,3,2,1,3,10,10,11,11,11,10,13,9,12,13,10,11,13,11,12,13,13,12,13,11,11,10,8,14,10,13,14,13,11,13,14,10,7,14,11,20,13,15,10,12,10,9,10,16,12,13,13,12,8,10,9,D C,1,1,1,1,1,1,20,1,1,1,1,1,1,1,1
19096995,Juninho,1651,11/03/1987,29,0,0,0,0,175,0,2,1,1,2,2,3,3,3,3,1,1,7,5,9,4,13,7,5,13,3,8,13,2,9,11,10,8,9,11,7,9,12,3,11,10,9,9,8,10,13,13,8,7,10,15,13,20,13,11,10,10,5,10,10,15,12,9,11,9,10,14,5,AM C,1,1,1,20,1,1,1,1,1,1,15,1,1,1,1
19096996,Edenilson,1651,13/09/1987,28,0,0,0,0,185,72,1,2,2,2,3,2,1,1,3,1,3,8,10,11,7,12,12,11,13,4,11,13,7,13,13,15,11,13,10,13,12,12,15,10,8,11,12,13,13,9,10,11,13,20,9,7,10,11,11,13,10,13,13,9,12,12,12,12,12,8,12,8,DM/M LC,1,1,1,12,1,1,1,1,1,20,20,15,11,7,1
19097000,Ramos,1651,25/04/1985,31,0,0,0,0,187,0,4,1,2,3,3,2,4,3,3,1,3,6,9,7,5,12,6,8,7,4,11,8,1,13,8,11,8,9,8,8,7,13,5,4,6,6,13,9,8,10,10,7,13,10,13,10,20,11,8,11,13,9,9,14,9,9,11,12,12,6,13,8,D/DM/M RC,1,1,1,1,1,1,20,1,17,16,1,1,16,1,13
19097104,João Carlos,1651,05/01/1978,38,0,0,0,0,189,0,2,3,2,4,2,1,1,3,2,1,4,1,3,2,7,8,1,14,4,2,11,8,1,13,6,9,14,9,3,8,6,14,5,1,13,7,14,7,8,9,7,8,9,9,4,7,20,13,9,8,6,3,7,9,11,11,12,10,11,5,15,3,D C,1,1,1,1,1,1,20,1,1,1,1,1,1,1,1
19097119,Alexandre Bindé,1651,06/09/1983,32,0,0,0,0,175,70,3,3,2,3,2,3,1,2,3,4,2,5,6,7,5,11,5,7,7,8,9,9,6,9,8,6,9,9,10,11,8,14,2,4,11,7,10,10,10,15,11,12,8,10,14,13,20,15,7,9,8,9,5,9,14,13,12,12,11,2,12,2,D/WB R,1,1,1,1,1,1,1,1,20,1,1,1,1,1,17
19097186,Roger Carvalho,1651,10/12/1986,29,0,0,0,0,184,77,2,3,3,3,1,3,2,2,3,3,1,5,6,6,6,11,7,13,6,6,13,10,8,12,11,12,13,13,11,12,11,12,7,11,10,10,14,13,12,13,13,11,13,9,14,13,20,15,11,12,13,11,12,10,11,12,11,11,12,12,11,9,D C,1,1,1,1,1,1,20,1,8,5,1,1,1,1,1
19097199,Leozinho,1651,07/06/1988,28,0,0,0,0,169,64,2,2,3,2,3,3,3,2,3,1,2,7,11,12,8,10,5,8,8,10,5,12,12,5,12,11,11,13,12,11,10,13,12,13,3,15,4,12,12,16,15,14,4,20,9,15,7,12,4,11,11,8,3,14,20,13,11,10,12,6,14,4,AM/S L,1,1,17,11,20,13,1,1,1,1,1,1,1,1,1
19097437,Thiaguinho,1651,19/05/1990,26,0,0,0,0,178,73,2,2,3,1,3,1,2,2,1,1,2,9,9,11,9,11,10,8,8,5,5,11,11,4,11,10,9,7,9,9,10,10,9,12,6,11,6,9,11,13,13,11,9,8,12,13,20,11,7,11,7,9,7,11,8,8,14,9,8,8,15,6,AM/S RLC,1,1,16,20,15,16,1,1,1,1,12,5,6,1,1
19097475,Carlos Aguiar,1651,08/05/1991,25,0,0,0,0,195,0,13,7,12,1,10,11,8,13,9,9,8,1,1,3,3,4,6,1,1,2,2,2,2,3,6,8,8,15,7,7,6,13,12,2,10,2,11,7,6,13,10,7,14,9,12,12,20,4,12,8,8,3,5,8,12,11,15,10,14,11,10,12,GK ,20,1,1,1,1,1,1,1,1,1,1,1,1,1,1
19097538,Menezes,1651,02/01/1989,27,0,0,0,0,182,76,3,2,1,2,4,2,1,2,1,1,3,3,5,5,6,7,4,13,9,4,12,7,8,11,7,15,10,14,9,10,6,10,14,6,11,7,11,15,12,11,10,13,11,10,15,11,20,14,12,12,12,11,5,7,12,13,13,11,13,9,13,10,D C,1,11,1,1,1,1,20,1,1,1,1,1,1,1,1
19097593,Neto Berola,1651,18/11/1987,28,0,0,0,0,171,66,3,1,1,1,3,2,2,4,2,3,1,11,12,14,10,15,13,9,10,5,4,12,10,5,14,11,12,12,10,10,12,11,12,16,7,12,8,6,12,18,16,7,6,10,9,16,20,9,9,13,5,13,15,14,10,12,14,13,17,6,13,5,S R,1,1,20,10,10,15,1,1,1,1,1,1,1,1,1
19097638,Manoel Chuva,1651,12/01/1994,22,0,0,0,0,174,70,1,1,1,2,1,2,2,1,4,1,2,2,6,10,11,9,5,9,9,2,3,9,12,3,10,12,7,10,10,7,8,10,12,16,3,12,7,10,10,12,11,8,7,7,14,12,20,8,8,11,5,11,4,8,10,13,13,8,14,8,12,12,M/AM R,1,1,12,1,1,20,1,1,1,1,1,1,18,1,1
19097681,Elizeu,1651,28/05/1989,27,0,0,0,0,183,78,1,2,2,3,1,1,3,3,1,1,3,6,5,8,3,5,6,5,11,5,14,12,5,14,6,13,12,14,11,12,10,13,12,12,9,11,11,12,13,14,14,15,12,9,14,14,20,15,15,10,12,10,6,6,11,13,5,11,10,13,15,15,DM/M C,1,1,1,1,1,1,1,1,1,20,18,1,1,1,1
19097925,Junior Alves,1651,25/03/1990,26,0,0,0,0,194,95,2,2,1,2,3,2,2,2,1,3,1,2,5,7,6,7,1,14,6,9,12,8,4,13,6,18,10,12,8,8,8,9,10,2,6,6,10,14,11,10,10,14,15,7,11,10,20,13,14,10,16,6,10,10,8,10,8,6,8,6,6,17,D C,1,1,1,1,1,1,20,1,1,1,1,1,1,1,1
19097930,Fábio Sanches,1651,06/01/1991,25,0,0,0,0,186,75,3,2,1,1,1,1,3,3,2,3,3,6,6,6,6,9,6,11,6,6,13,9,6,11,9,13,12,13,11,12,7,12,3,1,11,6,13,12,13,12,11,9,13,7,13,12,20,13,12,11,13,10,5,13,17,12,14,11,10,10,16,1,D C,1,1,1,1,1,1,20,1,1,15,7,1,1,1,1
19097933,Aleks,1651,20/02/1991,25,0,0,4,0,194,0,13,10,11,3,13,10,8,13,7,14,9,3,1,2,1,1,6,1,3,2,1,1,3,3,1,5,9,13,3,11,7,13,5,2,14,1,11,8,7,13,14,8,16,11,14,11,20,5,11,12,10,10,5,10,17,10,10,13,14,8,17,5,GK ,20,1,1,1,1,1,1,1,1,1,1,1,1,1,1
19097936,Augusto,1651,16/04/1986,30,0,0,0,0,187,80,2,1,1,2,1,3,3,1,1,3,2,2,4,8,8,9,8,12,6,6,11,9,8,11,8,13,11,11,10,10,5,11,12,9,10,8,12,13,12,10,4,12,13,10,12,9,20,11,12,15,9,11,7,12,10,13,6,13,13,12,12,10,D C,1,12,1,1,1,1,20,4,8,1,1,1,1,1,1
19098041,Luiz Eduardo,1651,23/01/1987,29,0,0,0,0,191,87,1,2,2,3,1,2,2,1,2,1,1,7,7,10,9,10,9,14,12,10,12,10,11,12,10,12,11,10,10,12,10,9,13,10,11,10,13,12,12,13,7,15,15,20,16,13,10,14,15,12,13,10,4,9,20,13,10,10,12,9,10,10,D C,1,1,1,1,1,1,20,1,1,1,1,1,1,1,1
19098175,Henik,1651,08/09/1989,26,0,0,0,0,181,76,3,3,2,1,1,2,2,1,1,2,1,6,8,7,7,14,8,8,7,4,10,13,5,14,14,5,9,9,9,9,10,10,5,9,2,8,9,9,12,14,14,9,10,10,12,14,20,14,11,10,10,10,10,10,13,12,12,8,11,1,12,6,DM ,1,1,1,1,1,1,1,1,1,20,10,1,1,1,1
19098177,Tiago,1651,17/06/1990,26,0,0,0,0,191,89,2,1,3,3,2,1,1,3,3,3,1,8,12,8,12,14,13,14,16,7,13,11,12,13,11,14,14,14,10,13,10,11,15,5,13,10,12,12,12,12,9,10,17,8,12,11,20,14,15,13,12,11,5,11,17,12,13,13,12,10,12,6,D C,1,1,1,1,1,1,20,1,1,1,1,1,1,1,1
19098180,André Gava,1651,08/06/1992,24,0,0,0,0,175,69,2,3,1,4,2,4,1,3,1,1,1,6,6,7,8,13,6,6,11,3,7,10,3,6,13,9,7,5,7,7,9,8,5,13,14,9,8,7,11,13,13,7,6,9,13,13,20,13,5,9,9,3,9,9,16,11,11,10,9,1,5,4,AM C,1,1,10,20,1,1,1,1,1,1,15,1,1,1,1
19098183,Rodrigo,1651,08/10/1990,25,0,0,0,0,192,83,2,1,2,1,1,4,3,2,3,2,3,1,2,3,3,8,1,14,2,5,9,8,7,14,7,9,9,9,6,6,3,14,6,3,5,6,9,7,9,12,13,8,16,3,9,13,20,13,12,9,9,9,9,9,20,11,11,12,10,7,19,3,D C,1,1,1,1,1,1,20,1,1,1,1,1,1,1,1
19098184,Ronny,1651,19/08/1991,24,0,0,0,0,176,72,2,3,2,1,1,2,3,2,3,3,3,10,10,12,10,12,11,8,11,3,5,12,12,5,13,9,11,10,11,11,12,10,13,13,7,12,6,12,11,13,13,14,7,10,11,13,20,11,8,12,13,13,13,11,12,12,10,11,6,8,11,7,M/AM RC,1,1,1,20,10,19,1,1,1,1,15,7,17,1,1
19098186,Ramon Zanardi,1651,28/09/1991,24,0,0,0,0,181,77,3,2,2,1,1,2,2,2,1,2,3,1,1,3,1,7,1,13,1,1,13,7,1,13,3,9,12,8,4,6,5,13,3,1,12,4,13,6,7,13,13,10,9,20,11,13,10,4,8,9,5,9,9,9,16,10,13,11,11,7,8,4,D C,1,1,1,1,1,1,20,1,1,1,1,1,1,1,1
19098531,Renato de Vecchi,1651,07/02/1989,27,0,0,0,0,178,67,1,4,3,3,1,2,2,2,1,1,3,7,11,10,6,11,2,1,5,2,3,6,1,5,6,7,8,5,6,5,7,9,6,8,6,6,4,5,7,12,12,5,8,12,14,12,20,9,3,7,8,4,8,8,7,15,5,9,10,9,8,2,M/AM RLC,1,1,15,15,18,20,1,1,1,1,1,16,18,1,1
19098925,Marlon,1651,05/02/1990,26,0,0,0,0,178,75,2,1,3,3,2,3,2,4,1,2,1,7,4,13,13,13,7,13,7,1,7,8,5,2,13,7,13,6,8,8,6,8,1,13,13,13,8,7,8,13,13,7,8,9,14,13,20,13,12,10,7,10,9,10,14,8,11,10,11,9,1,1,S ,1,1,20,1,1,1,1,1,1,1,1,1,1,1,1
19099130,Gérson,1651,07/01/1992,24,0,0,0,0,186,85,3,2,3,2,4,3,3,2,1,1,3,2,5,9,5,8,4,12,6,4,13,12,4,11,11,10,11,10,13,9,10,11,8,13,10,11,13,10,10,13,12,12,13,20,13,12,12,12,12,12,5,8,10,10,13,10,12,8,11,8,5,1,D/DM C,1,1,1,1,1,1,20,1,1,18,15,1,1,1,1
19099133,Neguete,1651,03/05/1990,26,0,0,0,0,190,82,1,3,3,3,2,3,3,2,2,2,1,4,6,7,8,10,4,12,7,5,12,11,9,12,10,12,12,13,12,11,8,11,12,5,11,5,13,14,13,10,11,7,15,7,14,10,20,14,13,12,6,11,2,10,10,11,10,13,13,12,12,5,D C,1,1,1,1,1,1,20,1,10,1,1,1,1,1,1
19099135,Sebá,1651,08/06/1992,24,0,0,2,0,179,73,2,1,2,3,1,3,1,3,2,1,3,11,11,11,10,11,10,10,9,9,10,12,12,9,11,16,10,15,10,12,12,9,16,12,8,13,10,15,15,15,13,15,10,20,16,14,8,15,16,15,12,13,4,12,14,15,12,15,16,9,10,4,M/AM/S RL,1,1,16,10,20,19,1,1,1,1,6,16,16,1,1
19099202,Alemão,1651,17/07/1991,24,0,0,0,0,183,81,3,3,4,2,1,1,3,1,4,2,2,5,8,7,11,8,4,12,8,8,13,8,3,12,7,13,10,10,5,11,6,10,2,4,10,8,9,12,8,9,9,13,12,20,12,9,11,11,12,10,14,13,8,3,12,11,11,11,13,12,10,1,D C,1,1,1,1,1,1,20,1,1,1,1,1,1,1,1
19099358,Luiz Vinícius,1651,16/01/1990,26,0,0,0,0,179,66,3,1,1,1,3,3,2,2,1,2,3,4,4,13,13,13,6,8,8,5,7,12,6,6,13,9,5,5,7,6,7,13,3,13,4,12,6,7,8,13,13,3,8,9,7,13,20,12,6,9,9,3,9,9,15,10,10,14,13,10,9,8,M/AM/S C,1,1,17,20,1,1,1,1,1,1,19,1,1,1,1
19099575,Danilo,1651,15/07/1991,24,15,0,15,2,184,78,1,3,1,1,3,1,2,3,1,3,1,11,11,13,9,12,11,11,14,13,12,12,12,15,13,14,12,14,11,14,11,10,15,14,10,15,12,13,16,13,12,13,12,16,15,17,20,17,14,13,15,12,9,14,12,15,13,12,16,12,12,8,D/WB R,1,1,1,1,1,1,1,1,20,10,11,1,12,1,19
19099576,Vinícius Gandra,1651,25/11/1988,27,0,0,0,0,186,79,12,11,11,8,9,13,13,15,16,12,11,6,2,1,2,7,9,1,1,6,3,4,1,2,4,9,6,12,10,12,4,7,3,2,13,2,12,14,9,10,12,12,14,7,12,4,20,12,13,9,9,12,8,9,11,12,10,12,9,9,12,1,GK ,20,1,1,1,1,1,1,1,1,1,1,1,1,1,1
19099586,Roberto,1651,29/01/1990,26,0,0,0,0,185,82,13,9,8,6,10,13,9,11,6,7,9,4,1,1,1,1,9,8,2,3,5,7,2,1,6,7,9,14,8,10,6,8,9,1,14,3,10,7,6,10,11,7,12,8,16,9,20,1,12,9,8,3,8,9,12,11,11,10,10,5,9,8,GK ,20,1,1,1,1,1,1,1,1,1,1,1,1,1,1
19099906,Galvão,1651,22/06/1991,25,0,0,0,0,181,68,2,2,2,2,1,1,1,4,3,2,2,8,11,11,8,10,6,9,9,9,10,11,8,11,11,5,12,10,9,11,11,14,9,10,5,10,10,11,11,13,12,11,12,20,11,12,7,11,11,11,10,10,10,10,19,12,11,12,12,4,4,6,D/WB/M/AM L,1,1,1,12,18,1,1,16,1,1,1,20,1,18,1
19100035,Didi,1651,25/05/1991,25,0,0,0,0,183,70,2,3,3,2,1,1,1,1,1,2,1,6,6,11,7,9,5,11,4,7,15,9,9,13,11,14,12,14,11,11,8,9,11,10,7,10,12,13,12,12,12,13,13,8,14,12,20,12,13,12,11,12,7,10,18,13,11,12,13,8,17,1,D C,1,1,1,1,1,1,20,1,1,14,5,1,1,1,1
19100036,Cléber,1651,05/12/1990,25,0,0,0,0,183,87,2,3,4,3,4,4,1,1,3,3,2,4,9,13,8,11,7,14,10,10,16,12,7,15,12,16,12,17,14,9,11,10,16,10,11,8,10,8,14,13,12,17,13,10,16,17,20,13,15,10,14,11,6,8,8,15,7,13,12,7,9,10,D C,1,1,1,1,1,1,20,1,12,1,1,1,1,1,10
19100037,Vagner,1651,24/08/1989,26,0,0,0,0,191,82,11,12,13,6,13,11,13,14,12,16,12,2,1,1,3,6,7,5,3,11,2,6,5,1,7,14,12,15,11,10,6,12,11,10,12,8,12,13,14,13,14,13,16,5,15,11,20,14,14,12,13,11,6,11,11,11,16,8,10,7,11,4,GK ,20,1,1,1,1,1,1,1,1,1,1,1,1,1,1
19100038,Samuel Xavier,1651,06/06/1990,26,0,0,0,0,166,66,3,3,3,3,1,3,3,1,3,1,3,11,13,13,9,12,8,9,10,9,13,13,9,13,12,16,12,14,12,12,10,12,11,11,8,14,13,13,14,13,14,13,7,12,13,13,20,14,12,13,10,12,5,13,17,13,6,9,9,8,11,11,D/DM RLC,1,1,1,1,1,1,1,15,20,17,15,1,13,13,13
19100039,Rafael Pascoal,1651,02/09/1990,25,0,0,0,0,189,74,13,8,6,1,9,10,6,9,9,3,12,7,2,2,2,3,9,1,1,1,1,1,1,3,1,9,6,14,6,10,6,11,9,1,4,2,10,7,6,12,13,7,11,9,9,11,20,4,10,8,9,2,8,9,7,11,8,11,13,7,1,6,GK ,20,1,1,1,1,1,1,1,1,1,1,1,1,1,1
19100041,Diego Barboza,1651,27/07/1989,26,0,0,0,0,175,67,1,1,2,3,3,2,1,1,3,1,2,10,9,13,12,11,10,7,11,10,6,12,11,5,13,8,11,12,11,8,12,8,11,11,6,13,11,12,7,14,14,10,7,20,10,14,8,10,7,10,4,11,5,9,11,10,13,9,10,10,16,3,AM/S LC,1,1,17,20,17,1,1,1,1,1,1,1,1,1,1
19100042,João Paulo,1651,02/07/1985,31,0,0,0,0,184,79,2,2,4,2,3,3,2,1,1,3,2,4,7,9,11,10,4,14,7,7,5,10,12,7,10,10,7,7,8,8,10,8,4,7,8,10,10,10,10,11,10,9,12,8,12,11,20,15,10,7,9,8,8,6,19,11,11,10,11,10,8,1,S ,1,1,20,1,1,1,1,1,1,1,1,1,1,1,1
19100057,Lucas,1651,06/12/1988,27,0,0,0,0,176,0,1,1,1,3,1,3,1,1,2,4,1,7,7,14,14,11,7,14,8,4,7,5,4,1,7,9,6,7,7,8,8,11,9,6,14,10,8,7,9,14,14,8,5,9,10,14,20,13,11,9,9,4,7,8,4,13,11,11,13,1,3,6,S ,1,1,20,1,1,1,1,1,1,1,1,1,1,1,1
19100369,Paulo Rafael,1651,22/01/1991,25,0,0,0,0,186,82,13,11,9,1,10,11,9,12,10,10,9,4,3,2,2,7,7,1,3,2,1,1,3,2,8,9,13,14,9,11,8,14,6,3,3,1,11,9,8,12,10,9,14,10,11,13,20,8,14,10,8,3,4,10,17,9,10,11,11,13,10,6,GK ,20,1,1,1,1,1,1,1,1,1,1,1,1,1,1
19100372,Admilton,1651,15/10/1989,26,0,0,0,0,184,74,1,3,3,2,2,3,2,2,1,1,2,4,1,3,2,7,6,14,2,1,14,8,3,14,4,7,11,9,4,10,5,13,9,3,7,7,9,7,8,14,12,8,6,9,11,13,20,5,7,9,9,9,6,9,13,13,11,9,10,2,11,5,D C,1,1,1,1,1,1,20,1,1,1,1,1,1,1,1
19100375,Jenison,1651,22/03/1991,25,0,0,0,0,185,75,1,3,1,3,3,3,3,1,3,3,1,12,10,10,10,10,10,10,10,10,7,11,10,9,12,10,10,10,10,12,12,11,4,11,10,10,10,10,12,12,12,11,10,7,12,13,20,13,10,11,10,11,10,12,9,12,11,9,11,7,7,2,M/AM/S C,1,1,20,20,13,13,1,1,1,1,17,1,1,1,1
19101022,Weldinho,1651,16/01/1991,25,0,0,0,0,181,70,1,3,3,3,2,1,2,2,2,1,1,13,11,12,11,12,10,10,12,12,11,12,11,10,12,11,11,11,11,12,11,11,12,11,8,12,11,13,12,14,13,11,11,8,13,14,20,13,10,11,11,9,8,11,10,12,10,13,11,7,11,13,D/WB R,1,1,1,1,1,1,1,1,20,1,1,1,1,1,19
19101150,Stéfano,1651,12/01/1991,25,0,0,0,0,183,78,1,2,1,2,3,1,3,3,3,3,1,14,10,12,13,12,6,9,8,7,5,11,8,6,13,7,9,9,12,9,12,9,9,14,5,12,6,9,10,13,12,10,11,20,13,12,10,11,11,11,6,2,10,10,17,10,10,12,11,14,13,6,AM/S L,1,1,20,13,20,1,1,7,1,1,1,13,1,10,1
19101228,Allan,1651,08/01/1991,25,0,0,5,0,173,73,1,4,2,3,3,3,2,3,3,2,1,6,11,15,10,14,8,10,12,8,16,14,10,17,14,16,13,16,14,15,13,14,16,13,11,13,14,16,15,14,14,13,9,8,14,14,20,16,15,14,12,13,12,15,13,13,12,14,14,12,13,9,DM/M C,1,1,1,1,1,1,1,1,10,19,20,1,1,1,5
19101685,Vinícius Santos,1651,16/01/1990,26,0,0,0,0,187,81,2,1,3,1,3,1,2,1,3,2,1,9,10,10,9,10,5,11,5,11,11,11,10,12,9,14,11,12,11,11,5,10,13,8,11,9,11,13,12,12,10,6,14,20,14,11,5,13,12,12,6,12,12,14,11,11,11,11,12,12,10,5,D LC,1,1,1,1,1,1,20,19,10,1,1,1,1,1,1
19102112,Thalles,1651,08/01/1991,25,0,0,0,0,188,0,1,2,3,1,3,3,1,4,4,3,4,6,7,13,9,13,2,13,6,4,3,7,6,1,13,9,9,6,13,7,5,9,6,13,10,10,7,6,7,13,11,7,11,5,9,13,20,8,7,12,8,4,9,9,8,10,12,10,11,9,7,8,S ,1,1,20,1,1,1,1,1,1,1,1,1,1,1,1
19102123,Carlinho Rech,1651,05/06/1987,29,0,0,0,0,188,81,3,2,2,3,1,3,1,1,1,3,3,5,3,4,5,8,3,10,4,1,13,8,2,10,6,10,13,10,4,9,3,13,6,4,4,7,13,7,8,13,11,8,13,9,10,13,20,5,12,10,9,8,10,10,11,10,11,12,13,5,11,2,D C,1,1,1,1,1,1,20,1,1,1,1,1,1,1,1
19102141,Sandro Müller,1651,19/10/1986,29,0,0,0,0,193,0,3,2,2,3,2,2,3,2,2,2,4,4,3,5,3,6,6,11,6,1,13,8,3,13,7,9,9,9,7,7,7,13,9,3,12,6,11,6,8,13,11,7,15,4,10,11,20,8,12,9,9,9,8,9,7,9,9,12,12,7,1,4,D C,1,1,1,1,1,1,20,1,7,15,10,1,1,1,1
19102143,Domingues,1651,28/09/1988,27,0,0,0,0,190,82,3,3,3,3,3,4,2,3,2,3,1,5,4,1,5,9,7,11,6,3,11,5,4,11,5,8,9,10,8,10,7,13,10,3,12,4,13,7,9,13,13,12,14,11,13,12,20,10,12,10,7,6,6,10,12,13,12,10,8,5,17,1,D C,1,1,1,1,1,1,20,1,12,15,5,1,1,1,1
19102154,Claudecir,1651,29/06/1989,27,0,0,0,0,189,78,1,2,3,2,2,3,2,2,1,2,1,6,5,13,13,9,6,10,7,1,6,7,5,1,13,8,13,3,7,7,3,12,9,13,10,13,4,6,7,13,12,3,14,9,9,13,20,10,10,9,9,5,6,9,8,11,12,10,11,1,10,4,S ,1,1,20,1,1,1,1,1,1,1,1,1,1,1,1
19102161,Pedro Balú,1651,11/12/1987,28,0,0,0,0,176,0,2,3,2,3,1,2,2,3,4,2,1,4,7,8,4,14,4,7,6,7,9,6,2,12,9,9,9,8,8,11,9,10,9,4,13,7,7,9,9,14,14,9,8,10,10,14,20,7,9,9,8,9,4,9,20,11,10,10,13,8,4,2,D/WB R,1,1,1,1,1,1,1,1,19,1,1,1,1,1,20
19102287,Ruan,1651,15/02/1989,27,0,0,0,0,182,0,1,2,3,4,1,3,2,3,2,3,1,2,1,11,9,13,5,3,8,1,4,13,3,3,13,8,8,4,6,6,8,12,4,13,1,6,6,6,8,13,13,6,10,8,9,12,20,12,9,8,6,4,8,8,17,11,11,13,9,12,14,2,AM C,1,1,1,20,1,1,1,1,1,1,10,1,1,1,1
19102292,Leandro,1651,06/05/1988,28,0,0,0,0,186,0,3,1,1,3,1,1,3,3,1,3,3,2,1,1,2,3,1,8,2,1,9,3,1,9,1,7,8,6,3,8,1,11,7,4,11,1,11,2,3,11,11,3,10,8,11,11,20,7,6,7,4,7,7,7,10,10,9,10,12,6,9,5,D C,1,1,1,1,1,1,20,1,1,1,1,1,1,1,1
19102401,Jonatan Reis,1651,30/06/1989,27,0,0,0,0,180,0,1,1,2,1,3,1,1,3,1,3,1,7,6,12,12,14,7,12,8,6,5,8,11,3,10,9,11,3,8,7,6,8,9,9,13,12,10,4,9,9,11,8,10,9,15,10,20,13,13,9,6,9,7,9,8,11,12,13,10,10,18,3,S ,1,1,20,1,1,1,1,1,1,1,1,1,1,1,1
19102512,Naôh,1651,26/10/1989,26,0,0,0,0,186,73,1,2,2,3,3,3,1,2,3,1,2,6,7,13,9,13,6,9,6,3,6,3,4,1,13,9,12,4,9,7,6,9,5,13,9,10,7,6,10,13,13,7,11,10,15,13,20,11,11,9,6,9,7,9,14,12,10,10,10,10,3,1,S ,1,1,20,1,1,1,1,1,1,1,1,1,1,1,1
19102518,Ideilson,1651,16/11/1989,26,0,0,0,0,172,68,1,3,4,2,1,3,1,1,1,4,1,6,8,10,11,13,6,6,8,4,6,10,3,8,10,8,8,4,7,7,10,10,6,9,11,8,7,11,12,13,13,8,6,20,11,13,9,12,6,8,4,9,6,9,9,9,8,9,10,10,3,3,AM LC,1,1,1,20,15,1,1,1,1,1,1,12,1,1,1
19102519,Gustavo Campanharo,1651,04/04/1992,24,0,0,0,0,175,75,1,4,3,2,1,1,2,2,2,1,3,14,12,15,11,14,14,8,13,7,10,15,14,11,14,11,13,11,11,12,15,12,14,13,8,10,10,12,12,10,13,12,10,9,15,10,20,12,10,13,3,14,8,13,13,12,11,12,14,12,12,9,M/AM C,1,1,1,20,1,1,1,1,1,14,18,1,1,1,1
19102543,Dyego Sousa,1651,14/09/1989,26,0,0,0,0,190,85,2,3,3,3,3,3,1,1,1,4,2,7,8,12,15,12,8,16,12,6,5,11,13,6,13,18,13,11,12,14,10,13,11,8,8,15,7,13,14,10,11,15,15,12,13,12,20,13,15,13,15,11,5,5,8,14,10,11,9,6,4,14,S ,1,1,20,7,10,7,1,1,1,1,1,1,1,1,1
19102658,Douglas,1651,15/05/1992,24,0,0,0,0,194,0,13,8,8,6,13,13,10,13,9,9,7,5,2,3,1,3,8,1,2,1,1,1,3,2,4,9,10,11,7,11,6,9,8,1,11,1,9,7,6,13,11,4,14,9,9,12,20,4,11,9,8,5,9,9,16,11,12,11,12,6,10,7,GK ,20,1,1,1,1,1,1,1,1,1,1,1,1,1,1
19102660,Digão,1651,12/03/1993,23,0,0,0,0,177,78,2,3,4,3,3,3,1,3,1,2,2,11,14,12,11,13,11,9,15,9,8,12,14,8,13,7,12,8,12,12,10,12,10,13,4,13,9,10,14,13,12,9,8,5,13,12,20,15,9,8,5,13,6,11,16,12,12,9,12,6,12,5,D/WB/M R,1,1,1,1,1,1,1,1,20,1,1,1,16,1,18
19102662,Pablo Felipe,1651,15/02/1993,23,0,0,0,0,178,84,4,1,1,1,1,1,1,3,2,1,1,5,2,1,2,6,1,13,5,1,9,6,1,9,5,8,12,8,6,8,2,13,4,1,6,5,10,5,6,13,13,10,6,20,15,12,6,3,10,8,4,7,8,8,18,13,10,10,10,1,11,4,D C,1,1,1,1,1,1,20,1,1,1,1,1,1,1,1
19102663,Negueba,1651,07/04/1992,24,0,0,7,0,177,70,2,2,3,2,3,3,1,2,2,3,3,10,12,14,10,12,9,7,9,1,8,12,11,6,14,8,11,7,11,12,11,11,10,15,6,13,8,13,13,15,16,8,8,8,7,15,20,13,7,10,5,10,16,11,7,9,12,13,11,7,12,9,M/AM RC,1,1,14,18,1,20,1,1,1,1,16,1,18,1,1
19102664,João Felipe,1651,11/03/1992,24,0,0,0,0,182,73,2,1,2,3,2,3,3,3,3,3,2,7,11,12,8,12,4,6,9,10,11,11,6,12,12,10,11,9,11,11,10,10,3,12,10,12,11,11,11,12,13,8,10,10,14,11,20,12,9,10,10,10,4,12,13,11,11,12,12,7,2,5,D/WB R,1,1,1,1,1,1,1,1,20,11,13,1,14,1,19
19102666,Thomás,1651,24/02/1993,23,0,0,5,2,179,72,1,3,1,2,2,2,3,3,3,1,2,10,11,12,11,12,9,9,9,5,8,12,11,5,13,9,11,7,11,10,12,10,13,13,9,13,6,11,11,14,13,12,9,6,12,13,20,12,7,11,10,9,8,12,15,13,10,9,12,9,10,7,M/AM/S RLC,1,1,16,20,16,18,1,1,1,1,16,14,16,1,1
19102668,Lorran,1651,10/01/1993,23,0,0,0,0,182,74,3,2,1,3,3,1,2,2,2,2,3,9,10,10,9,11,8,8,12,7,10,12,10,9,12,9,11,9,10,10,12,12,13,12,10,9,11,10,12,12,12,7,9,20,12,11,8,12,7,12,7,3,10,12,9,10,8,10,12,8,12,8,DM/M C,1,1,1,14,1,1,1,1,1,20,18,1,1,1,1
19102913,Lucas,1651,11/09/1989,26,0,0,0,0,183,0,3,2,3,3,3,2,2,1,1,3,2,7,7,9,9,7,7,5,9,2,8,10,3,8,11,10,10,9,10,5,9,10,10,11,8,8,9,8,12,13,13,8,6,10,7,13,20,13,9,10,10,10,6,10,7,12,12,11,13,1,5,1,AM C,1,1,1,20,1,1,1,1,1,1,15,1,1,1,1
19102935,Henrique Miranda,1651,10/05/1993,23,0,0,0,0,179,65,3,2,1,1,1,2,2,2,3,1,1,9,10,12,6,11,7,9,10,9,4,10,5,5,13,7,11,6,11,11,12,11,12,13,13,12,7,10,12,14,12,6,9,20,6,13,8,11,7,10,5,10,20,10,7,11,12,11,10,7,10,7,D/WB L,1,1,1,1,14,1,1,20,1,1,1,14,1,18,1
19102937,João Schmidt,1651,19/05/1993,23,0,0,0,0,183,77,3,2,4,3,3,2,2,3,2,3,2,14,15,13,13,16,15,8,12,9,12,15,15,11,15,11,14,10,14,12,14,14,14,15,11,12,11,12,12,11,11,12,9,20,11,11,5,9,11,12,7,12,9,13,11,11,11,11,13,3,6,5,DM/M/AM C,1,1,1,16,1,1,1,1,1,18,20,14,1,1,1
19102938,Leo,1651,28/12/1992,23,0,0,0,0,189,77,10,10,8,10,11,7,8,15,6,13,11,6,3,3,2,5,8,6,2,3,1,7,3,3,5,10,13,11,11,10,10,8,6,10,10,11,15,13,16,9,15,10,15,5,10,11,20,10,11,12,8,12,7,10,12,12,11,10,12,2,6,6,GK ,20,1,1,1,1,1,1,1,1,1,1,1,1,1,1
19102939,Luiz Eduardo,1651,28/04/1993,23,0,0,0,0,186,76,3,2,4,3,1,1,4,3,1,3,2,5,9,7,8,9,8,14,10,8,13,13,5,14,11,12,12,13,11,12,9,10,14,10,10,5,13,14,13,13,13,12,13,11,14,13,20,11,12,11,8,9,11,11,12,12,12,11,11,9,9,7,D C,1,1,1,1,1,1,20,1,1,1,1,1,1,1,1
19102940,Marcelo,1651,19/03/1993,23,0,0,0,0,192,0,3,3,1,2,3,3,1,1,3,2,3,3,3,4,1,6,1,9,3,6,9,7,2,12,1,9,10,9,7,6,2,13,9,1,10,5,13,6,7,13,11,7,13,8,9,13,20,4,11,9,9,9,9,9,18,11,13,13,11,1,7,6,D C,1,1,1,1,1,1,20,1,1,1,1,1,1,1,1
19102971,Emerson Santos,1651,27/02/1992,24,0,0,0,0,178,73,1,2,3,4,3,2,1,3,2,3,2,7,7,12,10,11,9,11,11,7,11,10,7,11,11,10,12,9,11,11,10,12,13,12,11,10,9,12,12,14,13,11,9,10,10,14,20,13,11,9,9,11,7,15,15,12,12,13,11,11,12,9,M/AM C,1,1,1,20,1,1,1,1,1,1,17,1,1,1,1
19103217,Nilson,1651,31/03/1989,27,0,0,0,0,183,78,3,2,1,3,2,1,1,2,1,2,1,5,9,11,10,11,7,10,10,8,13,12,8,13,11,13,12,12,9,11,10,10,11,10,7,12,13,13,13,12,13,12,12,10,14,13,20,13,13,11,12,10,6,7,10,8,14,10,15,8,10,5,DM/M C,1,1,5,10,1,1,15,1,1,20,18,1,1,1,1
19103547,Luizinho,1651,16/02/1988,28,0,0,0,0,179,63,1,1,2,1,1,3,3,1,3,1,4,4,10,11,8,10,7,8,8,4,4,9,4,5,12,13,9,12,10,8,9,11,12,15,5,12,7,9,11,13,14,7,8,8,14,13,20,12,5,9,5,9,8,8,12,15,10,12,11,7,10,13,S ,1,1,20,10,10,10,1,1,1,1,1,1,1,1,1
19104178,Éverton Heleno,1651,25/11/1990,25,0,0,0,0,187,87,1,2,1,2,2,1,1,1,3,3,1,11,12,12,11,8,14,4,13,5,12,13,14,12,12,13,11,13,10,9,11,10,12,12,7,14,8,10,10,13,14,9,12,7,12,14,20,11,8,11,8,10,5,11,10,13,12,10,12,12,14,14,M C,1,1,1,1,1,1,1,1,1,15,20,1,1,1,1
19105470,Igor,1651,16/12/1989,26,0,0,0,0,181,0,3,2,2,2,3,2,2,1,2,3,3,8,9,13,14,10,8,11,7,8,8,10,6,8,14,8,9,5,10,8,8,9,3,13,8,14,9,8,9,14,14,10,11,20,13,14,10,9,7,11,10,10,10,10,17,10,10,12,11,9,7,4,AM/S L,1,1,20,1,19,1,1,1,1,1,1,1,1,1,1
19105713,Felipe Anderson,1651,15/04/1993,23,1,0,6,1,178,69,1,2,1,1,2,3,3,1,3,3,2,10,15,16,12,16,12,6,14,4,4,15,10,6,17,12,14,10,10,10,15,11,16,19,9,14,4,12,11,17,16,10,8,15,15,16,20,11,8,13,10,12,8,16,14,14,14,10,18,16,14,5,M/AM RLC,1,1,6,15,19,20,1,1,1,1,1,13,16,1,9
19105719,Guilherme,1651,05/04/1991,25,0,0,0,0,179,77,3,3,2,1,2,1,4,1,3,2,2,5,12,12,10,12,11,12,14,10,13,13,10,14,14,12,13,12,12,12,13,12,13,9,9,12,14,15,13,14,14,14,10,9,14,13,20,14,12,10,10,11,12,14,10,13,14,14,14,10,14,8,DM C,1,1,1,12,1,1,1,1,1,20,15,3,12,1,1
19105867,Rafael Pernão,1651,24/03/1993,23,0,0,0,0,176,0,3,2,1,2,2,3,2,1,1,2,2,7,7,13,13,13,6,13,6,5,5,8,3,3,12,10,9,2,9,6,6,12,6,15,11,13,6,5,8,13,12,8,7,9,7,14,20,11,8,10,6,10,10,10,11,10,12,12,8,11,10,8,S ,1,1,20,1,1,1,1,1,1,1,1,1,1,1,1
19105934,Jaime,1651,26/02/1990,26,0,0,0,0,183,80,3,2,3,1,1,1,3,2,1,3,2,6,7,9,6,9,8,11,6,10,11,9,8,12,9,13,11,12,11,10,8,11,3,9,10,8,11,14,12,11,11,11,12,7,11,12,20,12,13,10,13,10,12,6,15,11,10,11,12,6,16,2,D C,1,1,1,1,1,1,20,1,1,1,1,1,1,1,1
19105937,Jefferson,1651,27/10/1989,26,0,0,0,0,180,76,2,3,3,1,2,3,3,3,1,2,3,9,8,6,7,10,9,9,12,9,11,15,4,12,12,10,13,10,10,12,11,12,10,7,4,7,11,10,14,10,12,5,8,8,16,10,20,12,12,10,10,4,10,10,12,12,11,12,10,10,10,4,DM ,1,1,1,1,1,1,1,1,1,20,10,1,1,1,1
19106478,Patrick Vieira,1651,11/01/1992,24,0,0,0,0,181,0,1,3,2,1,2,3,3,1,2,2,1,11,11,13,11,12,10,11,12,6,5,11,12,6,13,11,12,13,12,12,12,11,13,12,6,13,8,12,12,13,14,11,10,20,14,14,8,13,9,11,11,13,14,12,11,14,13,14,11,8,11,12,M/AM LC,1,1,14,20,17,12,1,1,1,1,18,15,6,1,1
19106889,Caion,1651,05/10/1990,25,0,0,0,0,184,79,2,2,2,1,1,3,3,3,1,3,2,7,9,11,12,13,6,12,10,8,5,10,9,4,13,10,11,11,10,8,11,8,13,13,6,14,5,9,9,12,13,11,10,6,12,14,20,13,10,8,9,12,9,10,5,11,10,11,9,9,12,9,S ,1,1,20,1,1,1,1,1,1,1,1,1,1,1,1
19107371,Renato Xavier,1651,30/06/1986,30,0,0,0,0,180,80,2,1,3,2,3,1,2,3,3,3,3,7,7,4,3,13,5,7,13,1,10,9,6,13,10,9,13,9,7,9,9,13,5,10,10,6,12,8,11,13,13,8,9,9,9,13,20,13,8,10,10,10,5,10,20,9,11,12,12,13,16,6,DM ,1,1,1,1,1,1,1,1,1,20,10,1,1,1,1
19107686,Warley,1651,05/02/1993,23,0,0,0,0,169,0,1,3,3,3,1,1,3,4,4,2,3,10,11,11,10,10,9,9,5,5,6,13,11,7,10,10,11,11,9,10,12,11,8,11,6,11,7,9,11,12,13,11,7,5,10,13,20,12,10,8,5,9,6,8,10,11,10,10,9,2,5,1,AM/S C,1,1,20,18,1,1,1,1,1,1,15,1,1,1,1
19107796,Fernando,1651,12/02/1990,26,0,0,0,0,186,77,2,1,3,3,3,3,3,1,4,2,3,4,6,6,8,13,4,6,12,1,8,12,3,11,13,8,13,8,8,8,8,13,5,7,12,7,10,7,11,13,13,7,10,9,11,13,20,12,9,9,4,9,9,9,11,11,9,15,9,10,9,2,DM ,1,1,1,11,1,1,1,1,1,20,14,1,1,1,1
19107798,Giovani da Rosa,1651,07/01/1992,24,0,0,0,0,188,83,1,3,2,4,1,2,3,2,2,3,1,4,5,13,13,13,7,13,8,3,7,7,8,1,10,9,12,7,13,7,7,11,1,10,3,13,6,7,8,13,11,8,15,9,17,12,20,12,13,10,6,10,9,10,20,9,10,12,12,8,14,7,S ,1,1,20,1,1,1,1,1,1,1,1,1,1,1,1
19107854,Goiano,1651,28/02/1992,24,0,0,0,0,172,0,2,3,3,2,2,1,3,2,3,3,3,8,6,10,10,14,8,8,8,1,8,14,6,12,14,10,11,9,9,7,13,14,5,10,10,8,12,10,9,14,14,10,4,1,15,14,20,8,9,10,6,10,10,10,17,13,9,11,9,8,12,1,DM/M C,1,1,1,1,1,1,1,1,1,17,20,1,1,1,1
19107855,Fabrício Lusa,1651,11/03/1992,24,0,0,0,0,175,71,3,2,1,2,3,3,2,1,1,1,1,9,10,10,11,12,11,9,12,9,12,12,10,11,12,12,9,12,9,10,10,10,13,12,10,7,11,13,12,12,12,11,6,9,13,12,20,13,11,12,10,10,5,15,12,12,11,12,13,6,12,3,DM/M RC,1,1,1,12,1,10,1,1,15,18,20,1,13,1,14
19107873,Rafael Dutra,1651,09/05/1991,25,0,0,0,0,186,83,13,8,9,1,13,13,12,13,7,5,8,1,3,2,1,2,5,1,2,1,2,1,2,1,1,9,7,11,7,11,6,13,2,2,6,3,11,7,6,10,9,5,13,9,10,11,20,4,10,9,9,9,9,9,18,9,14,10,10,1,3,3,GK ,20,1,1,1,1,1,1,1,1,1,1,1,1,1,1
19107892,Pereira,1651,19/08/1988,27,0,0,0,0,183,78,4,3,2,1,2,2,3,3,1,2,1,12,11,12,11,13,12,11,11,8,8,12,12,7,11,10,13,10,10,10,11,10,7,12,7,13,11,12,11,13,12,10,12,11,10,13,20,11,10,10,13,11,7,11,20,12,10,13,9,2,12,2,M/AM RC,1,1,10,20,1,17,1,1,1,1,18,1,14,1,1
19107917,Paulo Maranhão,1651,17/10/1985,30,0,0,0,0,182,0,3,2,1,3,3,3,1,3,1,1,2,6,4,3,2,5,3,10,7,2,13,7,1,9,1,6,11,9,8,10,1,14,9,1,4,7,14,7,8,14,14,8,10,8,12,14,20,5,7,9,4,7,9,9,9,11,8,10,10,10,10,5,D C,1,1,1,1,1,1,20,1,1,1,1,1,1,1,1
19107956,Lúcio Maranhão,1651,18/09/1988,27,0,0,0,0,188,85,2,3,3,1,3,1,2,1,1,1,1,6,11,12,12,13,8,12,11,6,9,10,14,5,11,13,12,13,13,11,10,10,13,6,12,13,12,13,14,13,10,15,15,8,14,13,20,14,14,14,6,13,8,10,17,12,10,12,12,15,12,5,S ,1,1,20,1,10,10,1,1,1,1,1,1,1,1,1
19108016,Léo Paraíba,1651,08/08/1988,27,0,0,0,0,177,71,1,1,3,1,1,3,1,2,3,3,1,7,9,14,10,13,12,5,7,4,4,7,2,8,9,9,9,8,7,8,8,13,3,9,12,7,7,8,11,14,14,8,8,20,13,14,10,7,7,9,9,9,9,9,16,13,11,10,10,10,5,5,AM L,1,1,1,1,20,1,1,1,1,1,1,15,1,1,1
19108063,Julinho,1651,26/02/1986,30,0,0,0,0,187,0,1,2,1,1,1,2,1,3,1,1,3,2,4,4,5,9,1,7,4,4,8,2,4,10,8,9,11,9,7,10,7,13,6,9,9,5,10,7,9,13,11,7,7,9,10,14,20,12,7,9,9,7,6,9,18,12,11,10,11,8,5,7,D R,1,1,1,1,1,1,1,1,20,1,1,1,1,1,1
19108169,Jheimy,1651,06/08/1988,27,0,0,0,0,180,76,1,4,3,1,2,2,3,3,2,1,2,7,8,10,12,11,10,13,10,7,7,10,10,7,10,12,12,11,13,11,11,9,12,11,11,13,5,11,12,13,11,10,10,11,14,13,20,12,13,10,12,11,7,6,16,12,8,12,8,9,15,2,S ,1,1,20,1,1,1,1,1,1,1,1,1,1,1,1
19108263,Thomazella,1651,15/08/1990,25,0,0,0,0,191,86,14,8,6,9,10,13,8,13,9,9,14,2,2,1,1,7,6,1,2,1,3,1,3,3,7,8,10,14,8,8,7,13,9,2,9,3,10,8,7,14,16,8,14,9,9,13,20,7,9,9,6,9,6,9,10,11,10,12,12,3,15,5,GK ,20,1,1,1,1,1,1,1,1,1,1,1,1,1,1
19108266,Marlon,1651,08/02/1991,25,0,0,0,0,185,77,2,2,3,3,2,3,1,3,2,1,3,1,1,9,12,12,1,12,5,1,2,3,5,1,8,8,10,2,8,5,4,9,8,9,13,11,5,4,5,12,12,5,11,8,7,12,20,5,8,8,5,2,8,8,14,9,12,10,11,7,14,2,S ,1,1,20,1,1,1,1,1,1,1,1,1,1,1,1
19108344,Maurício,1651,31/12/1992,23,0,0,0,0,188,81,2,2,2,2,1,3,2,3,1,3,2,4,8,10,12,11,8,12,6,1,4,11,9,4,10,11,11,7,11,11,7,12,4,9,11,12,10,12,11,11,10,14,12,15,13,10,20,12,13,12,5,12,9,8,16,9,13,12,13,1,9,3,AM/S RL,1,1,20,1,15,17,1,1,1,1,1,1,1,1,1
19108345,Myller Alves,1651,16/01/1992,24,0,0,0,0,179,72,3,3,1,1,2,1,3,3,2,2,4,6,4,5,6,5,1,8,7,4,9,9,5,14,8,7,11,9,8,6,4,10,1,6,14,6,6,8,9,14,14,8,4,20,10,14,10,13,9,9,8,9,7,9,11,9,12,12,12,3,11,6,D/WB L,1,1,1,1,1,1,1,20,1,1,1,1,1,16,1
19108349,Elivélton,1651,30/01/1993,23,0,0,0,0,182,77,3,3,1,1,3,1,3,3,3,2,1,7,7,8,8,14,7,7,12,3,7,14,5,9,10,9,8,3,9,8,9,13,3,9,2,12,9,8,11,14,13,5,11,10,12,14,20,8,7,9,9,8,8,9,14,10,10,12,11,6,13,7,AM C,1,1,1,20,1,1,1,1,1,1,15,1,1,1,1
19108352,Giancarlo,1651,14/01/1990,26,0,0,0,0,195,96,4,2,1,3,1,1,1,2,2,3,2,5,7,9,12,10,7,14,10,3,3,9,13,3,10,9,10,11,10,9,7,10,2,11,6,11,5,12,12,10,9,3,17,9,13,10,20,13,17,8,7,6,4,4,16,10,11,11,12,8,11,7,S ,1,1,20,1,1,1,1,1,1,1,1,1,1,1,1
19108402,Rafael Recife,1651,04/06/1989,27,0,0,0,0,180,75,1,2,2,1,2,3,1,1,1,1,3,2,5,6,4,7,4,5,7,1,8,8,5,10,7,12,9,7,1,4,5,13,2,8,9,5,13,7,9,13,13,9,9,9,8,13,20,5,9,8,11,8,8,8,10,10,12,13,11,9,5,2,DM ,1,1,1,1,1,1,1,1,12,20,10,1,1,1,10
19108408,Ebinho,1651,18/01/1988,28,0,0,0,0,178,73,2,2,1,1,1,2,3,1,1,3,2,2,2,13,12,13,6,13,6,2,4,7,5,5,13,6,7,4,9,4,5,13,3,13,1,13,7,6,8,13,13,11,8,5,7,13,20,12,7,9,4,8,9,9,13,11,11,12,10,1,14,2,S ,1,1,20,1,1,1,1,1,1,1,1,1,1,1,1
19108461,Felipe Cordeiro,1651,13/08/1991,24,0,0,0,0,178,77,1,1,2,3,2,3,1,2,1,1,1,7,8,5,6,12,3,10,7,9,9,10,6,11,11,6,12,11,10,10,7,15,8,8,5,10,12,10,10,6,12,10,7,10,6,14,20,15,15,10,10,10,10,10,11,13,11,10,5,10,10,6,D R,1,1,1,1,1,1,1,1,20,1,1,1,1,1,15
19108462,Diego Tavares,1651,28/06/1990,26,0,0,0,0,185,80,1,1,3,1,1,2,3,3,3,3,3,4,4,6,5,8,7,12,6,6,13,8,7,12,10,10,11,12,8,10,4,10,14,3,10,8,12,14,13,9,9,16,14,5,16,11,20,14,16,12,5,8,10,5,12,8,8,11,15,14,14,6,D C,1,1,1,1,1,1,20,1,1,1,1,1,1,1,1
19108464,Diney,1651,02/03/1991,25,0,0,0,0,179,77,2,2,2,2,4,3,1,3,3,1,2,11,15,11,10,12,7,9,10,9,13,10,7,9,8,10,12,8,11,10,11,13,9,5,12,11,10,11,11,11,12,11,7,10,13,11,20,15,7,11,5,10,8,10,19,9,13,12,10,10,20,8,M/AM R,1,1,1,1,1,20,1,1,1,12,14,1,16,1,14
19108465,Paulo Roberto,1651,08/02/1991,25,0,0,0,0,196,0,3,2,1,1,3,1,3,3,3,3,1,5,5,6,8,13,7,7,13,1,14,9,4,10,13,12,9,9,9,8,9,11,10,5,14,7,13,8,12,10,11,8,14,16,16,9,20,10,12,11,10,8,4,10,19,10,9,13,9,11,6,6,DM ,1,1,1,1,1,1,1,1,1,20,13,1,1,1,1
19108529,Hélio Baptista,1651,28/01/1990,26,0,0,0,0,187,80,2,2,4,4,4,1,2,1,4,3,1,1,5,5,4,7,4,13,8,8,11,9,4,13,6,8,11,10,10,10,6,12,8,6,11,8,12,12,12,9,10,13,13,10,13,9,20,12,13,12,11,10,10,10,16,12,11,11,12,7,12,6,D/DM C,1,1,1,1,1,1,20,1,1,17,1,1,1,1,1
19108533,Júnior Morais,1651,22/07/1986,29,0,0,0,0,176,73,3,2,1,3,1,3,2,2,3,2,1,13,14,11,10,12,12,6,14,12,12,13,12,12,15,10,10,10,12,10,12,12,12,15,7,15,12,14,14,13,13,14,8,20,13,12,5,13,13,14,8,15,7,12,14,11,13,13,13,10,11,8,D/WB L,1,1,1,1,13,1,1,20,1,1,1,14,1,17,1
19108535,João Paulo,1651,07/04/1988,28,0,0,0,0,189,80,2,3,1,2,1,1,2,2,1,1,1,4,2,3,6,7,6,15,7,4,11,9,2,11,6,12,12,10,10,10,4,11,11,8,11,8,11,9,10,9,7,13,15,20,6,10,12,7,13,9,6,9,9,9,14,14,11,11,11,6,18,3,D C,1,1,1,1,1,1,20,12,1,12,1,1,1,1,1
19108538,Luiz Carlos,1651,05/07/1985,30,0,0,0,0,175,65,3,1,3,4,3,1,4,1,1,2,3,8,9,11,8,14,8,9,13,8,10,14,12,12,14,13,14,15,14,15,14,14,15,11,10,13,15,15,15,12,12,14,9,8,15,12,20,15,12,13,3,13,8,12,13,12,13,14,14,14,9,7,M C,1,1,1,6,1,1,1,1,1,14,20,1,1,1,1
19108563,Jeferson,1651,15/01/1986,30,0,0,0,0,188,78,3,2,2,2,3,3,1,3,3,1,1,7,7,6,7,9,8,13,10,10,12,9,10,11,10,13,10,13,10,12,7,10,12,6,8,6,13,10,10,9,9,16,15,20,12,9,9,14,16,9,10,7,7,6,12,11,11,12,12,10,10,6,D C,1,1,1,1,1,1,20,1,1,1,1,1,1,1,1
19108573,Ismaily,1651,11/01/1990,26,0,0,0,0,176,78,2,2,3,2,3,3,1,2,2,1,2,11,14,12,9,12,13,11,14,10,12,13,12,15,14,11,13,13,13,12,12,13,13,11,9,14,11,13,12,16,13,12,8,20,14,16,6,14,11,13,9,13,9,11,9,11,13,12,12,13,13,6,D/WB L,1,1,1,1,10,1,1,20,1,1,1,10,1,18,1
19108576,Uederson,1651,01/08/1985,30,0,0,0,0,178,75,1,1,2,2,2,2,1,3,2,1,3,7,7,14,14,14,8,14,9,5,8,8,5,2,12,8,12,7,11,7,4,11,2,11,6,10,9,8,9,14,14,7,4,8,15,14,20,14,7,10,10,9,10,10,7,9,9,14,8,1,6,4,S ,1,1,20,1,1,1,1,1,1,1,1,1,1,1,1
19108738,Gladson,1651,18/09/1990,25,0,0,0,0,181,73,3,1,1,3,3,4,2,2,1,3,1,4,3,4,6,11,5,5,11,1,8,11,1,13,13,5,10,7,6,6,5,13,8,7,9,5,12,6,6,12,10,6,9,8,7,12,20,10,7,8,8,3,8,8,9,10,11,10,14,9,6,3,DM ,1,1,1,1,1,1,1,1,1,20,10,1,1,1,1
19108972,Dida,1651,09/09/1985,30,0,0,0,0,196,86,13,11,8,1,13,13,7,12,8,9,11,1,2,3,2,5,5,1,2,2,1,1,2,1,3,9,6,15,7,6,6,13,9,1,3,1,6,7,6,12,12,3,16,10,12,8,20,5,10,9,6,9,9,9,17,10,13,10,10,4,12,7,GK ,20,1,1,1,1,1,1,1,1,1,1,1,1,1,1
19108974,Joilson,1651,25/05/1991,25,0,0,0,0,188,81,2,3,2,3,3,4,2,4,2,1,2,5,3,3,4,9,1,14,5,2,14,9,4,14,8,10,10,10,9,10,4,14,8,5,9,7,8,8,4,14,13,9,14,11,16,14,20,8,10,10,4,10,7,10,7,7,10,10,12,6,8,4,D C,1,1,1,1,1,1,20,1,1,1,1,1,1,1,1
19108985,Maurinho,1651,10/12/1989,26,0,0,0,0,173,69,2,1,1,2,2,1,2,4,1,1,2,9,10,11,12,11,7,10,9,7,6,10,12,6,12,10,11,11,11,11,9,11,5,12,8,12,8,9,12,14,14,14,7,20,13,13,9,13,6,12,10,8,9,11,15,13,12,10,12,7,8,2,S ,1,1,20,12,13,14,1,1,1,1,6,1,1,1,1
19108989,Jonatas Belusso,1651,10/06/1988,28,0,0,0,0,176,74,3,1,1,3,3,1,3,1,1,2,2,11,11,11,10,16,11,12,9,4,10,11,14,8,16,4,15,8,10,11,11,12,11,13,10,12,11,11,12,14,13,9,11,5,13,13,20,13,10,11,10,11,7,11,7,13,12,12,11,8,1,7,S ,1,1,20,1,1,1,1,1,1,1,1,1,1,1,1
19109109,Tindurim,1651,21/01/1991,25,0,0,0,0,171,68,1,1,1,2,2,3,3,3,4,1,3,1,5,13,12,13,6,8,8,5,5,12,7,6,11,9,9,5,8,7,9,9,5,11,13,13,8,7,8,11,12,10,6,10,10,11,20,11,9,9,5,9,3,8,15,11,11,10,10,9,10,1,AM/S C,1,1,18,20,1,1,1,1,1,1,15,1,1,1,1
19109654,Guido,1651,18/02/1994,22,0,0,0,0,186,77,12,11,12,2,13,12,12,13,12,11,11,7,1,1,3,11,9,5,1,2,1,11,3,2,6,6,11,10,12,11,5,11,15,2,7,8,12,11,12,10,12,12,14,6,8,11,20,12,12,10,3,10,10,10,8,15,5,11,15,4,11,3,GK ,20,1,1,1,1,1,1,1,1,1,1,1,1,1,1
19109655,Josué,1651,28/01/1994,22,0,0,0,0,188,80,4,1,1,3,1,1,3,2,1,1,2,3,8,9,8,9,4,13,8,4,13,9,9,13,11,14,11,14,11,11,5,12,13,9,6,12,12,13,13,13,12,9,13,8,14,13,20,13,13,12,13,13,4,8,9,11,14,11,10,13,1,3,D C,1,11,1,1,1,1,20,1,1,1,1,1,1,1,1
19109657,Wellington,1651,08/01/1994,22,0,0,0,0,172,0,2,1,3,2,2,1,2,2,1,3,3,8,10,10,10,11,6,8,10,5,6,11,11,6,11,8,10,10,9,8,12,10,13,14,3,12,7,9,10,14,14,14,6,7,12,14,20,12,4,12,6,12,5,14,16,14,7,12,5,5,6,17,AM/S RC,1,1,16,20,11,16,1,1,1,6,13,6,9,1,1
19109713,Max Walef,1651,23/10/1993,22,0,0,0,0,185,84,8,9,10,1,11,11,12,12,9,9,11,2,2,3,3,2,6,3,2,2,1,5,3,3,5,5,9,9,8,10,10,9,9,2,5,1,11,11,9,10,14,11,11,3,7,11,20,5,10,9,8,3,5,9,8,11,11,10,12,1,15,7,GK ,20,1,1,1,1,1,1,1,1,1,1,1,1,1,1
19109719,Eduardo,1651,07/06/1993,23,0,0,0,0,178,73,3,2,2,3,3,1,3,1,3,4,3,13,12,13,11,14,14,8,12,7,6,14,13,5,14,8,14,8,12,12,13,13,12,15,8,13,7,12,11,12,13,10,7,20,10,12,11,12,9,9,5,12,5,11,12,12,12,13,9,6,12,8,M/AM LC,1,1,5,20,19,10,1,1,1,1,17,16,5,1,1
19109914,Lucas Paiva,1651,06/09/1993,22,0,0,0,0,165,0,2,2,3,3,1,3,1,1,2,1,3,7,3,9,7,10,7,7,8,3,6,13,4,9,8,5,11,7,11,8,8,12,5,10,4,9,8,8,11,12,13,8,3,11,7,13,20,13,5,10,5,10,3,10,12,9,11,10,10,10,13,2,M/AM C,1,1,1,20,10,10,1,1,1,1,18,5,5,1,1
19109919,Matheus Menezes,1651,12/01/1991,25,0,0,0,0,187,81,1,2,3,3,1,1,2,2,2,3,2,5,6,5,6,9,4,11,6,6,12,11,7,10,10,8,11,10,9,10,6,9,11,10,12,10,10,10,9,11,11,10,12,19,12,11,20,12,11,10,10,11,10,11,8,10,12,7,11,5,12,9,D C,1,11,1,1,1,1,20,1,1,1,1,1,1,1,1
19109920,Paulo,1651,12/01/1993,23,0,0,0,0,174,68,3,1,3,1,1,2,1,3,3,2,3,8,10,11,10,11,9,10,10,5,7,12,4,9,11,9,9,1,10,10,10,11,2,12,12,11,6,7,12,13,12,15,7,11,12,13,20,13,4,10,10,10,10,11,15,12,13,13,11,1,10,1,M/AM/S RLC,1,1,18,20,15,15,1,1,1,1,16,5,5,1,1
19109922,Wallace,1651,14/04/1992,24,0,0,0,0,183,85,12,12,11,7,12,12,12,12,10,10,12,3,2,3,3,7,7,1,2,1,3,2,3,1,4,14,11,9,10,9,3,10,8,3,10,4,12,3,9,10,9,7,11,9,7,11,20,9,12,10,10,13,10,9,9,13,10,13,11,8,6,8,GK ,20,1,1,1,1,1,1,1,1,1,1,1,1,1,1
19109923,Vínicius,1651,16/04/1992,24,0,0,0,0,189,0,2,1,3,3,2,2,1,2,1,2,1,6,6,13,13,13,6,13,7,6,5,5,5,1,9,8,10,7,6,7,7,9,9,9,8,12,7,6,7,13,13,7,7,3,9,13,20,6,13,9,9,9,9,9,13,11,12,10,10,7,8,2,S ,1,1,20,1,1,1,1,1,1,1,1,1,1,1,1
19109926,Rithely,1651,27/01/1991,25,0,0,0,0,172,75,3,2,2,2,3,2,2,3,1,1,3,9,10,11,12,13,10,14,11,10,14,14,10,14,14,15,13,14,14,15,13,12,15,11,13,13,13,14,13,14,13,13,9,10,16,13,20,14,13,14,12,13,6,11,8,13,16,13,12,6,12,10,DM/M C,1,1,1,1,1,1,1,1,1,20,17,1,1,1,1
19110275,Bruno Alves,1651,16/04/1991,25,0,0,0,0,184,81,2,1,1,1,3,1,2,3,1,3,3,7,9,10,9,10,7,12,7,9,12,9,7,13,9,12,12,14,11,13,8,11,13,11,10,9,12,14,13,13,12,10,13,8,14,12,20,15,12,12,12,11,5,8,11,13,9,13,11,7,9,1,D C,1,1,1,1,1,1,20,1,1,1,1,1,1,1,1
19110282,André,1651,27/09/1990,25,4,0,0,0,184,77,3,2,2,1,1,1,3,2,1,3,3,7,9,13,14,13,9,15,12,10,8,12,14,8,13,7,14,13,12,13,13,13,12,12,12,14,10,12,13,13,13,14,13,9,13,13,20,14,14,13,7,11,7,7,5,12,8,10,9,12,12,8,S ,1,1,20,1,1,1,1,1,1,1,1,1,1,1,1
19111265,Tiago,1651,16/05/1993,23,0,0,0,0,190,90,7,10,10,9,14,13,13,15,6,13,10,3,3,1,1,11,8,1,1,1,2,10,4,7,12,7,12,15,12,12,11,11,13,1,8,2,13,12,11,9,10,14,12,10,18,8,20,12,16,11,11,10,11,11,7,12,12,12,15,10,14,5,GK ,20,1,1,1,1,1,1,1,1,1,1,1,1,1,1
19111268,Eduardo Brock,1651,06/05/1991,25,0,0,0,0,184,81,4,2,2,1,1,1,3,3,1,2,1,5,5,4,5,9,3,13,2,6,9,8,3,13,7,10,10,10,8,13,7,13,1,5,11,7,10,7,8,13,13,8,9,20,14,12,10,10,13,10,7,10,5,10,12,9,10,9,9,2,10,4,D LC,1,1,1,1,1,1,20,18,1,1,1,1,1,1,1
19111272,Giácomo,1651,08/11/1992,23,0,0,0,0,185,0,1,2,3,3,1,1,3,2,3,3,3,5,7,13,6,10,5,5,5,4,5,13,1,7,8,5,6,7,6,6,12,9,8,8,2,7,6,7,10,13,12,5,9,20,9,13,8,5,9,8,8,6,8,8,14,11,11,13,9,11,6,1,M/AM LC,1,1,1,20,19,1,1,1,1,1,18,17,1,1,1
19111293,Mateus Magro,1651,27/10/1990,25,0,0,0,0,178,66,1,2,1,2,1,3,3,3,2,3,1,10,10,8,10,10,10,6,11,4,11,11,8,15,10,10,10,10,11,10,11,11,13,11,10,11,9,11,14,13,9,7,4,10,11,13,20,9,7,10,6,5,10,10,16,12,12,12,13,10,14,6,DM ,1,1,1,1,1,1,1,1,1,20,10,1,1,1,1
19111294,Bergson,1651,09/02/1991,25,0,0,0,0,179,76,2,2,1,2,3,3,2,2,3,2,2,6,7,13,7,12,6,7,7,6,5,9,12,5,13,13,11,11,11,10,11,11,13,13,8,11,6,11,11,12,11,10,8,15,13,13,20,11,8,7,7,11,12,13,8,11,12,8,12,5,6,7,AM/S C,1,1,20,18,10,11,1,1,1,1,5,1,1,1,1
19111801,Gil Baiano,1651,20/07/1980,35,0,0,0,0,179,76,1,2,2,3,3,3,3,3,3,2,1,7,6,5,7,8,7,7,9,5,10,11,2,12,10,9,10,8,9,7,11,14,3,4,13,7,11,8,11,7,12,11,9,10,11,11,20,8,6,9,9,9,4,9,11,11,12,10,12,12,17,4,DM C,1,1,1,1,1,1,1,1,1,20,15,1,1,1,1
19112124,Henrique Mattos,1651,25/07/1990,25,0,0,0,0,190,78,3,2,1,2,2,2,3,3,1,1,1,8,6,4,3,11,6,13,7,3,15,10,7,14,8,10,13,11,11,11,7,12,1,10,11,10,13,14,11,10,11,11,15,1,12,10,20,10,16,12,10,10,10,10,9,12,7,10,13,5,12,8,D C,1,1,1,1,1,1,20,1,1,1,1,1,1,1,1
19112126,Érico,1651,20/07/1989,26,0,0,0,0,185,81,1,1,2,3,2,3,2,4,3,3,1,3,3,11,5,12,3,14,5,8,13,12,8,12,11,14,12,15,14,11,5,12,13,10,8,5,10,14,13,11,12,14,14,5,15,12,20,13,13,13,12,12,7,5,17,15,13,16,13,14,12,5,D C,1,1,1,1,1,1,20,1,1,10,1,1,1,1,1
19112128,Élton,1651,20/07/1989,26,0,0,0,0,185,82,1,2,1,3,1,1,1,3,2,1,3,5,7,7,5,13,7,11,7,5,13,12,10,12,12,13,13,15,13,12,10,11,14,10,10,7,12,13,12,12,10,13,12,8,13,11,20,12,14,12,13,11,4,14,12,12,10,12,10,2,1,6,D/DM/M C,1,1,1,1,1,1,16,1,1,20,18,1,1,1,1
19112143,Vander,1651,26/09/1986,29,0,0,0,0,174,69,1,2,1,2,2,2,2,2,2,3,2,5,5,3,6,14,7,6,11,6,12,14,5,8,14,9,8,2,8,5,8,14,8,8,7,12,9,8,13,14,13,8,9,8,10,14,20,8,10,9,9,2,9,9,11,13,13,11,10,8,5,8,M C,1,1,1,1,1,1,1,1,1,1,20,1,1,1,1
19112560,Everaldo,1651,05/07/1991,24,0,0,0,0,181,80,2,2,1,1,2,4,2,4,1,1,2,9,10,11,12,10,9,11,8,9,10,10,13,7,12,8,11,11,11,11,11,11,1,12,7,12,12,11,11,13,11,13,12,10,12,12,20,12,13,11,5,9,5,7,19,10,10,8,11,9,17,4,S ,1,1,20,1,1,1,1,1,1,1,1,1,1,1,1
19112562,Mateus,1651,24/12/1991,24,0,0,0,0,185,0,2,1,1,1,2,2,3,1,3,3,1,10,13,7,7,13,6,6,6,6,7,8,4,7,13,9,9,5,7,5,10,7,3,7,13,8,5,7,10,13,13,7,11,8,16,13,20,9,8,9,9,9,9,9,15,11,11,12,12,1,11,6,M LC,1,1,1,1,1,1,1,1,1,1,15,20,1,1,1
19112564,Vinícius Volpini,1651,03/03/1991,25,0,0,0,0,167,0,1,2,2,2,3,2,1,3,1,3,3,7,8,4,7,14,3,8,4,7,9,9,6,8,9,9,6,9,9,8,9,12,6,3,12,7,8,9,9,14,13,9,4,20,15,13,3,13,11,9,7,9,9,9,8,13,10,11,8,4,1,5,D/WB L,1,1,1,1,1,1,1,20,1,1,1,1,1,17,1
19112646,Teda,1651,28/03/1988,28,0,0,0,0,184,0,2,3,3,3,2,3,2,2,3,1,3,3,3,1,1,7,1,14,7,3,9,7,3,11,4,7,13,9,8,12,2,14,6,2,4,6,14,7,8,14,13,8,10,9,14,13,20,6,8,9,8,6,9,9,8,11,13,9,9,3,13,4,D C,1,1,1,1,1,1,20,1,1,1,1,1,1,1,1
19112674,Michel Lugo,1651,09/06/1987,29,0,0,0,0,182,78,1,2,3,1,1,3,3,1,3,2,3,5,8,14,8,14,7,10,11,2,7,9,5,4,10,6,10,3,8,8,9,10,9,9,3,13,7,7,9,14,14,12,8,20,8,14,10,7,7,9,6,8,7,9,17,8,9,9,8,10,7,6,AM/S C,1,1,20,18,1,1,1,1,1,1,1,1,1,1,1
19112676,Régis,1651,13/10/1989,26,0,0,0,0,180,67,2,3,1,2,3,2,3,2,1,2,3,3,5,6,3,11,1,9,7,6,10,9,1,14,10,6,7,10,9,6,7,12,3,2,3,8,8,9,9,14,14,9,10,10,8,14,20,14,10,10,10,10,8,10,18,13,11,11,10,6,9,3,D R,1,1,1,1,1,1,1,1,20,1,1,1,1,1,15
19112678,Lucas Tagliapietra,1651,05/11/1990,25,0,0,0,0,194,90,2,4,2,3,3,1,2,3,2,3,4,4,4,6,5,10,6,16,2,6,15,9,8,14,9,15,12,15,9,14,9,14,14,4,13,11,14,13,12,9,9,16,16,10,15,10,20,13,15,12,6,12,5,4,8,12,13,13,15,10,13,6,D C,1,1,1,1,1,1,20,1,1,1,1,1,1,1,1
19112679,Amaral,1651,21/07/1989,26,0,0,0,0,172,0,3,3,2,3,4,2,2,4,2,2,3,5,7,4,5,9,7,6,9,5,7,7,3,13,6,7,13,9,9,7,8,13,10,9,9,7,13,8,12,12,9,11,6,16,14,12,20,13,11,10,10,10,7,10,14,10,13,9,11,6,4,1,DM ,1,1,1,1,1,1,1,1,1,20,12,5,9,1,1
19112682,Jajá,1651,11/05/1986,30,0,0,0,0,189,79,3,3,2,2,2,2,1,2,1,3,2,4,3,13,13,11,6,13,7,1,5,7,6,3,13,9,10,6,13,7,5,8,7,13,11,12,5,6,8,13,12,7,13,10,10,12,20,12,8,9,7,9,9,9,10,11,12,10,10,6,1,5,S ,1,1,20,1,1,1,1,1,1,1,1,1,1,1,1
19112713,Xaro,1651,04/03/1987,29,0,0,0,0,178,70,1,2,3,3,3,2,1,1,3,3,1,9,11,13,6,9,7,8,9,17,11,9,4,15,11,6,9,7,8,8,8,8,4,13,10,10,12,12,13,13,13,12,6,20,10,13,5,12,16,12,7,10,10,10,20,10,13,12,11,7,9,5,D/WB L,1,1,1,1,1,1,1,20,1,1,1,1,1,17,1
19112716,Bronzatti,1651,06/12/1986,29,0,0,0,0,183,76,3,1,1,4,3,3,3,2,2,3,2,4,6,3,6,9,1,14,7,1,13,9,6,12,6,9,11,9,12,12,8,10,5,3,13,7,13,14,9,11,10,8,12,10,14,10,20,12,10,13,9,9,9,9,18,11,10,13,13,1,14,4,D C,1,1,1,1,1,1,20,1,1,14,1,1,1,1,1
19112717,Wagsley,1651,03/09/1989,26,0,0,0,0,183,75,3,1,1,1,3,1,3,3,2,2,3,7,8,11,12,8,6,9,10,4,7,10,2,8,12,7,6,8,7,10,9,9,8,12,9,13,10,11,11,9,10,12,10,11,7,10,20,11,10,9,8,5,7,11,13,9,10,9,13,2,7,4,S ,1,1,20,14,1,1,1,1,1,1,1,1,1,1,1
19112719,Uillian Nicoletti,1651,03/11/1988,27,0,0,0,0,186,0,2,1,2,1,3,2,4,3,2,2,2,3,1,3,5,6,1,10,5,1,9,7,1,13,6,9,8,6,6,6,6,13,1,3,7,4,11,6,7,13,10,7,13,8,10,10,20,10,12,9,9,9,9,9,7,11,10,8,13,13,4,1,D C,1,1,1,1,1,1,20,1,1,1,1,1,1,1,1
19112744,Gian,1651,06/09/1987,28,0,0,0,0,188,0,1,1,1,3,2,2,2,3,1,2,2,7,8,7,5,13,3,10,9,8,11,10,8,13,10,6,9,11,9,11,8,15,6,5,12,8,13,10,10,15,9,10,11,10,11,10,20,9,9,10,9,9,9,10,17,12,12,13,12,8,10,2,D/WB R,1,1,1,1,1,1,1,1,20,1,1,1,1,1,18
19113317,Clayton,1651,19/12/1991,24,0,0,0,0,176,69,3,2,2,3,3,1,3,1,2,2,3,9,10,11,10,10,8,7,10,4,6,10,9,7,12,12,10,8,10,10,10,10,10,11,7,10,7,11,12,13,14,14,7,9,11,13,20,13,7,11,13,4,10,9,13,12,9,11,12,12,13,5,AM C,1,1,10,20,1,1,1,1,1,1,10,1,1,1,1
19113321,Gustavo,1651,28/03/1990,26,0,0,0,0,182,68,2,1,2,1,1,3,2,3,2,3,1,5,9,7,4,7,6,6,4,1,8,8,3,12,8,9,10,8,6,8,8,10,4,7,8,7,8,7,8,13,13,7,10,20,4,13,9,11,8,9,5,9,8,9,13,11,13,11,9,7,6,8,D/WB L,1,1,1,8,10,1,1,18,1,1,1,15,1,20,1
19113322,Juba,1651,03/11/1984,31,0,0,0,0,180,77,4,3,1,1,2,2,2,1,1,1,1,8,8,14,13,12,8,14,14,3,8,11,8,5,13,3,8,9,14,8,9,14,3,10,12,14,10,8,9,14,12,9,9,11,11,10,20,11,10,10,5,14,9,10,18,10,10,9,9,5,10,2,S ,1,1,20,1,1,1,1,1,1,1,1,1,1,1,1
19113357,André Ribeiro,1651,25/02/1988,28,0,0,0,0,186,0,1,1,3,2,3,2,3,1,3,1,3,6,8,4,6,9,3,14,4,3,12,8,6,12,6,10,14,10,4,9,4,13,5,2,10,6,14,8,9,11,9,9,13,9,6,11,20,12,10,10,9,10,8,10,8,11,12,12,10,11,18,7,D C,1,1,1,1,1,1,20,1,1,1,1,1,1,1,1
19113733,Maicon,1651,28/07/1989,26,0,0,0,0,187,73,3,1,3,3,2,1,1,1,2,1,3,7,9,12,6,11,8,8,7,6,8,10,3,10,12,10,11,9,10,10,9,14,2,10,3,9,9,8,10,13,13,7,14,20,16,13,10,7,11,10,3,7,10,10,15,9,12,12,12,1,6,6,D/WB/M/AM RL,1,1,1,1,20,17,1,17,1,1,1,17,17,17,1
19113735,Murilo Henrique,1651,31/10/1989,26,0,0,0,0,192,86,1,3,1,3,2,2,1,3,3,2,2,5,8,2,2,13,2,13,8,7,10,10,5,14,9,10,7,10,9,11,6,14,1,1,10,8,9,9,9,14,11,9,14,10,15,11,20,14,10,10,8,10,10,10,13,11,10,10,10,4,2,6,D R,1,1,1,1,1,1,1,1,20,1,1,1,1,1,15
19113736,Ernando,1651,15/12/1989,26,0,0,0,0,188,0,2,1,3,2,2,1,3,2,2,1,1,1,1,1,1,7,1,13,2,4,13,5,1,13,5,9,7,9,7,10,4,13,5,6,3,5,13,6,8,13,13,7,7,9,8,13,20,12,9,9,9,5,9,9,20,10,12,10,11,5,10,2,D C,1,1,1,1,1,1,20,1,1,1,1,1,1,1,1
19113741,Helton,1651,04/08/1991,24,0,0,0,0,176,0,2,3,2,3,4,3,1,1,1,3,3,7,6,13,13,13,6,12,8,3,5,5,4,2,12,5,12,6,9,6,6,7,2,12,2,13,8,7,8,13,13,5,5,11,13,13,20,13,13,10,10,10,10,10,20,13,11,13,11,11,17,3,S ,1,1,20,1,1,1,1,1,1,1,1,1,1,1,1
19114357,Romeu,1651,10/04/1990,26,0,0,0,0,181,0,2,1,2,1,2,2,4,2,3,3,3,6,8,7,1,10,6,8,5,7,9,9,7,10,6,6,8,9,9,12,9,12,2,7,3,5,11,9,4,14,13,7,8,9,6,14,20,9,7,9,8,5,6,9,13,13,10,10,14,4,7,4,D/WB R,1,1,1,1,1,1,1,1,20,1,10,1,10,1,17
19114536,Alexandre,1651,02/01/1991,25,0,0,0,0,186,82,3,3,2,3,3,3,1,3,3,1,1,7,5,4,8,9,2,9,5,5,14,9,6,14,8,10,13,10,6,10,4,14,11,1,14,8,14,8,9,14,11,9,11,1,13,14,20,10,8,11,8,2,10,10,8,10,12,11,9,9,6,6,D C,1,7,1,1,1,1,20,1,1,1,1,1,1,1,1
19114771,Jean Pedro,1651,06/11/1991,24,0,0,0,0,186,0,1,2,1,3,2,3,2,3,1,1,3,8,6,12,10,11,8,6,8,6,8,9,12,6,13,3,10,11,12,9,13,13,4,13,9,15,8,9,9,11,11,5,11,8,12,11,20,8,4,8,6,9,12,8,16,9,10,10,13,4,16,7,S ,1,1,20,1,1,1,1,1,1,1,1,1,1,1,1
19114800,Neílson,1651,01/08/1987,28,0,0,0,0,181,77,3,2,1,2,2,1,1,2,3,1,2,7,5,9,10,10,7,10,8,3,3,7,5,3,9,9,13,6,10,7,8,13,1,14,12,13,10,7,8,11,11,9,10,20,13,12,14,13,10,12,9,10,10,10,17,10,8,12,11,5,13,1,S ,1,1,20,1,1,1,1,1,1,1,1,1,1,1,1
19114801,Nelsinho,1651,01/01/1988,28,0,0,0,0,176,74,3,2,1,2,2,3,3,3,2,2,3,11,11,12,7,10,7,6,9,11,7,10,7,8,12,10,11,11,9,7,9,8,12,11,6,11,7,11,12,15,14,10,7,20,12,15,7,12,7,10,6,5,7,10,13,8,13,5,12,11,14,15,D/WB L,1,1,1,1,1,1,1,20,1,1,1,10,1,19,1
19114831,Jorge,1651,23/04/1987,29,0,0,0,0,179,70,1,2,2,2,1,1,1,4,1,2,3,8,11,10,11,11,7,14,7,4,4,8,4,1,13,12,9,8,10,8,6,12,1,12,13,10,8,7,8,10,11,4,10,10,11,11,20,13,7,8,6,3,9,9,8,12,11,13,9,1,9,8,S R,1,1,20,1,10,15,1,1,1,1,1,1,1,1,1
19114833,Alessandro,1651,11/06/1983,33,0,0,0,0,180,73,1,1,1,2,2,1,1,1,2,1,2,2,5,10,7,7,6,10,6,5,11,7,9,11,10,11,12,11,11,10,9,10,9,12,10,5,11,13,11,10,9,10,9,10,13,11,20,11,9,12,8,8,8,9,12,10,11,11,12,4,10,7,D/DM C,1,1,1,1,1,1,19,1,1,20,12,1,1,1,1
19114883,Matheus Ortigoza,1651,08/09/1993,22,0,0,0,0,182,83,2,3,3,2,4,1,3,3,1,2,1,2,7,9,10,9,5,14,9,3,4,9,5,4,8,5,10,7,12,11,10,9,10,10,1,16,9,9,11,10,11,13,11,11,12,10,20,12,14,10,10,3,10,10,17,10,12,11,12,7,7,3,S ,1,1,20,1,1,1,1,1,1,1,1,1,1,1,1
19114925,David Dener,1651,14/01/1987,29,0,0,0,0,184,86,1,3,3,1,2,1,1,1,2,1,2,6,6,7,13,13,6,7,8,2,4,9,6,1,10,7,12,5,10,7,10,10,1,10,13,8,7,7,8,13,11,7,11,9,12,13,20,7,14,9,9,2,9,9,14,12,12,10,11,1,10,5,AM C,1,1,15,20,10,10,1,1,1,1,10,1,1,1,1
19114926,Diego Felipe,1651,06/01/1989,27,0,0,0,0,186,75,2,2,4,2,1,1,1,2,2,1,1,9,7,8,12,14,9,13,11,2,11,14,5,14,14,6,14,10,11,9,13,14,9,11,10,11,13,10,12,14,12,9,13,11,13,12,20,14,10,13,7,3,3,11,13,9,12,11,12,5,17,1,DM/M C,1,1,1,13,1,1,1,1,1,18,20,1,1,1,1
19115035,Lino,1651,28/03/1988,28,0,0,0,0,178,83,2,2,3,3,2,1,3,3,2,1,1,3,5,7,13,13,5,13,2,1,4,7,5,3,9,7,13,6,9,7,4,13,3,9,5,13,7,6,5,13,13,7,8,9,14,13,20,9,13,9,9,9,9,9,16,11,12,10,10,9,4,5,S ,1,1,20,1,1,1,1,1,1,1,1,1,1,1,1
19115159,Everton,1651,05/02/1990,26,0,0,0,0,186,0,2,1,1,2,2,2,3,4,3,1,3,4,7,1,1,9,7,13,6,7,13,7,1,12,8,10,13,10,9,7,9,13,7,10,8,7,13,8,9,14,14,7,12,20,5,13,11,14,9,10,8,7,5,9,10,9,9,11,12,3,11,1,D C,1,1,1,1,1,1,20,1,1,15,7,1,1,1,1
19115169,Everton Dias,1651,04/06/1990,26,0,0,0,0,183,75,2,2,1,3,1,2,2,2,3,4,1,4,9,9,7,10,7,13,8,8,13,9,10,12,10,10,11,14,8,11,10,12,10,8,12,10,14,12,14,13,13,12,13,1,14,12,20,15,12,12,7,10,4,10,17,10,14,9,13,8,9,8,D/DM C,1,1,1,1,1,1,17,1,1,20,10,1,1,1,1
19115170,Macalé,1651,22/05/1980,36,0,0,0,0,184,75,1,2,1,2,1,3,2,1,3,3,4,2,4,9,3,8,3,14,5,4,12,8,3,14,6,9,10,8,10,10,6,8,9,8,6,3,12,10,10,11,8,12,11,10,14,9,20,10,12,7,6,11,9,9,8,10,9,10,12,12,17,7,D C,1,1,1,1,1,1,20,1,1,1,1,1,1,1,1
19115172,Nando,1651,08/03/1988,28,0,0,0,0,185,78,1,3,3,3,2,3,3,1,1,2,2,4,7,11,13,12,13,13,10,8,5,10,13,6,10,8,12,12,10,12,8,16,7,10,9,15,12,10,11,13,11,8,13,10,13,12,20,13,10,11,10,6,10,10,9,11,11,13,13,6,13,6,S ,1,1,20,1,1,1,1,1,1,1,1,1,1,1,1
19115174,Elyeser,1651,25/06/1990,26,0,0,0,0,179,76,2,2,2,1,1,3,3,3,1,1,1,10,5,8,11,4,10,7,12,5,13,14,6,13,11,12,12,13,11,12,12,11,10,10,11,11,12,14,13,13,14,12,12,11,12,13,20,12,11,12,8,8,4,9,13,10,11,11,10,4,17,6,DM/M C,1,1,1,1,1,1,1,1,1,20,17,1,1,1,1
19115175,Léo Paraíba,1651,04/01/1990,26,0,0,0,0,193,0,1,1,2,1,1,1,2,4,2,3,3,8,6,10,8,14,8,7,11,8,9,13,6,14,14,10,10,9,10,10,10,14,3,13,7,10,10,9,11,14,11,9,13,1,13,13,20,13,13,10,10,10,10,10,18,14,11,11,14,9,9,5,DM/M/AM C,1,1,1,20,1,1,1,1,1,17,18,1,1,1,1
19115179,Lauro César,1651,27/03/1990,26,0,0,0,0,180,70,2,1,2,3,1,3,2,3,4,3,2,6,6,13,9,10,6,13,6,4,4,4,6,1,10,9,9,4,11,5,6,7,1,10,6,13,7,6,7,13,13,7,9,9,10,13,20,9,8,8,9,2,9,9,16,13,11,12,12,4,7,1,S ,1,1,20,1,1,1,1,1,1,1,1,1,1,1,1
19115188,Jonathan Almeida,1651,15/11/1992,23,0,0,0,0,179,72,1,1,2,1,1,3,3,2,3,3,1,11,7,9,7,9,13,10,10,8,13,10,10,12,9,12,10,15,10,9,13,10,10,7,7,10,12,12,15,13,11,10,11,8,12,12,20,10,13,10,12,10,3,10,13,12,11,9,10,9,1,5,DM/M C,1,1,1,1,1,1,1,1,1,20,17,1,1,1,1
19115253,Daniel Gigante,1651,10/03/1981,35,0,0,0,0,193,92,1,3,3,2,3,2,2,3,1,2,1,5,2,8,1,9,1,14,2,1,14,9,5,14,7,9,11,10,8,9,4,14,8,8,7,8,12,8,9,9,6,10,15,11,13,9,20,13,14,13,6,10,9,10,15,9,12,12,9,13,16,6,D C,1,1,1,1,1,1,20,1,1,1,1,1,1,1,1
19115255,Fred,1651,03/06/1986,30,0,0,0,0,190,84,3,1,3,3,2,1,4,3,1,3,1,7,5,1,4,8,9,12,4,3,13,5,5,12,4,9,12,10,8,11,2,13,5,2,9,7,11,7,8,12,10,8,14,10,9,11,20,7,13,10,7,6,10,10,9,10,10,11,13,1,1,4,D C,1,1,1,1,1,1,20,1,1,1,1,1,1,1,1
19115269,Fillipe Soutto,1651,11/03/1991,25,0,0,0,0,177,70,3,1,1,2,3,2,1,1,3,4,2,8,11,12,11,12,9,11,13,10,13,13,10,12,13,12,13,12,12,13,11,11,15,8,11,13,13,13,13,11,12,10,9,20,8,11,5,12,11,9,10,7,13,13,16,10,13,12,15,7,12,8,DM/M C,1,1,1,1,1,1,1,9,1,20,19,14,1,14,1
19115396,Carlos Júnior,1651,05/12/1988,27,0,0,0,0,179,0,3,1,1,1,1,1,2,3,3,2,3,7,6,13,13,14,7,14,4,1,7,8,6,4,13,9,11,7,14,8,5,12,9,12,2,14,8,7,9,14,14,7,9,1,12,14,20,13,8,9,5,4,3,9,10,14,11,12,13,7,12,3,S ,1,1,20,1,1,1,1,1,1,1,1,1,1,1,1
19115437,Michel,1651,21/07/1991,24,0,0,0,0,184,75,12,6,5,1,12,11,7,12,5,6,5,5,1,1,1,1,7,1,2,1,1,1,2,3,2,7,7,13,5,9,4,12,6,2,10,3,8,5,4,10,10,5,6,20,8,11,9,4,6,8,6,8,8,8,17,12,13,13,12,1,12,2,GK ,20,1,1,1,1,1,1,1,1,1,1,1,1,1,1
19115476,Piauí,1651,28/06/1990,26,0,0,0,0,188,79,2,1,2,1,2,2,4,2,2,3,2,6,7,13,13,13,6,13,7,1,6,7,7,2,12,4,10,7,12,7,3,11,11,12,11,11,6,6,7,13,10,7,11,2,13,13,20,11,9,10,9,1,7,9,15,10,11,10,10,7,19,8,S ,1,1,20,8,8,8,1,1,1,1,1,1,1,1,1
19115563,Wilson Júnior,1651,25/04/1991,25,0,0,0,0,177,74,2,3,2,3,3,2,1,3,4,1,2,4,8,11,13,12,10,12,11,4,4,10,12,5,12,11,10,11,11,9,8,10,12,14,3,13,7,10,10,13,14,10,9,11,14,13,20,11,12,12,8,11,7,10,8,11,10,13,15,9,14,9,S ,1,1,20,1,1,1,1,1,1,1,1,1,1,1,1
19115567,Bruninho,1651,08/02/1990,26,0,0,0,0,170,69,3,2,4,1,2,1,3,3,1,1,1,12,10,13,11,11,11,6,10,7,5,12,14,6,13,7,8,8,10,7,12,10,10,14,2,11,7,10,10,13,14,6,4,10,11,14,20,9,4,11,9,10,9,12,7,13,6,10,13,12,9,13,M/AM C,1,1,10,20,12,12,1,1,1,1,19,6,6,1,1
19115641,Gustavo,1651,10/03/1993,23,0,0,0,0,186,77,12,12,11,6,12,12,13,13,12,13,12,2,2,2,3,11,5,7,1,3,1,11,4,3,11,13,12,11,11,9,4,11,11,4,7,4,11,12,12,11,12,8,13,6,13,11,20,13,13,13,7,13,13,10,14,11,14,10,15,10,13,10,GK ,20,1,1,1,1,1,1,1,1,1,1,1,1,1,1
19115702,Madson,1651,01/03/1990,26,0,0,0,0,174,70,2,3,1,2,3,2,1,1,1,3,3,6,9,12,10,11,9,9,10,8,12,12,10,11,12,13,11,12,10,9,10,10,13,10,8,12,12,12,12,12,13,10,7,8,12,12,20,11,8,10,9,9,7,13,9,11,15,9,12,14,13,7,DM/M C,1,1,1,1,1,1,1,1,1,20,18,1,1,1,1
19115703,Muller Fernandes,1651,14/03/1989,27,0,0,0,0,175,79,1,1,2,3,3,2,1,3,2,1,2,6,10,12,9,10,8,8,9,4,6,9,9,7,12,17,10,10,11,12,9,11,10,13,7,12,6,11,10,14,15,7,6,8,13,15,20,13,7,12,6,7,8,12,7,11,11,12,12,2,9,8,S ,1,1,20,12,10,14,1,1,1,1,6,1,8,1,1
19116242,Luís Felipe,1651,22/05/1991,25,0,0,0,0,184,78,1,1,1,1,2,2,1,1,1,1,2,6,4,5,5,8,4,13,3,4,10,6,4,13,6,8,7,9,6,8,5,13,3,2,11,4,13,6,8,11,13,7,11,10,13,13,20,12,10,9,12,9,5,9,13,9,11,14,11,12,6,3,D C,1,11,1,1,1,1,20,1,1,1,1,1,1,1,1
19116247,Leandro,1651,28/02/1991,25,0,0,0,0,182,70,2,3,4,2,1,2,1,1,2,3,3,5,7,8,9,11,8,10,10,5,12,12,10,12,12,12,10,11,9,10,9,11,12,10,9,9,13,12,13,11,11,12,11,10,14,11,20,12,10,13,8,10,8,7,10,12,11,11,13,10,13,3,DM/M C,1,1,1,1,1,1,1,1,1,20,16,1,1,1,1
19116250,Arnaldo,1651,15/09/1991,24,0,0,0,0,182,69,1,1,3,3,4,3,1,1,2,2,3,10,9,12,10,11,10,8,7,9,10,11,3,10,10,9,10,10,12,10,12,11,3,12,14,11,13,11,12,13,13,7,10,11,13,13,20,10,6,11,6,7,7,10,8,10,12,13,10,2,8,8,D/WB/M/AM R,1,1,1,10,10,17,1,1,20,1,7,5,17,1,17
19116253,Luisinho,1651,10/03/1991,25,0,0,0,0,175,65,2,1,1,3,3,2,1,3,1,1,3,11,11,12,14,14,6,8,11,4,6,12,13,5,13,11,13,13,10,8,12,10,11,14,8,14,6,9,11,15,15,8,7,7,12,15,20,12,7,11,11,13,6,12,13,13,11,9,10,11,12,3,AM/S RLC,1,1,20,15,17,16,1,1,1,1,10,7,7,1,1
19116255,Ruan,1651,07/01/1991,25,0,0,0,0,186,0,1,2,3,3,3,1,2,1,1,3,2,6,3,13,12,13,6,13,7,5,6,7,7,1,13,5,13,8,7,7,6,11,9,13,6,13,7,6,7,13,11,7,7,8,11,11,20,5,11,9,9,9,9,9,19,14,12,12,11,2,12,1,S ,1,1,20,1,1,1,1,1,1,1,1,1,1,1,1
19116256,Tardelly,1651,19/10/1991,24,0,0,0,0,173,65,2,3,3,3,1,4,1,1,3,1,1,10,10,13,9,15,10,7,9,6,5,11,10,6,13,12,9,11,10,8,11,10,8,9,4,13,7,10,8,15,14,7,7,6,10,14,20,12,7,9,8,9,9,9,7,11,12,13,10,3,8,7,S ,1,1,20,10,10,10,1,1,1,1,1,1,1,1,1
19116257,Pedro Henrique,1651,18/12/1992,23,0,0,0,0,190,87,3,2,2,3,2,2,1,1,3,4,2,4,5,8,7,9,6,12,7,8,15,12,7,13,11,9,11,14,12,13,11,13,14,6,9,8,14,13,14,12,11,15,16,20,17,13,8,14,17,12,9,11,5,8,11,12,13,11,14,15,12,7,D/DM C,1,11,1,1,1,1,20,1,1,18,7,1,1,1,1
19116337,Fernando,1651,17/11/1991,24,0,0,0,0,188,82,3,2,2,1,2,3,2,3,3,3,3,7,8,10,11,11,8,10,13,7,12,12,12,12,12,15,11,14,10,11,12,10,13,11,12,12,13,11,12,12,13,7,14,7,14,12,20,10,13,12,14,9,8,14,12,14,12,12,15,7,11,7,DM/M C,1,1,1,13,1,1,1,1,1,20,18,1,1,1,1
19116338,Francinei,1651,17/06/1991,25,0,0,0,0,171,0,2,1,2,3,2,3,2,1,3,2,3,11,11,12,9,10,11,5,11,4,5,12,10,6,12,12,7,10,8,6,13,10,12,12,2,10,7,7,9,12,14,7,6,20,14,13,10,9,8,10,9,10,8,12,10,11,11,11,13,15,12,8,M/AM LC,1,1,10,20,19,14,1,1,1,7,18,16,12,1,1
19116340,Bruno Turco,1651,30/07/1991,24,0,0,0,0,179,75,1,2,2,3,1,3,2,3,3,2,1,8,10,9,8,12,9,8,9,1,11,12,9,10,12,11,11,12,9,12,12,12,14,10,10,8,13,12,13,12,10,10,9,12,13,11,20,10,10,13,9,13,7,17,12,6,12,12,14,11,9,7,D/DM C,1,1,1,10,1,1,17,1,1,20,15,1,1,1,1
19116341,Gilsinho,1651,20/03/1991,25,0,0,0,0,163,0,1,3,3,3,2,2,3,2,3,1,2,7,9,12,8,9,6,5,7,2,3,9,11,4,12,16,6,13,8,5,9,8,14,14,3,11,5,8,12,13,13,7,3,9,13,13,20,8,7,14,13,14,7,14,7,12,13,11,13,7,15,6,AM/S RLC,1,1,19,20,17,18,1,1,1,1,10,12,13,1,1
19116344,Luiz Gustavo,1651,12/02/1994,22,0,0,0,0,180,65,3,2,2,1,3,3,3,1,1,2,1,4,11,11,10,11,5,11,11,10,13,12,10,13,12,15,13,14,12,10,10,12,14,13,11,12,13,13,15,13,13,12,10,7,13,13,20,13,5,14,13,13,8,15,14,8,16,13,15,8,7,6,DM/M C,1,12,1,8,1,1,15,1,12,20,17,1,1,1,10
19117206,Ronaldo,1651,10/04/1991,25,0,0,0,0,180,72,3,3,3,1,2,2,3,1,2,1,1,4,8,12,11,11,8,11,10,9,7,12,12,6,12,12,12,12,12,11,10,11,7,11,10,11,8,13,10,13,14,9,12,10,15,11,20,14,9,13,4,12,5,10,7,11,11,12,11,5,6,1,S ,1,1,20,1,1,1,1,1,1,1,1,1,1,1,1
19117209,Anselmo,1651,20/11/1984,31,0,0,0,0,186,83,3,3,2,1,1,3,2,3,2,2,2,3,5,1,1,4,4,12,6,4,13,8,3,14,5,9,14,9,8,10,5,11,2,1,9,6,12,7,8,8,10,8,11,8,10,8,20,10,13,9,8,8,9,9,16,10,12,8,10,12,2,5,D C,1,1,1,1,1,1,20,1,1,1,1,1,1,1,1
19117266,Rodrigo Sena,1651,27/01/1987,29,0,0,0,0,190,0,2,3,1,1,1,2,2,2,3,3,4,1,1,4,1,7,1,13,1,5,13,7,1,13,6,9,10,7,7,8,5,13,4,6,4,6,8,6,8,13,13,7,12,20,13,13,12,12,10,9,7,4,6,9,20,10,13,11,11,8,2,8,D C,1,1,1,1,1,1,20,1,1,1,1,1,1,1,1
19117285,Moisés,1651,17/03/1988,28,0,0,0,0,184,76,1,2,1,1,3,2,2,2,1,2,2,7,11,14,11,13,10,13,14,16,12,15,9,13,14,14,13,13,13,14,14,14,15,8,11,13,13,14,14,12,13,10,13,10,13,12,20,11,12,14,12,11,13,12,12,9,11,12,16,14,12,12,M/AM C,1,1,1,17,1,1,1,1,1,13,20,1,1,1,1
19117305,Patrick,1651,22/01/1991,25,0,0,0,0,178,73,2,1,3,3,2,2,2,1,2,1,1,10,11,9,8,10,8,8,10,12,13,10,10,14,10,10,12,14,9,14,8,10,15,7,8,10,11,14,15,12,11,12,7,11,13,12,20,15,10,12,9,12,9,15,13,12,13,10,14,7,11,10,D/WB RL,1,1,1,1,1,1,1,20,20,1,1,1,13,11,19
19118535,Bruno Furlan,1651,09/07/1992,23,0,0,0,0,175,74,1,2,2,3,3,1,2,2,1,3,2,10,7,13,12,16,10,10,10,5,6,8,6,7,13,13,6,11,10,6,10,8,13,11,10,11,7,11,14,13,12,15,8,20,14,13,10,14,14,10,7,10,8,10,9,12,13,9,12,9,14,4,S ,1,1,20,1,1,1,1,1,1,1,1,1,1,1,1
19118604,Douglas,1651,17/08/1989,26,0,0,0,0,175,65,1,1,1,1,1,1,3,1,2,2,1,6,6,8,10,13,6,8,7,3,7,4,3,5,11,7,11,8,7,7,13,12,9,11,10,8,8,7,8,13,13,5,6,16,9,13,20,11,5,9,9,9,9,8,17,12,12,11,9,2,10,7,M/AM/S C,1,1,18,20,1,1,1,1,1,1,17,1,1,1,1
19118854,Gott,1651,16/01/1991,25,0,0,0,0,204,99,14,12,8,1,11,14,10,10,10,5,8,3,2,2,3,2,6,1,2,1,2,1,2,1,6,6,11,12,9,13,8,14,9,3,1,3,11,9,8,9,10,9,20,6,11,7,20,6,15,10,10,4,6,10,17,12,12,9,12,8,7,1,GK ,20,1,1,1,1,1,1,1,1,1,1,1,1,1,1
19118893,Max,1651,28/04/1990,26,0,0,0,0,179,67,1,2,3,3,3,1,1,1,1,2,3,5,11,11,9,12,8,5,11,5,9,12,5,10,12,12,11,9,10,11,12,12,13,13,6,12,8,12,13,13,12,7,7,8,12,13,20,13,7,13,8,11,9,15,19,12,12,11,12,9,11,12,D/WB RL,1,1,1,1,1,1,1,18,20,1,1,1,1,16,19
19119031,Jean Natal,1651,10/05/1992,24,0,0,0,0,175,73,1,3,3,2,2,2,3,1,4,3,2,7,7,7,14,13,11,12,9,3,5,9,5,5,9,9,11,8,6,9,7,10,6,9,14,11,8,7,9,14,12,13,7,20,11,12,14,14,8,9,9,6,9,9,16,13,10,11,12,9,15,1,AM/S C,1,1,20,17,1,1,1,1,1,1,1,1,1,1,1
19119099,Jonathan,1651,11/05/1991,25,0,0,0,0,175,63,2,1,3,3,2,3,2,2,2,1,2,5,11,13,11,12,7,10,11,5,8,12,11,7,14,10,13,12,13,12,13,12,13,14,10,14,7,13,12,13,15,9,8,8,12,13,20,13,8,11,5,11,11,13,19,13,9,11,11,8,6,6,AM/S C,1,1,18,20,1,1,1,1,1,1,10,1,1,1,1
19119113,Cidinho,1651,28/01/1993,23,0,0,0,0,169,57,1,3,3,3,2,4,2,3,3,1,4,10,11,12,10,12,10,7,12,13,6,12,10,9,12,7,9,7,12,10,13,11,11,13,7,14,10,12,11,13,12,5,10,10,8,12,20,13,7,12,12,12,16,12,7,10,10,12,10,5,10,9,AM RLC,1,1,1,20,17,17,1,1,1,1,10,1,1,1,1
19119116,William,1651,07/12/1991,24,0,0,0,0,183,83,3,1,1,3,3,2,1,3,1,4,2,6,6,11,13,12,7,12,8,8,7,11,9,8,11,10,12,10,11,10,11,11,10,12,9,14,13,11,14,14,12,11,11,10,12,13,20,13,16,11,11,11,10,10,17,12,9,9,11,6,11,6,S ,1,1,20,13,1,1,1,1,1,1,1,1,1,1,1
19119150,Elias Oliveira,1651,22/05/1992,24,0,0,0,0,175,67,1,3,1,3,2,2,3,3,2,3,2,11,9,13,10,12,6,4,6,6,3,9,10,3,13,8,10,10,9,8,10,9,13,13,7,10,3,9,11,15,13,5,8,10,13,16,20,10,5,10,5,8,9,14,12,14,14,10,12,12,12,7,AM/S RC,1,1,20,18,1,19,1,1,1,1,1,1,1,1,1
19119153,Tiago Garça,1651,23/05/1985,31,0,0,0,0,194,90,2,1,3,2,3,1,2,3,3,3,3,1,2,4,3,4,12,13,8,5,12,6,9,12,5,12,11,13,10,11,4,10,11,11,11,10,10,9,11,10,6,16,12,10,7,10,20,11,13,10,6,12,12,11,8,10,5,12,13,12,14,9,D C,1,11,1,1,1,1,20,1,1,1,1,1,1,1,1
19119171,Rafael Pin,1651,12/08/1992,23,0,0,0,0,195,0,13,10,7,1,13,8,6,13,9,7,10,8,1,2,2,1,10,1,2,2,2,1,2,3,1,5,8,15,6,9,7,13,10,1,12,3,11,6,7,13,14,8,13,5,8,12,20,5,11,10,8,10,10,10,8,11,11,10,11,8,18,6,GK ,20,1,1,1,1,1,1,1,1,1,1,1,1,1,1
19119197,Polaco,1651,21/08/1993,22,0,0,0,0,178,65,1,1,2,1,1,3,3,1,2,3,2,3,4,11,6,13,6,6,8,1,8,12,4,8,11,9,10,4,8,3,8,13,9,13,13,7,8,7,8,13,13,10,8,20,15,13,17,5,5,9,8,9,8,9,9,8,9,14,11,1,7,5,M/AM C,1,1,1,20,1,1,1,1,14,1,19,1,1,1,1
19119199,Tragodara,1651,19/04/1992,24,0,0,0,0,172,0,3,3,2,1,1,1,3,2,2,2,1,7,7,5,6,12,6,5,9,5,11,13,3,14,12,9,11,4,8,13,7,7,9,7,13,7,14,8,13,14,14,8,5,20,16,13,10,12,7,9,3,8,4,9,19,12,11,12,13,3,14,8,DM ,1,1,1,1,1,1,1,1,1,20,10,1,1,1,1
19119201,Franco,1651,11/07/1993,22,0,0,0,0,182,0,13,11,11,1,8,10,12,13,9,8,10,3,2,3,2,3,5,1,2,2,2,2,2,3,3,9,7,13,7,9,6,13,4,1,5,2,9,7,6,9,10,7,8,17,7,11,20,3,6,9,8,9,5,9,13,7,7,11,11,3,16,1,GK ,20,1,1,1,1,1,1,1,1,1,1,1,1,1,1
19119204,Ronaell,1651,25/11/1991,24,0,0,0,0,185,0,1,3,2,3,1,1,2,3,1,4,3,4,7,11,9,5,4,3,11,6,8,7,4,10,11,9,9,8,7,8,5,9,2,13,14,6,9,11,8,13,13,7,10,20,15,13,9,11,9,5,9,9,14,12,20,11,10,12,10,7,11,8,D/WB/DM L,1,1,1,1,1,1,1,20,1,17,10,1,1,19,1
19119207,Rafael Caldeira,1651,11/02/1991,25,0,0,0,0,191,73,2,3,2,1,2,2,4,3,1,1,1,1,4,6,5,8,1,12,8,8,11,9,7,12,10,10,10,11,9,10,8,10,12,2,7,7,12,13,11,10,10,13,16,10,14,10,20,12,13,10,11,6,10,10,13,11,11,10,9,10,9,7,D C,1,11,1,1,1,1,20,1,1,1,1,1,1,1,1
19119213,Januário,1651,22/06/1991,25,0,0,0,0,195,0,1,1,1,3,2,2,3,2,1,1,1,1,3,7,7,10,1,7,4,5,7,5,3,7,7,8,9,7,3,9,6,9,8,8,5,7,7,6,7,13,12,6,12,9,13,12,20,12,10,8,8,8,4,8,14,11,13,12,12,11,4,3,D/WB/S R,1,1,17,1,1,1,1,10,20,1,1,1,1,10,18
19119223,Luciano Castán,1651,13/09/1989,26,0,0,0,0,187,80,1,2,1,2,4,1,2,4,1,3,1,7,6,7,7,10,5,13,3,6,12,12,9,13,11,6,13,12,12,12,10,16,12,1,10,11,12,12,11,10,9,14,14,20,10,11,9,13,14,11,5,11,11,11,18,11,11,12,10,9,11,10,D C,1,1,1,1,1,1,20,1,1,1,1,1,1,1,1
19119271,Paulão,1651,25/02/1986,30,0,0,0,0,187,82,1,4,3,1,2,3,1,3,2,2,2,4,4,6,9,8,11,15,7,5,15,8,7,15,7,18,10,18,10,11,10,11,14,9,13,8,16,16,16,13,10,7,15,8,17,13,20,16,18,12,16,12,12,13,12,12,9,13,14,9,14,8,D/DM C,1,1,1,1,1,1,20,1,1,17,10,1,1,1,1
19119289,João Lucas,1651,15/09/1993,22,0,0,0,0,186,80,13,11,10,1,13,8,10,12,8,9,11,3,3,3,1,6,8,1,1,1,3,1,3,2,3,9,9,13,7,10,6,13,9,1,9,2,7,7,5,6,16,7,13,20,6,9,9,1,10,9,6,5,9,9,14,10,9,11,10,8,6,5,GK ,20,1,1,1,1,1,1,1,1,1,1,1,1,1,1
19119369,Alan Júnior,1651,18/09/1991,24,0,0,0,0,179,0,1,3,3,2,3,3,1,3,1,3,4,6,4,12,11,14,7,11,8,3,4,7,6,3,12,4,11,8,7,7,3,10,9,9,11,10,8,7,9,14,14,8,7,7,10,14,20,13,12,9,3,5,5,9,7,9,11,10,10,9,8,8,S ,1,1,20,1,1,1,1,1,1,1,1,1,1,1,1
19119371,Chico,1651,16/05/1991,25,0,0,0,0,174,69,3,1,2,3,1,1,2,4,3,2,2,9,10,11,9,10,12,9,10,6,8,12,11,7,12,8,10,12,10,11,12,9,6,8,8,11,10,11,13,13,12,11,9,10,14,12,20,13,6,13,7,10,7,12,16,11,10,9,11,6,10,3,M/AM C,1,1,1,20,1,1,1,1,1,1,18,1,1,1,1
19119389,Alê,1651,16/04/1985,31,0,0,0,0,190,0,3,4,3,2,1,2,3,1,3,3,1,8,6,3,7,9,3,14,2,1,12,9,1,9,5,5,12,10,9,12,4,14,3,2,5,8,12,8,9,10,10,9,14,8,10,10,20,8,9,10,8,1,10,10,15,10,11,12,13,1,2,6,D C,1,1,1,1,1,1,20,1,1,1,1,1,1,1,1
19119624,Dimba,1651,22/12/1992,23,0,0,0,0,181,0,1,1,2,2,3,1,2,4,3,2,4,8,9,11,12,10,7,12,10,8,8,10,10,8,10,4,11,9,11,11,12,8,5,11,10,13,13,12,12,11,11,10,10,12,13,12,20,13,11,9,8,8,10,8,8,12,3,11,13,6,12,13,S ,1,1,20,1,1,1,1,1,1,1,1,1,1,1,1
19119631,Tiago Alves,1651,21/01/1993,23,0,0,0,0,182,0,2,2,1,2,1,3,2,1,3,2,2,5,5,15,15,13,15,10,14,3,11,13,13,5,15,12,11,10,12,13,13,12,10,15,12,12,12,12,12,15,13,10,10,20,14,14,8,12,12,12,11,12,8,13,15,13,12,13,10,12,9,12,AM L,1,1,10,14,20,1,1,1,1,1,10,1,1,1,1
19119633,Rodrigo Sabiá,1651,03/09/1992,23,0,0,0,0,185,75,1,2,2,3,2,3,2,2,3,1,2,4,6,9,9,10,6,11,7,7,13,8,9,10,10,10,11,11,10,9,8,10,15,7,10,10,13,12,9,13,11,13,13,8,13,12,20,12,13,10,9,12,10,12,12,17,11,10,12,11,10,11,D C,1,1,1,1,1,1,20,1,10,1,1,1,1,1,1
19119792,Kaoê,1651,04/02/1991,25,0,0,0,0,177,0,3,1,2,1,3,1,1,1,1,3,1,7,8,8,3,10,2,9,7,8,7,8,8,12,9,10,9,10,10,9,10,14,8,7,4,5,11,10,10,14,11,10,5,20,11,13,10,8,7,10,5,7,10,10,19,12,12,12,12,1,7,8,D/WB L,1,1,1,1,1,1,1,20,1,1,1,1,1,19,1
19119899,Gustavo Busatto,1651,23/10/1990,25,0,0,0,0,189,83,10,9,10,7,12,11,9,12,4,10,13,4,2,1,3,8,8,3,3,2,1,4,3,2,5,10,14,9,11,13,10,16,11,3,4,1,12,11,10,12,9,11,16,7,12,10,20,10,12,9,10,4,4,10,13,11,11,10,12,2,10,4,GK ,20,1,1,1,1,1,1,1,1,1,1,1,1,1,1
19120014,Felipe Guedes,1651,04/06/1991,25,0,0,0,0,175,70,1,2,4,3,2,2,2,1,2,3,2,10,7,8,10,13,10,9,16,10,11,14,3,14,8,10,12,10,6,10,8,16,4,10,9,11,8,12,11,13,13,12,7,1,7,10,20,13,12,9,10,10,5,10,9,12,11,11,11,7,7,1,DM/M C,1,1,1,1,1,1,1,1,1,20,17,1,1,1,1
19120132,Silvinho,1651,01/07/1990,26,0,0,0,0,175,72,2,3,2,1,3,3,3,3,2,1,3,11,11,13,11,12,11,11,7,7,5,11,8,6,12,12,11,12,9,12,12,12,13,13,10,12,9,12,12,14,14,7,8,9,14,14,20,14,7,12,11,12,11,10,20,13,13,11,10,7,8,1,S L,1,1,20,8,15,12,1,1,1,1,1,1,1,1,1
19120154,Daniel,1651,09/03/1990,26,0,0,0,0,178,70,1,4,3,1,3,1,3,3,2,1,2,8,7,14,11,15,8,6,10,6,6,14,6,9,12,7,10,3,6,8,12,14,9,10,9,9,5,9,8,13,7,12,8,20,9,13,3,10,12,9,7,9,9,9,11,12,9,14,12,7,17,4,AM LC,1,1,1,20,17,1,1,1,1,1,10,11,1,1,1
19120419,Ryan,1651,09/05/1991,25,0,0,0,0,172,68,2,2,3,1,1,1,3,2,3,1,3,11,11,8,4,7,4,6,9,5,9,8,6,8,7,11,8,9,8,9,9,9,14,7,8,10,8,10,11,12,11,10,5,10,13,13,20,11,6,11,7,8,12,8,13,15,12,12,12,11,12,8,D/WB R,1,1,1,1,1,1,1,1,20,1,1,1,1,1,17
19120437,Romário,1651,15/01/1992,24,0,0,0,0,191,80,3,4,2,3,2,3,1,3,3,1,3,6,7,11,12,10,7,12,8,6,5,10,14,6,10,11,11,13,9,11,9,12,4,11,10,11,8,11,13,12,10,13,12,11,12,11,20,12,12,12,12,12,10,9,13,11,9,10,12,6,11,2,S ,1,1,20,1,1,1,1,1,1,1,1,1,1,1,1
19120447,Jáder,1651,18/01/1991,25,0,0,0,0,180,67,3,1,1,3,1,1,2,2,3,3,3,5,6,4,4,11,6,1,8,5,5,10,4,11,12,8,8,7,6,6,7,14,8,3,2,6,14,8,10,13,14,7,8,2,6,14,20,6,11,8,7,8,8,8,13,11,11,11,10,7,8,3,DM ,1,1,1,1,1,1,1,1,1,20,10,1,1,1,1
19120533,Tarcísio,1651,07/11/1992,23,0,0,0,0,171,68,2,2,1,1,2,3,2,1,2,3,1,6,10,8,7,13,5,8,10,1,7,11,1,7,13,9,10,3,8,5,8,10,4,13,1,8,8,7,10,13,13,7,2,20,6,13,8,10,4,9,8,4,7,9,12,13,12,11,11,1,10,5,M/AM C,1,1,1,20,13,1,1,1,1,1,18,10,1,1,1
19120718,Dejavan,1651,28/02/1990,26,0,0,0,0,162,0,3,3,1,3,2,1,3,3,3,1,1,2,4,3,6,11,5,4,8,3,11,13,1,12,9,8,9,7,4,5,8,10,5,5,13,10,6,7,11,13,13,6,1,8,15,13,20,12,5,8,8,8,5,8,10,12,11,12,11,9,11,5,M C,1,1,1,1,1,1,1,1,1,1,20,1,1,1,1
19120949,Jones Carioca,1651,14/10/1988,27,0,0,0,0,177,75,3,2,1,2,3,1,3,1,2,2,3,5,10,12,7,12,9,9,11,5,5,11,11,5,12,15,11,11,9,10,11,11,14,15,6,13,7,11,13,15,15,13,7,5,13,15,20,13,9,11,10,11,14,10,9,12,12,12,12,9,11,11,AM/S RC,1,1,20,19,10,15,1,1,1,1,12,5,8,1,1
19120961,Thiago Galhardo,1651,20/07/1989,26,0,0,0,0,183,71,3,1,3,3,2,2,1,3,1,1,1,11,11,14,10,13,11,8,10,7,6,15,8,7,16,11,12,10,15,11,15,13,3,13,7,14,10,14,13,12,14,12,11,12,9,13,20,11,8,11,8,8,18,11,8,9,11,11,9,4,11,3,M/AM C,1,1,1,20,1,1,1,1,1,1,17,1,1,1,1
19120974,Dodó,1651,20/06/1987,29,0,0,0,0,178,75,3,3,3,1,2,3,1,1,1,2,2,12,10,9,11,11,11,9,11,6,10,13,15,12,13,12,10,10,12,11,12,12,11,13,6,9,10,10,12,12,12,12,9,10,13,10,20,13,13,11,6,14,10,17,11,12,7,10,13,6,10,7,DM/M C,1,1,1,1,1,1,1,1,1,20,17,1,1,1,1
19120978,Paulo Victor,1651,09/06/1986,30,0,0,0,0,182,0,1,3,2,1,1,2,3,3,4,3,4,11,12,13,12,11,13,6,13,6,8,13,13,8,13,9,12,9,12,10,13,12,10,12,7,13,12,11,10,13,13,12,13,2,13,13,20,10,9,11,9,11,8,12,17,11,14,9,12,7,14,6,M RLC,1,1,1,15,15,15,1,1,1,1,20,1,1,1,1
19121074,Márcio Passos,1651,25/04/1985,31,0,0,0,0,182,76,1,2,3,1,1,2,3,1,1,1,1,10,9,8,9,10,10,10,11,2,14,10,10,13,9,14,11,13,12,12,9,10,13,10,3,11,12,14,14,11,11,9,11,11,14,11,20,13,10,10,4,7,10,10,5,10,11,13,12,8,12,1,DM C,1,1,1,1,1,1,1,1,1,20,15,1,1,1,1
19121140,Vinícius,1651,03/08/1987,28,0,0,0,0,185,77,1,4,2,2,3,2,4,1,1,3,3,11,10,12,7,11,6,8,5,1,8,10,4,7,12,12,8,11,7,9,13,9,14,13,10,12,8,7,8,11,11,10,13,10,11,12,20,13,9,9,9,9,9,10,18,12,12,8,13,9,5,6,M/AM C,1,1,13,20,10,10,1,1,1,1,19,1,1,1,1
19121168,Willian Bersan,1651,11/05/1989,27,0,0,0,0,176,69,3,1,2,1,3,1,3,1,1,3,1,3,3,6,6,10,5,5,12,3,8,10,3,13,13,7,6,7,6,7,4,9,8,1,7,3,13,7,10,13,12,6,6,9,10,13,20,6,8,8,8,6,8,8,15,11,10,12,12,2,10,4,DM ,1,1,1,1,1,1,1,1,1,20,10,1,1,1,1
19121442,Arthur Sanches,1651,29/03/1988,28,0,0,0,0,188,74,1,1,2,2,1,2,2,1,3,4,3,6,3,3,4,8,3,9,5,2,14,8,2,14,6,8,11,9,6,12,3,14,9,1,5,7,10,7,8,10,11,11,14,9,14,10,20,12,11,9,8,2,4,9,16,9,10,13,13,11,12,8,D C,1,1,1,1,1,1,20,1,1,1,1,1,1,1,1
19121578,Klézio,1651,30/04/1987,29,0,0,0,0,188,0,2,3,3,3,4,3,2,1,2,3,3,4,4,5,2,6,6,13,5,4,13,7,1,13,1,6,12,9,7,10,5,13,9,1,9,4,7,6,8,13,12,7,12,1,14,13,20,12,9,9,8,9,9,9,13,10,12,13,9,1,14,4,D C,1,1,1,1,1,1,20,1,1,1,1,1,1,1,1
19121736,Leone,1651,07/10/1990,25,0,0,0,0,188,82,2,3,2,2,1,3,2,1,2,1,1,4,3,3,3,8,6,10,7,2,11,7,4,13,7,8,10,8,4,9,7,12,7,9,11,3,9,6,8,13,13,7,8,9,14,13,20,11,12,9,7,9,6,9,20,10,12,12,12,7,10,3,D/DM C,1,1,1,1,1,1,20,1,1,18,1,1,1,1,1
19122312,Fran,1651,05/05/1992,24,0,0,0,0,180,80,2,1,3,2,3,1,2,2,2,2,3,9,6,13,14,13,14,6,6,2,7,10,8,7,12,8,9,3,13,11,13,10,8,9,10,12,7,6,9,14,14,7,10,10,9,14,20,5,6,9,4,9,7,9,8,14,14,12,10,1,3,1,AM C,1,1,1,20,1,1,1,1,1,1,10,1,1,1,1
19122391,Baiano,1651,09/09/1982,33,0,0,0,0,176,76,3,2,3,3,3,2,3,2,3,1,2,9,14,10,11,14,7,14,7,2,5,8,4,1,10,9,10,8,8,8,5,11,15,9,13,11,7,8,15,12,11,12,7,10,10,12,20,13,11,9,4,5,9,9,13,14,11,11,11,9,4,5,S R,1,1,20,1,1,15,1,1,1,1,1,1,1,1,1
19122782,Gabriel,1651,27/09/1992,23,1,0,20,0,193,90,13,12,13,9,14,9,12,15,14,13,12,1,1,1,1,8,1,4,1,8,1,10,1,1,8,11,13,12,12,13,8,11,14,2,10,1,13,11,9,11,14,16,16,5,14,13,20,16,15,13,8,7,7,1,13,14,14,11,15,16,15,7,GK ,20,1,1,1,1,1,1,1,1,1,1,1,1,1,1
19122785,Marquinhos,1651,01/04/1992,24,0,0,0,0,179,0,3,2,3,2,1,3,1,3,2,2,1,1,7,9,7,9,5,10,7,6,12,11,10,12,10,13,11,12,11,11,9,10,9,7,11,8,11,14,13,11,10,12,10,7,13,10,20,12,12,12,11,11,9,12,17,13,9,12,11,7,18,7,DM C,1,1,1,1,1,1,1,1,1,20,15,1,1,1,1
19122786,Weslley,1651,16/01/1992,24,0,0,0,0,184,80,4,2,1,3,2,3,3,2,3,2,1,1,6,7,6,7,1,9,6,5,10,10,7,12,10,12,12,10,9,9,4,9,9,1,11,8,9,11,10,12,11,12,11,5,12,12,20,11,12,10,7,5,9,9,11,12,12,12,10,5,1,6,D C,1,1,1,1,1,1,20,1,1,1,1,1,1,1,1
19122787,Éber Bessa,1651,21/03/1992,24,0,0,0,0,166,60,3,1,2,3,1,3,2,1,2,2,2,8,11,11,8,12,13,6,12,8,11,12,13,12,12,13,12,13,12,14,12,12,13,12,7,13,13,15,14,13,14,13,7,12,14,14,20,15,8,14,9,11,3,13,13,12,10,10,11,10,9,7,DM/M C,1,1,1,1,7,7,1,1,1,17,20,7,7,1,1
19122788,Élber,1651,27/05/1992,24,0,0,0,0,170,65,1,2,1,1,3,2,3,1,2,1,1,12,13,15,13,13,5,7,14,4,5,13,10,8,12,11,11,10,10,11,13,11,12,14,4,14,6,10,15,15,16,8,6,10,17,16,20,14,8,12,6,12,14,14,13,11,12,12,12,8,13,4,AM RL,1,1,13,14,17,20,1,1,1,1,13,14,15,1,1
19122789,Alan,1651,21/01/1992,24,0,0,0,0,178,0,2,1,4,2,4,3,2,3,2,2,1,1,6,10,11,9,1,8,7,1,1,10,11,6,10,8,11,9,10,9,10,10,5,11,7,10,7,12,10,12,13,11,8,8,12,13,20,14,9,8,6,9,7,10,15,10,12,10,11,5,9,5,S ,1,1,20,12,1,1,1,1,1,1,1,1,1,1,1
19123217,Romão,1651,31/07/1989,26,0,0,0,0,189,85,3,1,1,1,2,3,3,2,3,1,2,3,7,12,12,11,11,11,12,5,5,11,11,4,8,10,10,12,11,10,7,9,11,12,8,13,5,10,7,13,11,13,13,20,14,12,11,13,14,11,8,7,7,10,14,11,11,11,12,9,6,6,S ,1,1,20,1,1,1,1,1,1,1,1,1,1,1,1
19123244,Peu,1651,24/04/1993,23,0,0,0,0,178,72,3,2,3,1,2,3,2,1,1,1,3,13,15,13,12,12,10,10,8,3,2,12,8,3,13,2,10,8,13,12,11,15,4,10,1,12,3,7,7,13,10,8,9,20,11,12,14,12,7,10,10,8,8,10,15,9,11,9,9,1,14,4,S ,1,1,20,1,14,1,1,10,1,1,1,13,1,12,1
19123383,Andrei Girotto,1651,17/02/1992,24,0,0,0,0,185,77,1,1,3,2,1,1,3,1,3,3,1,7,10,12,11,12,12,14,13,7,13,12,8,14,12,10,13,11,13,13,12,13,16,10,8,12,13,13,13,14,14,12,14,12,14,13,20,11,12,12,12,10,11,7,17,11,10,10,10,7,8,5,DM ,1,1,1,1,1,1,1,1,1,20,10,1,1,1,1
19123385,Júnior,1651,10/04/1992,24,0,0,0,0,186,80,1,2,2,1,1,2,3,3,3,3,3,2,1,1,3,7,1,13,6,1,10,6,3,12,6,14,10,9,7,7,5,13,3,1,8,6,8,6,7,13,13,7,12,3,16,13,20,9,8,9,14,2,9,9,9,12,12,10,11,7,8,1,D C,1,1,1,1,1,1,20,1,1,1,1,1,1,1,1
19123453,Diego Oliveira,1651,04/08/1991,24,0,0,0,0,180,77,2,3,1,3,3,2,2,1,3,3,1,7,7,3,7,12,7,7,12,7,10,9,4,13,9,12,13,9,8,9,7,13,10,3,10,7,13,8,12,13,13,8,9,10,16,13,20,13,9,10,12,1,10,10,13,10,12,14,11,1,8,1,DM ,1,1,1,1,1,1,1,1,1,20,10,1,1,1,1
19123744,Janio,1651,03/07/1991,24,0,0,0,0,174,73,1,3,3,1,2,3,1,3,2,3,3,7,5,13,13,13,2,13,5,1,6,8,6,6,10,10,13,9,13,8,4,9,4,10,13,13,8,7,8,13,13,8,6,12,6,13,20,10,6,10,5,3,7,10,17,12,10,11,10,7,12,4,S ,1,1,20,1,1,1,1,1,1,1,1,1,1,1,1
19123747,Dudu,1651,12/05/1991,25,0,0,0,0,174,72,1,3,3,1,3,3,1,3,3,2,3,11,16,12,13,12,13,11,10,10,10,11,7,11,14,4,13,10,12,10,14,11,12,13,11,13,11,11,11,13,13,12,7,20,16,14,10,10,5,13,11,10,5,11,20,12,11,11,12,7,12,7,M/AM LC,1,1,1,16,20,1,1,1,1,1,1,17,1,1,1
19123750,Walisson Maia,1651,31/08/1991,24,0,0,0,0,189,75,3,3,3,2,3,3,1,2,4,2,2,6,4,8,3,11,5,11,5,8,14,10,8,14,6,7,11,11,10,14,8,14,11,2,14,9,14,9,10,14,14,10,15,1,15,14,20,9,9,12,10,11,10,11,9,11,11,12,12,7,10,4,D C,1,1,1,1,1,1,20,1,12,1,1,1,1,1,10
19123752,Bonfim,1651,24/07/1991,24,0,0,0,0,188,90,1,2,2,3,3,4,3,2,2,3,3,6,7,7,8,10,7,13,7,8,12,8,11,12,10,12,13,13,12,13,9,9,12,8,11,9,13,13,13,13,12,13,14,12,14,13,20,13,14,13,13,10,6,6,8,12,8,12,11,8,11,6,D C,1,1,1,1,1,1,20,1,1,1,1,1,1,1,1
19123791,Lêlê,1651,08/09/1989,26,0,0,0,0,180,75,2,3,2,2,3,3,2,1,3,1,3,6,6,1,7,10,6,6,8,1,8,11,2,13,13,9,8,8,7,7,6,13,2,6,14,7,8,7,9,13,13,7,10,10,8,13,20,6,11,12,7,9,9,9,11,12,10,11,11,4,16,4,DM/M C,1,1,1,1,1,1,1,1,13,20,17,1,7,1,13
19123794,Rafael Xavier,1651,27/01/1989,27,0,0,0,0,186,85,3,3,4,1,3,2,2,3,2,1,3,6,6,8,13,13,6,13,7,1,3,7,4,1,11,9,11,6,6,6,6,11,2,11,13,11,5,6,7,13,10,7,11,9,10,10,20,12,12,9,9,9,9,9,9,10,12,11,13,11,4,3,S ,1,1,20,1,1,1,1,1,1,1,1,1,1,1,1
19123803,Eduardo,1651,09/09/1992,23,0,0,0,0,174,0,3,3,1,3,3,2,1,1,2,1,2,6,2,14,10,12,7,9,8,4,6,9,6,8,9,9,11,6,8,5,7,14,5,9,7,12,8,8,4,14,14,8,9,20,15,14,10,8,6,9,9,7,5,9,9,9,13,12,11,12,15,3,M/AM/S C,1,1,16,20,1,1,1,1,1,1,17,1,1,1,1
19123804,Everton Sena,1651,24/04/1991,25,0,0,0,0,190,0,1,1,3,3,3,2,2,3,1,3,3,6,6,4,8,13,6,4,11,5,7,11,7,4,13,8,11,2,10,6,12,8,9,13,13,12,8,8,12,13,13,4,13,10,15,12,20,13,9,9,5,9,9,9,19,14,8,9,11,5,6,7,M/AM C,1,1,1,20,1,1,1,1,1,1,17,1,1,1,1
19123819,Willian Sarôa,1651,18/09/1987,28,0,0,0,0,184,81,3,3,3,2,2,3,3,3,1,1,2,5,6,11,10,7,6,9,7,6,5,8,8,5,7,9,8,6,13,9,9,7,9,9,12,15,11,9,9,11,12,6,9,8,10,12,20,12,10,8,9,9,9,9,9,9,13,12,11,1,9,7,S ,1,1,20,1,1,1,1,1,1,1,1,1,1,1,1
19123820,Fabrizzyo,1651,10/01/1989,27,0,0,0,0,181,80,3,3,1,1,3,1,2,4,1,2,3,9,9,12,12,11,13,9,9,9,11,13,7,9,13,14,11,12,11,11,12,12,8,11,7,11,11,12,8,12,12,11,11,9,14,11,20,13,12,8,11,8,16,10,8,8,12,8,12,10,10,2,M/AM C,1,1,1,17,1,1,1,1,1,13,20,1,1,1,1
19123822,João Francisco,1651,22/04/1992,24,0,0,0,0,187,85,1,3,2,2,4,1,3,2,1,2,1,7,7,8,7,8,7,12,7,7,13,11,7,13,7,9,11,12,11,11,12,10,13,11,13,11,12,12,13,12,10,12,12,9,11,11,20,8,11,8,9,7,5,8,18,13,7,11,11,1,8,1,DM/M C,1,1,1,10,1,1,1,1,1,17,20,1,1,1,1
19123824,Nenê Bonilha,1651,17/02/1992,24,0,0,0,0,175,70,2,2,1,1,1,3,3,2,2,3,2,9,11,11,8,13,12,8,10,11,10,14,7,11,14,12,12,12,13,12,13,13,12,12,6,12,13,13,12,13,13,11,7,12,11,13,20,13,8,13,7,9,5,11,11,13,14,12,14,11,12,1,M C,1,1,1,13,1,1,1,1,1,12,20,1,1,1,1
19123828,Carlão,1651,03/07/1992,23,0,0,0,0,186,72,3,3,1,3,2,1,3,4,3,3,2,6,8,11,12,11,5,13,8,8,10,11,12,10,11,8,12,13,11,11,8,12,12,9,4,12,10,14,11,13,13,14,13,10,13,13,20,10,12,10,7,5,5,5,18,11,7,8,11,10,13,1,S ,1,1,20,1,1,1,1,1,1,1,1,1,1,1,1
19123829,Brendon,1651,09/11/1992,23,0,0,0,0,171,64,3,2,2,3,3,1,1,3,2,2,3,8,3,1,3,13,12,6,12,1,10,12,3,12,12,9,12,13,5,8,6,8,5,4,12,7,12,12,11,13,12,7,2,10,13,10,20,6,8,8,9,2,12,11,8,8,10,14,13,1,16,1,DM/M C,1,1,1,1,1,1,1,1,13,20,17,1,1,1,1
19123883,Danilo Avelar,1651,09/06/1989,27,0,0,0,0,185,75,3,4,1,4,1,1,1,1,3,3,3,9,14,12,8,12,15,8,13,7,13,12,15,13,13,12,13,11,11,12,12,13,16,12,7,14,12,12,13,15,12,14,11,20,14,15,5,13,13,14,11,13,9,14,11,10,10,10,13,14,14,13,D/WB L,1,1,1,1,1,1,1,20,1,1,1,14,1,19,1
19123884,Alemão,1651,22/04/1988,28,0,0,0,0,184,78,3,2,1,1,3,4,3,1,2,3,2,5,6,5,6,12,6,8,6,1,11,13,2,12,8,7,9,8,5,5,10,9,4,9,11,6,12,7,11,13,13,7,10,8,9,13,20,7,10,9,6,9,7,8,16,10,8,11,10,5,16,2,DM C,1,1,1,1,1,1,15,1,1,20,10,1,1,1,1
19123919,Cassimba,1651,28/11/1984,31,0,0,0,0,178,0,2,3,3,1,3,3,3,3,3,2,1,7,7,4,8,13,7,2,14,1,9,14,5,14,14,9,10,8,8,8,7,13,5,4,5,7,14,8,13,14,9,8,9,9,13,9,20,14,5,9,7,9,9,9,19,10,10,12,12,1,16,5,DM ,1,1,1,1,1,1,1,1,1,20,10,1,1,1,1
19124035,Victor Cardozo,1651,19/12/1989,26,0,0,0,0,190,86,3,1,3,3,2,3,1,4,1,3,2,1,2,4,3,8,1,14,4,5,14,8,3,14,6,9,11,9,8,7,5,11,5,8,13,7,7,7,8,14,11,8,14,10,7,11,20,13,10,9,9,8,9,9,8,11,10,11,9,1,10,1,D C,1,1,1,1,1,1,20,1,1,1,1,1,1,1,1
19124061,Luan,1651,11/09/1991,24,0,0,0,0,190,83,1,1,2,1,4,3,2,3,1,1,2,6,4,11,13,13,6,13,7,4,6,6,6,5,13,9,8,1,7,7,5,11,9,13,3,13,6,6,7,13,8,7,12,10,13,9,20,11,11,9,9,9,9,9,18,9,13,11,13,7,11,4,S ,1,1,20,1,1,1,1,1,1,1,1,1,1,1,1
19124062,Hiago,1651,20/09/1991,24,0,0,0,0,175,68,3,3,3,3,2,1,2,1,2,2,1,10,12,8,11,13,7,8,8,6,5,8,6,5,12,7,8,6,7,7,8,7,1,12,14,11,6,7,8,13,13,7,7,12,9,13,20,11,5,7,6,9,9,9,13,9,9,11,11,1,11,2,AM R,1,1,15,14,10,20,1,1,1,1,1,1,1,1,1
19124201,Alex,1651,20/11/1985,30,0,0,0,0,170,75,3,1,2,1,2,2,1,2,1,2,3,4,6,7,2,8,2,5,6,6,8,8,2,13,8,8,8,7,7,10,4,7,8,5,11,6,7,7,7,14,14,7,3,20,5,14,9,8,8,8,6,8,6,8,17,11,11,11,10,11,14,5,WB L,1,1,1,1,1,1,1,15,1,1,1,1,1,20,1
19124348,Heber,1651,10/08/1991,24,0,0,0,0,180,78,1,1,4,1,1,2,2,1,2,1,1,4,9,11,11,10,8,10,10,3,6,11,12,7,12,11,12,12,11,11,11,11,11,12,9,12,8,11,12,12,14,11,9,10,13,12,20,13,9,11,11,11,11,7,16,10,11,12,10,8,10,7,AM/S L,1,1,20,8,17,14,1,1,1,1,1,15,1,1,1
19124394,Fágner,1651,03/06/1986,30,0,0,0,0,185,0,2,3,1,2,3,1,2,3,3,1,2,6,3,12,13,12,6,10,5,1,2,7,10,2,12,5,10,5,12,7,3,7,7,12,11,12,7,6,8,13,12,7,9,9,14,11,20,12,9,9,7,4,7,9,20,11,9,10,11,6,13,7,S ,1,1,20,1,1,1,1,1,1,1,1,1,1,1,1
19124418,Lelê,1651,09/02/1990,26,0,0,0,0,167,62,2,4,1,3,2,3,2,4,3,4,3,10,10,13,11,11,10,5,11,5,9,11,10,7,10,8,12,8,11,10,10,12,6,10,5,14,9,12,11,15,15,4,4,11,15,13,20,16,3,12,3,10,11,11,8,12,12,13,9,1,12,1,M/AM C,1,1,1,20,1,1,1,1,1,1,16,1,1,1,1
19124424,André Castro,1651,02/11/1991,24,0,0,0,0,181,77,2,2,1,1,1,2,2,1,3,2,2,12,11,11,11,12,7,10,12,8,12,14,3,11,11,10,12,9,8,7,11,10,10,9,8,11,12,11,12,12,13,11,8,10,12,12,20,12,10,10,9,10,6,12,17,9,11,13,14,7,5,2,DM/M C,1,1,1,12,1,1,1,1,1,18,20,1,1,1,1
19124425,Diego Marder,1651,14/02/1991,25,0,0,0,0,180,75,2,3,3,2,3,3,3,3,2,2,1,8,9,5,4,11,6,8,3,6,9,11,6,10,10,9,9,10,9,8,4,13,5,7,5,8,10,9,10,11,11,9,9,8,9,11,20,14,10,9,4,9,8,9,16,12,12,11,12,12,7,3,D R,1,1,1,1,1,1,1,1,20,1,1,1,1,1,14
19124426,Renato,1651,14/10/1991,24,0,0,0,0,188,80,2,3,3,1,2,3,3,1,3,3,1,7,6,1,2,9,4,12,7,4,10,10,2,11,5,12,7,10,7,8,6,14,9,3,5,8,13,8,9,14,12,8,15,10,17,12,20,14,13,10,11,10,6,10,17,12,12,11,13,12,10,4,D C,1,1,1,1,1,1,20,1,1,1,1,1,1,1,1
19124427,Wanderson,1651,07/02/1991,25,0,0,0,0,186,83,3,1,2,1,3,3,1,2,1,2,2,7,10,8,7,11,4,15,9,5,15,10,7,11,10,13,15,11,11,12,10,15,19,1,12,10,9,10,11,15,11,11,13,11,14,14,20,14,9,11,12,11,12,11,11,11,13,9,11,7,6,6,D C,1,1,1,1,1,1,20,1,1,1,1,1,1,1,1
19124429,Rodrigo,1651,27/09/1990,25,0,0,0,0,183,74,2,1,3,4,4,2,1,1,3,3,3,4,7,9,9,14,7,6,8,3,7,11,1,7,14,8,9,8,5,6,13,13,9,13,1,12,7,8,13,14,14,8,12,1,15,14,20,13,10,9,5,9,6,9,17,10,11,12,11,7,11,5,AM C,1,1,1,20,1,1,1,1,1,1,15,1,1,1,1
19124431,Anderson Feijão,1651,06/06/1991,25,0,0,0,0,180,73,2,3,1,1,3,1,2,1,2,3,1,7,10,11,10,15,8,8,10,4,8,12,6,10,12,9,10,8,9,6,13,9,7,12,10,10,5,10,9,12,13,10,8,8,5,11,20,8,9,9,9,9,4,9,16,12,9,13,13,9,13,7,AM RC,1,1,1,20,1,17,1,1,1,1,1,1,1,1,1
19124433,Augusto,1651,06/08/1992,23,0,0,0,0,178,69,3,3,2,3,1,3,3,1,2,1,2,10,6,12,12,10,10,10,11,8,12,11,9,15,12,9,13,11,11,6,14,11,13,13,12,9,12,11,14,15,12,11,7,8,12,13,20,15,9,12,13,11,5,11,7,12,12,11,11,13,11,7,M C,1,1,1,13,1,12,1,1,1,15,20,1,1,1,1
19124481,Rômulo César,1651,15/04/1991,25,0,0,0,0,175,68,2,1,2,3,1,2,1,4,1,2,1,12,10,13,8,11,9,10,12,4,11,10,5,13,11,10,10,11,11,9,10,10,3,7,1,8,11,11,11,14,11,11,9,20,11,14,5,12,8,10,10,10,8,10,15,11,12,13,12,8,14,6,D L,1,1,1,1,1,1,1,20,1,1,1,1,1,15,1
19124482,Marion,1651,07/09/1991,24,0,0,0,0,172,65,2,3,1,2,2,2,1,1,3,3,1,12,13,14,11,13,10,10,12,10,10,11,12,10,13,13,13,10,10,13,12,12,13,12,10,13,10,13,15,14,14,10,6,20,12,13,9,13,9,12,12,11,9,14,18,7,13,11,13,9,15,10,AM/S RL,1,1,19,1,20,17,1,1,1,1,1,1,1,1,1
19124483,Wescley,1651,11/10/1991,24,0,0,0,0,166,64,2,1,3,2,1,1,2,2,3,3,2,10,11,15,10,14,5,7,12,5,6,12,13,5,13,8,13,7,9,8,12,10,12,15,4,13,6,7,11,16,15,11,5,20,11,16,5,12,5,11,6,7,13,12,8,12,13,11,10,6,12,7,AM/S RL,1,1,16,13,20,18,1,8,1,1,8,12,9,8,1
19124484,Guto,1651,31/05/1991,25,0,0,0,0,178,79,3,1,2,2,2,1,3,3,1,1,2,8,6,12,15,15,8,13,13,6,8,7,15,11,12,11,14,4,10,9,7,12,2,9,8,13,9,8,9,10,11,9,7,5,10,12,20,9,10,9,4,9,9,9,12,12,11,13,13,6,8,2,S ,1,1,20,1,1,1,1,1,1,1,1,1,1,1,1
19124485,Breno,1651,05/12/1991,24,0,0,0,0,178,68,1,1,1,1,1,3,2,3,1,3,3,5,9,13,14,14,8,12,11,7,7,10,13,11,12,7,7,9,8,10,8,12,10,10,14,14,10,8,10,15,13,10,5,5,11,14,20,8,8,10,3,10,7,13,16,10,10,11,9,8,13,5,AM/S C,1,1,20,19,1,1,1,1,1,1,1,1,1,1,1
19124580,César,1651,27/01/1992,24,0,0,0,0,192,78,13,14,14,5,15,10,13,15,14,12,14,1,1,8,1,12,3,1,1,2,2,10,4,1,10,5,13,12,13,11,10,11,13,3,7,1,13,13,14,12,13,7,17,6,11,12,20,15,11,10,3,5,5,11,8,12,12,13,13,9,10,9,GK ,20,1,1,1,1,1,1,1,1,1,1,1,1,1,1
19124581,Nixon,1651,20/07/1992,23,0,0,0,0,176,71,3,3,2,2,3,3,2,1,3,2,1,6,11,12,12,12,9,14,10,6,7,12,13,8,12,10,13,11,13,13,13,12,12,13,10,13,8,13,13,15,13,11,10,9,8,14,20,13,11,12,14,11,16,11,13,11,8,11,9,7,10,8,S ,1,1,20,14,1,14,1,1,1,1,1,1,1,1,1
19124582,Fernando,1651,19/03/1993,23,0,0,0,0,185,76,1,2,2,2,1,3,4,1,1,3,3,3,5,7,7,9,8,14,6,5,10,10,9,12,10,10,11,9,10,11,9,10,11,5,11,8,14,12,10,9,9,12,13,8,14,8,20,14,12,12,7,11,5,8,8,12,14,12,11,12,15,10,D C,1,1,1,1,1,1,20,1,1,1,1,1,1,1,1
19124583,Adryan,1651,10/08/1994,21,0,0,3,0,175,71,3,3,2,1,3,1,2,2,3,3,2,9,13,14,12,14,14,8,13,5,6,14,11,6,15,8,13,8,12,11,13,14,12,15,9,14,7,11,12,13,13,8,7,10,14,13,20,13,8,10,9,12,8,10,10,10,9,10,12,5,10,9,M/AM C,1,1,1,20,1,1,1,1,1,1,16,1,1,1,1
19124704,Alcir,1651,24/04/1985,31,0,0,0,0,185,0,3,1,2,1,1,2,1,1,1,2,3,1,3,1,6,7,1,14,4,5,10,5,4,14,5,9,11,9,8,12,5,14,6,8,10,6,14,7,8,9,9,8,14,20,13,11,8,12,10,9,9,9,5,9,15,13,12,10,10,4,15,8,D C,1,1,1,1,1,1,20,1,1,1,1,1,1,1,1
19124865,Bressan,1651,15/01/1993,23,0,0,0,0,185,79,3,2,3,4,3,2,1,3,1,2,2,10,5,4,4,11,6,15,7,10,12,9,4,13,10,12,12,13,12,11,9,7,12,5,15,11,11,13,13,11,11,12,13,12,13,14,20,13,13,11,11,12,4,10,12,11,10,9,9,9,11,9,D C,1,1,1,1,1,1,20,1,1,1,1,1,1,1,1
19124870,Rodrigo Fernandes,1651,21/01/1986,30,0,0,0,0,178,77,1,1,2,2,1,2,1,3,2,1,1,6,9,9,6,13,7,6,8,5,8,13,3,9,10,10,8,9,8,9,10,10,5,10,10,9,6,8,9,13,12,8,8,20,12,12,10,13,9,11,5,8,10,10,13,9,11,11,13,8,6,6,D/WB/AM LC,1,1,1,18,12,1,1,20,1,1,13,14,1,18,1
19124871,Leandro Ferreira,1651,30/01/1981,35,0,0,0,0,183,77,2,2,1,1,2,3,1,2,2,1,1,4,7,5,8,10,7,7,6,1,12,14,5,12,10,6,13,8,6,7,7,14,10,6,9,6,11,8,12,11,8,8,11,10,9,7,20,8,10,12,9,9,9,9,8,11,12,12,10,9,9,12,DM ,1,1,1,1,1,1,1,1,1,20,10,1,1,1,1
19124873,Ulisses,1651,25/03/1989,27,0,0,0,0,185,75,1,1,1,3,2,4,3,3,1,3,4,5,1,12,8,9,5,5,9,1,5,12,1,6,12,9,9,8,3,6,12,12,9,13,12,7,5,6,10,12,11,6,6,10,11,12,20,12,9,11,8,6,9,9,17,12,12,11,12,8,5,1,AM C,1,1,1,20,1,1,1,1,1,1,10,1,1,1,1
19124874,Léo Mineiro,1651,10/03/1990,26,0,0,0,0,184,79,2,3,3,2,1,2,1,2,1,2,2,10,11,11,12,10,11,10,10,11,9,10,11,9,10,10,10,10,16,10,11,11,6,13,11,12,11,10,11,13,14,11,10,10,12,13,20,12,11,11,10,12,11,12,11,12,12,12,10,8,9,8,AM/S L,1,1,20,1,17,1,1,1,1,1,1,1,1,1,1
19125040,Nino Paraíba,1651,23/12/1986,29,0,0,0,0,180,80,3,1,1,2,3,2,1,3,3,2,2,7,9,10,12,13,12,12,12,7,6,12,12,7,11,11,11,12,12,11,10,11,8,11,10,11,8,12,12,12,9,14,11,9,13,10,20,13,15,11,8,10,8,10,10,13,11,10,10,8,9,1,M/AM C,1,1,1,20,10,10,1,1,1,1,18,5,5,1,1
19125042,Alvinho,1651,24/04/1992,24,0,0,0,0,175,72,3,1,2,2,3,2,3,3,3,1,3,6,5,16,16,9,7,8,7,3,4,10,8,4,14,8,8,6,9,7,9,9,3,12,5,14,7,8,10,12,13,14,7,8,14,12,20,9,10,9,9,7,8,9,16,11,11,11,12,8,6,6,S ,1,1,20,1,1,1,1,1,1,1,1,1,1,1,1
19125061,Judson,1651,25/05/1993,23,0,0,0,0,169,65,1,3,2,3,1,1,3,2,1,3,2,11,10,8,11,14,11,11,14,7,11,10,8,13,9,12,14,10,13,13,8,8,2,10,5,12,10,10,13,13,12,17,5,11,17,13,20,12,5,10,13,10,12,10,13,11,13,11,10,7,14,2,DM/M C,1,1,1,1,1,1,1,1,1,20,16,1,1,1,1
19125063,Erivélton,1651,10/02/1992,24,0,0,0,0,171,60,3,1,1,1,1,3,2,2,3,3,1,10,8,13,10,8,10,8,12,5,11,12,8,11,12,6,7,7,8,6,16,16,3,9,3,11,11,8,12,10,12,7,6,8,10,11,20,13,5,10,10,7,10,10,11,11,11,11,11,2,13,7,M/AM C,1,1,1,20,12,12,1,1,1,1,18,6,6,1,1
19125236,Fernandinho,1651,01/06/1991,25,0,0,0,0,174,68,1,2,1,1,2,3,3,1,2,1,1,6,8,8,11,10,9,12,11,3,7,11,7,7,9,9,9,5,11,7,8,9,9,9,13,10,7,10,11,13,10,13,7,20,13,12,10,12,7,12,9,5,9,16,17,9,9,10,10,3,7,4,D/WB L,1,1,7,8,13,11,1,20,12,1,7,15,13,17,11
19125310,Élvis Gabriell,1651,04/03/1992,24,0,0,0,0,196,0,14,7,10,5,10,9,10,14,5,6,10,5,3,2,1,1,10,1,1,2,2,3,3,2,6,10,10,10,8,11,8,14,12,2,6,1,12,9,8,14,10,7,17,1,14,11,20,4,11,10,6,10,7,10,14,11,10,12,14,10,7,5,GK ,20,1,1,1,1,1,1,1,1,1,1,1,1,1,1
19125312,Pablo,1651,21/06/1991,25,0,0,0,0,188,79,3,3,3,4,2,3,3,4,2,4,2,2,5,7,6,10,4,15,8,4,14,9,6,12,8,14,12,16,10,12,6,10,11,11,8,7,11,13,12,12,12,13,14,14,13,13,20,14,16,12,12,11,10,10,9,10,13,15,12,8,13,9,D C,1,11,1,1,1,1,20,1,1,1,1,1,1,1,1
19125410,Rene Santos,1651,21/04/1992,24,0,0,0,0,188,73,3,3,3,1,1,1,3,2,1,1,1,4,7,8,8,9,7,13,9,8,13,10,8,14,9,13,11,14,9,11,8,10,13,8,8,12,12,14,13,13,11,13,14,20,11,12,11,13,14,10,5,10,10,10,11,10,10,11,12,9,10,11,D/DM C,1,11,1,1,1,1,20,1,1,17,1,1,1,1,1
19125412,Danilo Barcelos,1651,17/08/1991,24,0,0,0,0,186,75,4,2,1,1,3,1,2,2,1,2,3,10,14,13,9,7,11,11,6,11,12,13,7,13,7,11,10,11,12,9,8,8,11,6,13,12,13,12,13,16,14,12,11,20,15,16,11,11,11,13,7,11,11,11,9,9,9,10,13,12,11,9,WB/M L,1,4,1,14,14,1,7,15,1,5,8,17,1,20,1
19125415,Fábio Gama,1651,02/10/1992,23,0,0,0,0,167,56,1,1,2,1,3,4,1,1,3,3,2,11,12,12,10,13,11,5,11,5,5,13,12,5,13,11,10,8,11,9,12,11,11,14,4,12,7,10,12,13,14,7,4,14,12,13,20,11,7,10,9,6,6,10,7,12,14,11,10,8,7,12,M/AM C,1,1,8,20,10,10,1,1,1,1,17,5,5,1,1
19125417,Victor Braga,1651,17/02/1992,24,0,0,0,0,191,85,12,14,12,7,10,10,8,14,10,14,9,4,1,1,2,5,9,3,2,1,3,6,4,3,6,6,11,13,11,10,7,7,11,2,8,3,11,12,13,10,14,11,12,3,12,10,20,11,11,10,10,4,7,10,10,10,14,10,12,11,13,10,GK ,20,1,1,1,1,1,1,1,1,1,1,1,1,1,1
19125422,Filipe Augusto,1651,12/08/1993,22,0,0,0,0,182,76,1,3,3,4,2,3,2,2,3,3,3,13,12,14,6,13,13,12,13,10,12,15,10,12,16,13,13,12,14,12,14,14,13,12,7,12,13,14,12,12,13,14,12,20,14,12,11,13,13,12,11,11,16,11,11,12,11,12,11,9,10,12,DM/M C,1,1,1,7,1,1,1,1,1,20,18,7,1,1,1
19125618,Felipe Lima,1651,18/01/1991,25,0,0,0,0,179,71,3,3,1,2,1,3,1,1,4,2,3,9,11,13,9,12,7,6,9,9,8,12,10,7,12,14,12,13,11,9,11,11,13,16,5,13,11,9,11,14,15,6,6,20,13,13,8,11,6,12,10,10,7,16,6,13,11,11,10,6,8,13,M/AM LC,1,1,11,20,18,7,1,12,1,13,17,15,1,13,1
19125756,Romarinho,1651,05/07/1994,21,0,0,0,0,169,64,3,3,3,3,2,2,4,3,1,3,3,2,5,15,10,11,8,11,12,2,2,12,13,6,13,9,8,11,9,11,8,8,11,15,2,12,6,13,13,15,13,10,4,7,12,11,20,13,9,11,2,8,15,11,12,13,11,11,13,7,8,4,AM L,1,1,13,13,20,10,1,1,1,1,1,1,1,1,1
19125760,Canga,1651,08/10/1992,23,0,0,0,0,171,70,2,2,4,3,3,3,2,3,3,1,2,8,11,12,10,16,10,6,9,6,4,11,6,5,11,8,8,9,9,7,8,9,1,9,3,15,8,10,12,13,14,15,6,7,9,13,20,9,9,8,9,9,9,9,11,11,13,9,13,4,5,4,S ,1,1,20,8,6,12,1,1,1,1,1,1,1,1,1
19125765,Laertes,1651,12/05/1993,23,0,0,0,0,171,62,1,2,3,1,3,3,3,2,1,3,1,8,10,11,10,14,8,3,9,1,8,15,7,8,10,1,7,9,8,9,13,13,5,9,1,10,7,9,13,11,13,15,5,7,13,12,20,9,3,9,6,1,9,9,18,13,13,11,11,5,11,2,M/AM RC,1,1,1,20,1,18,1,1,1,1,17,1,16,1,1
19125766,Pedro Lucas,1651,29/04/1994,22,0,0,0,0,177,68,1,2,1,1,1,2,1,1,2,3,4,3,5,9,6,15,4,8,9,4,10,14,8,15,12,12,8,10,5,9,7,7,4,9,10,9,10,9,6,11,11,12,9,7,7,10,20,10,7,9,9,8,9,9,10,11,11,9,9,10,17,7,DM/M C,1,1,1,1,1,1,1,1,1,20,17,1,1,1,1
19125906,Maycon,1651,02/04/1991,25,0,0,0,0,169,64,3,3,2,1,3,2,1,2,1,3,1,8,10,11,1,9,3,6,5,11,9,10,1,11,9,12,7,10,7,8,8,8,8,11,4,11,9,10,10,12,12,14,4,20,14,12,7,10,4,8,7,8,7,8,14,10,11,11,13,8,11,2,D/WB L,1,1,1,1,5,1,1,18,1,1,1,10,1,20,1
19125907,Felipe Amorim,1651,04/01/1991,25,0,0,0,0,180,76,1,3,2,1,2,2,3,1,4,1,1,10,10,14,12,14,12,10,13,6,5,14,13,6,14,8,10,10,11,10,13,13,11,13,5,12,8,9,11,13,14,9,11,8,14,14,20,12,8,12,7,10,5,5,14,14,10,11,9,7,12,3,M/AM C,1,1,13,20,10,10,1,1,1,1,18,5,5,1,1
19125909,Robert,1651,04/09/1991,24,0,0,0,0,176,64,2,2,4,3,1,2,1,2,3,2,1,11,10,12,9,11,11,6,9,5,3,11,6,3,12,8,8,8,9,7,11,9,3,9,4,10,5,8,9,13,15,13,7,10,12,13,20,9,4,10,6,3,4,10,11,11,11,9,11,9,17,3,M/AM C,1,1,15,20,10,10,1,1,1,1,18,5,5,1,1
19125958,Wellington Pirulito,1651,30/09/1991,24,0,0,0,0,188,85,1,1,2,1,3,3,3,1,3,2,2,3,7,7,7,10,5,12,8,12,12,11,9,11,9,13,11,12,11,12,7,12,12,10,11,9,14,14,12,13,12,13,14,8,11,12,20,12,13,11,12,11,14,8,8,11,11,9,12,10,14,6,D C,1,11,1,1,1,1,20,8,1,1,1,1,1,2,1
19125962,Hugo,1651,18/05/1992,24,0,0,0,0,176,0,3,3,2,3,1,1,2,2,2,2,3,8,11,10,4,13,4,8,8,10,10,10,7,12,9,9,7,10,7,7,9,9,10,9,11,8,10,10,10,12,11,10,8,20,12,11,7,10,8,8,6,9,7,9,19,9,11,11,10,8,10,8,D/WB L,1,1,1,1,5,1,1,20,1,1,1,10,1,19,1
19125963,Afonso,1651,14/11/1991,24,0,0,0,0,172,70,3,3,2,1,3,2,3,2,1,2,1,10,12,13,11,11,8,9,11,3,3,10,13,4,12,11,9,7,10,7,9,9,14,15,3,12,6,5,7,12,13,9,7,10,14,12,20,10,9,11,8,12,5,13,14,15,15,13,14,5,13,13,S ,1,1,20,12,13,13,1,1,1,1,1,1,1,1,1
19125964,Cristhian,1651,27/02/1992,24,0,0,0,0,187,0,1,3,3,2,3,1,3,3,2,1,1,2,4,7,9,8,3,11,9,5,13,10,6,12,8,14,9,13,8,9,8,8,13,6,9,8,12,14,13,10,8,13,14,7,16,9,20,13,16,12,13,11,7,11,13,14,11,11,12,7,13,9,DM/M C,1,5,1,1,1,1,11,1,1,20,16,1,1,1,1
19126104,Toty,1651,02/04/1991,25,0,0,0,0,170,64,1,3,3,2,2,1,1,1,3,1,1,13,11,11,9,9,12,7,9,11,9,10,11,15,11,12,7,12,9,8,9,8,10,1,5,10,11,11,11,13,13,7,5,7,13,13,20,12,5,9,9,9,9,10,16,12,12,10,13,1,16,2,D/WB R,1,1,1,1,1,6,1,1,20,1,1,1,12,1,19
19126108,Cássio Ortega,1651,02/04/1991,25,0,0,0,0,174,69,1,1,1,2,1,2,3,2,1,1,2,10,11,12,12,12,10,6,10,4,3,12,10,4,12,8,6,9,9,7,12,10,10,13,7,10,6,9,8,14,14,8,7,10,12,14,20,10,8,11,6,11,8,10,8,13,14,11,12,10,15,7,M/AM RLC,1,1,11,20,17,18,1,1,1,1,16,10,13,1,1
19126109,Davidson,1651,05/03/1991,25,0,0,0,0,177,76,1,1,1,3,1,2,1,3,3,1,2,10,11,14,12,12,10,8,9,3,10,13,12,5,14,12,8,11,9,10,13,11,12,12,5,13,8,9,10,14,15,12,8,11,10,14,20,12,10,10,9,10,6,10,11,14,9,10,12,8,11,12,AM RL,1,1,13,13,18,20,1,1,1,1,1,1,1,1,1
19126243,Davi Ceará,1651,19/11/1990,25,0,0,0,0,176,68,2,3,2,3,2,1,2,3,3,3,1,8,8,10,9,9,7,9,10,2,4,10,8,4,10,9,10,9,10,11,11,9,12,13,6,12,5,11,10,13,12,11,7,20,11,13,9,10,6,12,8,9,5,9,13,13,11,11,9,6,16,6,M/AM LC,1,1,1,20,17,1,1,1,1,1,19,1,1,1,1
19126253,Magalhães,1651,01/08/1989,26,0,0,0,0,175,0,4,1,1,2,3,2,2,2,3,1,1,1,7,8,9,7,5,6,9,9,8,11,7,10,9,13,10,12,9,9,6,9,10,9,9,7,9,15,16,14,12,11,6,20,15,13,14,15,12,10,12,8,10,12,19,10,10,11,10,2,12,2,DM ,1,1,1,1,1,1,1,7,1,20,13,1,1,11,1
19126379,Vinícius,1651,15/04/1991,25,0,0,0,0,177,75,2,2,3,2,2,2,1,3,2,2,3,12,12,11,13,13,11,11,15,6,10,14,9,10,12,9,12,10,13,12,13,13,11,14,8,13,12,14,11,13,12,13,8,10,16,13,20,12,13,12,4,7,8,11,16,15,5,10,9,7,6,14,AM C,1,1,1,20,10,10,1,1,1,1,15,1,10,1,1
19126395,Alex,1651,21/08/1990,25,0,0,0,0,179,76,3,1,3,2,3,2,1,1,1,1,3,3,2,13,13,13,4,12,5,2,2,8,14,6,12,12,8,4,11,11,8,10,10,12,12,14,6,9,9,14,13,11,10,12,15,13,20,12,11,10,14,12,6,4,11,10,7,10,8,7,9,8,S ,1,1,20,1,1,1,1,1,1,1,1,1,1,1,1
19126517,Heracles,1651,18/09/1992,23,0,0,0,0,170,70,3,1,3,1,2,1,3,1,3,3,3,10,12,12,11,13,10,9,11,9,11,12,10,11,12,11,12,13,11,11,11,11,12,11,9,11,12,13,12,12,12,11,5,20,10,13,8,12,9,11,10,11,15,11,10,12,13,13,14,7,12,8,D/WB L,1,1,1,1,5,1,1,20,1,1,1,10,1,19,1
19126771,Elias,1651,13/02/1987,29,0,0,0,0,182,78,2,2,2,3,3,4,3,3,3,1,2,8,11,12,12,13,5,13,11,8,6,12,14,5,11,10,13,13,11,11,12,12,12,13,6,13,11,14,12,13,13,12,11,8,13,13,20,13,12,11,5,11,7,6,10,5,10,10,14,10,10,5,S ,1,1,20,1,1,1,1,1,1,1,1,1,1,1,1
19127384,Wesley Santos,1651,21/01/1991,25,0,0,0,0,171,60,1,3,2,1,3,3,3,3,2,3,3,5,11,13,9,12,5,7,3,11,10,13,3,10,13,8,12,8,9,10,7,9,11,14,4,12,11,11,10,13,14,5,5,20,14,14,7,13,5,9,6,6,8,9,19,12,11,11,14,2,9,3,D/WB L,1,1,1,1,5,1,1,20,1,1,1,10,1,19,1
19127405,Vinícius,1651,03/08/1993,22,0,0,0,0,180,72,2,3,1,3,3,3,2,3,1,1,1,8,12,13,11,13,5,12,11,4,8,12,12,7,13,12,12,12,8,11,11,11,11,13,5,13,9,10,13,15,13,10,11,9,13,15,20,12,9,10,9,12,8,12,10,12,13,11,13,9,13,7,AM/S R,1,1,20,8,12,16,1,1,1,1,7,8,10,1,1
19127455,Assisinho,1651,28/07/1987,28,0,0,0,0,170,66,2,3,2,3,1,3,1,3,1,1,2,4,12,13,12,11,7,6,5,2,6,13,12,7,14,10,12,11,11,12,13,13,12,12,11,14,8,11,13,14,13,7,6,8,10,14,20,13,7,11,6,7,11,12,11,12,12,8,12,7,12,7,AM/S RC,1,1,18,15,12,20,1,1,1,1,1,1,1,1,1
19127459,Josy,1651,29/10/1988,27,0,0,0,0,180,0,3,1,3,4,3,2,1,2,3,2,3,7,5,14,12,14,7,7,11,1,5,11,5,7,14,8,7,8,11,8,9,12,7,13,11,8,8,8,6,14,14,8,8,3,12,14,20,11,7,9,4,6,9,9,12,10,11,12,10,5,12,1,AM C,1,1,1,20,1,1,1,1,1,1,10,1,1,1,1
19127810,Maurim,1651,01/05/1988,28,0,0,0,0,181,74,2,1,3,1,2,3,3,3,2,2,2,5,11,11,10,11,1,10,6,12,11,9,6,10,9,12,8,12,9,9,8,11,12,9,7,12,10,9,9,13,12,10,11,20,14,12,7,13,11,9,5,5,9,9,12,12,10,10,10,3,16,3,D/WB L,1,1,1,1,5,1,1,20,1,1,1,10,1,19,1
19127822,Alex Sandro,1651,04/06/1991,25,0,0,0,0,179,80,4,4,2,3,3,2,1,3,3,1,3,7,8,13,10,13,7,13,5,1,6,8,6,5,9,10,11,9,9,7,4,12,6,10,8,13,7,7,8,12,11,10,8,9,10,12,20,13,10,5,10,3,10,10,8,10,5,9,13,10,14,8,S ,1,1,20,1,1,1,1,1,1,1,1,1,1,1,1
19127830,Gabriel Paulista,1651,26/11/1990,25,0,0,0,0,185,72,3,4,3,1,2,3,3,2,1,3,1,5,9,8,8,12,8,15,10,10,15,12,6,16,11,17,14,18,11,13,10,11,17,6,11,10,14,15,16,15,13,14,14,10,15,15,20,15,16,14,13,13,7,14,12,15,10,14,15,9,11,10,D C,1,10,1,1,1,1,20,12,14,1,1,1,1,8,8
19128030,Roni,1651,02/02/1992,24,0,0,0,0,184,0,1,1,2,1,1,1,1,2,1,4,1,4,2,1,5,7,1,13,6,3,13,8,3,13,8,8,12,9,5,11,4,13,6,2,11,6,9,6,7,13,11,7,9,11,11,13,20,9,8,9,8,9,9,9,8,12,9,14,10,2,14,2,D C,1,1,1,1,1,1,20,1,1,1,1,1,1,1,1
19128545,Lucas Piazón,1651,20/01/1994,22,0,0,0,0,182,72,3,4,2,2,3,1,1,3,3,3,2,13,12,12,13,14,14,8,12,7,6,13,15,6,13,10,13,7,13,9,14,9,8,14,5,14,7,12,9,13,14,8,9,12,12,14,20,12,8,10,6,10,7,13,12,14,7,9,10,12,12,11,M/AM RLC,1,1,14,18,20,15,1,1,1,1,10,20,15,1,1
19128680,Kelvy,1651,07/01/1994,22,0,0,0,0,163,0,3,3,3,2,1,2,2,2,2,2,2,5,7,13,12,14,9,10,6,6,5,14,7,5,9,2,8,5,12,11,7,12,8,6,11,15,5,10,11,15,8,4,4,9,10,11,20,11,4,8,9,9,9,9,14,11,12,13,10,2,1,4,AM/S C,1,1,17,20,1,1,1,1,1,1,10,1,1,1,1
19128785,Edgar,1651,18/06/1991,25,0,0,0,0,175,0,4,2,1,3,2,2,3,1,3,3,2,7,10,8,5,10,2,8,8,6,7,10,4,8,9,7,10,9,10,8,10,10,2,9,4,7,7,7,9,14,13,7,6,10,16,12,20,14,8,9,11,9,6,9,17,14,11,12,9,5,1,8,D/WB R,1,1,1,1,1,1,1,1,20,1,1,1,1,1,19
19129265,Romarinho,1651,19/09/1993,22,0,0,0,0,176,70,3,2,1,1,3,1,3,3,2,3,2,8,9,12,11,14,8,13,9,6,6,9,8,7,9,10,8,9,14,9,10,12,5,13,9,11,9,8,10,13,11,9,6,5,7,12,20,10,8,10,10,6,9,10,13,8,11,12,9,11,2,7,S C,1,1,20,15,1,1,1,1,1,1,1,1,1,1,1
19129345,Fernando,1651,07/07/1984,31,0,0,0,0,189,0,14,10,8,10,11,9,11,12,5,9,9,2,3,1,3,4,3,1,1,2,3,2,1,1,6,9,7,10,8,11,7,14,2,3,13,1,12,8,7,14,11,8,13,8,11,14,20,7,10,9,9,4,9,9,18,10,13,11,11,2,1,7,GK ,20,1,1,1,1,1,1,1,1,1,1,1,1,1,1
19130222,Artur,1651,24/03/1989,27,0,0,0,0,185,0,10,10,6,2,13,11,9,11,9,5,13,6,2,2,1,1,9,1,3,2,1,2,2,3,4,9,7,13,7,11,6,13,9,2,7,1,11,7,6,12,10,7,11,7,16,11,20,6,8,9,6,9,7,9,11,12,10,13,10,10,7,2,GK ,20,1,1,1,1,1,1,1,1,1,1,1,1,1,1
19130461,Paulo Renê,1651,24/01/1989,27,0,0,0,0,178,71,1,2,2,1,1,2,3,2,2,1,3,5,4,13,13,13,7,13,8,2,7,8,5,5,13,10,8,6,13,8,8,12,12,13,2,11,8,7,8,13,13,8,7,6,11,13,20,13,8,10,10,10,7,10,20,11,12,11,10,10,15,6,S ,1,1,20,1,1,1,1,1,1,1,1,1,1,1,1
19130694,Daniel Pereira,1651,22/07/1989,26,0,0,0,0,179,79,2,1,2,1,1,2,4,1,2,1,4,8,8,6,8,14,7,8,13,3,12,13,4,14,14,10,13,9,8,10,8,14,3,9,11,8,14,9,11,14,14,9,4,20,13,14,1,9,7,10,10,6,10,10,10,13,11,10,12,9,6,1,DM ,1,1,1,1,1,1,1,1,1,20,13,1,1,1,1
19130957,Zezinho,1651,16/01/1993,23,0,0,0,0,179,0,2,1,4,2,3,2,2,1,1,3,1,7,8,14,14,14,7,12,6,1,7,8,9,4,14,7,13,4,13,8,10,14,9,13,13,11,7,7,9,14,13,8,4,3,10,14,20,6,8,9,9,8,9,9,16,14,13,12,10,5,14,2,S C,1,1,20,15,1,10,1,1,1,1,7,1,10,1,10
19131068,Dão,1651,13/02/1989,27,0,0,0,0,187,0,1,1,2,1,2,4,1,2,1,1,3,2,3,2,1,5,1,12,5,3,12,6,4,11,1,8,10,8,6,5,2,12,1,3,11,5,12,5,7,12,12,6,11,8,6,12,20,11,7,9,3,9,5,9,12,9,10,11,13,1,4,2,D C,1,1,1,1,1,1,20,1,1,1,1,1,1,1,1
19131105,Nadson,1651,22/07/1989,26,0,0,0,0,171,69,3,3,2,1,2,2,2,1,3,2,3,9,8,12,10,12,12,10,12,8,8,12,8,10,13,3,13,3,13,9,10,14,11,10,5,11,10,10,11,13,13,15,5,11,11,13,20,14,7,11,11,11,10,11,17,10,10,8,13,8,11,5,AM LC,1,1,14,20,19,10,1,1,1,1,11,5,5,1,1
19131168,Marcelo Rangel,1651,17/05/1988,28,0,0,0,0,186,79,15,11,10,7,14,12,15,16,10,8,13,8,1,3,2,11,10,8,3,3,1,10,3,1,11,13,11,11,13,12,8,13,12,4,6,3,12,13,12,10,11,10,13,5,12,9,20,13,14,12,7,11,5,11,12,13,9,11,15,12,11,7,GK ,20,1,1,1,1,1,1,1,1,1,1,1,1,1,1
19131202,Otávio,1651,21/01/1993,23,0,0,0,0,184,73,12,11,6,1,12,12,3,10,8,8,10,4,1,2,1,1,8,1,2,1,3,1,3,2,1,8,5,11,2,7,4,12,7,1,2,2,9,5,4,10,12,5,10,13,9,8,20,1,8,8,8,7,8,8,17,10,12,12,10,3,1,1,GK ,20,1,1,1,1,1,1,1,1,1,1,1,1,1,1
19131245,Leonardo Passos,1651,29/11/1989,26,0,0,0,0,182,80,2,1,3,2,1,3,1,1,1,2,2,5,9,12,13,9,9,12,11,5,8,12,13,11,13,12,11,14,11,9,12,11,8,12,8,11,11,15,14,12,11,11,12,20,16,8,5,12,17,10,5,10,3,10,16,11,12,12,10,10,6,11,S ,1,1,20,1,1,1,1,1,1,1,1,1,1,1,1
19131356,Flávio Henrique,1651,26/08/1985,30,0,0,0,0,190,85,3,1,3,2,2,1,1,4,1,2,3,6,8,7,9,12,9,16,9,6,9,10,3,7,8,8,10,11,10,10,10,10,12,5,5,12,10,9,9,11,12,11,15,12,8,11,20,12,14,9,7,10,10,10,11,10,11,10,11,9,9,9,S ,1,1,20,1,1,1,1,1,1,1,1,1,1,1,1
19131357,Jackson,1651,16/09/1987,28,0,0,0,0,187,0,2,1,3,2,1,1,1,3,2,2,3,6,3,13,13,13,5,9,6,1,6,5,6,2,13,4,6,8,11,7,6,10,9,13,3,13,6,6,7,13,13,7,13,9,9,13,20,6,12,9,7,9,6,9,17,11,8,11,13,12,9,5,S ,1,1,20,1,1,1,1,1,1,1,1,1,1,1,1
19131402,Henal,1651,07/12/1984,31,0,0,0,0,185,74,14,11,11,1,13,12,11,11,6,10,11,6,3,2,1,4,10,1,1,2,2,1,3,3,7,10,11,15,8,11,8,14,10,1,13,1,12,9,8,12,12,9,12,11,12,12,20,5,16,10,8,10,10,10,12,12,8,12,11,10,13,2,GK ,20,1,1,1,1,1,1,1,1,1,1,1,1,1,1
19131411,Tiago,1651,24/06/1986,30,0,0,0,0,176,0,3,2,1,2,1,1,1,1,1,3,1,3,7,12,13,8,5,5,7,3,5,7,1,6,10,8,6,7,5,7,6,6,5,10,13,7,6,6,7,13,13,7,5,20,9,13,9,5,10,8,7,3,4,8,19,10,9,10,13,6,4,3,AM/S LC,1,1,16,20,15,1,1,14,1,1,10,15,1,14,1
19132085,George,1651,02/03/1991,25,0,0,0,0,194,79,13,10,10,1,10,14,9,14,10,10,10,7,3,1,1,5,9,1,1,3,1,1,3,3,5,10,8,13,6,9,8,14,10,3,13,2,9,9,8,8,11,13,16,1,11,8,20,7,13,10,10,10,10,10,18,11,12,12,8,5,12,1,GK ,20,1,1,1,1,1,1,1,1,1,1,1,1,1,1
19132087,Brendon,1651,28/10/1992,23,0,0,0,0,187,0,2,3,3,3,1,1,1,1,2,3,2,5,6,7,8,9,2,8,10,6,12,9,2,13,14,13,9,12,6,8,8,8,8,6,6,8,10,13,10,12,13,8,8,8,9,13,20,11,9,9,9,9,9,9,12,12,12,11,11,1,15,6,DM/M C,1,1,1,1,1,1,1,1,1,20,16,1,1,1,1
19132122,Jacson,1651,16/12/1989,26,0,0,0,0,179,76,2,1,3,1,1,3,1,2,4,3,2,3,9,11,11,10,11,10,10,10,8,9,13,8,11,7,9,10,9,10,9,9,12,12,3,11,9,11,11,12,11,11,10,20,14,13,7,11,11,11,8,11,6,15,9,10,12,11,10,5,7,3,D/WB/S L,1,1,20,10,12,7,1,16,1,1,5,14,3,18,1
19132629,Luiz Ricardo,1651,10/02/1987,29,0,0,0,0,180,80,1,2,2,1,3,1,3,1,2,1,3,8,7,5,8,9,8,8,13,2,11,8,3,14,14,6,13,9,9,8,8,14,10,6,11,7,12,7,11,14,14,9,10,8,7,14,20,8,9,13,10,10,10,10,15,8,6,12,12,5,5,1,DM ,1,1,1,1,1,1,1,1,1,20,10,1,1,1,1
19132760,Thiago Potiguar,1651,27/05/1985,31,0,0,0,0,169,68,3,4,2,3,3,2,1,1,2,3,2,11,10,12,10,11,11,4,10,4,4,9,11,4,13,11,12,10,11,11,12,10,12,12,8,12,9,9,12,14,14,7,5,10,13,14,20,12,7,10,7,8,7,12,10,11,8,13,10,5,12,12,AM RLC,1,1,1,20,19,19,1,1,1,1,1,1,1,1,1
19132766,Moisés,1651,15/05/1989,27,0,0,0,0,175,65,3,3,1,1,2,1,2,2,1,4,2,3,7,9,8,9,8,4,6,3,2,9,11,3,8,11,11,10,8,8,7,8,13,11,6,8,1,11,11,13,12,5,5,7,12,12,20,11,4,11,7,10,12,7,8,14,4,12,10,5,11,12,AM/S R,1,1,20,1,1,17,1,1,1,1,1,1,1,1,1
19133994,Nílson,1651,06/04/1991,25,0,0,0,0,186,0,1,2,3,2,4,2,3,4,1,2,3,4,6,14,14,10,7,14,8,2,7,9,12,6,14,8,9,7,14,8,9,12,3,13,9,10,8,8,9,11,12,8,12,10,6,11,20,14,10,10,7,3,7,10,17,9,13,10,9,9,12,8,S ,1,1,20,1,1,1,1,1,1,1,1,1,1,1,1
19135019,Nildo Petrolina,1651,01/05/1986,30,0,0,0,0,175,63,4,3,3,2,2,2,2,1,3,3,3,11,13,14,11,12,11,8,15,10,9,12,12,11,13,10,11,13,10,12,10,8,14,12,8,14,9,11,13,14,14,12,8,20,12,13,8,12,8,9,8,11,8,14,12,12,10,13,12,9,11,7,M/AM RLC,1,1,1,18,20,15,1,7,1,1,16,18,1,7,1
19135096,Raul Silva,1651,04/11/1989,26,0,0,0,0,191,84,3,1,4,1,2,1,1,3,2,2,3,2,9,11,8,13,4,16,9,10,14,12,8,15,13,19,14,16,13,13,11,10,15,8,8,6,13,13,13,12,12,14,14,20,13,12,10,12,14,12,20,6,4,10,13,15,11,7,10,6,2,12,D C,1,11,1,1,1,1,20,1,1,1,1,1,1,1,1
19135102,Sidão,1651,24/12/1982,33,0,0,0,0,189,88,15,14,14,12,15,14,14,15,15,12,15,1,1,5,1,2,1,1,1,1,1,16,1,1,10,1,10,14,8,15,16,11,12,10,15,10,14,14,14,7,14,15,13,20,13,9,1,12,13,15,5,15,6,1,11,10,13,11,12,9,16,7,GK ,20,1,1,1,1,1,1,1,1,1,1,1,1,1,1
19135186,Madson,1651,09/05/1991,25,0,0,0,0,178,71,2,3,1,3,2,3,1,1,3,3,2,6,9,9,6,11,4,8,17,9,13,11,11,12,10,13,13,14,12,12,10,12,13,10,13,12,13,15,15,13,13,12,10,5,13,12,20,14,12,13,13,12,8,12,12,10,12,12,13,12,10,5,D/DM C,1,1,1,1,1,1,20,1,1,20,5,1,1,1,1
19135271,Netinho,1651,06/01/1986,30,0,0,0,0,179,0,2,3,1,1,1,2,3,2,2,3,1,5,3,10,7,12,3,6,6,3,5,9,2,6,12,9,7,7,6,6,12,12,3,13,7,9,5,6,7,12,12,6,5,8,14,12,20,12,4,9,9,5,5,9,7,10,11,12,10,3,2,7,AM C,1,1,12,20,1,1,1,1,1,1,10,1,1,1,1
19135315,Marcelo Pitbul,1651,18/04/1983,33,0,0,0,0,172,0,1,3,1,3,3,1,1,1,3,3,2,7,6,3,6,14,7,7,11,4,10,12,4,14,11,9,11,8,8,6,10,14,5,6,13,6,13,8,12,14,10,8,3,9,13,12,20,8,9,9,9,9,7,9,8,11,13,10,8,6,7,7,DM ,1,1,1,1,1,1,1,1,1,20,10,1,1,1,1
19135359,Adilson Goiano,1651,09/02/1988,28,0,0,0,0,180,76,2,2,2,1,2,2,1,3,3,3,2,8,11,11,7,10,7,6,8,6,11,13,5,12,12,15,14,14,13,13,12,12,12,8,11,8,12,13,13,11,12,14,8,11,14,11,20,13,12,13,10,10,4,6,11,8,10,11,15,13,12,6,DM ,1,1,1,1,1,1,1,1,1,20,13,1,1,1,1
19135387,Wellington,1651,05/10/1987,28,0,0,0,0,186,81,2,1,2,3,1,2,1,4,2,3,2,5,8,10,13,11,6,14,9,6,5,9,11,6,9,10,13,12,12,13,13,12,13,11,10,13,6,11,11,13,12,13,12,7,12,12,20,12,13,11,4,11,3,6,14,12,9,11,12,12,12,5,S ,1,1,20,1,1,1,1,1,1,1,1,1,1,1,1
19135415,Tayrones,1651,13/06/1994,22,0,0,0,0,171,0,1,2,1,1,1,3,3,1,3,2,2,7,7,7,2,14,5,8,5,7,9,9,7,14,10,8,7,9,7,9,6,12,8,8,9,6,7,8,8,11,12,7,5,9,14,15,20,7,6,8,8,8,8,8,10,12,10,12,13,4,14,1,D/WB R,1,1,1,1,1,1,1,1,20,1,1,1,1,1,18
19135417,Gustavo Eugênio,1651,15/04/1994,22,0,0,0,0,185,73,3,3,1,1,3,2,2,1,2,2,2,4,1,2,1,8,1,13,3,2,11,5,6,13,4,9,12,9,8,13,5,14,9,2,3,7,14,7,9,10,12,8,12,8,10,9,20,13,8,9,9,9,9,9,19,11,13,13,8,1,9,1,D C,1,1,1,1,1,1,20,1,1,1,1,1,1,1,1
19135621,Tiaguinho,1651,30/05/1989,27,0,0,0,0,177,63,1,1,2,2,3,3,3,2,1,2,2,4,8,9,11,8,5,7,8,1,4,9,7,9,12,5,12,6,15,9,8,15,5,10,9,12,9,9,9,14,11,10,8,20,13,14,15,8,8,12,9,5,10,10,13,12,13,12,10,3,9,3,AM/S L,1,1,20,1,17,13,1,1,1,1,1,1,1,1,1
19135730,Marcos Galletti,1651,26/08/1991,24,0,0,0,0,195,82,13,10,7,1,13,11,9,13,9,9,9,2,1,1,3,5,4,1,1,1,2,1,4,1,5,9,6,15,7,10,6,13,9,2,12,2,11,7,6,12,5,7,16,2,16,12,20,5,13,9,9,4,9,9,17,11,11,14,11,7,2,5,GK ,20,1,1,1,1,1,1,1,1,1,1,1,1,1,1
19135741,Guilherme Teixeira,1651,30/01/1992,24,0,0,0,0,192,70,1,2,1,4,3,3,3,2,1,3,1,5,5,7,5,9,3,12,5,5,12,10,6,12,7,11,15,14,8,12,7,14,12,3,14,9,11,12,13,10,9,9,14,11,13,10,20,14,14,12,10,10,6,10,11,11,14,12,14,9,8,10,D C,1,1,1,1,1,1,20,1,1,1,1,1,1,1,1
19135747,Diogo Cerbasi,1651,29/04/1985,31,0,0,0,0,193,88,14,10,7,1,14,14,8,13,9,9,11,4,3,3,1,5,9,1,3,3,2,1,2,2,5,6,8,11,5,10,7,14,2,3,12,3,11,8,7,10,6,8,16,8,10,8,20,2,11,9,9,9,8,9,11,11,11,11,9,8,5,6,GK ,20,1,1,1,1,1,1,1,1,1,1,1,1,1,1
19135868,Wellington,1651,05/07/1989,26,0,0,0,0,180,82,2,1,1,1,1,2,3,2,1,3,3,3,4,7,13,12,5,14,6,5,6,4,15,5,7,10,12,12,12,12,13,11,11,8,6,12,5,12,11,13,11,13,13,13,11,11,20,12,13,9,5,10,7,6,9,10,12,10,11,7,10,7,S ,1,1,20,1,1,1,1,1,1,1,1,1,1,1,1
19135907,Léo Maceió,1651,11/08/1987,28,0,0,0,0,176,77,3,1,1,3,3,4,2,3,2,3,3,5,9,7,8,10,8,8,6,8,9,13,4,14,9,7,9,9,8,9,9,14,6,3,2,9,11,8,10,14,14,8,7,10,8,15,20,12,8,10,7,6,9,10,17,13,11,10,8,4,6,2,D/WB/DM RC,1,1,1,1,1,1,1,1,20,18,15,1,1,1,16
19135916,Ítalo,1651,22/02/1989,27,0,0,0,0,180,75,3,3,2,2,2,1,2,2,2,2,2,3,3,5,4,8,1,14,2,3,10,9,6,14,7,10,13,10,9,7,8,14,10,3,12,6,12,8,8,12,13,8,9,14,12,13,20,13,8,10,10,10,10,10,14,10,10,12,11,6,11,1,D C,1,1,1,1,1,1,20,1,1,1,1,1,1,1,1
19135931,Alexon,1651,03/12/1992,23,0,0,0,0,194,88,2,3,3,3,2,2,3,3,1,1,1,6,4,6,7,12,7,7,10,6,11,13,2,10,11,9,12,7,11,7,7,14,9,7,12,9,10,8,6,14,12,8,16,8,10,12,20,9,12,9,9,8,6,9,13,10,12,11,11,10,19,7,M C,1,1,1,1,1,1,1,1,1,1,20,1,1,1,1
19135974,Thiago Almeida,1651,23/02/1988,28,0,0,0,0,182,0,2,3,2,2,1,2,1,2,1,3,1,4,7,7,4,10,1,10,3,8,11,10,3,10,8,9,12,10,11,7,4,10,10,5,13,8,11,7,9,14,14,10,9,7,9,14,20,11,10,10,10,8,5,10,8,8,10,11,14,3,14,5,D C,1,11,1,1,1,1,20,1,1,1,1,1,1,1,1
19135993,Siderval,1651,17/04/1987,29,0,0,0,0,161,0,3,3,3,2,2,2,3,4,2,3,1,5,6,4,5,13,1,8,7,7,6,7,5,12,9,9,10,6,7,7,6,11,3,9,11,7,7,8,9,14,14,8,1,20,16,14,9,13,9,9,7,6,3,9,20,13,11,13,10,10,2,1,D/WB L,1,1,1,1,1,1,1,20,1,1,1,1,1,18,1
19136123,Guilherme Mattis,1651,12/09/1990,25,0,0,0,0,193,90,3,1,4,1,2,3,2,3,3,3,1,3,6,9,7,9,12,14,6,6,13,10,9,16,12,14,12,16,10,13,8,12,15,7,15,12,13,14,14,11,9,9,16,6,8,10,20,15,16,14,13,14,16,6,15,11,13,14,15,15,13,12,D C,1,1,1,1,1,1,20,1,1,1,1,1,1,1,1
19136125,Carioca,1651,07/03/1992,24,0,0,0,0,191,82,13,11,7,1,13,12,8,13,7,8,8,1,1,3,3,5,3,1,1,2,2,1,1,1,1,9,8,13,6,12,6,10,8,2,4,3,10,7,6,11,15,7,13,8,16,10,20,6,9,9,9,4,7,9,13,11,11,9,10,9,6,8,GK ,20,1,1,1,1,1,1,1,1,1,1,1,1,1,1
19136129,Luiz Souza,1651,25/10/1993,22,0,0,0,0,179,69,3,1,4,4,3,3,3,2,2,4,3,5,7,6,5,14,8,7,14,1,7,8,6,13,14,4,14,9,10,6,7,9,3,10,11,8,11,9,10,14,14,8,8,9,15,14,20,7,7,10,10,6,5,10,13,10,11,11,12,1,13,5,DM ,1,1,1,1,1,1,1,1,1,20,13,1,1,1,1
19136130,Léo Cittadini,1651,27/02/1994,22,0,0,0,0,178,68,1,3,2,2,3,3,3,2,2,1,2,12,13,13,12,12,12,11,11,8,13,15,11,13,15,8,12,11,10,10,15,13,11,13,9,14,5,13,13,13,13,12,8,20,12,13,12,12,13,10,9,6,8,11,19,10,10,13,13,6,12,1,M C,1,1,1,12,1,1,1,1,1,14,20,1,1,1,1
19136133,Rafael Gava,1651,20/05/1993,23,0,0,0,0,178,71,3,2,2,1,3,2,2,1,1,3,1,10,12,13,11,12,10,6,7,3,4,12,9,6,13,13,10,8,11,12,11,9,14,12,3,13,10,12,13,14,13,10,8,13,12,13,20,13,7,8,12,11,5,14,10,14,10,11,9,12,10,12,M/AM C,1,1,1,20,12,12,1,8,1,1,18,12,1,8,1
19136134,Pablo,1651,18/12/1992,23,0,0,0,0,175,65,2,1,1,2,1,1,2,3,2,2,1,10,14,12,9,12,6,11,9,9,7,9,4,10,12,11,12,10,9,11,11,9,8,14,3,12,9,10,10,13,15,11,9,11,14,13,20,15,8,10,11,9,10,11,14,9,9,10,10,5,10,5,AM RL,1,1,15,1,15,20,1,1,1,1,1,1,1,1,1
19136135,Pedro Gusmão,1651,04/06/1992,24,0,0,0,0,177,77,1,3,1,3,2,3,1,2,4,3,1,6,4,13,13,9,4,13,6,3,5,3,7,4,11,9,11,4,13,7,6,12,1,11,11,13,7,6,8,12,10,7,5,8,11,13,20,12,8,9,8,8,9,8,11,11,10,13,13,1,12,6,S ,1,1,20,1,1,1,1,1,1,1,1,1,1,1,1
19136137,Douglas Tanque,1651,27/10/1993,22,0,0,0,0,186,84,4,1,3,3,1,1,2,2,3,2,1,8,7,8,11,6,9,12,11,9,6,7,11,6,8,12,12,13,11,12,11,9,13,7,10,12,7,12,12,9,9,14,9,20,14,9,11,12,14,12,6,12,9,6,2,12,12,10,12,12,12,6,S ,1,1,20,1,1,1,1,1,1,1,1,1,1,1,1
19136172,Gustavo Henrique,1651,27/05/1991,25,0,0,0,0,185,78,3,1,1,2,4,4,1,4,1,1,1,4,6,8,6,8,2,13,10,8,12,9,6,10,8,10,13,14,9,9,8,9,13,1,8,8,10,13,12,11,10,14,14,10,14,11,20,15,14,10,9,7,10,10,15,11,13,8,10,8,11,1,D C,1,11,1,1,1,1,20,1,1,1,1,1,1,1,1
19136176,Elivélton,1651,26/04/1992,24,0,0,0,0,171,0,2,1,1,3,3,3,3,3,2,3,1,8,5,4,8,11,8,8,14,5,11,14,5,11,12,10,8,9,9,8,9,14,5,3,12,8,10,9,13,14,12,9,2,8,15,12,20,14,9,10,5,10,10,10,9,11,12,10,9,10,9,1,DM ,1,1,1,1,1,1,1,1,1,20,10,1,1,1,1
19136455,Júnior Chicão,1651,22/12/1986,29,0,0,0,0,184,84,3,2,1,3,1,2,3,3,1,3,3,7,5,9,10,9,7,12,3,1,3,9,3,4,9,9,11,5,9,8,6,8,9,7,3,12,7,7,13,14,13,13,11,10,16,13,20,13,13,9,7,4,9,6,10,9,14,11,10,10,9,3,S ,1,1,20,1,1,1,1,1,1,1,1,1,1,1,1
19136458,Deca,1651,20/05/1984,32,0,0,0,0,173,65,3,3,3,2,1,1,3,1,2,2,2,8,11,11,2,10,5,9,6,8,11,10,7,14,11,9,10,9,9,8,7,14,1,9,7,5,12,9,9,13,11,14,6,20,13,13,10,9,5,9,9,4,9,9,10,12,14,10,10,10,14,4,D/WB L,1,1,1,1,1,1,1,20,1,1,1,1,1,18,1
19136657,Ruan,1651,17/08/1993,22,0,0,0,0,178,75,2,3,2,3,3,2,3,3,2,3,2,7,7,12,12,12,9,11,11,5,6,12,12,7,13,10,12,11,13,12,11,12,12,13,8,13,7,11,12,14,14,11,9,7,14,13,20,13,11,7,10,7,5,9,9,12,12,9,9,6,9,6,AM RL,1,1,15,1,20,16,1,1,1,1,1,1,1,1,1
19137163,Claudinei,1651,08/10/1988,27,0,0,0,0,177,78,2,4,1,1,1,1,2,2,1,2,3,5,7,10,8,11,5,11,6,10,13,10,10,14,7,12,12,15,12,13,8,13,14,7,11,11,13,12,14,15,12,13,9,5,14,15,20,15,11,9,12,10,7,9,7,11,13,12,9,10,9,11,DM/M C,1,1,1,10,1,1,1,1,1,20,17,1,1,1,1
19137172,Cleyton Pedra,1651,02/01/1984,32,0,0,0,0,180,80,3,2,1,3,3,2,2,2,1,1,2,7,3,9,14,14,3,14,8,6,5,7,9,3,12,9,13,6,11,8,8,12,1,11,11,14,8,7,8,13,11,9,10,10,13,9,20,6,12,8,9,1,9,9,20,11,9,11,9,7,1,3,S ,1,1,20,1,1,1,1,1,1,1,1,1,1,1,1
19137174,Sadrak,1651,26/03/1989,27,0,0,0,0,178,71,3,2,2,2,4,1,1,3,2,3,3,9,8,8,4,9,9,7,8,8,10,9,2,11,10,9,10,10,9,11,7,15,7,8,9,8,8,9,9,10,9,9,9,20,15,10,10,13,10,5,9,9,9,9,8,12,11,11,10,8,13,7,D/WB L,1,1,1,1,1,1,1,20,1,1,1,1,1,18,1
19137192,Júnior Gaúcho,1651,22/05/1988,28,0,0,0,0,179,0,3,3,4,3,2,3,3,4,2,1,2,7,5,8,8,14,7,7,9,1,10,10,1,14,13,4,8,8,6,9,8,12,9,7,10,7,13,8,13,11,14,8,4,9,10,14,20,14,7,9,9,9,7,9,7,10,10,8,11,4,20,1,DM ,1,1,1,1,1,1,1,1,1,20,10,1,1,1,1
19137197,Fernando Pires,1651,06/10/1988,27,0,0,0,0,175,73,1,1,1,1,3,1,2,3,2,2,2,10,10,7,6,12,8,10,10,4,10,12,4,10,9,9,15,9,10,13,15,11,9,4,9,9,10,13,13,9,11,10,10,10,8,9,20,12,8,9,9,4,4,9,9,11,8,11,12,4,12,7,DM/M C,1,1,1,1,1,1,1,1,1,20,17,1,8,1,1
19137202,Naldinho,1651,12/05/1990,26,0,0,0,0,181,69,3,1,1,1,3,1,1,4,1,2,3,8,6,13,11,12,8,10,11,1,7,12,1,6,13,7,11,9,11,12,14,14,10,13,12,14,6,11,12,14,13,10,10,11,8,13,20,11,7,8,10,7,10,10,12,12,8,11,10,7,8,5,AM C,1,1,1,20,1,1,1,1,1,1,10,1,1,1,1
19137388,Allan Petterson,1651,07/03/1992,24,0,0,0,0,180,72,1,3,1,3,1,3,2,3,1,2,1,6,6,4,7,11,5,6,7,5,10,8,1,13,13,9,10,8,7,7,8,13,3,3,4,6,13,7,10,13,13,7,9,9,11,13,20,6,7,9,9,9,9,9,13,10,11,10,11,5,10,8,DM ,1,1,1,1,1,1,1,1,1,20,10,1,1,1,1
19137395,Betinho,1651,04/04/1992,24,0,0,0,0,182,61,3,3,2,3,1,2,3,3,3,1,3,6,5,6,6,12,6,6,12,1,6,10,2,6,8,8,8,6,6,5,11,10,9,9,10,9,7,7,12,14,13,6,10,9,11,12,20,13,6,9,3,9,9,9,12,9,11,12,11,1,17,4,AM C,1,1,1,20,1,1,1,1,1,1,10,1,1,1,1
19137607,Paulinho Mossoró,1651,11/06/1987,29,0,0,0,0,169,69,2,2,1,3,3,2,1,1,2,2,2,4,3,12,11,14,7,6,9,1,6,10,4,8,14,9,10,3,8,5,12,8,4,13,9,14,6,8,8,14,14,15,4,1,9,14,20,10,7,9,9,9,9,9,15,11,13,10,14,8,9,7,AM C,1,1,10,20,1,1,1,1,1,1,10,1,1,1,1
19137619,Ruan,1651,06/07/1989,26,0,0,0,0,177,75,14,8,10,8,14,13,10,10,6,7,6,3,3,11,3,1,7,1,1,1,1,2,3,3,5,8,9,13,7,7,6,9,5,3,9,3,6,7,6,14,7,7,7,11,10,14,20,6,8,5,8,8,8,8,14,10,13,10,11,1,15,2,GK ,20,1,1,1,1,1,1,1,1,1,1,1,1,1,1
19137697,Leonardo,1651,08/03/1982,34,0,0,0,0,179,0,3,1,1,3,2,1,3,2,3,3,1,4,4,8,9,13,6,5,11,3,8,12,7,9,14,5,7,8,9,8,9,9,9,13,9,11,8,8,13,9,9,7,9,8,10,8,20,14,7,9,9,9,8,9,14,9,12,11,12,1,1,8,M/AM C,1,1,1,20,1,1,1,1,1,1,16,1,1,1,1
19137798,Ivan,1651,12/12/1984,31,0,0,0,0,187,81,12,12,12,3,14,7,12,14,13,8,12,9,1,2,2,7,11,3,2,1,3,7,3,2,6,11,13,14,12,12,11,13,14,8,13,2,13,15,13,12,13,12,14,10,12,8,20,13,14,11,13,11,7,10,14,14,12,11,10,4,16,6,GK ,20,1,1,1,1,1,1,1,1,1,1,1,1,1,1
19137826,Pedrinho,1651,24/11/1992,23,0,0,0,0,176,74,4,3,2,4,3,1,2,1,3,2,1,7,7,13,13,12,7,9,8,5,6,12,10,6,9,4,10,8,11,9,7,9,10,10,2,13,9,8,8,13,13,11,7,11,10,13,20,12,10,10,9,6,10,9,17,11,9,10,13,12,18,7,AM/S C,1,1,16,20,1,1,1,1,9,1,10,1,1,1,11
19137859,Hércules,1651,06/02/1984,32,0,0,0,0,175,0,2,2,2,3,3,1,1,1,4,2,3,8,4,4,9,13,8,8,12,4,7,13,3,12,13,9,14,6,8,10,13,15,3,9,13,6,10,9,12,15,8,7,7,1,10,12,20,8,8,9,9,7,9,9,10,11,9,11,9,3,11,2,DM ,1,1,1,1,1,1,1,1,1,20,10,1,1,1,1
19137910,Diogo Silva,1651,15/01/1989,27,0,0,0,0,180,74,3,3,1,1,1,1,1,3,3,3,3,1,4,7,6,10,1,8,1,6,9,6,5,10,9,9,12,8,8,11,8,12,9,9,7,7,11,8,8,14,14,10,10,10,12,14,20,10,8,9,9,9,9,9,17,13,13,9,9,9,8,1,D/WB R,1,1,1,1,1,1,1,1,20,1,1,1,1,1,18
19138129,Mário Lúcio,1651,11/12/1989,26,0,0,0,0,179,70,3,2,3,1,3,2,1,1,2,2,1,13,12,15,10,13,12,9,11,6,6,13,15,8,12,9,11,12,12,10,10,10,11,14,9,10,10,12,8,13,15,6,8,9,11,14,20,11,4,6,14,6,4,9,8,11,11,13,6,7,5,13,AM C,1,1,1,20,13,13,1,1,1,1,10,1,1,1,1
19138145,Daniel Piauí,1651,14/12/1984,31,0,0,0,0,175,68,3,2,3,2,1,3,3,2,3,4,3,7,7,8,8,15,7,6,10,5,9,15,6,14,13,9,13,8,8,10,9,10,9,9,10,7,11,9,11,10,11,9,5,4,14,11,20,7,7,9,9,6,8,9,11,12,9,8,11,9,5,8,DM ,1,1,1,10,1,1,1,1,1,20,13,1,1,1,1
19138159,Jackson Caucaia,1651,21/01/1987,29,0,0,0,0,177,70,3,2,3,1,1,2,2,1,1,3,2,10,12,12,8,11,10,10,9,8,12,9,9,12,13,13,12,14,11,11,12,11,5,12,10,13,12,13,13,13,13,14,9,10,12,13,20,11,9,12,15,10,5,11,10,12,10,11,9,8,10,4,DM/M C,1,1,1,12,1,1,1,1,1,16,20,1,1,1,1
19138183,Bruno Peres,1651,01/03/1990,26,0,0,0,0,176,72,1,4,3,1,2,2,4,3,3,1,2,8,12,16,9,15,8,9,12,12,9,13,8,12,15,13,13,12,12,11,11,11,15,13,8,14,8,13,14,17,14,12,7,10,14,17,20,14,11,12,12,14,5,12,10,12,9,11,11,12,11,8,D/WB/M RL,1,1,1,1,1,7,1,15,18,1,1,12,16,15,20
19138184,Juninho Quixadá,1651,12/12/1985,30,0,0,0,0,170,65,3,3,3,2,2,3,2,1,4,1,2,7,10,14,12,15,10,6,12,4,4,13,11,4,14,10,10,11,11,8,13,8,14,14,8,15,6,9,12,15,17,9,5,15,11,14,20,10,6,11,10,11,10,12,7,11,13,9,12,7,6,8,S RC,1,1,20,15,10,15,1,1,1,1,1,1,1,1,1
19138368,Danilo Cortat,1651,25/01/1992,24,0,0,0,0,178,0,3,1,3,2,2,2,1,3,2,2,1,7,12,10,6,11,5,5,7,5,5,6,5,7,7,4,6,6,8,7,10,12,9,8,8,7,6,7,11,12,12,7,2,20,9,12,11,12,4,9,6,9,7,9,17,10,12,11,11,6,13,4,AM LC,1,1,1,17,20,1,1,1,1,1,12,1,1,1,1
19138484,Daniel Amora,1651,20/10/1987,28,0,0,0,0,187,76,3,2,2,3,2,1,3,1,1,1,1,8,10,10,7,14,6,8,10,7,10,14,6,14,13,10,11,9,10,10,13,12,5,4,4,10,10,9,13,11,10,9,14,11,15,12,20,9,13,10,9,5,10,10,11,11,10,10,12,6,11,4,DM/M RC,1,1,1,1,1,1,1,1,1,19,20,1,18,1,1
19138505,Marllon,1651,16/04/1992,24,0,0,0,0,184,75,1,1,1,2,3,2,4,3,1,1,3,2,4,8,7,6,4,16,4,2,14,8,8,16,9,8,14,15,13,12,7,10,16,5,12,5,14,14,15,12,8,13,17,8,14,11,20,15,13,10,10,11,10,7,15,10,8,14,12,1,8,3,D C,1,1,1,1,1,1,20,1,1,1,1,1,1,1,1
19138507,Reinaldo,1651,09/10/1994,21,0,0,0,0,188,84,8,7,11,8,14,13,10,14,9,9,10,6,1,2,2,4,8,1,2,2,3,1,2,3,5,8,6,15,6,10,7,14,9,3,11,2,7,8,5,10,10,8,14,6,13,10,20,2,9,9,9,7,6,9,14,13,13,12,9,9,13,4,GK ,20,1,1,1,1,1,1,1,1,1,1,1,1,1,1
19138509,Léo Arantes,1651,01/03/1994,22,0,0,0,0,184,65,3,3,2,3,1,3,3,2,1,1,1,5,9,7,2,13,1,8,3,7,7,6,2,11,9,8,5,9,8,10,6,13,7,8,1,7,10,8,8,13,13,8,9,8,9,13,20,7,9,8,7,8,8,8,12,10,10,10,11,1,11,5,D/WB R,1,1,1,1,1,1,1,1,20,1,1,1,1,1,16
19138510,Wallace,1651,14/04/1994,22,0,0,0,0,183,0,1,3,2,3,2,2,3,2,3,2,2,7,7,11,8,14,7,12,5,1,5,8,3,5,13,8,11,8,11,4,8,11,9,12,11,13,8,7,8,14,13,8,7,1,15,14,20,9,10,9,9,9,9,9,8,8,11,10,13,7,14,6,S ,1,1,20,1,1,1,1,1,1,1,1,1,1,1,1
19138512,Vitor Hugo,1651,16/01/1993,23,0,0,0,0,196,0,3,3,3,1,1,3,3,2,3,1,1,6,6,3,7,13,6,6,12,3,11,13,4,13,12,9,11,8,7,3,8,13,4,2,10,7,12,7,11,13,13,7,12,8,16,13,20,7,13,9,6,9,9,9,10,12,10,8,10,8,5,6,DM/M C,1,1,1,1,1,1,1,1,1,20,16,1,1,1,1
19138598,Nicolas,1651,04/10/1989,26,0,0,0,0,181,71,3,2,3,2,3,1,1,1,3,2,1,7,4,13,13,12,7,13,7,1,4,7,9,5,12,10,11,5,10,6,5,13,10,15,9,11,3,7,8,12,14,8,7,9,14,12,20,8,8,10,10,8,8,9,18,10,10,13,13,5,16,8,S ,1,1,20,1,1,1,1,1,1,1,1,1,1,1,1
19138879,Elton,1651,14/06/1987,29,0,0,0,0,171,66,1,3,3,1,1,3,4,2,1,2,3,6,4,11,12,13,6,3,13,1,4,13,2,5,9,9,8,3,5,6,10,10,9,9,13,7,10,7,12,13,13,7,4,9,7,13,20,13,4,9,8,9,8,9,15,10,10,12,10,10,9,7,AM C,1,1,1,20,1,1,1,1,1,1,10,1,1,1,1
19138901,Hiltinho,1651,08/12/1985,30,0,0,0,0,172,60,1,3,2,3,3,4,1,3,2,2,2,7,11,11,9,13,5,6,4,4,7,9,4,7,11,10,11,9,9,10,7,9,12,10,7,9,6,8,9,13,13,5,6,9,8,14,20,12,5,10,10,5,10,10,18,11,11,12,10,10,13,2,D/AM RC,1,1,15,20,1,19,1,1,16,1,10,1,1,1,15
19138903,Wellington Lima,1651,13/06/1989,27,0,0,0,0,182,75,3,1,3,2,1,4,1,2,3,1,3,4,2,2,6,6,2,10,1,2,10,8,4,14,6,8,8,9,7,6,7,14,6,1,1,7,14,7,8,14,11,8,7,9,10,11,20,5,7,9,9,9,9,9,20,11,10,10,10,10,7,4,D C,1,1,1,1,1,1,20,1,1,1,1,1,1,1,1
19139020,Gustavo Scarpa,1651,05/01/1994,22,0,0,0,0,177,65,3,3,1,3,2,1,3,1,1,3,3,15,14,13,14,13,16,7,14,10,12,14,12,9,14,12,13,14,14,13,14,14,13,13,10,13,8,13,15,13,14,10,7,20,13,13,5,16,10,13,9,12,6,15,17,13,12,13,12,7,10,9,AM RLC,1,1,10,20,19,19,1,10,1,1,14,15,10,10,1
19139123,Marcão,1651,07/01/1989,27,0,0,0,0,187,78,3,3,1,3,3,3,3,1,2,4,1,8,8,9,5,8,7,9,10,5,8,10,5,11,10,9,9,8,8,8,9,8,11,10,7,10,11,11,10,9,10,11,13,13,11,9,20,12,11,10,13,9,10,11,10,11,10,7,12,11,10,9,DM C,1,1,1,1,1,1,1,1,1,20,15,1,1,1,1
19139273,Robert,1651,15/02/1993,23,0,0,0,0,190,0,1,3,1,4,2,1,4,1,3,1,3,3,5,12,12,12,1,12,6,1,5,5,2,1,12,4,9,5,6,1,5,7,9,13,7,12,3,5,6,12,11,3,13,20,8,12,9,8,13,9,7,8,9,9,11,12,12,13,8,1,12,7,S ,1,1,20,1,1,1,1,1,1,1,1,1,1,1,1
19139365,Neto,1651,16/08/1985,30,0,0,0,0,195,94,2,4,4,1,2,2,2,4,2,3,3,4,6,8,9,10,10,14,8,9,14,10,7,12,8,14,15,14,12,13,9,12,12,6,13,8,12,14,13,10,9,6,16,7,14,10,20,14,16,11,14,12,16,9,7,9,9,9,11,7,6,6,D C,1,1,1,1,1,1,20,1,1,1,1,1,1,1,1
19139625,Dos Santos,1651,26/03/1988,28,0,0,0,0,171,0,3,4,3,3,3,2,3,3,3,3,3,4,7,4,7,14,7,4,11,6,9,14,7,8,12,12,8,2,6,8,12,13,9,9,8,9,11,13,10,14,14,8,3,9,13,14,20,10,5,9,9,8,8,9,12,11,12,12,11,5,9,2,M C,1,1,1,1,1,1,1,1,1,1,20,1,1,1,1
19139629,Michel Henrique,1651,19/05/1989,27,0,0,0,0,185,76,3,4,2,3,4,2,3,2,1,1,3,8,8,13,12,14,8,12,6,5,7,9,4,6,12,7,14,8,13,12,6,10,3,13,10,12,5,8,9,13,10,8,9,11,12,12,20,11,13,10,10,7,9,10,17,10,11,11,11,8,12,8,S ,1,1,20,1,1,1,1,1,1,1,1,1,1,1,1
19139688,Tote,1651,27/05/1986,30,0,0,0,0,173,68,1,2,2,1,1,2,1,3,2,2,1,7,8,12,2,8,13,9,2,7,10,10,4,11,6,9,8,10,9,6,9,13,7,9,9,8,10,8,9,14,14,7,7,10,16,15,20,13,6,10,6,8,7,10,20,8,11,10,10,8,11,5,D/WB R,1,1,1,1,1,1,1,1,20,1,1,1,1,1,18
19139694,Marcelessandro,1651,04/06/1985,31,0,0,0,0,186,0,2,3,1,1,2,3,3,2,3,1,1,6,4,1,1,7,3,13,3,1,13,7,2,13,2,5,9,9,4,11,2,13,5,1,13,4,13,6,7,11,6,7,11,16,13,8,20,12,7,9,9,9,7,9,13,10,9,11,11,2,13,7,D C,1,1,1,1,1,1,20,1,1,1,1,1,1,1,1
19139707,Roni,1651,14/04/1984,32,0,0,0,0,178,71,1,1,1,2,2,2,1,2,3,1,2,6,8,9,11,9,8,11,9,6,8,11,9,7,10,8,8,11,10,8,10,10,4,9,8,10,12,11,11,12,11,12,9,20,11,10,11,12,11,9,7,11,8,10,10,13,10,9,7,8,11,6,S ,1,1,20,1,1,1,1,1,1,1,1,1,1,1,1
19139723,Marinho,1651,19/03/1986,30,0,0,0,0,186,0,1,2,1,1,3,3,1,3,3,1,1,1,1,1,1,4,1,7,1,1,11,5,3,12,4,8,12,7,5,10,1,8,8,2,9,4,12,4,5,12,12,5,12,8,12,12,20,9,9,8,1,8,8,8,14,9,10,10,10,1,7,6,D C,1,1,1,1,1,1,20,1,1,1,1,1,1,1,1
19139739,Pretão,1651,02/05/1983,33,0,0,0,0,178,0,1,3,4,4,2,1,3,2,1,3,2,3,6,2,5,10,6,6,12,6,8,13,4,13,8,9,10,8,7,10,7,12,3,8,10,6,13,7,9,13,8,7,3,8,16,9,20,9,9,9,9,9,8,9,16,11,10,9,9,11,18,1,DM ,1,1,1,1,1,1,1,1,1,20,10,1,1,1,1
19139799,Cris,1651,17/12/1990,25,0,0,0,0,189,85,14,13,9,1,11,14,7,12,5,9,7,6,2,2,1,5,9,1,2,1,1,1,2,2,3,9,7,15,8,10,7,10,9,3,12,2,11,8,7,14,15,7,9,10,14,10,20,7,10,9,8,9,9,9,17,12,13,12,9,2,7,2,GK ,20,1,1,1,1,1,1,1,1,1,1,1,1,1,1
19139814,Rogério,1651,05/01/1988,28,0,0,0,0,190,85,2,3,2,1,4,3,1,1,3,2,1,6,4,1,1,7,4,9,2,2,12,6,2,12,6,8,7,10,6,8,5,12,9,3,16,6,9,6,7,12,12,7,14,16,5,12,20,7,9,10,8,10,10,10,15,11,14,10,12,11,13,7,D C,1,1,1,1,1,1,20,1,1,1,1,1,1,1,1
19139822,Gilvan,1651,10/11/1989,26,0,0,0,0,188,77,2,1,3,2,2,3,1,1,3,3,1,5,7,7,5,9,8,13,5,4,11,9,10,14,9,11,11,13,9,12,11,13,4,7,11,11,16,13,14,11,10,13,13,20,13,11,8,15,12,14,11,12,10,11,15,9,11,10,13,8,12,1,D C,1,1,1,1,1,1,20,1,1,13,1,1,1,1,1
19139827,Sílvio,1651,10/04/1988,28,0,0,0,0,182,78,2,1,1,3,1,2,2,4,1,1,1,3,6,9,7,11,4,12,5,8,14,12,11,14,11,14,7,12,12,13,9,11,12,9,11,7,12,13,12,13,10,8,12,10,12,12,20,11,13,11,14,12,10,11,12,11,13,11,13,11,9,10,D/DM C,1,1,1,1,1,1,20,1,1,17,1,1,1,1,1
19139837,Bruno Henrique,1651,21/10/1989,26,0,0,0,0,180,75,3,3,2,4,3,1,4,1,1,3,1,12,11,12,13,11,14,12,16,10,14,13,9,14,14,13,13,13,12,13,12,11,12,12,13,12,13,12,14,14,13,12,10,13,14,13,20,14,12,14,13,12,11,12,12,13,13,12,12,8,11,7,DM/M C,1,1,1,15,1,1,1,1,1,20,19,1,1,1,1
19139841,William Paulista,1651,04/09/1985,30,0,0,0,0,188,85,2,1,3,2,1,3,2,3,1,1,1,8,8,10,12,10,10,13,9,5,3,11,12,6,10,14,11,8,11,10,10,10,2,10,5,10,5,10,10,12,11,13,14,8,9,13,20,13,13,10,7,9,10,7,8,11,9,11,10,8,13,6,S ,1,1,20,10,9,12,1,1,1,1,1,1,1,1,1
19139925,Daniel Paraíba,1651,09/11/1985,30,0,0,0,0,175,0,1,3,3,1,1,1,1,1,1,1,2,6,3,5,7,13,6,1,9,4,11,13,6,6,9,7,7,8,10,7,13,13,5,4,3,5,10,7,11,13,13,7,8,9,15,13,20,13,4,9,8,5,9,9,19,11,9,10,13,3,10,4,M C,1,1,1,1,1,1,1,1,1,1,20,1,1,1,1
19139938,Marino,1651,18/02/1986,30,0,0,0,0,182,72,4,3,2,2,1,4,3,3,2,3,3,6,10,11,12,10,9,12,13,8,13,8,9,11,11,12,13,12,10,13,11,9,12,9,11,11,13,11,12,12,10,13,11,12,9,12,20,12,13,12,13,10,10,11,16,11,12,11,11,8,10,12,DM ,1,1,1,1,1,1,1,1,1,20,10,1,1,1,1
19140048,Petros,1651,29/05/1989,27,0,0,0,0,182,78,3,3,1,2,2,1,2,2,1,1,3,9,13,10,9,13,9,11,10,11,13,13,11,16,12,16,14,17,12,13,12,12,15,9,14,13,13,14,14,14,12,12,11,13,15,14,20,16,12,13,15,14,8,12,11,13,12,12,13,6,7,6,DM/M C,1,1,1,12,12,10,1,6,1,18,20,6,12,6,1
19140077,Everlan,1651,06/09/1986,29,0,0,0,0,171,0,3,3,3,2,1,3,2,1,1,2,2,10,11,12,11,11,11,7,10,8,6,12,11,6,12,8,10,9,11,10,12,12,9,8,9,12,10,11,9,12,13,13,6,9,12,12,20,11,8,11,8,11,10,11,18,12,11,9,10,1,12,2,M C,1,1,1,15,1,1,1,1,1,1,20,1,1,1,1
19140127,Elsinho,1651,30/11/1989,26,0,0,0,0,187,75,1,3,1,1,1,3,2,3,2,3,2,12,12,13,10,13,9,10,10,5,8,11,12,8,13,10,11,11,12,12,12,11,11,14,10,12,8,11,11,15,14,10,14,10,13,15,20,13,10,12,12,11,10,14,11,12,12,11,11,6,10,9,D/WB RC,1,1,1,13,1,1,1,1,20,1,15,1,10,1,18
19140138,Thiaguinho,1651,11/05/1990,26,0,0,0,0,171,0,3,1,2,3,1,2,1,3,2,2,2,7,7,8,4,11,2,5,7,4,10,10,1,14,9,9,9,9,9,12,6,12,4,8,9,8,10,9,9,15,15,9,6,10,14,15,20,6,7,9,9,4,9,9,13,11,10,11,12,6,12,8,D/WB R,1,1,1,1,1,1,1,1,20,1,1,1,1,1,18
19140251,Natan,1651,08/11/1990,25,0,0,0,0,171,67,2,2,1,1,3,2,1,2,1,4,2,7,7,11,9,13,7,7,10,4,8,11,2,9,12,8,9,8,10,8,12,12,3,15,11,13,7,7,10,14,13,4,5,11,7,14,20,12,4,11,6,10,16,10,15,10,11,11,13,6,11,2,M/AM C,1,1,1,20,1,1,1,1,1,1,18,1,1,1,1
19140255,Victor Hugo,1651,30/06/1991,25,0,0,0,0,165,65,1,3,2,1,3,1,2,1,2,2,1,9,3,13,10,12,12,4,9,5,4,11,11,3,14,7,9,8,11,11,9,9,13,15,7,10,5,8,11,16,15,4,3,14,11,15,20,5,4,11,8,10,6,12,11,12,7,12,10,4,11,10,AM/S C,1,1,17,20,1,1,1,1,1,1,10,1,1,1,1
19140258,Everton Sena,1651,14/06/1991,25,0,0,0,0,185,73,1,1,1,1,4,3,1,3,1,3,1,8,8,8,5,9,5,12,4,8,14,11,4,13,11,13,11,9,12,13,8,12,13,6,9,7,12,11,12,13,7,9,13,10,13,11,20,13,10,11,9,10,8,13,10,12,11,13,14,13,13,8,D C,1,1,1,1,1,1,20,10,13,15,5,1,1,5,8
19140265,Danilo,1651,28/05/1985,31,0,0,0,0,176,72,1,2,2,1,1,1,1,1,2,2,3,13,13,13,12,14,12,7,11,7,7,14,13,8,14,8,15,11,13,13,14,14,13,14,9,13,8,13,12,11,12,8,8,10,13,12,20,9,8,11,8,10,9,8,11,12,15,12,14,14,15,6,AM C,1,1,1,20,7,7,1,1,1,1,13,1,1,1,1
19140426,Ancelmo,1651,03/04/1990,26,0,0,0,0,180,75,3,1,4,3,1,1,1,3,2,1,1,12,11,12,9,12,12,8,11,10,8,12,13,6,12,8,11,7,8,11,13,11,8,12,7,11,11,10,12,9,12,11,10,12,8,10,20,11,10,10,7,3,15,10,8,9,11,10,14,10,13,4,M/AM C,1,1,1,20,1,1,1,1,1,1,17,1,1,1,1
19140701,Uilliams,1651,17/01/1989,27,0,0,0,0,179,73,1,3,4,3,1,2,3,2,2,1,1,10,6,6,12,6,10,9,7,4,10,10,5,5,9,9,7,12,9,9,9,9,4,12,4,12,6,9,15,13,12,11,11,20,11,14,10,14,12,9,9,9,5,9,18,12,11,9,12,5,9,6,AM/S C,1,1,20,18,1,1,1,1,1,1,1,1,1,1,1
19140726,Bruno Smith,1651,13/07/1992,23,0,0,0,0,173,68,3,3,2,1,1,2,3,2,2,2,1,9,12,11,11,12,8,10,11,4,9,12,4,5,13,10,11,10,12,11,13,12,4,10,11,10,12,11,10,11,12,12,7,10,11,10,20,12,11,12,8,9,10,16,11,13,7,11,13,8,13,3,M/AM C,1,1,1,16,10,10,1,1,1,10,20,12,12,1,1
19140756,Júnior Viçosa,1651,24/07/1989,26,0,0,0,0,180,70,2,3,1,3,2,1,2,2,2,3,4,6,11,14,13,13,8,10,8,6,4,10,12,4,13,11,12,10,13,12,11,12,12,14,7,13,4,10,12,16,14,10,11,10,13,15,20,13,8,10,10,8,8,9,6,12,12,13,11,6,12,7,S ,1,1,20,1,1,1,1,1,1,1,1,1,1,1,1
19140956,Dedé,1651,12/01/1994,22,0,0,0,0,164,67,1,3,3,4,1,2,3,1,3,2,1,7,5,7,7,13,4,7,11,2,9,13,5,13,8,9,11,7,8,8,6,5,5,2,9,9,12,9,12,12,10,9,3,9,11,13,20,8,5,9,9,9,8,9,13,12,11,13,11,9,15,8,DM/M C,1,1,1,1,1,1,1,1,1,17,20,1,1,1,1
19140957,Bruno Medeiros,1651,15/04/1992,24,0,0,0,0,174,67,1,2,1,2,2,2,3,3,3,1,2,6,6,5,7,9,6,6,5,5,6,9,1,12,9,9,11,8,7,5,9,13,9,1,8,7,13,7,5,13,13,7,5,9,14,11,20,7,5,9,9,4,9,9,17,14,11,9,12,1,16,3,DM ,1,1,1,1,1,1,1,1,1,20,14,1,1,1,1
19140961,Andrey,1651,17/07/1993,22,0,0,0,0,190,82,12,12,10,16,12,12,12,13,11,11,12,6,2,2,1,6,10,1,3,2,2,3,3,3,4,11,12,11,10,14,9,14,11,2,11,3,13,10,7,13,13,8,15,20,3,13,5,3,13,12,11,11,11,11,12,10,11,11,10,2,10,1,GK ,20,1,1,1,1,1,1,1,1,1,1,1,1,1,1
19140964,Davi,1651,03/09/1990,25,0,0,0,0,177,73,1,3,1,2,1,2,2,1,2,3,2,1,2,13,13,13,1,13,7,2,6,7,9,1,9,9,8,8,11,7,5,10,6,9,5,8,5,6,8,13,13,7,6,9,9,13,20,12,10,9,8,9,9,9,15,10,12,10,11,6,16,4,S ,1,1,20,1,1,1,1,1,1,1,10,10,10,1,1
19140968,Fabiano,1651,02/02/1992,24,0,0,0,0,186,0,3,2,1,1,3,1,3,2,3,2,1,3,5,8,8,13,7,7,7,6,10,11,6,13,13,10,7,9,9,8,13,13,10,4,9,8,12,9,12,13,13,9,13,10,10,12,20,13,9,10,7,10,7,10,15,9,11,11,11,8,11,2,DM/M C,1,1,1,1,1,1,1,1,1,20,19,1,1,1,1
19141393,Diego Jussani,1651,07/09/1987,28,0,0,0,0,189,85,2,1,1,2,2,4,1,1,1,3,2,5,4,6,3,7,15,12,5,5,13,3,4,13,3,12,11,13,12,12,9,13,12,12,13,11,12,13,13,12,11,13,13,8,12,12,20,13,14,10,13,12,6,3,11,12,13,12,14,13,11,8,D C,1,1,1,1,1,1,20,1,1,1,1,1,1,1,1
19141394,Renan Fonseca,1651,13/08/1990,25,0,0,0,0,189,81,3,2,1,1,1,3,3,2,2,3,1,4,6,8,4,12,4,13,6,4,13,12,5,11,10,6,13,11,14,12,9,14,8,11,14,11,14,14,13,13,13,14,14,2,14,14,20,14,15,12,9,14,5,2,17,10,14,11,10,7,1,2,D C,1,1,1,1,1,1,20,1,1,1,1,1,1,1,1
19141395,Naldo,1651,25/08/1988,27,0,0,0,0,188,83,2,3,2,3,1,2,3,3,3,1,2,3,7,8,9,9,10,11,8,7,13,11,10,13,11,13,15,12,9,15,7,14,14,10,10,9,14,14,15,12,12,13,14,10,14,13,20,15,13,12,12,12,6,7,13,12,5,10,11,6,7,11,D C,1,1,1,1,1,1,20,1,10,1,1,1,1,1,1
19141409,Alexsandro,1651,20/08/1988,27,0,0,0,0,178,72,2,3,2,3,3,1,1,3,2,3,3,7,5,6,7,14,6,7,9,2,12,9,3,12,14,6,11,8,9,6,12,14,9,2,1,7,10,8,11,14,14,7,9,10,14,14,20,7,7,12,9,7,4,9,20,11,14,10,12,8,6,4,DM ,1,1,1,1,1,1,1,1,1,20,13,1,1,1,1
19141410,Álvaro,1651,06/06/1991,25,0,0,0,0,178,78,1,2,3,2,3,2,2,1,3,4,3,6,8,11,8,13,6,6,6,1,6,12,3,8,8,6,9,6,7,5,7,13,5,8,7,8,7,7,11,13,12,10,8,13,12,13,20,11,10,9,5,8,9,9,8,12,12,13,10,8,9,1,AM RC,1,1,1,20,1,16,1,1,1,1,11,1,13,1,1
19141414,Rafael Gomes,1651,14/12/1988,27,0,0,0,0,179,80,2,1,2,3,2,1,1,3,1,2,1,6,7,12,13,11,6,13,7,4,6,6,4,2,8,9,11,2,9,7,7,11,9,8,5,11,7,6,7,13,13,5,9,9,14,13,20,6,13,9,8,7,9,9,12,11,11,10,13,12,11,4,S ,1,1,20,1,1,1,1,1,1,1,1,1,1,1,1
19141422,Poti,1651,28/11/1984,31,0,0,0,0,190,84,14,11,12,5,14,13,9,14,9,6,8,2,2,2,3,1,5,1,1,2,2,1,2,2,4,9,10,15,7,10,7,12,6,2,8,3,11,8,7,9,8,7,15,6,9,10,20,4,12,9,9,9,6,9,17,11,11,10,13,1,4,3,GK ,20,1,1,1,1,1,1,1,1,1,1,1,1,1,1
19141450,Wagner,1651,17/08/1990,25,0,0,0,0,194,97,2,1,1,3,3,1,3,3,3,1,4,3,4,4,3,7,3,12,6,4,12,7,3,12,5,2,11,9,2,6,5,12,7,2,2,6,12,6,7,12,9,7,14,9,17,11,20,12,15,5,10,10,10,10,12,12,13,12,8,2,16,2,D C,1,1,1,1,1,1,20,1,1,1,1,1,1,1,1
19141459,Tássio,1651,28/09/1992,23,0,0,0,0,193,80,2,1,1,1,3,2,3,3,2,1,2,9,7,8,7,15,9,12,9,9,11,10,13,15,15,9,14,9,11,11,11,13,3,2,3,10,12,10,12,10,9,4,16,11,12,8,20,9,13,10,10,4,10,10,19,11,11,8,11,1,12,1,DM/M C,1,1,1,1,1,1,13,1,1,20,17,1,1,1,1
19141473,Maurício,1651,19/08/1993,22,0,0,0,0,191,0,3,1,3,2,1,3,3,1,3,3,1,5,5,7,10,13,3,4,11,1,5,12,3,5,10,8,6,6,6,6,11,12,4,10,4,8,6,7,10,13,10,6,14,9,14,13,20,7,10,8,8,8,4,8,15,11,11,10,10,10,10,2,AM C,1,1,1,20,1,1,1,1,1,1,1,1,1,1,1
19141480,Balão Marabá,1651,07/10/1987,28,0,0,0,0,196,0,3,2,1,3,3,1,3,1,2,3,1,4,4,6,4,12,2,3,9,1,2,10,2,6,10,8,6,5,6,4,12,8,7,11,10,9,6,6,10,12,8,5,11,10,10,12,20,12,12,8,8,8,7,8,10,14,11,13,10,10,11,8,AM C,1,1,1,20,1,1,1,1,1,1,15,1,1,1,1
19141483,Marcelão,1651,28/11/1989,26,0,0,0,0,192,0,3,1,3,1,3,3,3,3,1,1,1,2,1,1,3,7,1,9,6,3,11,7,1,7,2,9,9,9,7,8,4,13,3,3,10,5,12,6,7,12,10,7,14,9,9,11,20,6,12,9,9,7,9,9,12,11,12,11,10,10,7,4,D C,1,1,1,1,1,1,20,1,1,1,1,1,1,1,1
19141535,Shailison,1651,27/08/1991,24,0,0,0,0,166,61,1,1,2,3,2,3,3,1,1,1,3,6,4,10,13,8,4,12,6,2,4,7,5,2,12,7,11,5,12,7,2,12,9,12,9,10,7,6,7,13,11,5,3,8,16,13,20,7,4,8,4,6,7,9,17,9,10,8,10,10,18,12,S ,1,1,20,1,1,1,1,1,1,1,1,1,1,1,1
19141565,Luís Jorge,1651,19/05/1986,30,0,0,0,0,192,0,3,4,2,1,3,2,1,1,3,1,3,8,12,7,6,10,6,8,4,6,9,9,5,14,6,7,10,8,9,12,6,10,2,4,10,7,11,9,9,14,11,9,11,20,6,11,9,8,11,9,9,7,9,9,20,9,11,15,10,10,1,5,D/WB L,1,1,1,1,1,1,1,20,1,1,1,1,1,19,1
19141629,Dudu,1651,20/01/1986,30,0,0,0,0,175,74,1,2,2,2,2,1,1,2,3,1,1,4,7,6,7,12,7,7,13,3,11,6,5,11,14,9,11,8,9,9,11,11,3,3,3,7,11,9,11,14,14,11,8,9,5,14,20,8,10,9,9,7,9,9,19,10,12,12,10,10,9,3,DM/M C,1,1,1,1,1,1,1,1,1,20,19,1,1,1,1
19141878,Hudson,1651,28/01/1992,24,0,0,0,0,179,77,1,3,2,1,1,1,1,1,1,1,3,6,7,13,13,12,6,13,6,2,6,6,4,2,8,6,12,4,8,7,3,8,3,9,10,12,7,6,5,13,13,10,8,9,12,13,20,10,8,9,9,9,4,8,13,12,10,12,9,5,8,5,S ,1,1,20,1,1,1,1,1,1,1,1,1,1,1,1
19141880,Jailton Santos,1651,13/04/1993,23,0,0,0,0,183,0,3,3,3,3,3,1,1,1,3,2,2,5,3,4,4,7,3,11,6,7,14,9,1,14,4,10,10,10,8,10,4,9,2,3,9,6,14,8,9,14,14,9,7,9,10,14,20,14,10,10,10,3,8,10,8,11,12,11,14,1,11,7,D C,1,1,1,1,1,1,20,1,1,1,1,1,1,1,1
19141941,Jean Chera,1651,12/05/1995,21,0,0,0,0,170,68,1,3,1,1,4,2,3,3,1,2,4,8,8,12,9,11,14,5,10,2,2,11,10,2,12,8,9,8,9,7,10,9,12,13,2,11,4,10,10,10,10,14,5,20,10,12,7,9,6,8,6,6,7,11,6,13,3,4,9,6,10,18,M/AM C,1,1,10,20,14,10,1,1,1,1,16,10,7,1,1
19141974,Marcelo,1651,29/05/1994,22,0,0,0,0,181,75,1,2,2,3,2,1,2,2,1,1,1,5,10,11,10,13,9,11,13,8,14,13,9,13,13,13,14,14,13,8,11,10,12,13,6,13,14,12,14,13,12,10,11,8,14,13,20,15,15,12,12,12,9,13,13,10,13,13,12,13,14,5,DM/M C,1,5,1,1,1,1,7,1,1,20,18,1,1,1,1
19141985,Ricardo Silva,1651,03/08/1992,23,0,0,0,0,190,78,1,1,2,1,2,3,2,3,2,3,3,10,11,10,11,12,10,13,10,10,12,12,11,13,11,12,12,11,11,12,11,12,11,10,11,12,10,11,11,11,12,8,15,11,12,11,20,12,12,12,11,12,12,12,12,11,13,13,13,2,4,1,D C,1,1,1,1,1,1,20,1,1,13,1,1,1,1,1
19141986,Mineiro,1651,09/12/1992,23,0,0,0,0,188,0,2,1,3,2,1,4,2,4,2,1,3,6,4,1,3,7,3,11,5,1,11,5,1,13,2,9,10,9,7,7,1,13,5,7,11,5,11,6,7,13,13,7,10,8,11,13,20,5,9,9,6,9,4,9,16,11,10,9,12,1,7,2,D C,1,1,1,1,1,1,20,1,1,1,1,1,1,1,1
19141989,Jairo,1651,07/04/1992,24,0,0,0,0,185,0,1,3,2,1,2,2,3,3,2,2,2,6,8,4,9,15,8,10,10,3,7,6,4,8,10,8,8,9,9,10,7,15,4,4,11,8,10,9,12,15,12,11,9,2,12,13,20,15,12,9,9,9,10,9,15,10,8,12,11,12,2,4,D/DM C,1,1,1,1,1,1,17,1,1,20,13,1,1,1,1
19141991,Bruno Sabino,1651,04/05/1990,26,0,0,0,0,171,74,3,2,2,4,1,3,1,1,2,2,3,7,6,7,7,9,7,5,11,1,11,11,5,13,8,10,12,9,6,7,12,13,10,1,6,6,12,8,12,13,13,13,5,9,12,13,20,9,7,10,10,1,8,10,17,9,10,9,9,1,15,2,DM ,1,1,1,1,1,1,1,1,1,20,10,1,1,1,1
19142015,Hédipo,1651,07/02/1988,28,0,0,0,0,174,0,1,3,2,3,2,1,3,2,2,4,3,5,5,8,11,12,5,6,7,2,3,10,2,6,11,3,7,3,8,5,7,10,4,11,4,10,6,6,7,13,13,6,7,5,15,13,20,7,6,8,6,8,8,7,9,10,12,11,10,9,13,6,AM C,1,1,15,20,1,1,1,1,1,1,1,1,1,1,1
19142197,Venício,1651,13/03/1994,22,0,0,0,0,185,81,3,1,2,1,2,1,1,3,1,3,3,1,6,1,1,7,4,12,4,1,10,6,4,13,3,9,10,8,6,8,6,13,7,9,8,6,12,4,7,12,7,7,12,15,14,7,20,4,9,9,7,9,9,9,20,10,11,8,12,3,11,2,D C,1,1,1,1,1,1,20,1,1,1,1,1,1,1,1
19142198,Gegê,1651,28/01/1994,22,0,0,0,0,175,73,3,1,2,3,2,2,2,2,2,3,1,14,14,13,13,13,12,4,14,13,13,14,6,12,13,5,12,10,12,5,12,9,6,12,5,12,13,15,14,14,13,12,11,20,13,13,10,13,12,11,10,10,5,11,11,9,6,7,7,6,12,12,M/AM LC,1,1,1,17,20,1,1,1,1,1,18,19,1,1,1
19142199,Feijão,1651,18/04/1994,22,0,0,0,0,179,74,4,3,1,2,4,3,3,1,2,1,2,4,5,7,7,8,8,11,8,9,15,10,8,14,8,15,11,17,6,7,8,9,16,13,11,10,15,17,17,13,13,7,10,16,14,13,20,15,14,12,15,9,4,5,12,10,14,13,6,12,7,18,DM/M C,1,1,1,1,1,1,1,1,1,20,18,1,1,1,1
19142498,Carlinhos,1651,29/11/1986,29,0,0,0,0,167,71,1,3,3,2,1,1,2,2,2,3,1,13,13,14,11,12,11,8,12,12,9,11,10,9,14,12,11,11,11,12,13,12,12,13,11,13,9,13,13,15,13,8,10,20,12,14,9,13,12,12,9,11,13,12,14,10,7,10,10,5,12,9,D/WB L,1,1,1,1,5,1,1,20,1,1,1,10,1,19,1
19142503,Júnior Juazeiro,1651,24/11/1989,26,0,0,0,0,186,83,2,2,3,1,3,2,2,3,3,3,1,8,10,12,10,12,11,8,9,5,3,11,12,4,13,11,10,11,9,8,11,9,12,14,5,13,4,8,9,13,12,8,12,20,12,13,9,12,9,12,7,5,9,11,7,11,14,11,11,5,10,10,S ,1,1,20,12,14,11,1,1,1,1,1,1,1,1,1
19142515,Diogo Caruaru,1651,23/09/1992,23,0,0,0,0,180,70,1,3,2,3,1,1,1,3,3,1,1,7,7,13,10,13,7,13,8,4,7,8,2,3,12,10,9,9,8,5,5,10,4,12,6,10,6,7,8,13,11,8,10,15,14,11,20,9,7,10,3,10,8,10,18,12,9,13,11,3,10,6,S ,1,1,20,1,1,1,1,1,1,1,1,1,1,1,1
19142718,Dennis,1651,22/04/1992,24,0,0,0,0,185,84,1,1,1,2,3,3,1,4,2,2,1,6,9,14,11,14,8,14,8,5,3,10,6,4,13,5,11,6,9,10,9,14,6,12,13,11,3,8,10,12,8,13,11,20,10,11,11,12,13,7,5,10,8,10,16,13,11,13,11,10,14,2,AM/S C,1,1,20,17,1,1,1,1,1,1,1,1,1,1,1
19143370,Charles,1651,04/02/1994,22,0,0,0,0,186,81,10,10,13,11,8,13,10,15,9,15,12,4,1,1,1,9,9,8,3,3,1,9,7,2,9,11,11,12,10,11,9,9,12,2,10,2,9,12,11,10,13,11,12,5,13,10,20,11,12,8,10,12,6,10,10,10,10,12,12,13,9,7,GK ,20,1,1,1,1,1,1,1,1,1,1,1,1,1,1
19143371,Léo Bonatini,1651,28/03/1994,22,0,0,0,0,185,80,1,3,1,3,3,2,1,2,1,3,1,6,11,13,14,12,7,12,11,5,5,11,12,6,13,11,13,12,12,13,12,13,11,12,8,15,8,11,13,13,13,14,12,13,11,12,20,12,13,12,3,12,4,5,9,12,13,10,12,12,13,13,S ,1,1,20,1,1,1,1,1,1,1,1,1,1,1,1
19143372,Rodrigo Dourado,1651,17/06/1994,22,0,0,0,0,186,80,4,3,3,3,2,3,1,2,1,3,1,7,8,11,10,12,11,14,11,10,15,13,10,14,12,13,13,13,13,13,11,12,12,11,10,12,14,14,13,14,14,14,13,12,13,13,20,14,13,13,12,12,7,10,17,12,12,13,11,5,10,6,DM C,1,1,1,1,1,1,1,1,1,20,15,10,10,1,1
19143434,Luiz Matheus,1651,10/01/1993,23,0,0,0,0,188,84,2,3,1,3,3,3,2,3,2,1,1,8,7,6,3,6,5,14,8,1,14,7,6,14,2,3,7,10,9,11,8,13,1,1,8,6,9,8,9,12,11,9,14,9,15,12,20,7,9,10,4,10,10,10,16,12,10,10,8,9,12,2,D C,1,1,1,1,1,1,20,1,1,1,1,1,1,1,1
19143480,Torres,1651,14/03/1991,25,0,0,0,0,175,64,3,3,2,3,2,2,1,1,1,3,2,2,3,10,12,11,3,8,5,1,3,5,5,1,6,7,4,4,7,2,4,6,3,7,10,11,5,3,6,12,12,4,4,9,13,12,20,11,4,7,6,7,7,7,14,11,12,12,12,1,10,1,S C,1,1,20,15,1,1,1,1,11,1,1,1,1,1,12
19143755,Giba,1651,11/07/1987,28,0,0,0,0,186,79,3,2,2,2,3,2,3,1,2,2,2,7,5,8,12,14,7,8,8,2,7,14,6,8,14,7,11,6,12,9,12,12,4,13,14,9,10,9,12,11,12,9,12,8,17,11,20,10,10,9,7,10,10,10,14,12,15,11,11,8,11,8,AM C,1,1,1,20,1,1,1,1,1,1,15,1,1,1,1
19143756,Marcão,1651,04/06/1989,27,0,0,0,0,187,71,3,1,2,3,1,2,3,1,2,2,3,5,4,2,1,4,3,13,6,2,10,7,2,11,6,9,9,9,4,7,4,13,9,1,5,6,10,6,8,13,13,7,12,9,15,13,20,12,10,8,13,8,4,8,20,11,9,10,14,2,4,1,D C,1,1,1,1,1,1,20,1,8,1,1,1,1,1,1
19143846,Márcio Arantes,1651,05/01/1984,32,0,0,0,0,185,85,14,12,12,1,13,11,10,11,10,10,10,5,1,1,2,3,8,1,2,1,1,1,1,1,8,9,12,11,9,11,8,14,2,3,9,3,12,9,8,11,15,6,10,10,14,10,20,8,7,10,4,7,4,10,10,10,11,11,14,7,6,7,GK ,20,1,1,1,1,1,1,1,1,1,1,1,1,1,1
19143855,Caio,1651,17/03/1990,26,0,0,0,0,174,0,2,4,2,1,2,4,3,2,4,2,2,6,6,10,7,13,6,1,13,4,5,11,3,5,11,9,6,7,8,7,13,9,8,11,11,9,7,7,12,13,13,7,4,9,16,13,20,12,5,9,4,1,9,9,14,10,10,11,13,8,4,6,AM C,1,1,1,20,1,1,1,1,1,1,10,1,1,1,1
19143870,Guaçuí,1651,05/01/1984,32,0,0,0,0,188,0,3,2,2,3,1,2,1,2,2,3,3,4,9,9,9,10,4,11,6,3,11,7,4,10,9,6,12,11,10,10,4,14,8,1,12,9,11,9,10,10,12,10,9,8,17,10,20,12,13,10,8,1,10,10,12,12,11,11,12,1,13,3,D C,1,1,1,1,1,1,20,1,1,1,1,1,1,1,1
19143880,Nivaldo,1651,22/06/1988,28,0,0,0,0,185,82,1,1,1,3,3,4,1,3,2,3,1,8,8,9,9,13,7,9,8,11,10,11,1,8,14,11,10,10,10,10,7,11,4,11,8,11,9,10,10,12,11,10,12,10,10,13,20,11,12,10,10,13,7,12,12,12,12,12,12,14,16,4,S C,1,1,20,15,10,10,1,1,1,10,13,7,10,1,1
19143887,Magno,1651,23/03/1986,30,0,0,0,0,183,0,3,1,1,2,1,1,2,1,1,3,3,3,6,7,4,10,1,6,7,6,9,9,4,12,8,8,8,9,8,9,8,7,2,6,8,4,9,9,9,14,14,9,9,10,9,14,20,14,7,9,9,7,7,9,19,12,9,12,10,7,15,4,D/WB R,1,1,1,1,1,1,1,1,20,1,1,1,1,1,17
19143894,Ualisson Pikachu,1651,27/06/1989,27,0,0,0,0,168,68,3,3,1,1,4,4,3,1,1,1,3,8,9,14,14,14,8,10,10,4,7,9,11,8,13,7,9,7,13,9,9,14,9,12,11,13,9,8,10,14,14,8,3,8,10,14,20,7,12,10,10,1,10,10,20,12,9,10,10,5,14,4,S C,1,1,20,15,1,1,1,1,1,1,1,1,1,1,1
19143985,Dudu,1651,29/12/1988,27,0,0,0,0,176,70,2,1,1,1,3,2,3,3,3,1,3,10,8,12,12,8,7,8,8,5,5,8,12,8,12,10,9,10,10,9,7,10,4,12,10,9,11,12,12,12,11,8,9,11,10,12,20,9,10,12,5,12,8,9,10,11,11,11,10,7,8,8,S R,1,1,20,11,12,15,1,1,1,1,1,1,1,1,1
19144020,Renato Júnior,1651,19/01/1990,26,0,0,0,0,175,75,1,1,3,1,3,1,2,1,3,1,3,11,12,12,11,12,11,8,11,12,10,12,10,11,12,12,13,10,11,10,12,13,13,12,10,12,8,12,10,14,14,12,8,8,14,14,20,16,9,11,14,7,7,11,18,12,13,13,12,7,13,3,D/WB R,1,1,1,1,1,1,1,10,20,1,1,1,12,1,18
19144024,João Neto,1651,22/10/1986,29,0,0,0,0,175,70,1,1,1,2,2,1,1,2,3,3,4,2,5,7,6,10,4,8,13,1,10,8,3,10,8,14,13,13,8,10,7,12,13,7,9,7,10,12,12,10,10,10,6,10,10,10,20,12,7,9,6,9,9,9,9,10,12,9,8,7,11,4,DM C,1,1,1,1,1,1,1,1,1,20,15,1,1,1,1
19144027,Luís Gustavo,1651,10/11/1989,26,0,0,0,0,190,76,4,3,3,3,1,3,2,1,2,1,3,3,4,3,4,5,3,13,2,3,12,4,3,12,5,13,11,13,9,11,9,9,12,9,11,9,12,11,11,12,9,10,15,18,12,5,20,12,14,9,11,9,8,5,8,14,10,13,12,8,15,8,D C,1,1,1,1,1,1,20,1,1,1,1,1,1,1,1
19144028,Max Pardalzinho,1651,14/05/1987,29,0,0,0,0,169,64,2,3,2,3,1,3,3,4,3,3,2,4,6,13,11,13,5,7,4,7,7,8,7,3,12,4,13,4,10,11,8,14,6,12,11,12,5,7,9,14,13,5,6,20,13,15,18,7,5,11,10,10,10,10,8,13,11,12,12,4,6,5,S ,1,1,20,1,1,1,1,1,1,1,1,1,1,1,1
19144068,Dija Baiano,1651,05/04/1990,26,0,0,0,0,171,70,2,1,1,3,2,2,2,1,1,2,1,8,6,14,14,14,8,14,9,6,6,9,3,6,13,10,14,9,8,9,8,10,1,12,3,14,8,8,9,14,14,14,6,6,15,14,20,8,6,10,10,10,6,10,16,11,12,12,13,10,13,1,S ,1,1,20,1,1,1,1,1,1,1,1,1,1,1,1
19144077,Jonathan,1651,25/08/1992,23,0,0,0,0,179,75,2,3,3,3,3,1,3,2,1,2,3,10,11,9,5,12,5,11,10,10,11,10,5,13,11,10,10,14,12,12,9,12,6,8,8,8,4,14,14,12,11,14,11,20,15,12,7,14,12,10,3,10,6,10,17,12,9,13,13,5,9,4,D/WB R,1,1,1,1,1,1,1,1,20,1,1,1,1,1,17
19144080,Miltão,1651,25/03/1990,26,0,0,0,0,192,94,1,2,4,3,3,3,2,3,1,2,1,4,5,4,4,9,1,12,4,7,11,9,2,14,4,10,13,10,6,12,6,11,10,1,8,7,11,8,9,10,10,15,16,7,12,10,20,13,15,10,10,10,6,10,17,12,10,12,10,10,9,7,D C,1,1,1,1,1,1,20,1,1,1,1,1,1,1,1
19144086,Willian,1651,05/03/1988,28,0,0,0,0,178,75,2,1,1,2,2,3,1,2,3,3,3,11,11,11,9,11,9,4,10,8,7,11,10,7,12,13,11,9,11,11,12,11,13,13,12,11,8,12,11,13,13,5,8,20,13,14,9,13,4,9,9,3,9,9,13,13,12,13,11,5,13,4,D/WB L,1,1,1,1,1,1,1,20,1,1,1,1,1,19,1
19144095,Anderson Correia,1651,06/05/1991,25,0,0,0,0,177,73,3,1,1,2,2,2,2,1,3,1,2,12,12,12,8,12,11,8,12,12,8,12,11,11,13,13,11,12,12,11,11,10,14,14,9,13,9,11,12,14,13,7,7,20,11,14,10,12,8,12,10,11,14,12,12,10,12,9,11,7,10,7,D/WB L,1,1,1,1,13,1,1,20,1,1,1,13,1,18,1
19144097,Vítor Hugo,1651,20/05/1991,25,0,0,0,0,187,80,1,1,2,1,3,3,3,3,1,3,1,9,9,10,8,10,9,15,10,8,13,10,10,14,10,12,14,13,13,14,9,13,12,10,12,9,14,13,13,13,12,9,16,20,13,12,12,14,13,13,12,12,3,7,11,13,12,13,13,12,10,10,D C,1,1,1,1,1,1,20,1,1,1,1,1,1,1,1
19144225,Wanderson,1651,06/06/1993,23,0,0,0,0,183,0,3,2,1,2,2,1,3,3,2,3,2,8,5,14,11,15,8,10,9,3,6,9,5,6,12,5,12,7,11,9,9,7,8,9,12,11,4,8,9,15,12,4,11,1,11,13,20,11,11,5,8,5,9,9,18,12,11,9,13,8,9,6,S ,1,1,20,1,1,1,1,1,1,1,1,1,1,1,1
19144255,Rafinha,1651,01/04/1993,23,0,0,0,0,164,55,4,1,3,3,3,3,2,1,1,1,2,11,11,13,11,12,10,6,11,5,5,12,12,5,13,8,11,8,11,11,12,12,14,15,10,13,8,11,11,15,15,6,3,7,12,15,20,13,6,11,6,11,6,12,9,12,12,12,11,6,13,6,AM/S RL,1,1,20,13,17,19,1,1,1,1,11,12,13,1,1
19144260,Genílson,1651,27/10/1990,25,0,0,0,0,183,80,4,2,4,2,3,3,4,1,4,1,2,3,3,6,6,8,8,11,10,10,12,9,8,13,8,12,13,10,9,11,8,11,7,9,10,8,12,11,12,11,11,9,12,5,16,12,20,12,15,11,9,11,5,8,14,10,11,11,12,8,12,8,D C,1,1,1,1,1,1,20,1,1,1,1,1,1,1,1
19144731,Romário,1651,17/07/1994,21,0,0,0,0,177,74,4,3,4,3,1,4,1,1,3,3,4,10,9,12,10,8,10,8,11,2,7,9,9,5,10,8,8,8,8,7,9,7,20,12,9,10,6,10,10,15,12,9,6,8,16,13,20,15,8,10,6,6,10,10,7,12,11,10,9,4,15,7,AM/S R,1,1,17,1,13,20,1,1,1,1,1,7,10,1,1
19144874,Mike,1651,08/06/1993,23,0,0,0,0,175,67,1,2,3,2,1,3,2,2,3,1,1,3,7,13,11,14,3,9,7,7,6,12,11,4,14,12,13,11,13,12,11,12,15,13,6,16,12,9,14,14,15,7,8,20,12,14,12,12,6,13,9,13,11,10,12,13,11,9,13,9,11,11,AM/S RL,1,1,20,1,19,17,1,1,1,1,1,1,1,1,1
19144893,Diogo Barbosa,1651,17/08/1992,23,0,0,0,0,180,76,2,2,2,1,1,3,2,1,2,2,1,5,13,13,5,13,11,12,7,11,14,14,4,13,13,12,14,12,12,13,10,12,2,13,5,8,12,10,10,16,15,12,8,20,13,14,10,12,13,14,10,13,12,10,13,15,15,11,13,6,9,5,D/WB L,1,1,1,1,1,1,1,20,1,1,1,15,1,17,1
19144895,Kelvin,1651,01/06/1993,23,0,0,0,0,173,66,2,3,1,2,3,3,1,1,1,3,1,13,13,15,12,14,12,5,12,5,5,12,14,6,14,7,14,10,14,12,11,12,11,16,6,14,6,11,13,17,15,6,7,20,13,16,7,8,7,12,8,11,9,13,12,15,10,13,10,10,11,7,AM RLC,1,1,13,15,18,20,1,2,1,1,1,8,1,6,1
19144898,Henrique,1651,23/12/1991,24,0,0,0,0,175,70,1,4,3,1,3,3,2,3,1,4,1,6,9,8,5,11,1,7,5,9,8,9,4,7,10,7,9,9,10,11,6,15,7,8,13,9,8,10,9,14,12,9,9,20,14,14,10,12,8,10,10,10,10,10,11,11,11,12,11,6,10,1,D/WB L,1,1,1,1,1,1,1,20,1,1,1,1,1,18,1
19144991,Pedro Henrique,1651,16/06/1990,26,0,0,0,0,179,73,3,2,1,3,1,1,2,3,2,3,1,8,11,14,10,14,11,8,13,5,6,13,5,6,14,5,11,9,12,12,13,13,14,9,9,12,5,12,15,14,14,10,8,20,12,13,15,14,7,11,11,10,5,10,13,14,9,12,13,8,7,11,AM RL,1,1,13,13,20,18,1,1,1,1,1,15,15,1,1
19145015,Philipe Pardal,1651,14/05/1992,24,0,0,0,0,178,0,3,3,3,3,1,1,1,2,4,1,3,5,5,12,12,12,5,12,5,1,5,5,5,4,8,9,11,4,12,4,6,10,8,9,4,12,4,5,6,12,12,6,5,16,11,12,20,8,12,9,3,9,9,9,13,8,13,11,11,5,1,7,S ,1,1,20,1,1,1,1,1,1,1,1,1,1,1,1
19145100,Guilherme Costa,1651,31/03/1994,22,0,0,0,0,176,0,3,1,2,2,3,1,2,3,2,3,3,13,13,13,11,8,14,9,12,5,2,13,13,2,13,9,11,8,12,8,14,11,13,14,8,10,6,14,11,13,14,6,8,20,12,12,18,12,6,10,7,9,8,13,17,12,10,12,12,7,10,6,AM RLC,1,1,14,20,15,15,1,1,1,1,15,1,1,1,1
19145102,Giovanni Oliveira,1651,01/04/1990,26,0,0,0,0,174,63,3,1,1,1,3,3,2,3,3,1,2,6,8,12,8,13,12,6,4,4,6,8,11,6,11,7,8,7,8,7,6,9,5,13,5,8,7,8,12,11,12,12,6,10,11,11,20,13,7,9,5,6,9,9,16,12,11,12,11,7,11,2,AM RC,1,1,1,20,1,17,1,1,1,1,10,1,10,1,1
19145406,Edinho Canutama,1651,04/10/1990,25,0,0,0,0,185,0,2,2,1,3,2,2,1,1,2,2,1,6,7,11,13,6,6,13,5,2,4,8,6,1,11,8,8,5,10,8,8,8,2,12,11,13,8,6,7,13,13,7,11,10,11,13,20,11,8,9,9,9,7,9,8,8,10,9,11,5,8,2,S ,1,1,20,1,1,1,1,11,1,1,1,10,1,11,1
19145484,Luiz Otávio,1651,14/09/1988,27,0,0,0,0,190,81,2,2,3,1,3,3,3,1,3,2,1,3,6,7,6,10,6,12,9,1,13,10,4,13,8,11,11,11,10,12,5,14,3,3,6,9,13,9,13,11,11,13,15,11,16,13,20,13,13,11,9,10,11,11,16,12,9,9,12,1,12,6,D C,1,1,1,1,1,1,20,1,1,1,1,1,1,1,1
19145496,Adeilson,1651,15/02/1990,26,0,0,0,0,182,73,2,1,1,2,1,1,2,2,3,3,1,6,5,13,13,12,3,13,7,2,5,7,4,3,13,8,10,5,5,6,6,9,3,13,13,8,5,6,8,13,11,7,8,8,15,11,20,12,6,9,6,9,9,9,14,12,10,10,13,2,5,2,S ,1,1,20,1,1,1,1,1,1,1,1,1,1,1,1
19145563,Túlio,1651,05/03/1991,25,0,0,0,0,192,0,2,3,1,2,3,1,3,1,3,1,3,4,5,6,5,9,3,1,6,1,5,11,1,4,12,8,9,2,6,5,6,10,6,5,13,6,4,6,10,12,12,5,13,14,13,12,20,10,9,8,8,8,8,8,8,13,11,9,9,10,11,1,M RLC,1,1,1,1,1,1,1,1,1,1,20,17,17,1,1
19145916,Rogério,1651,04/08/1989,26,0,0,0,0,180,75,3,2,1,1,3,1,3,1,2,2,2,6,6,9,9,12,7,7,13,2,7,13,5,11,13,10,8,9,9,9,8,10,10,13,13,9,10,8,12,13,13,10,9,9,8,13,20,13,10,10,7,8,7,10,18,13,13,14,11,6,15,3,M/AM C,1,1,1,18,1,1,1,1,1,15,20,1,1,1,1
19145984,Tety,1651,16/11/1984,31,0,0,0,0,164,58,2,1,2,3,2,1,3,2,3,2,2,6,3,8,13,13,4,11,2,1,3,6,3,1,13,5,10,7,10,5,7,11,4,13,14,13,7,4,7,12,10,17,2,9,16,12,20,8,8,6,9,1,8,9,11,8,11,13,8,12,4,4,S ,1,1,20,1,1,1,1,1,1,1,1,1,1,1,1
19146082,Wanderson,1651,11/03/1989,27,0,0,0,0,181,75,1,3,1,3,3,3,3,3,1,3,1,7,5,9,10,13,3,10,9,9,11,9,5,15,11,3,14,11,11,12,11,11,6,1,15,9,11,14,12,13,15,11,10,9,13,13,20,11,10,10,5,10,4,10,10,13,11,9,10,10,12,3,D/WB L,1,1,1,1,1,1,1,20,1,1,1,1,1,19,1
19146267,Julio César,1651,18/02/1991,25,0,0,0,0,187,0,2,2,3,3,1,3,3,3,3,2,2,5,5,6,5,13,4,3,8,3,6,10,3,9,11,7,9,7,7,7,8,8,7,6,8,4,10,7,12,11,13,7,13,9,11,13,20,10,7,8,8,6,8,8,8,9,13,10,11,6,6,6,DM/M C,1,1,1,1,1,1,1,1,1,20,17,1,1,1,1
19146272,Eric,1651,23/07/1987,28,0,0,0,0,175,70,2,1,3,1,1,3,2,3,4,3,2,10,12,11,10,10,12,9,10,12,11,11,8,9,10,8,14,11,12,11,11,11,9,12,13,11,12,11,12,13,13,9,7,8,13,13,20,13,8,12,10,6,9,10,16,12,11,14,12,1,4,2,D/WB R,1,1,1,1,1,1,1,1,20,1,1,1,1,1,17
19146285,Nathan Indio,1651,16/09/1993,22,0,0,0,0,173,0,2,3,3,2,2,3,2,3,3,2,3,6,8,12,10,12,7,9,9,2,6,8,5,12,12,9,6,8,9,7,11,13,9,5,9,8,11,10,13,13,14,13,3,10,11,13,20,13,11,9,7,6,7,9,18,13,11,13,10,9,15,6,D/DM/M RC,1,1,1,10,1,1,1,1,17,20,17,1,13,1,13
19146310,Bruno Alves,1651,08/07/1990,25,0,0,0,0,189,85,3,3,2,3,2,2,1,2,2,3,2,3,1,1,2,9,3,14,1,2,14,6,3,14,8,10,10,10,9,7,7,14,1,3,2,8,12,8,9,14,14,9,14,1,17,13,20,7,14,10,5,8,10,10,18,10,12,14,13,6,12,5,D C,1,1,1,1,1,1,20,1,1,1,1,1,1,1,1
19147076,Rosseto,1651,20/09/1993,22,0,0,0,0,169,0,2,1,3,3,3,2,3,3,2,1,2,6,10,10,5,11,8,9,9,4,10,10,3,10,15,9,9,9,11,11,11,9,8,5,7,10,10,10,11,13,10,3,6,9,12,10,20,8,5,9,9,9,5,12,20,12,10,13,12,6,16,3,DM/M RC,1,1,1,1,1,1,1,1,15,19,20,1,10,1,15
19147079,Felipe Coltro,1651,14/06/1993,23,0,0,0,0,177,66,2,4,1,1,2,3,1,2,2,1,1,10,12,11,5,11,9,5,4,10,12,12,9,3,10,9,10,10,8,9,9,15,2,9,3,9,4,12,10,11,14,9,7,20,10,11,10,11,9,9,9,9,4,9,10,11,11,10,10,5,1,8,D/WB L,1,1,1,1,1,1,1,20,1,1,1,1,1,18,1
19147093,Wallace Oliveira,1651,01/05/1994,22,0,0,2,0,175,72,1,3,2,1,3,2,2,3,1,2,1,10,11,11,6,10,10,7,9,8,8,10,11,8,11,14,10,10,11,9,10,10,12,10,10,12,9,10,11,14,13,12,8,12,14,14,20,15,12,8,11,9,9,10,7,13,12,10,12,10,11,8,D/WB R,1,1,1,1,1,13,1,14,20,1,1,8,14,11,19
19147125,Mirrai,1651,09/01/1994,22,0,0,0,0,176,67,2,2,1,3,2,3,4,3,2,1,2,9,10,11,8,11,9,5,8,6,4,12,5,5,12,6,10,8,10,9,11,11,13,12,6,11,5,11,8,13,10,13,7,20,12,12,10,11,6,9,5,10,15,10,12,12,12,10,12,5,10,6,AM C,1,1,1,20,1,1,1,1,1,1,10,1,1,1,1
19147162,Felipe Dias,1651,10/10/1993,22,0,0,0,0,172,70,1,3,1,1,3,3,3,2,1,3,2,7,9,8,5,13,8,8,10,8,10,10,7,15,10,8,8,8,10,12,11,13,8,4,6,8,11,10,10,14,11,10,7,20,13,13,6,10,6,9,4,9,8,9,17,9,12,13,14,1,10,3,D/WB/DM/M LC,1,1,1,1,1,1,1,19,1,20,19,1,1,16,1
19147163,Nicollas,1651,27/04/1994,22,0,0,0,0,180,81,1,2,1,2,2,2,1,3,2,2,4,1,3,5,5,7,6,12,5,3,12,8,8,12,9,12,11,10,10,12,8,11,11,5,9,5,12,12,12,10,7,11,12,6,12,9,20,13,10,12,8,10,12,9,14,12,8,11,11,12,14,5,D C,1,1,1,1,1,1,20,1,1,1,1,1,1,1,1
19147649,Alberto,1651,21/01/1988,28,0,0,0,0,177,70,2,1,1,2,1,1,1,1,2,1,1,8,8,8,10,14,8,8,13,6,11,14,7,14,14,3,10,9,9,8,7,9,6,5,10,10,10,10,12,14,14,10,6,8,13,14,20,8,6,10,10,10,10,10,18,12,11,9,11,11,8,8,DM/M C,1,1,1,1,1,1,1,1,10,19,20,1,1,1,10
19147650,Tiago Granja,1651,21/07/1986,29,0,0,0,0,172,70,3,1,1,4,2,1,2,3,1,3,1,2,5,7,5,11,1,8,7,6,9,9,1,14,8,9,9,8,7,9,9,12,8,9,10,7,12,9,9,14,14,13,6,10,10,14,20,14,6,9,9,9,9,9,14,10,11,10,12,1,15,8,D/WB R,1,1,1,1,1,1,1,1,20,1,1,1,1,1,19
19147654,Léo Olinda,1651,21/12/1984,31,0,0,0,0,172,0,3,2,3,1,2,3,3,1,4,2,3,7,5,13,9,13,5,6,11,2,6,11,4,8,13,7,8,4,7,8,13,13,4,13,11,9,7,8,11,12,10,8,3,9,11,10,20,13,7,10,9,10,5,10,8,11,11,10,12,8,6,2,AM C,1,1,1,20,1,1,1,1,1,1,10,1,1,1,1
19147655,Carlão,1651,28/04/1989,27,0,0,0,0,187,80,3,2,1,2,1,2,1,3,1,1,1,2,4,5,6,7,4,13,5,4,11,7,7,11,7,10,11,13,9,14,5,15,4,2,9,7,11,13,13,10,9,5,13,13,12,9,20,13,14,10,10,10,9,10,15,12,9,10,10,9,4,4,D/DM C,1,1,1,1,1,1,20,1,1,16,1,1,1,1,1
19147891,Juninho,1651,23/02/1990,26,0,0,0,0,179,80,3,2,1,3,2,1,1,1,4,3,2,3,4,8,11,10,3,11,4,1,3,4,5,1,6,8,5,5,11,2,4,11,8,8,8,11,4,3,5,11,11,4,1,20,8,11,20,9,10,7,8,8,8,8,12,10,9,11,12,10,17,2,S ,1,1,20,1,1,1,1,1,1,1,1,1,1,1,1
19147941,Dieguinho,1651,20/05/1992,24,0,0,0,0,172,62,4,2,3,3,1,4,1,3,4,2,2,7,9,13,7,14,7,6,7,7,5,13,5,8,9,9,8,8,8,8,10,14,5,9,5,7,8,8,11,14,12,8,6,10,11,13,20,6,6,9,8,9,9,9,19,11,9,10,11,4,14,3,AM RC,1,1,10,20,1,17,1,1,1,1,11,1,1,1,1
19148006,Karl,1651,07/04/1993,23,0,0,0,0,182,74,1,3,2,2,2,4,1,2,2,3,1,11,11,11,7,11,11,7,10,8,10,13,5,11,12,12,12,13,9,11,12,8,4,1,10,13,12,14,12,11,11,13,12,14,12,11,20,14,11,12,10,3,10,11,7,11,13,12,9,1,5,8,M C,1,1,1,7,1,1,1,1,1,13,20,1,1,1,1
19148204,Samuel,1651,30/04/1992,24,0,0,0,0,188,77,2,2,1,1,2,1,1,1,2,1,2,8,6,4,7,14,6,8,9,3,10,14,6,14,13,6,14,9,9,8,13,12,8,7,10,8,11,9,13,14,11,8,14,9,11,12,20,13,8,10,6,9,9,10,16,13,13,10,10,8,10,8,DM ,1,1,1,1,1,1,1,1,1,20,10,1,1,1,1
19148205,Bruno,1651,24/06/1993,23,0,0,0,0,182,67,1,3,1,3,1,1,1,2,2,2,1,6,8,8,1,9,3,7,8,5,9,13,7,14,8,9,11,8,7,7,9,14,7,7,13,7,12,8,9,14,11,8,11,20,15,12,5,8,8,9,9,1,9,9,11,10,8,9,9,7,13,6,D/WB/DM L,1,1,1,1,1,1,1,16,1,20,10,1,1,16,1
19148207,Amiron,1651,22/01/1994,22,0,0,0,0,177,68,2,2,2,2,1,3,3,2,1,1,2,1,2,6,6,11,4,2,6,1,4,12,4,6,9,6,9,3,6,5,11,12,5,10,6,5,6,6,10,12,11,5,6,10,15,12,20,7,6,8,8,8,8,8,14,10,14,10,11,1,2,7,AM C,1,1,1,20,1,1,1,1,1,1,15,1,1,1,1
19148208,Ezequiel,1651,22/02/1993,23,0,0,0,0,179,71,1,2,1,2,2,3,2,1,1,2,3,9,11,9,8,12,8,7,8,8,12,12,7,12,14,13,12,11,13,14,13,12,11,7,9,13,14,16,14,12,13,11,9,8,10,12,20,13,11,10,13,9,11,10,14,12,10,11,12,5,16,7,D/WB R,1,1,1,1,1,1,1,1,20,1,1,1,1,1,19
19148211,Vítor Michels,1651,23/07/1993,22,0,0,0,0,180,72,1,3,2,2,2,1,3,2,2,2,3,6,6,8,6,13,6,1,7,1,7,13,2,7,13,8,4,1,9,7,13,8,5,13,5,11,6,7,12,13,11,7,9,10,11,11,20,9,5,9,9,9,9,9,9,11,13,10,13,1,15,2,AM C,1,1,1,20,1,1,1,1,1,1,15,1,1,1,1
19148300,Alex Porto,1651,21/05/1986,30,0,0,0,0,177,73,1,3,1,1,3,1,3,2,1,4,4,9,9,10,8,11,8,7,10,5,10,12,9,11,10,10,10,11,11,11,10,10,11,8,11,9,11,12,11,9,10,12,7,10,11,9,20,11,12,9,8,10,5,9,12,11,8,9,12,13,11,11,DM/M C,1,1,1,1,1,1,1,1,1,20,18,1,1,1,1
19148389,Caio Martins,1651,22/01/1993,23,0,0,0,0,173,73,3,2,3,2,3,1,2,3,1,3,2,5,8,5,3,13,7,8,6,7,9,9,3,14,9,9,10,5,9,9,6,12,6,4,7,4,10,9,9,14,14,7,3,10,14,14,20,5,6,9,7,9,9,9,9,11,13,11,11,1,8,2,D/DM R,1,1,1,1,1,1,1,1,20,17,8,1,1,1,11
19148430,Alemão,1651,18/10/1990,25,0,0,0,0,186,80,3,3,1,1,3,1,1,3,1,2,1,9,10,11,6,11,8,10,8,10,11,11,10,12,11,13,11,13,11,11,9,11,4,11,8,10,10,12,12,13,11,9,13,9,13,13,20,14,11,11,14,6,8,13,10,9,12,9,13,4,2,4,D RC,1,1,1,1,1,1,20,1,17,15,6,1,1,1,12
19148533,Thiago Brito,1651,20/08/1992,23,0,0,0,0,168,65,3,2,1,2,3,1,1,1,1,3,3,9,9,12,9,10,9,6,7,8,7,11,2,9,11,9,11,10,10,10,11,10,10,13,6,13,9,11,11,14,13,5,7,11,13,13,20,13,3,12,8,6,5,10,17,10,11,12,11,6,18,2,AM RL,1,1,13,13,17,20,1,1,1,1,1,1,1,1,1
19148891,Rivaldinho,1651,29/04/1995,21,0,0,0,0,186,85,3,2,2,2,4,3,2,3,1,2,3,10,10,11,11,12,10,13,10,7,6,10,11,7,9,9,12,9,11,12,11,11,12,14,9,12,6,12,12,11,11,11,13,11,12,13,20,13,11,11,9,10,6,10,13,13,13,10,10,6,12,5,S ,1,1,20,1,1,1,1,1,1,1,1,1,1,1,1
19148918,Lucas Farias,1651,18/08/1994,21,0,0,0,0,174,68,1,2,1,3,2,2,4,3,1,3,2,8,11,12,9,11,8,8,9,10,10,12,7,13,13,12,13,12,11,12,9,11,10,13,8,13,9,12,12,14,13,11,7,12,12,14,20,13,6,10,10,11,4,15,7,12,13,9,10,7,15,6,D/WB R,1,1,1,1,1,13,1,10,20,10,12,1,13,12,19
19148958,Cortez,1651,11/03/1987,29,1,0,0,0,182,78,1,3,2,2,3,2,3,1,3,4,3,11,13,13,10,14,10,4,10,12,9,14,5,7,14,3,12,8,12,12,13,14,12,13,5,13,8,13,13,14,15,10,10,20,14,14,10,14,12,10,12,12,10,13,15,10,13,14,10,5,12,9,D/WB/M L,1,1,1,1,1,1,1,17,1,1,1,17,1,20,1
19148964,Aírton,1651,29/05/1994,22,0,0,0,0,188,83,12,7,7,1,12,12,11,13,12,11,12,6,1,2,1,2,10,1,1,1,1,3,3,3,5,8,7,11,10,15,7,15,14,2,13,1,9,10,9,12,13,12,15,8,13,12,20,8,12,10,10,2,7,10,9,13,10,11,12,14,16,4,GK ,20,1,1,1,1,1,1,1,1,1,1,1,1,1,1
19148968,Santos,1651,17/03/1990,26,0,0,0,0,188,79,12,13,12,12,12,12,12,12,13,12,13,5,2,1,2,11,9,9,3,1,10,11,2,4,11,10,9,13,11,13,13,13,3,14,12,15,10,13,12,12,12,11,10,12,13,11,20,11,9,13,13,13,10,11,17,13,13,13,11,9,6,4,GK ,20,1,1,1,1,1,1,1,1,1,1,1,1,1,1
19149016,Wendell,1651,20/07/1993,22,0,0,4,0,176,66,3,3,1,2,3,3,2,3,3,1,3,11,11,14,7,15,10,8,9,13,13,12,8,16,14,17,13,14,10,9,11,11,14,14,7,13,9,10,17,17,17,9,9,20,14,15,8,16,7,11,13,12,4,10,11,16,10,12,11,7,7,13,D/WB L,1,1,1,1,13,1,1,20,1,1,1,13,1,20,1
19149112,Anderson Baiano,1651,15/03/1993,23,0,0,0,0,185,81,1,2,3,1,1,2,1,3,2,1,1,5,5,12,12,12,5,12,6,5,4,6,8,1,9,6,12,1,8,4,1,10,1,10,9,10,6,5,6,12,12,6,10,18,12,12,20,7,6,9,6,9,9,9,17,11,12,10,11,7,13,5,S ,1,1,20,1,1,1,1,1,1,1,1,1,1,1,1
19149113,Heitor,1651,19/01/1993,23,0,0,0,0,187,82,3,2,2,1,1,4,3,1,3,3,1,2,5,4,5,8,5,6,4,1,11,7,2,12,7,9,7,11,6,8,4,12,9,5,11,5,11,6,9,12,9,4,12,7,4,10,20,5,11,9,9,9,9,9,10,12,11,12,9,10,14,1,DM C,1,1,1,1,1,1,15,1,1,20,10,1,1,1,1
19149114,Jean Moser,1651,23/06/1993,23,0,0,0,0,182,80,4,1,3,2,3,3,3,3,3,2,3,3,5,11,10,13,6,13,7,3,6,5,7,5,10,10,11,9,12,8,5,13,12,10,5,13,8,7,8,12,13,11,10,9,10,13,20,12,11,10,6,10,3,10,16,8,8,10,11,9,2,4,S ,1,1,20,1,1,1,1,1,1,1,1,1,1,1,1
19149116,Renan Rinaldi,1651,28/12/1992,23,0,0,0,0,190,79,4,8,9,4,13,8,8,13,9,9,7,5,1,2,3,4,7,1,1,2,1,1,3,3,2,7,9,13,7,9,6,13,9,3,9,2,13,7,6,11,13,5,14,2,8,13,20,1,9,8,9,9,7,9,17,11,12,10,12,13,4,6,GK ,20,1,1,1,1,1,1,1,1,1,1,1,1,1,1
19149202,Danilo Ferreira,1651,02/08/1991,24,0,0,0,0,186,0,2,2,3,2,3,1,4,1,3,3,3,5,5,7,6,8,1,13,7,8,12,9,6,13,8,14,10,13,8,10,7,9,14,1,9,9,11,14,13,12,11,13,13,9,16,12,20,14,13,9,9,8,9,9,8,9,11,12,12,8,14,5,D C,1,11,1,1,1,1,20,1,1,1,1,1,1,1,1
19149203,Clayton Sales,1651,24/02/1993,23,0,0,0,0,177,74,1,1,1,3,3,4,2,1,1,2,1,10,12,12,8,10,7,7,11,12,9,11,12,9,13,10,9,12,8,9,12,9,13,12,4,12,9,12,11,16,14,8,11,7,14,14,20,12,7,12,5,10,10,14,11,12,8,13,12,9,12,7,D/WB R,1,1,1,1,1,8,1,1,20,1,1,1,12,1,19
19149204,Samuel,1651,03/05/1991,25,0,0,0,0,174,74,3,2,3,2,2,2,1,2,3,1,3,8,7,9,10,13,6,8,10,5,6,10,6,8,10,9,8,9,10,9,15,9,9,9,5,9,8,9,13,12,10,12,7,9,9,11,20,8,13,9,9,8,4,9,18,13,13,11,12,11,13,5,M/AM C,1,1,10,20,10,10,1,1,1,1,18,5,5,1,1
19149208,Assuério,1651,24/02/1993,23,0,0,0,0,179,70,2,1,1,1,1,3,2,1,3,3,2,9,9,12,10,15,9,15,10,3,3,10,9,3,12,9,14,7,9,7,9,8,16,10,10,13,5,9,7,13,14,7,7,9,17,13,20,9,7,10,10,10,7,10,15,10,15,12,15,10,10,10,S ,1,1,20,1,1,1,1,1,1,1,1,1,1,1,1
19149434,Júlio César,1651,23/01/1990,26,0,0,0,0,183,70,2,2,3,2,2,1,2,3,2,1,1,5,7,10,10,9,8,9,9,4,3,9,7,3,9,4,9,8,9,8,9,8,12,7,5,11,5,7,9,12,13,9,11,8,13,12,20,9,9,9,9,9,5,9,11,12,13,15,12,8,19,7,S ,1,1,20,1,1,1,1,1,1,1,1,1,1,1,1
19149435,Bruno,1651,05/06/1990,26,0,0,0,0,181,78,2,2,1,3,2,2,1,2,1,4,1,11,12,13,11,12,9,9,12,9,9,12,10,11,13,11,10,12,12,10,12,11,11,13,10,11,9,12,13,13,13,11,10,20,10,13,9,13,11,11,9,11,9,10,13,12,10,10,14,10,11,9,AM RLC,1,1,13,20,15,17,1,1,1,1,14,13,6,1,1
19149436,Jean Carlos,1651,15/02/1992,24,0,0,0,0,178,74,3,1,3,3,3,3,2,2,3,1,3,11,12,13,11,13,14,7,14,7,7,14,13,6,13,13,13,12,12,12,14,11,11,12,7,12,8,13,12,13,13,7,8,20,13,14,7,11,5,12,10,10,5,9,10,13,13,12,14,8,10,11,M/AM LC,1,1,12,20,17,1,1,1,1,1,18,15,1,1,1
19150106,Mahatma,1651,18/02/1992,24,0,0,0,0,179,73,3,2,4,1,2,2,2,2,4,1,3,8,8,9,7,13,7,8,11,5,11,14,6,14,14,6,10,9,9,10,7,12,6,3,3,8,13,9,11,14,14,9,7,10,5,14,20,14,11,10,8,10,9,10,11,8,12,10,10,3,14,6,DM ,1,1,1,1,1,1,1,1,1,20,10,1,1,1,1
19150495,Ravi,1651,29/04/1994,22,0,0,0,0,188,79,11,12,8,5,11,14,8,9,7,10,8,3,3,1,3,6,5,1,3,3,3,2,3,1,6,9,11,13,6,15,6,13,3,7,8,9,9,9,9,11,9,8,14,5,8,12,20,5,10,9,6,7,5,9,20,9,9,12,10,5,6,1,GK ,20,1,1,1,1,1,1,1,1,1,1,1,1,1,1
19151236,Marlone,1651,02/04/1992,24,0,0,0,0,180,75,3,1,1,3,1,3,3,2,2,2,3,9,13,14,12,14,8,11,14,9,5,14,10,5,13,13,13,13,12,13,13,13,12,14,10,14,6,12,13,14,13,14,10,13,12,14,20,13,13,12,10,11,10,13,20,12,12,12,12,6,12,6,AM RLC,1,1,8,19,20,15,1,1,1,1,15,1,1,1,1
19151430,Lucas Kattah,1651,10/03/1994,22,0,0,0,0,173,0,1,3,1,2,1,2,1,3,2,3,3,7,9,12,9,14,7,5,9,7,8,14,1,11,11,6,7,8,4,9,11,13,9,14,6,13,6,8,13,10,10,8,7,20,9,11,10,8,5,9,9,8,4,14,9,12,11,11,9,7,10,6,DM/M/AM LC,1,1,1,17,15,1,1,1,1,18,20,18,1,1,1
19151433,Yago,1651,07/07/1995,20,0,0,0,0,174,73,3,2,3,2,1,1,1,3,2,3,1,7,10,12,11,11,8,6,10,7,12,12,9,8,12,10,11,9,10,8,11,11,11,12,9,10,13,7,8,13,12,12,7,15,10,12,20,10,12,10,9,10,11,12,7,12,11,12,12,8,9,7,DM/M C,1,1,1,1,1,1,1,1,1,19,20,1,1,1,1
19152048,Bernard,1651,08/09/1992,23,15,1,0,0,168,63,1,3,1,1,2,2,1,3,2,3,4,11,14,17,13,16,10,9,11,6,3,13,10,6,17,11,12,7,10,11,14,14,14,18,10,14,6,9,11,18,16,7,4,10,15,15,20,13,6,10,14,13,9,16,8,14,11,12,9,12,10,3,AM RLC,1,1,14,15,20,15,1,1,7,1,7,13,7,1,1
19152106,Pedro Castro,1651,05/02/1993,23,0,0,0,0,180,77,1,3,2,2,2,2,4,2,3,2,2,8,9,10,10,13,9,9,10,8,11,14,9,12,13,12,10,13,9,11,10,10,3,10,12,11,9,14,13,10,10,13,8,9,14,12,20,13,14,9,9,1,5,10,20,11,10,11,10,5,4,8,M/AM C,1,1,1,20,1,1,1,1,1,1,16,1,1,1,1
19152162,Danilo,1651,25/04/1991,25,0,0,0,0,186,83,4,1,3,2,2,2,3,1,1,3,2,8,6,12,11,12,8,11,12,8,6,12,5,6,10,9,12,9,10,9,6,12,10,8,10,12,5,6,11,12,11,11,12,11,15,11,20,11,14,11,10,12,13,10,18,11,9,13,11,8,12,3,S ,1,1,20,1,1,1,1,1,1,1,1,1,1,1,1
19152229,Aguilar,1651,07/03/1995,21,0,0,0,0,190,0,3,4,1,3,1,2,2,2,1,3,1,8,9,14,14,10,8,14,4,7,5,7,5,3,14,5,6,7,10,8,7,11,5,13,13,14,9,8,9,13,10,5,14,3,12,12,20,13,11,10,9,5,9,10,19,10,10,11,12,3,1,1,S ,1,1,20,1,1,1,1,1,1,1,1,1,1,1,1
19152300,Guilherme,1651,10/09/1991,24,0,0,0,0,177,70,1,2,1,3,3,3,1,2,1,3,3,11,13,13,11,11,1,4,10,8,10,11,2,12,11,10,11,6,11,12,12,10,14,13,8,13,10,11,13,12,12,8,8,20,13,11,10,12,10,11,6,11,6,11,13,8,9,11,13,11,6,7,D/WB L,1,1,1,1,1,1,1,17,1,1,1,1,1,20,1
19152301,Fabrício Messias,1651,23/03/1990,26,0,0,0,0,180,76,1,3,1,3,1,1,1,1,4,2,1,10,7,14,12,14,14,7,15,12,7,13,14,10,15,5,6,5,11,12,14,13,11,11,10,11,11,11,10,13,12,12,8,10,12,12,20,12,8,11,10,12,10,9,12,6,11,10,12,11,10,7,M/AM RLC,1,1,1,20,17,17,1,1,1,1,17,1,1,1,1
19152627,Jone,1651,13/11/1991,24,0,0,0,0,182,78,1,3,3,1,1,4,1,3,2,2,2,7,8,10,13,12,8,11,11,6,7,11,12,8,12,11,11,12,12,11,12,12,15,13,9,12,8,13,12,11,11,13,12,20,13,12,5,11,12,12,8,1,6,9,14,14,12,12,10,13,12,6,S ,1,1,20,10,1,1,1,1,1,1,1,1,1,1,1
19152704,Zi,1651,01/06/1993,23,0,0,0,0,178,0,1,3,1,3,2,3,1,2,4,3,1,4,5,7,7,11,5,4,9,1,6,10,1,6,10,8,8,4,5,7,10,9,8,10,11,7,7,7,10,12,13,7,6,8,12,13,20,7,5,8,7,8,8,8,15,12,11,10,13,7,13,2,M/AM C,1,1,1,20,1,1,1,1,1,1,17,1,1,1,1
19152793,Rafael Thyere,1651,17/05/1993,23,0,0,0,0,190,84,3,2,1,3,2,2,1,3,1,3,1,5,6,6,5,11,4,13,7,5,14,10,7,14,9,11,13,13,12,13,5,13,15,8,5,11,13,13,13,13,12,13,14,12,14,13,20,14,13,13,12,13,8,10,17,12,11,13,12,9,12,10,D C,1,1,1,1,1,1,20,1,1,1,1,1,1,1,1
19152797,Thales,1651,28/04/1994,22,0,0,0,0,178,73,3,3,4,1,2,2,1,2,2,1,2,8,10,10,9,11,11,10,9,7,9,11,9,10,11,10,11,11,11,12,8,10,14,13,9,12,11,12,12,12,13,11,8,9,12,12,20,13,10,10,7,5,10,11,8,11,11,12,14,11,16,4,D R,1,1,1,1,1,1,5,10,20,1,1,1,1,5,15
19152800,Vanderlei,1651,25/09/1987,28,0,0,0,0,182,74,3,1,3,2,2,2,2,2,2,4,1,6,10,13,7,13,7,8,7,8,9,11,8,7,13,9,10,11,13,10,6,9,11,11,10,12,10,11,11,14,15,7,11,7,11,14,20,10,8,11,6,8,10,10,8,11,8,9,12,6,10,10,S ,1,1,20,7,1,1,1,1,1,1,1,1,1,1,1
19152845,Elivelton,1651,10/05/1992,24,0,0,0,0,180,85,3,1,2,3,2,1,3,2,3,2,2,6,7,7,5,9,5,13,7,7,12,9,6,12,9,14,10,13,9,9,6,9,5,7,8,6,11,11,14,12,13,11,16,12,14,13,20,14,15,11,13,8,8,7,10,10,12,11,11,10,17,1,D C,1,1,1,1,1,1,20,1,1,8,1,1,1,1,1
19152846,Wellington Carvalho,1651,15/02/1993,23,0,0,0,0,185,84,3,1,2,1,3,3,3,2,2,3,2,6,5,7,3,10,3,12,8,7,12,11,4,12,8,8,13,11,11,13,7,11,12,4,13,8,12,12,14,10,10,13,12,5,12,9,20,12,15,11,10,5,6,10,19,12,13,11,12,12,10,6,D C,1,1,1,1,1,1,20,1,1,1,1,1,1,1,1
19152847,Marquinhos,1651,08/03/1992,24,0,0,0,0,169,60,2,3,2,2,1,3,1,3,3,2,2,8,8,7,9,12,6,8,12,2,11,10,6,12,11,11,12,11,10,9,11,11,9,9,12,9,12,9,13,12,11,11,4,8,5,12,20,11,6,9,9,8,8,9,16,12,13,10,11,7,15,4,DM C,1,1,1,1,1,1,1,1,1,20,15,1,1,1,1
19152850,Ilídio,1651,26/01/1992,24,0,0,0,0,173,72,2,2,3,3,1,1,3,1,4,1,2,6,8,12,5,11,6,4,6,3,2,7,4,3,12,5,6,6,3,4,5,5,13,10,5,8,5,8,9,14,15,7,6,13,12,14,20,11,5,11,10,10,7,9,14,10,10,14,11,15,15,5,M/AM/S RL,1,1,17,1,17,20,1,1,1,1,1,17,18,1,1
19152851,Luciano,1651,11/02/1992,24,0,0,0,0,190,72,13,9,10,1,13,9,7,9,6,9,13,4,3,2,2,1,7,1,3,2,2,1,3,3,5,8,7,15,5,13,6,13,9,1,13,3,12,7,6,12,13,6,14,10,11,13,20,4,9,9,5,9,9,9,18,10,9,10,9,8,10,6,GK ,20,1,1,1,1,1,1,1,1,1,1,1,1,1,1
19152853,Lucas Patinho,1651,06/03/1992,24,0,0,0,0,184,75,1,4,2,3,1,1,4,3,3,3,1,9,10,11,11,10,13,11,9,2,7,10,6,8,11,10,11,11,9,11,9,10,5,12,11,12,10,10,7,11,10,11,10,14,11,10,20,10,10,12,10,10,9,10,14,6,13,11,5,6,12,7,AM LC,1,1,14,20,15,14,1,1,1,1,15,12,12,1,1
19152856,Marcos Júnior,1651,19/01/1993,23,0,0,0,0,167,64,1,1,3,1,1,3,1,3,1,1,1,10,11,13,11,12,9,7,8,7,9,12,12,8,12,17,12,16,10,10,12,10,7,14,5,16,9,12,11,16,14,10,16,5,15,16,20,14,12,10,7,12,12,12,20,7,10,12,13,5,6,11,AM/S RL,1,1,20,13,17,19,1,1,1,1,1,1,1,1,1
19152858,André Bahia,1651,26/05/1986,30,0,0,0,0,188,0,2,1,1,2,2,2,2,2,3,1,2,5,4,2,1,7,1,13,1,2,13,4,1,13,6,9,10,9,7,10,3,13,7,7,13,6,12,6,7,9,9,7,12,8,14,10,20,7,12,9,9,9,9,9,17,12,11,9,12,8,5,6,D C,1,1,1,1,1,1,20,1,1,10,1,1,1,1,1
19152892,Bryan,1651,04/07/1989,26,0,0,0,0,175,66,1,4,2,1,1,2,3,2,4,1,2,5,8,7,2,14,5,8,7,4,9,7,1,9,9,9,10,9,5,9,6,7,3,7,6,6,10,8,9,14,14,8,8,20,9,12,9,13,8,8,8,9,9,9,9,8,11,11,12,9,4,7,D/WB L,1,1,1,1,1,1,1,20,1,1,1,1,1,18,1
19152893,Billy,1651,04/07/1989,26,0,0,0,0,173,68,2,1,1,2,3,3,3,2,3,2,2,5,7,3,7,13,7,6,8,3,10,13,5,13,10,10,12,9,9,9,8,10,5,9,7,7,10,8,11,13,13,8,7,17,16,13,20,13,6,10,5,9,10,10,7,11,11,11,11,10,11,7,DM/M C,1,1,1,1,1,1,1,1,1,20,18,1,1,1,1
19152912,Mayke,1651,10/11/1992,23,0,0,0,0,178,68,2,1,1,3,3,1,1,1,2,1,2,12,14,14,12,13,10,9,12,9,10,14,10,11,15,11,14,12,13,11,13,12,13,13,11,15,10,14,15,15,14,10,9,7,14,14,20,13,10,10,6,13,13,15,17,13,12,12,12,11,10,7,D/WB R,1,1,1,11,1,13,1,1,20,1,13,1,15,1,19
19152913,Ruan Gusmão,1651,15/01/1992,24,0,0,0,0,194,82,10,10,10,5,11,11,10,12,10,13,12,2,3,1,2,9,7,9,3,2,3,8,3,3,8,6,9,12,9,7,8,9,4,3,8,3,11,13,11,9,12,13,16,8,12,11,20,13,13,9,9,1,3,9,10,9,12,10,11,11,14,2,GK ,20,1,1,1,1,1,1,1,1,1,1,1,1,1,1
19152914,Murilo,1651,19/03/1993,23,0,0,0,0,191,85,1,1,4,2,3,1,1,2,1,2,2,1,6,5,6,5,4,11,6,4,12,8,8,12,7,12,10,12,8,9,5,9,12,5,11,4,10,12,11,11,10,11,15,8,11,10,20,10,12,9,10,8,2,4,15,9,10,9,11,11,10,4,D C,1,1,1,1,1,1,20,1,1,1,1,1,1,1,1
19152915,Franco,1651,27/01/1993,23,0,0,0,0,174,67,3,3,3,1,1,3,3,2,3,2,3,9,9,11,6,15,9,9,12,2,11,12,8,10,12,10,14,10,8,10,11,15,11,11,10,11,14,10,14,13,15,10,8,5,5,15,20,9,9,10,6,10,2,10,10,12,11,10,10,1,5,4,M C,1,1,1,14,1,1,1,1,1,15,20,1,1,1,1
19152916,Gabriel Araújo,1651,29/01/1992,24,0,0,0,0,179,74,3,2,2,2,2,3,3,2,2,2,1,12,12,11,10,10,11,6,10,12,10,12,12,11,11,11,13,13,12,12,10,12,12,11,9,12,10,12,12,13,13,8,9,20,12,14,8,13,7,11,6,10,3,12,12,12,11,12,11,7,10,11,D/WB L,1,1,1,1,1,1,1,20,1,1,1,1,1,19,1
19152917,Lucas Silva,1651,16/02/1993,23,0,0,4,1,182,80,1,2,1,1,1,3,1,2,3,2,2,12,11,12,9,14,12,10,16,8,13,15,13,14,13,12,15,13,14,14,13,13,13,11,13,12,13,15,15,11,12,11,11,10,13,12,20,15,12,12,9,12,5,15,5,11,12,12,13,12,11,4,DM/M C,1,1,1,1,1,1,11,1,9,20,19,1,1,1,10
19152918,Cristian Santos,1651,01/12/1993,22,0,0,0,0,187,80,2,3,3,1,3,1,2,2,3,1,2,9,10,12,10,12,10,7,7,4,4,11,10,5,11,10,10,8,10,8,12,10,9,12,6,12,5,10,11,13,12,10,14,20,13,12,8,11,11,9,2,7,5,10,10,10,13,9,8,6,10,6,AM/S RLC,1,1,18,20,17,19,1,1,1,1,15,13,13,1,1
19153002,Jean Deretti,1651,01/05/1993,23,0,0,0,0,174,65,4,3,2,3,4,1,3,3,3,4,3,10,8,11,11,12,10,7,15,6,4,12,8,4,13,6,10,5,10,11,12,14,8,13,1,11,5,11,15,15,12,4,7,20,11,14,11,12,5,10,5,10,10,10,11,10,13,15,9,5,1,3,AM C,1,1,1,20,1,10,1,1,1,1,15,1,7,1,1
19153003,Ryan Ramos,1651,01/04/1992,24,0,0,0,0,180,70,3,1,1,1,1,3,3,1,1,2,1,6,6,7,7,10,7,8,7,8,15,10,12,12,11,15,12,15,12,12,7,11,10,7,8,11,12,12,12,10,10,9,10,10,13,14,20,13,12,11,13,10,5,10,16,10,11,11,10,6,1,6,DM/M C,1,1,1,1,1,1,1,1,1,20,18,1,1,1,1
19153004,Guilherme Lazaroni,1651,18/11/1992,23,0,0,0,0,179,72,4,1,3,4,2,4,3,2,1,2,2,7,9,13,9,11,7,5,8,7,10,12,7,8,13,7,8,11,7,9,10,11,7,11,7,11,9,13,10,13,12,11,8,20,10,11,10,13,13,9,5,8,7,14,10,12,11,10,10,8,11,2,D/WB/M/AM LC,1,1,10,20,18,1,1,16,1,1,16,15,1,17,1
19153005,Diogo Dolem,1651,14/03/1992,24,0,0,0,0,173,64,3,3,2,1,2,3,3,3,2,4,3,10,13,12,6,9,6,6,7,4,6,10,1,8,13,7,8,8,6,7,10,9,3,13,12,8,6,7,10,13,13,14,5,10,13,13,20,11,5,9,7,9,5,9,16,9,12,12,12,8,6,6,M/AM RC,1,1,1,18,1,20,1,1,1,1,16,1,15,1,1
19153007,Jackson,1651,18/08/1990,25,0,0,0,0,176,71,3,1,1,3,1,1,2,4,3,3,2,4,6,9,8,11,7,7,9,9,14,11,9,14,10,12,10,11,12,10,7,10,17,7,7,8,11,14,13,14,12,10,8,11,11,15,20,15,11,12,11,12,12,9,20,12,11,9,12,11,14,3,DM/M C,1,1,1,1,1,1,1,1,9,20,18,1,1,1,6
19153008,Léo Rodrigues,1651,06/04/1991,25,0,0,0,0,177,66,2,2,2,2,1,1,3,3,2,2,3,11,13,13,9,7,11,6,10,10,10,12,8,11,13,11,8,9,9,9,9,9,10,11,4,12,8,8,10,14,14,8,9,5,13,15,20,14,9,8,10,6,10,13,8,9,10,11,10,9,12,8,D/WB/M/AM RC,1,1,1,18,1,18,1,1,19,1,1,1,18,1,20
19153070,Rafhael Lucas,1651,30/11/1992,23,0,0,0,0,175,68,3,2,4,2,1,1,1,1,2,2,3,8,10,12,14,12,10,13,12,8,8,11,10,8,12,8,13,13,13,12,11,12,11,12,5,13,13,12,12,12,12,13,11,8,12,13,20,13,11,12,9,11,6,10,9,9,10,11,12,1,17,2,S ,1,1,20,1,1,1,1,1,1,1,1,1,1,1,1
19153071,Rafa,1651,21/03/1992,24,0,0,0,0,175,65,1,1,4,4,2,1,1,3,2,2,1,10,11,13,6,3,9,5,5,4,5,10,8,7,17,7,10,8,7,8,9,7,4,17,8,12,9,6,10,12,14,10,5,20,11,10,5,12,4,9,7,11,4,10,17,10,9,13,11,1,14,1,AM RL,1,1,1,1,17,20,1,1,1,1,1,15,15,1,1
19153073,Andrew,1651,09/01/1992,24,0,0,0,0,184,76,2,3,2,1,3,1,3,2,1,4,2,6,5,13,13,11,6,10,6,1,6,5,5,2,12,9,13,5,7,7,5,11,12,12,13,12,6,6,7,13,13,8,11,6,11,13,20,7,10,9,9,8,9,8,11,14,9,11,9,1,8,2,S ,1,1,20,9,10,7,1,1,1,1,1,1,1,1,1
19153074,Alan Junior,1651,10/04/1993,23,0,0,0,0,183,70,3,1,1,2,1,1,3,2,3,3,2,4,9,12,15,12,6,13,12,8,4,12,18,9,12,11,12,11,12,14,10,12,12,11,6,12,11,7,11,12,9,12,12,8,12,12,20,14,14,12,6,12,3,11,15,12,12,11,15,1,12,1,S ,1,1,20,7,10,10,1,1,1,1,1,1,1,1,1
19153075,Luizinho,1651,04/05/1992,24,0,0,0,0,166,62,4,2,2,3,1,3,2,2,3,3,1,13,12,9,5,14,12,1,4,4,8,6,4,9,11,9,11,8,9,8,6,8,1,6,9,8,9,4,8,14,14,8,4,4,15,14,20,11,6,9,7,9,9,9,20,7,11,10,13,6,7,6,WB/M R,1,1,1,1,1,14,1,1,15,1,1,1,18,1,20
19153076,Thiago Primão,1651,11/02/1993,23,0,0,0,0,163,64,1,1,1,2,3,2,4,2,1,2,3,10,6,11,12,11,10,10,12,9,11,12,7,9,16,4,12,9,8,12,12,16,10,13,3,5,12,12,11,13,12,5,2,11,16,13,20,12,5,10,7,8,6,10,13,12,10,13,12,1,9,6,M/AM C,1,1,1,20,1,1,1,1,1,1,17,1,1,1,1
19153078,Ícaro,1651,05/08/1993,22,0,0,0,0,183,68,2,3,3,1,1,2,1,2,2,1,4,3,7,4,8,14,7,8,12,3,9,14,7,14,10,4,6,6,10,10,10,14,9,2,9,9,8,9,12,14,12,5,8,20,9,12,5,7,8,10,6,2,10,10,20,10,12,11,12,3,15,5,DM/M C,1,1,1,1,1,1,1,1,1,20,16,1,1,1,1
19153083,Tadeu,1651,04/02/1992,24,0,0,0,0,183,75,14,11,11,1,14,14,11,14,10,10,11,5,2,3,2,2,8,1,1,3,1,3,3,1,3,10,7,14,5,10,8,12,6,3,3,2,11,7,8,10,9,9,8,5,15,11,20,3,8,5,6,6,4,10,8,10,11,10,8,5,7,3,GK ,20,1,1,1,1,1,1,1,1,1,1,1,1,1,1
19153354,Thiago Martins,1651,17/03/1995,21,0,0,0,0,185,78,3,3,2,1,3,2,3,2,2,2,2,7,8,9,8,11,8,12,8,9,13,11,9,12,11,12,12,13,12,11,9,12,14,11,9,10,12,14,13,13,13,9,13,9,14,13,20,14,12,10,14,9,7,6,10,9,9,13,10,5,3,1,D C,1,1,1,1,1,1,20,1,1,1,1,1,1,1,1
19153361,Jonh Lennon,1651,29/12/1991,24,0,0,0,0,178,71,4,1,1,1,1,3,1,3,4,2,3,1,9,11,7,12,4,9,3,9,11,13,3,11,11,5,12,6,11,11,9,9,5,12,5,11,9,11,4,12,12,5,9,12,13,12,20,12,10,11,12,11,5,10,19,10,11,12,14,6,12,4,D/WB RL,1,1,1,1,1,1,1,17,20,1,1,1,1,1,19
19153380,Caleb,1651,09/11/1992,23,0,0,0,0,172,63,3,1,1,2,2,3,1,1,2,3,3,8,12,13,9,13,7,8,6,7,7,6,6,5,12,10,8,9,9,6,8,8,2,12,9,9,7,8,8,13,13,8,3,10,12,13,20,9,5,10,10,3,7,10,20,13,12,10,9,6,4,4,AM RL,1,1,13,13,17,20,1,1,1,1,1,10,13,1,1
19153474,Mateus Caitano,1651,04/01/1993,23,0,0,0,0,170,0,2,1,2,2,1,2,2,3,1,1,3,6,7,4,4,14,8,7,11,5,12,11,4,14,14,10,13,9,9,9,9,14,12,1,12,8,14,9,10,13,14,9,2,9,16,14,20,7,8,10,6,6,8,10,16,10,11,11,12,1,15,8,DM ,1,1,1,1,1,1,1,1,1,20,10,1,1,1,1
19153477,Gabriel,1651,18/09/1993,22,0,0,0,0,186,80,2,1,1,1,1,1,1,1,2,3,2,10,10,11,9,13,10,9,13,9,13,15,11,12,15,9,13,12,15,13,14,14,12,14,11,13,13,12,12,11,13,13,9,20,10,12,12,13,12,12,11,12,14,8,12,8,11,16,14,6,19,1,DM/M C,1,1,1,1,1,1,1,1,1,18,20,1,1,1,1
19153535,Caique Valdivia,1651,23/10/1992,23,0,0,0,0,178,70,1,3,1,2,1,3,3,3,1,3,1,12,12,12,10,12,11,6,10,6,5,13,12,5,13,6,11,9,11,11,12,10,13,13,8,12,10,11,11,13,14,12,9,9,13,12,20,14,8,11,8,11,10,12,11,12,12,12,12,5,10,11,M/AM C,1,1,1,20,7,7,1,1,1,1,19,1,1,1,1
19153561,Neverton,1651,07/06/1992,24,0,0,0,0,170,65,2,3,3,3,3,4,3,4,1,2,2,7,6,14,11,11,3,14,7,1,7,8,4,4,14,5,12,3,14,8,8,14,6,14,9,14,5,3,8,15,15,5,5,4,10,13,20,12,7,4,9,4,9,9,4,10,13,12,8,5,14,7,S ,1,1,20,1,1,1,1,1,1,1,1,1,1,1,1
19153563,Tito,1651,04/03/1989,27,0,0,0,0,179,78,1,1,3,1,2,1,3,1,3,1,2,6,4,13,13,13,6,13,7,4,4,7,7,2,13,4,12,7,9,7,5,11,5,13,10,11,6,6,8,13,13,7,8,9,15,13,20,12,6,9,9,6,9,9,10,10,12,12,12,3,18,2,S ,1,1,20,1,1,1,1,1,1,1,1,1,1,1,1
19153567,Davis,1651,14/01/1991,25,0,0,0,0,180,78,3,3,1,3,2,1,2,1,1,2,1,4,5,14,14,12,7,14,8,4,4,7,9,5,8,9,13,5,13,8,8,10,6,9,11,8,8,7,8,14,14,11,9,1,7,14,20,10,11,9,9,4,8,9,15,11,10,11,12,4,15,1,S ,1,1,20,1,1,1,1,1,1,1,1,1,1,1,1
19153570,Dellatorre,1651,01/05/1992,24,0,0,0,0,181,76,3,2,1,1,1,1,4,4,1,2,1,6,8,13,13,11,9,12,10,6,8,11,13,8,11,7,13,11,12,13,13,12,11,12,9,13,8,13,13,15,14,13,9,9,13,14,20,14,11,10,9,10,8,8,20,12,7,12,12,7,11,7,S ,1,1,20,1,11,13,1,1,1,1,1,1,1,1,1
19153572,Auremir,1651,10/09/1991,24,0,0,0,0,174,64,4,2,1,1,3,1,3,2,1,3,1,6,10,11,9,12,7,10,10,11,13,11,8,13,11,13,11,13,10,11,11,11,14,12,9,9,12,13,13,13,11,11,10,12,12,13,20,13,12,12,10,11,7,18,10,10,14,9,13,11,9,1,D/DM/M RC,1,1,1,1,1,1,1,1,18,20,16,1,1,1,1
19153579,Roberto Dias,1651,08/08/1988,27,0,0,0,0,188,86,4,2,1,1,2,2,3,1,2,2,3,7,4,8,2,8,5,14,3,5,9,8,6,12,8,8,14,10,9,12,3,12,10,2,12,8,14,8,9,14,14,9,10,14,12,14,20,12,8,10,6,10,8,10,11,12,10,8,12,4,11,2,D C,1,1,1,1,1,1,20,1,1,1,1,1,1,1,1
19153584,Neílson,1651,28/02/1988,28,0,0,0,0,170,0,4,3,2,2,3,2,3,1,2,2,2,7,6,6,8,13,3,7,6,2,8,13,6,7,13,10,7,3,8,7,13,9,6,13,8,9,7,8,12,13,13,8,2,16,14,13,20,8,5,10,5,10,10,10,19,11,12,13,11,6,10,3,AM C,1,1,1,20,1,1,1,1,1,1,15,1,1,1,1
19153591,Cristian,1651,06/07/1993,22,0,0,0,0,175,0,1,2,3,4,1,3,1,1,2,1,3,8,11,8,8,13,7,7,4,4,8,9,4,9,13,6,9,9,9,8,6,13,10,13,3,8,8,8,9,13,13,8,5,20,11,13,10,12,6,9,9,4,8,10,20,10,12,11,13,1,4,1,M/AM LC,1,1,1,18,20,1,1,13,1,1,15,17,1,15,1
19153683,Thiago Cristian,1651,09/08/1987,28,0,0,0,0,176,0,3,3,1,1,3,2,1,3,1,1,3,6,8,3,5,10,4,8,2,2,10,8,5,12,7,9,10,7,9,8,6,9,6,10,11,9,11,9,9,14,14,9,8,20,9,14,9,14,7,10,6,10,6,10,18,11,9,13,11,9,15,6,D/WB L,1,1,1,1,1,1,1,18,1,1,1,1,1,20,1
19153739,Waldir,1651,18/08/1990,25,0,0,0,0,178,70,1,3,3,3,1,1,2,3,3,1,3,7,4,8,14,14,8,13,7,1,7,9,7,1,10,5,10,7,10,9,6,14,13,10,8,14,9,8,9,14,13,9,9,10,12,15,20,12,7,10,6,10,10,10,8,9,11,10,9,6,9,7,S ,1,1,20,1,1,1,1,1,1,1,1,1,1,1,1
19153741,Victor Bolt,1651,14/04/1987,29,0,0,0,0,178,77,3,2,3,1,2,2,3,4,1,3,2,10,11,11,12,12,9,10,11,11,8,10,11,8,10,12,11,13,11,10,11,12,13,12,5,11,8,13,12,16,12,13,10,20,13,15,10,13,14,11,12,10,5,13,17,10,11,11,13,7,12,8,M C,1,1,1,12,8,1,1,1,1,15,20,12,1,1,1
19153795,William Barbio,1651,22/10/1992,23,0,0,0,0,175,71,2,2,1,1,2,2,3,1,3,4,1,5,8,12,11,12,8,8,8,4,8,12,8,8,12,12,12,11,9,10,9,10,5,15,8,13,11,12,14,15,15,13,7,7,14,15,20,14,7,12,10,12,6,12,11,13,9,10,12,6,13,8,AM RL,1,1,15,1,18,20,1,1,1,1,1,8,10,1,1
19153797,Naylhor,1651,24/06/1987,29,0,0,0,0,189,76,1,2,3,2,1,2,3,1,2,2,3,8,5,3,1,8,5,14,4,5,14,8,8,14,3,6,11,10,9,11,4,11,7,4,9,8,14,8,9,14,14,9,14,1,15,13,20,6,12,10,5,7,10,10,10,12,12,9,11,7,15,6,D C,1,1,1,1,1,1,20,1,1,1,1,1,1,1,1
19153798,Maycon Aperibé,1651,21/07/1986,29,0,0,0,0,182,78,1,1,1,1,1,1,1,1,1,1,1,4,6,11,10,9,7,12,13,6,6,9,5,8,10,5,10,7,9,12,9,10,9,16,5,10,6,9,10,13,13,9,12,3,11,13,20,9,12,10,3,8,5,5,17,11,12,11,12,7,6,3,S ,1,1,20,1,10,1,1,1,1,1,1,1,1,1,1
19153808,Pablo,1651,07/10/1987,28,0,0,0,0,182,83,1,1,2,2,1,3,2,2,1,3,2,6,10,10,10,11,7,13,12,9,14,12,8,13,11,13,13,13,12,12,11,12,13,10,11,10,13,14,13,13,11,14,12,1,12,12,20,14,15,10,10,4,5,10,18,13,11,14,9,8,1,4,DM/M C,1,1,1,1,1,1,1,1,1,20,17,1,1,1,1
19153809,Maranhão,1651,03/05/1990,26,0,0,0,0,168,63,3,1,3,1,3,1,4,3,4,2,1,13,10,16,10,13,13,9,11,6,7,12,13,7,14,8,12,10,11,11,12,11,12,14,6,13,7,10,12,15,15,10,4,12,12,15,20,11,7,11,7,8,7,13,20,11,12,11,7,6,7,8,AM RC,1,1,8,19,13,20,1,1,1,1,10,10,13,1,1
19153810,Gabriel,1651,06/01/1990,26,0,0,0,0,178,64,1,3,1,2,4,1,2,3,1,3,2,14,12,14,11,14,12,9,11,12,6,12,15,6,13,11,11,12,11,9,12,11,13,14,10,13,9,10,11,14,16,6,8,8,13,14,20,13,7,9,8,12,6,15,12,6,14,9,14,13,12,10,M/AM/S R,1,1,18,12,14,20,1,1,12,11,14,13,16,1,14
19153818,Amaral,1651,01/05/1988,28,0,0,0,0,174,80,2,2,1,1,3,3,2,1,1,2,2,3,8,7,8,10,7,12,11,7,15,10,8,15,9,16,12,16,13,10,9,11,15,6,13,11,15,15,16,12,11,9,8,8,16,13,20,15,16,14,12,14,7,6,12,11,12,13,11,5,12,6,DM/M C,1,1,1,1,1,1,1,1,1,20,18,1,1,1,1
19153823,Ronaldo,1651,15/05/1989,27,0,0,0,0,175,68,1,2,2,2,2,2,1,1,3,1,3,3,8,8,8,10,2,9,6,8,10,9,1,13,10,5,10,10,8,11,8,14,10,1,8,6,9,9,8,13,14,9,6,10,17,14,20,12,10,10,10,10,10,10,14,12,11,12,10,6,15,7,D/WB R,1,1,1,1,1,1,1,1,20,1,1,1,1,1,18
19153939,Denner,1651,21/11/1993,22,0,0,0,0,181,70,2,2,2,2,3,3,2,4,4,2,1,5,10,12,7,11,12,10,11,6,10,10,10,9,11,6,11,9,11,11,11,11,12,13,9,10,7,12,11,13,12,12,11,20,12,13,8,13,10,12,5,11,16,6,14,13,12,12,12,5,10,9,D/WB L,1,1,1,1,1,1,1,20,1,1,1,1,1,19,1
19153941,Weslley,1651,21/04/1992,24,0,0,0,0,180,72,3,2,3,3,2,1,3,1,1,1,2,9,10,11,11,11,9,9,9,9,7,10,8,9,11,12,10,10,10,9,13,11,13,12,9,11,8,11,10,11,11,11,12,11,11,11,20,9,10,11,8,10,8,12,11,15,11,11,11,10,5,3,AM/S RLC,1,1,20,18,18,18,1,1,1,1,1,1,1,1,1
19153943,Jô,1651,16/01/1992,24,0,0,0,0,190,88,1,3,2,3,3,2,1,2,1,1,3,8,6,14,11,14,8,11,9,4,8,9,4,5,14,8,14,11,11,9,4,12,6,10,8,14,9,8,9,8,10,14,16,18,12,8,20,13,14,10,10,10,10,10,4,6,6,7,5,10,8,15,S ,1,1,20,1,1,1,1,1,1,1,1,1,1,1,1
19153949,Rodolfo Potiguar,1651,24/01/1988,28,0,0,0,0,187,82,2,2,3,3,3,2,3,1,3,3,2,8,6,7,7,14,8,5,14,1,13,14,5,14,13,8,14,9,9,8,9,13,5,10,9,8,14,9,12,14,14,9,8,9,10,14,20,13,11,10,4,2,6,10,8,11,9,10,10,1,12,8,DM ,1,1,1,1,1,1,1,1,1,20,10,1,1,1,1
19154015,Renan Winck,1651,08/08/1994,21,0,0,0,0,187,0,1,3,2,1,2,3,4,1,3,3,2,1,1,11,11,10,1,11,2,1,1,1,6,1,5,6,3,2,5,2,1,5,1,7,10,11,2,1,2,11,6,2,7,1,8,10,20,4,6,6,6,4,6,6,10,12,9,9,9,11,6,8,S ,1,1,20,1,1,1,1,1,1,1,1,1,1,1,1
19154072,Rilla,1651,01/09/1982,33,0,0,0,0,191,84,3,1,2,2,3,2,2,2,3,2,1,5,1,1,3,7,3,13,5,1,13,4,1,11,6,9,10,9,7,10,1,10,3,7,4,6,12,6,7,10,13,7,14,9,14,11,20,11,11,9,9,3,6,9,16,10,12,9,11,4,15,8,D C,1,1,1,1,1,1,20,1,1,1,1,1,1,1,1
19154094,Daniel Recife,1651,23/10/1990,25,0,0,0,0,177,0,1,2,3,3,1,3,3,1,3,3,1,6,6,10,7,9,6,6,13,4,9,9,5,13,10,7,10,12,9,8,11,13,2,14,3,8,10,10,9,10,11,11,9,10,12,10,20,11,8,9,5,8,8,9,16,11,13,11,12,3,12,1,DM/M C,1,1,1,1,1,1,1,1,1,17,20,1,1,1,1
19154105,Maneco,1651,10/06/1989,27,0,0,0,0,173,71,3,2,2,1,2,2,3,3,2,4,3,6,5,8,6,13,3,7,4,8,10,10,6,14,10,9,11,10,10,10,9,14,10,10,4,8,11,10,10,14,14,10,4,10,12,14,20,10,10,10,9,3,7,10,13,12,13,8,13,4,11,5,D/WB R,1,1,1,1,1,1,1,1,20,1,1,1,1,1,19
19154402,Walisson,1651,30/01/1992,24,0,0,0,0,178,72,2,3,2,3,1,3,1,3,3,3,1,7,6,13,12,11,4,13,8,1,7,8,5,2,11,10,8,7,9,8,7,13,10,11,4,13,7,7,8,13,13,8,7,9,12,13,20,10,13,10,9,3,8,10,18,10,12,8,12,2,19,7,S ,1,1,20,1,1,1,1,1,1,1,1,1,1,1,1
19154441,Gabriel,1651,10/07/1992,23,0,0,0,0,172,69,2,3,2,1,1,1,2,2,1,3,2,9,12,10,10,13,9,8,10,10,14,12,8,14,11,13,14,15,13,14,8,13,14,13,12,13,13,15,14,15,14,14,6,9,14,13,20,16,11,14,13,14,13,8,13,8,18,10,13,11,10,5,DM ,1,1,1,1,1,1,1,1,1,20,10,1,1,1,1
19154582,Leandro,1651,12/05/1993,23,1,1,0,0,176,72,1,1,2,2,2,1,1,2,3,1,1,8,11,14,13,11,8,10,10,5,7,13,13,7,13,14,12,12,12,12,12,12,10,13,9,13,7,11,10,15,14,8,7,10,12,15,20,12,9,12,15,10,10,11,19,12,12,8,8,5,7,13,AM/S RLC,1,1,20,18,15,15,1,1,1,1,1,1,1,1,1
19154715,Léo Kanú,1651,14/01/1988,28,0,0,0,0,196,88,3,1,3,1,3,3,2,2,1,2,3,5,5,8,6,8,5,12,9,4,9,10,5,10,9,11,9,9,8,10,8,15,11,4,12,11,9,8,10,9,6,12,16,9,9,9,20,11,12,9,8,9,9,9,16,13,13,13,11,14,14,4,D/DM C,1,1,10,1,1,1,20,1,1,17,1,1,1,1,1
19155081,Lukian,1651,21/09/1991,24,0,0,0,0,182,80,1,3,3,1,2,3,2,3,3,4,2,8,5,14,14,10,8,14,9,6,6,9,7,5,11,6,10,8,10,9,7,13,10,10,6,14,7,8,9,14,12,9,10,9,15,14,20,9,8,10,5,2,8,10,9,11,10,12,12,4,4,3,S ,1,1,20,1,1,1,1,1,1,1,1,1,1,1,1
19156224,Dhiego Martins,1651,27/08/1988,27,0,0,0,0,180,80,3,3,1,1,2,2,1,2,2,3,1,6,9,13,12,12,7,8,11,5,4,12,14,4,12,13,12,14,12,11,8,11,15,13,9,13,5,6,13,12,13,12,7,12,10,12,20,12,7,13,9,14,14,10,11,13,5,12,11,7,6,10,S R,1,1,20,14,1,15,1,1,1,1,10,1,1,1,1
19156536,Rodrigo Caio,1651,17/08/1993,22,1,0,0,0,182,76,2,1,2,1,2,4,3,3,1,1,1,8,9,11,9,13,8,16,8,8,15,13,9,14,13,12,14,14,13,14,12,14,11,11,13,12,14,13,14,14,14,13,14,10,12,14,20,14,11,14,12,13,16,15,7,13,13,12,12,7,10,7,D C,1,16,1,1,1,1,20,1,11,15,12,1,1,1,1
19156939,Casagrande,1651,28/07/1986,29,0,0,0,0,190,80,2,2,2,2,1,2,1,3,3,4,2,6,7,8,8,13,6,11,7,5,6,7,2,3,13,11,10,5,6,7,4,12,2,13,10,13,12,6,7,13,10,7,14,20,12,11,9,12,11,9,3,7,9,9,13,11,13,11,10,9,8,2,S ,1,1,20,1,1,1,1,1,1,1,1,1,1,1,1
19157007,Dinho,1651,13/02/1990,26,0,0,0,0,172,64,1,1,3,3,2,2,3,3,3,1,2,6,6,12,8,11,6,3,5,1,6,13,5,7,13,7,5,8,7,7,6,13,6,13,11,11,4,7,12,13,13,6,6,9,10,13,20,13,6,9,5,2,9,9,17,13,13,12,10,10,6,7,AM C,1,1,1,20,1,1,1,1,1,1,1,1,1,1,1
19157026,Bruno Bacabal,1651,17/06/1991,25,0,0,0,0,177,0,2,1,4,3,2,3,2,3,2,3,4,4,6,2,1,7,1,7,3,5,11,7,2,14,7,8,9,8,6,7,2,9,1,8,10,5,10,6,7,13,13,6,5,9,11,13,20,11,7,8,8,1,8,8,8,12,8,15,10,10,11,3,D RL,1,1,1,1,1,1,1,15,20,1,1,1,1,1,1
19157059,Rafamar,1651,07/08/1988,27,0,0,0,0,180,0,1,3,1,3,2,1,3,3,3,1,2,5,4,10,8,9,6,10,6,1,5,8,7,4,6,4,11,7,13,6,6,10,9,9,10,13,11,6,7,13,13,7,6,9,12,13,20,8,10,9,9,2,7,9,17,13,11,8,10,10,2,3,S ,1,1,20,1,1,1,1,1,1,1,1,1,1,1,1
19157324,Felipe Brisola,1651,06/06/1990,26,0,0,0,0,170,66,1,3,2,1,2,2,2,2,1,3,2,10,11,12,10,12,11,8,11,7,8,13,10,9,13,9,11,10,10,11,12,11,9,13,9,13,11,12,13,13,11,5,8,12,10,13,20,10,6,11,10,10,10,10,18,12,11,11,9,5,9,6,AM RC,1,1,1,20,1,16,1,1,1,1,15,1,1,1,1
19157360,Rafael Silva,1651,23/03/1991,25,0,0,0,0,176,68,2,1,2,2,4,3,1,3,2,2,2,8,10,12,11,11,9,10,11,5,4,11,12,6,11,11,12,13,12,10,12,11,11,12,10,13,9,9,13,15,14,15,7,13,13,14,20,12,6,10,14,12,10,11,16,12,10,12,11,5,8,5,AM RL,1,1,13,13,20,15,1,1,1,1,8,1,1,1,1
19157361,Yago,1651,29/08/1992,23,0,0,0,0,185,80,1,1,2,1,2,3,4,4,2,3,1,7,8,7,5,12,12,14,10,9,14,8,9,13,13,12,13,12,12,12,12,10,13,3,8,11,13,14,14,14,13,14,15,12,14,15,20,13,13,12,11,10,9,11,11,11,11,12,12,4,11,8,D/DM C,1,1,1,1,1,1,20,9,11,17,1,1,1,1,1
19157362,Ivan,1651,25/08/1992,23,0,0,0,0,170,68,2,1,3,1,1,3,2,1,2,1,1,10,11,12,10,11,13,8,8,5,10,11,6,10,11,10,12,11,11,11,10,13,12,14,3,14,10,10,11,15,14,7,7,8,10,14,20,8,7,10,11,10,10,10,9,11,9,10,10,9,2,6,D/WB R,1,1,1,1,1,1,1,13,20,1,1,1,1,1,17
19157363,Diego Augusto,1651,17/05/1991,25,0,0,0,0,186,79,3,1,3,2,3,2,4,1,3,2,1,5,1,4,5,7,2,13,2,6,13,8,3,13,3,9,9,10,8,9,2,13,7,4,12,6,13,7,8,13,12,12,13,16,5,13,20,11,10,10,5,10,10,10,7,9,9,10,13,8,15,8,D C,1,1,1,1,1,1,20,1,1,1,1,1,1,1,1
19157376,Aírton,1651,03/12/1990,25,0,0,0,0,188,77,1,2,2,1,3,3,3,2,2,1,3,3,8,8,7,8,4,13,9,9,12,9,4,12,8,6,12,11,7,10,8,11,10,6,11,9,12,13,10,11,10,13,14,7,13,11,20,14,12,11,11,10,10,10,7,11,9,10,9,5,8,5,D C,1,1,1,1,1,1,20,1,1,1,1,1,1,1,1
19157442,Bebeto,1651,20/03/1993,23,0,0,0,0,173,59,2,2,1,3,3,2,2,2,1,4,2,8,10,12,10,11,8,4,7,6,8,11,8,6,13,9,9,9,11,11,12,11,9,13,4,12,10,11,14,11,13,3,5,12,13,11,20,12,3,13,8,12,12,9,9,13,12,10,8,6,15,2,M/AM C,1,1,1,20,1,1,1,1,1,1,17,1,1,1,1
19157459,Fernando Russi,1651,21/04/1989,27,0,0,0,0,184,78,3,1,4,2,1,2,1,2,1,1,1,6,7,13,13,12,6,13,8,1,6,7,6,2,13,9,10,4,11,7,3,12,1,13,13,13,7,6,8,13,13,7,7,9,12,13,20,11,10,9,9,9,6,9,16,8,11,11,8,7,8,8,S ,1,1,20,13,1,1,1,1,1,1,1,1,1,1,1
19157461,Leandro Oliveira,1651,02/01/1988,28,0,0,0,0,172,67,3,3,1,3,3,2,3,1,3,1,3,10,10,11,11,11,11,6,11,10,8,10,12,6,12,9,10,9,9,8,9,9,10,11,7,11,10,9,14,13,13,8,6,12,12,12,20,9,6,10,8,10,4,10,19,9,12,12,12,9,11,6,AM C,1,1,1,20,1,1,1,1,1,1,13,1,1,1,1
19157462,Alemão,1651,11/03/1988,28,0,0,0,0,176,0,1,2,1,3,1,3,3,3,1,1,3,6,9,8,9,8,7,7,10,8,10,9,6,11,9,14,9,11,8,9,9,14,11,8,9,10,9,12,11,10,11,8,6,7,11,10,20,10,10,11,13,9,7,9,9,11,11,11,12,9,13,13,DM/M C,1,1,1,1,1,1,1,1,1,20,17,1,1,1,1
19157509,Tutinha,1651,20/05/1992,24,0,0,0,0,170,65,1,3,1,4,4,3,2,4,2,2,3,11,9,12,9,10,9,6,8,8,6,9,4,4,10,7,12,14,10,11,10,11,9,11,3,13,9,10,13,14,13,3,5,10,13,14,20,12,4,11,9,3,9,9,8,9,13,10,10,10,5,3,S ,1,1,20,1,10,10,1,1,1,1,1,1,1,1,1
19157510,Everton,1651,08/07/1994,21,0,0,0,0,173,65,1,1,2,3,3,3,2,1,2,2,2,6,5,10,13,10,6,11,6,4,5,7,7,2,10,9,10,8,8,7,5,10,6,14,1,12,5,6,7,12,13,6,5,16,16,12,20,5,5,9,6,9,6,9,18,11,13,11,13,4,6,2,S ,1,1,20,1,1,1,1,1,1,1,1,1,1,1,1
19157608,Jean,1651,28/04/1992,24,0,0,0,0,194,94,14,13,7,1,9,10,10,10,9,9,8,3,1,3,3,1,6,1,1,3,2,3,4,1,4,9,9,14,8,11,7,10,5,2,12,1,8,8,6,13,9,8,16,9,9,12,20,5,15,9,6,9,9,9,9,14,10,12,12,6,4,8,GK ,20,1,1,1,1,1,1,1,1,1,1,1,1,1,1
19157856,Mattos,1651,10/08/1986,29,0,0,0,0,186,79,3,3,1,1,1,2,1,1,2,1,2,5,3,4,4,8,5,5,9,1,9,11,3,9,9,8,9,5,6,6,7,13,4,8,2,6,8,5,5,13,13,7,11,10,8,13,20,9,7,8,8,4,8,8,16,11,10,14,10,10,17,7,DM/M C,1,1,1,1,1,1,1,1,1,20,17,1,1,1,1
19158043,Emerson Palmieri,1651,13/03/1994,22,0,0,0,0,178,77,1,3,2,1,3,1,1,2,1,2,3,8,13,13,7,12,4,8,9,12,11,13,4,13,13,11,13,10,10,12,10,14,14,8,5,15,10,14,15,16,14,13,10,20,7,15,10,14,12,13,6,6,5,3,12,12,13,12,14,8,11,9,D RL,1,1,1,1,13,10,1,20,15,10,12,14,12,15,12
19158044,Victor Andrade,1651,30/09/1995,20,0,0,5,1,171,60,2,1,1,3,2,2,1,1,2,2,1,8,12,15,10,13,8,9,12,4,6,11,12,6,15,8,11,9,9,9,12,8,13,17,8,13,6,8,10,16,15,8,5,10,11,15,20,12,6,10,4,9,10,8,8,12,13,11,10,6,12,14,M/AM RL,1,1,12,1,20,18,1,1,1,1,1,20,18,1,1
19158045,Lucas Otávio,1651,09/10/1994,21,0,0,0,0,164,61,2,2,1,4,3,2,1,3,1,2,1,5,6,13,9,12,5,11,11,5,12,13,7,12,12,4,12,14,10,13,12,12,15,10,8,12,12,14,14,14,15,16,3,10,13,13,20,13,5,13,5,7,10,8,18,10,10,11,10,3,8,7,DM/M C,1,1,1,10,1,1,1,1,1,18,20,1,1,1,1
19158154,André,1651,06/05/1989,27,0,0,0,0,190,87,1,3,2,1,1,2,3,3,2,2,3,6,6,7,7,10,6,12,7,9,12,10,7,11,9,10,11,13,9,10,6,11,10,1,9,7,11,13,13,10,9,6,15,7,13,12,20,13,14,9,10,6,9,7,9,12,8,7,11,4,14,7,D C,1,1,1,1,1,1,20,1,1,1,1,1,1,1,1
19158212,Jô,1651,30/11/1989,26,0,0,0,0,170,65,3,1,1,1,2,3,2,3,1,1,2,6,11,11,9,10,6,10,8,2,6,10,9,6,10,13,10,13,10,11,7,9,14,13,5,11,14,13,14,15,11,10,5,12,12,14,20,10,10,10,7,11,8,9,12,11,8,11,11,10,13,10,AM/S R,1,1,20,1,13,20,1,1,1,1,1,1,1,1,1
19158378,Gauther,1651,24/01/1992,24,0,0,0,0,190,0,13,13,12,1,13,13,10,13,5,10,10,8,2,2,1,1,10,1,1,1,1,1,1,2,3,10,11,13,8,9,7,13,4,2,13,2,11,6,7,13,13,8,14,20,11,13,9,7,9,10,8,4,10,10,12,12,10,12,10,11,16,3,GK ,20,1,1,1,1,1,1,1,1,1,1,1,1,1,1
19158379,Lucão,1651,22/07/1992,23,0,0,0,0,193,79,3,2,3,1,3,3,1,1,1,3,1,6,7,9,7,11,4,12,5,7,11,10,7,12,11,13,11,12,11,12,10,12,12,11,9,11,12,11,11,11,10,11,14,8,14,11,20,12,11,11,10,10,10,10,17,12,10,12,11,12,10,11,D C,1,1,1,1,1,1,20,1,1,1,1,1,1,1,1
19158380,Anderson Rosa,1651,11/03/1993,23,0,0,0,0,175,0,1,1,3,1,1,1,3,2,4,1,1,4,7,7,9,14,1,7,6,6,11,9,5,14,14,9,11,8,9,7,9,11,3,7,6,8,11,8,10,11,12,8,7,20,13,14,10,7,10,9,9,1,9,9,18,11,12,11,11,10,17,4,DM/M C,1,1,1,13,1,1,1,1,1,17,20,1,1,1,1
19158381,Nick,1651,04/03/1993,23,0,0,0,0,187,78,1,1,3,1,3,3,3,3,3,1,4,4,3,4,2,8,2,13,4,1,13,8,1,13,7,9,11,10,8,13,4,13,10,5,8,6,12,7,8,13,13,8,11,20,8,13,10,5,9,10,10,10,10,10,10,12,11,11,10,2,15,2,D C,1,1,1,1,1,1,20,1,1,1,1,1,1,1,1
19158427,Cássio,1651,29/08/1992,23,0,0,0,0,175,65,2,1,3,2,2,3,3,3,3,4,1,8,6,8,9,14,8,7,12,4,6,11,5,9,12,10,10,5,9,9,11,14,14,13,14,14,9,9,13,12,13,5,6,10,13,11,20,6,5,10,6,7,10,10,15,10,11,11,11,5,17,8,AM C,1,1,1,20,1,10,1,1,1,1,10,1,1,1,1
19158503,Henrique,1651,08/02/1991,25,0,0,0,0,185,80,4,2,3,2,3,2,3,2,1,2,1,6,5,4,2,6,3,12,4,4,13,8,6,13,2,7,10,10,8,8,3,13,6,1,14,7,10,7,5,13,13,8,11,11,12,13,20,9,11,10,10,7,10,10,11,9,11,9,13,9,3,1,D C,1,1,1,1,1,1,20,1,1,1,1,1,1,1,1
19158519,Mauro,1651,31/10/1990,25,0,0,0,0,178,73,2,2,2,2,2,1,3,2,3,3,3,8,9,10,8,12,8,11,12,8,12,13,4,14,12,13,14,13,12,13,11,13,13,6,12,12,13,15,14,12,12,14,8,11,13,13,20,14,12,14,11,12,6,11,12,12,10,10,12,10,10,5,DM/M C,1,1,1,1,1,1,1,1,1,20,16,1,1,1,1
19158629,Jomar,1651,08/09/1992,23,0,0,0,0,185,74,2,2,1,3,3,1,3,2,2,2,1,8,7,6,7,10,8,13,8,9,14,10,7,14,10,13,13,14,13,13,9,12,12,8,11,8,13,14,13,13,11,14,14,5,15,13,20,15,14,13,8,13,8,8,14,13,10,13,13,10,11,6,D C,1,1,1,1,1,1,20,1,1,1,1,1,1,1,1
19158713,Kaká,1651,16/03/1993,23,0,0,0,0,167,57,3,1,3,4,3,2,1,1,1,1,3,6,6,7,7,13,6,2,9,1,7,10,5,4,13,9,9,4,7,7,11,12,4,13,8,10,8,7,11,13,12,7,3,20,14,13,8,6,5,9,5,9,9,9,18,9,13,11,11,8,12,3,M/AM C,1,1,1,20,1,1,1,1,1,1,16,1,1,1,1
19158714,Elvinho,1651,29/01/1992,24,0,0,0,0,174,0,2,3,2,1,2,2,3,2,2,2,2,8,7,12,10,15,8,8,9,1,9,11,5,9,12,6,10,6,7,9,15,12,9,10,6,13,10,9,14,14,15,4,10,2,14,14,20,9,3,9,9,7,5,9,14,12,13,11,10,10,8,6,M/AM C,1,1,10,20,10,10,1,1,1,1,18,1,1,1,1
19158716,Andrade,1651,15/02/1994,22,0,0,0,0,179,71,2,3,2,2,2,3,4,3,2,3,4,11,12,10,8,9,8,10,10,5,8,12,13,9,12,6,10,6,8,8,12,10,11,9,7,12,10,14,10,11,8,8,9,20,10,11,8,12,8,12,5,11,13,15,15,12,8,11,10,10,10,12,D/WB/M/AM LC,1,1,1,14,16,1,1,16,1,14,16,18,1,20,1
19158718,Renan Donizete,1651,05/10/1995,20,0,0,0,0,176,68,2,1,1,2,3,2,2,3,1,2,1,13,11,12,11,10,10,11,11,1,4,13,14,3,12,4,10,5,11,8,13,12,8,15,3,13,5,8,8,12,10,8,8,8,10,11,20,12,8,8,5,14,10,11,18,8,6,12,5,8,12,15,M/AM RC,1,1,1,20,1,16,1,1,1,1,18,1,1,1,1
19158719,Jajá,1651,18/03/1995,21,0,0,6,0,178,70,3,4,1,1,2,3,3,2,1,2,3,14,11,12,11,12,14,9,12,3,9,13,13,11,13,10,13,10,13,13,13,11,10,14,7,12,9,12,12,14,14,12,8,20,12,13,8,12,8,11,10,12,6,14,12,10,12,12,10,10,12,10,M/AM C,1,1,1,16,12,11,1,8,1,14,20,11,8,10,1
19158787,Matheus,1651,19/07/1992,23,0,0,0,0,190,84,13,12,12,17,12,15,11,17,15,12,14,4,1,1,3,4,9,6,3,2,2,6,1,2,8,15,10,15,13,7,9,6,14,1,7,3,14,10,16,13,16,14,14,6,13,12,20,13,13,8,8,10,7,11,12,12,12,11,11,10,12,6,GK ,20,1,1,1,1,1,1,1,1,1,1,1,1,1,1
19158788,Lula,1651,18/02/1992,24,0,0,0,0,184,69,2,3,1,1,1,3,1,1,2,2,3,7,7,7,8,10,7,11,9,8,11,11,10,10,10,11,11,12,11,11,6,10,8,11,8,8,12,13,12,12,12,8,13,10,12,12,20,12,9,11,12,12,12,12,14,10,9,10,13,1,19,2,D C,1,1,1,1,1,1,20,1,1,1,1,1,1,1,1
19158789,Rafael Estevam,1651,26/04/1988,28,0,0,0,0,178,76,1,3,1,3,1,2,4,2,2,4,1,9,7,7,9,13,6,10,7,9,11,11,6,15,10,10,11,11,8,8,7,11,2,4,8,8,11,11,11,15,15,11,9,20,10,15,10,12,8,10,5,9,10,10,16,13,11,11,10,9,12,2,D/WB L,1,1,1,1,1,1,1,20,1,1,1,1,1,19,1
19158790,China,1651,29/08/1992,23,0,0,0,0,175,0,3,2,2,2,1,2,3,3,2,2,1,8,3,14,13,14,7,6,12,3,7,13,1,7,13,4,11,4,6,8,14,12,8,13,10,11,8,9,12,14,12,9,5,10,10,11,20,14,6,10,8,6,10,10,17,10,12,10,12,6,17,7,AM C,1,1,1,20,1,1,1,1,1,1,10,1,1,1,1
19158802,Roger,1651,10/02/1992,24,0,0,0,0,187,0,1,1,1,2,1,2,2,3,1,3,1,10,14,10,8,12,8,6,3,8,9,10,6,10,14,10,11,9,10,9,10,14,10,8,7,8,10,9,10,14,11,9,9,20,17,12,10,7,9,10,7,10,8,10,9,12,11,11,12,1,10,1,D/M L,1,1,1,1,1,1,1,18,1,1,1,20,1,1,1
19158803,Leleu,1651,05/03/1993,23,0,0,0,0,171,68,1,3,3,3,1,3,3,3,2,2,3,6,10,12,7,14,8,8,8,3,9,9,6,6,13,10,7,6,8,9,7,14,9,10,11,10,9,9,11,15,13,9,6,20,11,14,10,9,6,10,10,3,8,11,12,9,12,11,11,5,5,5,M/AM LC,1,1,1,20,11,1,1,1,1,1,17,15,1,1,1
19158804,Uilson,1651,28/04/1994,22,0,0,0,0,186,75,12,14,11,1,11,9,12,13,11,10,14,3,1,1,1,10,5,2,2,1,3,5,3,3,10,6,12,12,10,12,11,16,19,2,13,2,13,12,11,14,14,12,14,10,13,15,20,11,10,11,10,11,8,11,10,12,12,13,12,10,1,1,GK ,20,1,1,1,1,1,1,1,1,1,1,1,1,1,1
19158805,Donato,1651,07/02/1994,22,0,0,0,0,190,79,2,1,4,1,1,2,3,2,1,2,3,5,1,4,3,8,2,11,5,3,10,7,3,11,6,10,11,10,11,11,4,13,5,8,14,5,10,7,8,10,9,8,14,10,12,9,20,10,11,11,10,12,7,10,13,13,12,11,15,6,4,8,D C,1,1,1,1,1,1,20,1,1,1,1,1,1,1,1
19158806,Dodô,1651,05/09/1994,21,0,0,0,0,171,64,1,1,2,1,3,3,1,2,2,1,2,12,11,12,11,13,12,8,11,6,8,12,14,9,13,12,12,10,13,12,12,12,12,14,12,12,8,12,12,15,15,15,6,10,14,14,20,13,6,11,13,11,9,11,15,12,13,11,12,6,11,7,AM RLC,1,1,14,20,17,15,1,1,1,1,12,1,1,1,1
19158807,Paulo Victor,1651,21/04/1992,24,0,0,0,0,186,0,12,9,10,1,10,12,10,11,9,6,7,4,1,1,2,4,9,1,1,2,2,1,3,1,3,8,7,11,6,6,5,12,4,1,8,3,9,6,5,11,14,6,6,10,13,8,20,5,9,5,5,7,5,9,13,10,11,9,12,4,14,1,GK ,20,1,1,1,1,1,1,1,1,1,1,1,1,1,1
19158809,Carlos,1651,15/08/1995,20,0,0,0,0,172,68,3,3,3,3,3,2,3,2,1,1,2,8,10,13,13,13,11,12,13,10,7,12,14,7,14,13,14,14,12,12,12,13,15,14,12,14,7,13,13,15,13,11,8,10,18,14,20,14,11,12,6,14,12,14,10,12,12,13,14,7,14,8,AM/S L,1,1,20,1,20,13,1,1,1,1,1,1,1,1,1
19158810,Marcos Vinicius,1651,24/02/1994,22,0,0,0,0,188,0,1,1,2,2,3,4,1,3,2,1,2,6,4,14,14,14,7,14,8,4,6,8,3,1,10,9,13,2,9,8,6,10,9,9,5,14,8,7,8,14,14,8,8,1,8,14,20,10,10,9,4,9,9,9,20,9,12,13,13,8,1,2,S ,1,1,20,1,1,1,1,1,1,1,1,1,1,1,1
19159353,Andrigo,1651,27/02/1995,21,0,0,0,0,170,63,3,2,1,1,1,4,1,1,2,1,2,12,12,11,11,16,11,15,13,8,7,14,11,9,13,9,13,10,13,13,14,13,14,13,11,14,7,13,12,15,13,10,8,11,12,14,20,12,10,11,9,12,7,14,10,13,13,13,13,8,12,6,S RC,1,1,20,15,1,15,1,1,1,1,1,1,1,1,1
19159354,Lucas Severo,1651,25/07/1995,20,0,0,0,0,182,63,1,3,2,3,3,1,3,3,2,1,3,10,9,7,6,16,10,10,14,5,10,12,10,11,12,10,9,10,10,10,12,14,5,6,5,12,11,11,15,11,10,11,11,7,9,10,20,10,8,10,5,10,4,10,8,11,12,14,11,11,14,6,DM/M C,1,1,1,1,1,1,1,1,1,16,20,1,1,1,1
19159355,Wellington,1651,04/01/1995,21,0,0,0,0,182,69,9,8,6,1,10,13,10,12,9,9,5,5,2,3,2,1,9,1,1,1,1,1,4,2,4,9,4,15,7,13,6,12,8,3,12,3,7,7,6,11,12,3,6,9,7,10,20,5,6,9,5,9,9,9,14,10,7,11,13,7,3,5,GK ,20,1,1,1,1,1,1,1,1,1,1,1,1,1,1
19159356,Jacsson,1651,12/03/1994,22,0,0,0,0,188,80,12,12,11,11,12,12,11,13,11,11,13,3,1,3,3,6,6,1,3,2,2,2,3,3,4,7,10,12,10,10,9,14,18,3,11,2,14,10,9,14,16,10,13,11,11,13,20,4,9,12,6,11,10,11,18,13,12,11,9,2,17,1,GK ,20,1,1,1,1,1,1,1,1,1,1,1,1,1,1
19159357,Nathan,1651,18/01/1994,22,0,0,0,0,176,75,2,3,1,3,1,1,1,3,3,3,2,9,10,9,15,12,8,12,10,5,9,8,8,7,8,10,15,6,12,10,9,11,7,10,10,15,10,9,10,14,12,6,8,7,10,13,20,11,12,9,10,10,4,10,17,13,11,13,12,8,19,6,S ,1,1,20,1,1,1,1,1,1,1,1,1,1,1,1
19159358,Alex Nemetz,1651,10/03/1994,22,0,0,0,0,178,70,3,2,1,2,2,3,1,1,2,1,3,8,4,11,9,12,9,8,9,3,9,11,4,9,10,9,11,9,9,8,12,12,9,9,11,13,9,9,6,12,11,11,9,7,13,12,20,8,8,13,9,6,5,9,19,14,11,10,9,5,11,7,AM C,1,1,1,20,1,1,1,1,1,1,15,1,1,1,1
19159359,Marlon Bica,1651,25/05/1994,22,0,0,0,0,182,78,2,3,2,1,1,3,3,3,2,3,3,8,10,7,9,10,10,10,14,3,11,13,7,12,11,9,12,10,10,12,10,16,11,10,15,12,12,11,11,14,12,11,8,10,10,10,20,11,8,10,8,12,5,10,10,12,12,11,14,1,14,2,M C,1,1,1,1,1,1,1,1,1,15,20,1,1,1,1
19159360,Cláudio Winck,1651,15/04/1994,22,0,0,0,0,183,77,2,3,3,2,1,1,1,2,2,2,4,11,11,12,11,13,12,10,12,12,11,12,14,11,12,9,11,12,11,11,12,12,12,14,11,12,11,12,12,13,13,11,11,7,13,14,20,13,10,11,13,12,12,14,14,13,10,12,10,9,10,8,WB R,1,1,1,1,1,13,1,8,15,1,13,1,14,7,20
19159361,Tárik,1651,18/02/1993,23,0,0,0,0,183,72,4,2,3,3,2,3,2,3,1,2,3,8,6,2,5,7,5,14,5,6,12,11,4,12,8,7,13,9,9,7,6,12,9,1,13,5,15,8,10,14,9,9,10,6,11,11,20,11,11,8,7,9,9,9,10,11,9,11,10,2,5,1,D C,1,1,1,1,1,1,20,1,1,12,10,1,1,1,1
19159362,Fred,1651,05/03/1993,23,4,0,5,0,169,64,4,3,3,4,3,2,1,1,2,1,2,10,14,15,12,15,6,9,13,6,12,15,7,13,16,7,14,11,14,14,15,16,12,15,8,14,11,14,13,14,16,10,6,20,13,14,15,13,9,15,5,14,3,14,13,12,12,13,13,12,9,12,DM/M C,1,1,10,14,1,13,1,1,1,18,20,1,1,1,1
19159364,Paulinho,1651,14/06/1992,24,0,0,0,0,180,72,2,4,2,1,3,3,4,3,1,2,2,5,10,5,11,13,5,7,13,1,9,13,4,10,11,8,11,8,9,6,9,9,1,5,12,7,8,8,9,12,11,8,7,20,12,12,8,14,9,8,8,9,7,9,11,12,11,11,11,6,7,6,WB L,1,1,1,1,1,1,1,15,1,1,14,14,1,20,1
19159428,Fabiano,1651,18/11/1991,24,0,0,0,0,188,82,3,1,1,4,2,3,1,1,2,1,1,9,12,10,9,12,10,13,11,10,13,11,8,13,11,13,13,14,12,12,10,12,13,9,11,11,12,14,13,12,10,8,14,8,14,12,20,14,13,13,12,10,4,16,9,12,11,8,12,7,8,8,D/WB RC,1,1,1,1,1,1,19,1,20,8,5,1,1,1,18
19159431,Douglas Grolli,1651,10/01/1989,27,0,0,0,0,188,84,2,2,1,2,3,4,3,3,1,3,1,9,7,4,6,11,7,13,7,9,12,8,6,13,10,9,11,12,12,11,8,16,10,9,8,12,12,13,13,10,11,7,15,12,11,10,20,12,14,13,9,11,10,11,17,12,7,11,9,9,10,8,D C,1,1,1,1,1,1,20,1,1,1,1,1,1,1,1
19159497,Dílson,1651,11/01/1991,25,0,0,0,0,176,0,3,1,2,1,2,2,3,2,2,1,1,5,4,6,7,12,6,3,8,2,7,11,3,11,10,8,13,7,5,10,9,11,8,8,7,5,9,8,12,14,14,5,6,3,10,14,20,8,5,8,8,8,8,8,11,12,13,7,10,11,18,4,DM ,1,1,1,1,1,1,1,1,1,20,10,1,1,1,1
19159541,William Cordeiro,1651,15/07/1993,22,0,0,0,0,171,63,1,3,3,1,3,3,2,1,2,3,1,8,11,9,6,8,4,8,7,9,7,11,4,11,11,10,11,10,10,9,10,12,4,6,8,10,12,10,10,15,15,10,5,11,9,14,20,10,7,10,6,9,5,10,16,10,11,8,13,3,2,4,D/WB R,1,1,1,1,1,1,1,1,18,1,1,1,1,1,20
19159566,Negretti,1651,11/05/1985,31,0,0,0,0,182,80,3,3,3,1,2,2,1,2,2,3,4,7,8,8,8,11,9,8,9,8,16,11,5,13,10,9,12,14,12,9,8,13,10,8,14,11,13,12,13,9,8,15,9,11,13,9,20,12,14,12,8,7,5,10,13,12,11,11,10,8,15,4,DM RC,1,1,1,1,1,1,14,6,15,20,15,1,1,1,1
19159714,Philippe Guimarães,1651,18/03/1991,25,0,0,0,0,178,74,4,3,1,3,2,2,2,2,3,3,2,5,5,2,6,11,5,5,11,3,7,11,1,13,6,8,6,6,6,7,8,13,8,8,10,3,10,6,10,13,13,6,5,20,15,11,8,5,6,8,6,2,7,8,10,11,10,11,9,2,5,1,DM ,1,1,1,1,1,1,1,1,1,20,10,1,1,1,1
19159715,Marrone,1651,15/09/1992,23,0,0,0,0,172,67,2,1,3,1,2,2,1,3,2,1,1,7,10,10,7,8,9,9,8,3,11,10,5,15,11,7,12,10,10,9,11,15,6,10,6,9,14,10,11,13,15,14,6,11,15,15,20,10,6,10,10,10,6,10,16,13,9,12,11,1,10,5,D/WB/DM RL,1,1,1,1,1,1,1,15,16,20,10,1,1,13,16
19160515,Sassá,1651,18/12/1988,27,0,0,0,0,170,66,2,3,1,3,3,2,1,2,1,1,2,5,2,13,13,12,6,13,3,1,6,3,4,1,12,6,12,8,10,6,7,8,6,12,8,13,7,6,7,13,13,13,4,10,11,13,20,12,6,9,8,9,9,9,20,10,13,10,11,5,3,7,S ,1,1,20,1,1,1,1,1,1,1,1,1,1,1,1
19160961,Gian Martins,1651,01/04/1993,23,0,0,0,0,184,77,2,2,4,3,3,1,3,1,4,1,2,5,8,11,7,12,6,11,8,5,12,12,8,15,13,16,15,14,12,15,9,14,13,11,9,11,14,13,14,12,12,15,13,20,14,13,5,15,13,13,11,11,6,12,16,11,11,13,15,15,8,6,DM ,1,1,1,1,1,1,1,1,1,20,13,1,1,1,1
19160964,Régis,1651,19/05/1992,24,0,0,0,0,181,0,2,2,2,1,1,2,3,1,1,3,2,7,7,6,7,12,7,7,9,1,11,13,3,13,8,5,12,9,8,6,12,13,10,6,9,7,13,8,12,13,12,8,7,9,17,13,20,10,6,10,7,10,7,10,8,10,10,12,11,5,7,6,DM ,1,1,1,1,1,1,1,1,1,20,10,1,1,1,1
19160967,Tarcísio,1651,05/11/1992,23,0,0,0,0,178,0,2,1,1,1,2,3,1,1,2,2,3,3,5,6,7,13,1,5,5,1,7,10,1,11,13,8,8,7,5,7,11,9,8,8,9,7,10,7,10,13,13,6,4,8,8,13,20,6,6,8,10,8,8,8,18,12,8,10,11,6,13,1,M C,1,1,1,13,1,1,1,1,1,15,20,1,1,1,1
19161009,Alexandre Cardoso,1651,30/04/1992,24,0,0,0,0,182,82,3,4,1,2,2,2,2,1,3,1,3,8,8,7,8,9,8,6,7,4,9,14,3,14,14,6,12,9,7,9,10,11,3,10,7,8,13,9,11,14,14,9,10,10,17,14,20,13,9,10,14,3,10,10,10,9,12,13,13,1,16,3,DM ,1,1,1,1,1,1,1,1,1,20,10,1,1,1,1
19161011,Bruno Oliveira,1651,11/01/1993,23,0,0,0,0,171,70,1,2,2,4,3,3,1,3,2,2,2,8,9,9,5,11,6,6,2,9,11,5,5,15,11,8,12,10,10,10,6,15,2,4,2,10,9,11,11,15,14,13,5,10,12,14,20,10,8,10,10,4,3,10,12,10,10,13,11,2,10,8,D/WB R,1,1,1,1,1,1,1,1,17,1,1,1,1,1,20
19161012,Bruno Dybal,1651,03/03/1994,22,0,0,0,0,181,73,1,2,2,3,1,1,2,2,2,1,2,14,10,11,9,11,13,10,9,4,8,13,10,12,13,8,12,11,12,11,13,13,14,6,9,12,12,12,13,12,11,11,10,14,11,12,20,12,12,13,9,11,11,11,20,13,12,10,10,3,16,3,DM/M C,1,1,1,12,1,1,1,1,1,16,20,1,1,1,1
19161013,Bruno Sabiá,1651,21/03/1994,22,0,0,0,0,180,70,1,3,1,1,1,3,3,2,3,3,1,8,8,10,10,13,8,8,14,2,8,14,6,7,9,10,11,7,7,9,14,12,7,10,11,14,10,7,12,14,13,9,10,10,10,12,20,10,7,10,7,1,8,10,15,12,11,13,10,1,11,4,AM C,1,1,1,20,1,1,1,1,1,1,15,1,1,1,1
19161014,Dunguinha,1651,13/04/1993,23,0,0,0,0,167,62,4,1,1,1,1,1,3,1,3,3,3,6,4,8,8,13,6,5,12,5,7,13,1,8,13,6,7,8,6,6,13,7,9,13,10,10,8,7,11,13,13,7,2,9,11,13,20,6,4,9,7,1,9,9,12,13,13,12,11,6,7,4,AM C,1,1,1,20,1,1,1,1,1,1,15,1,1,1,1
19161015,Diego Souza,1651,16/01/1993,23,0,0,0,0,172,71,3,2,1,2,3,2,3,2,3,3,3,12,9,12,11,11,10,8,12,5,4,11,6,5,12,7,11,5,11,11,11,11,10,13,1,12,5,12,7,13,13,9,6,10,11,12,20,11,9,7,6,2,9,10,17,12,10,10,10,8,10,4,AM C,1,1,1,20,1,1,1,1,1,1,15,1,1,1,1
19161016,Luca Savoia,1651,18/05/1994,22,0,0,0,0,177,72,1,1,1,3,2,2,1,3,2,4,1,6,6,10,11,13,5,13,7,3,5,2,6,1,10,3,12,8,8,3,3,7,7,10,14,12,7,6,7,13,10,7,8,11,9,12,20,7,7,9,7,9,9,9,14,11,12,11,12,7,11,5,S ,1,1,20,1,1,1,1,1,1,1,1,1,1,1,1
19161017,Lucão,1651,14/05/1993,23,0,0,0,0,192,88,3,1,3,3,1,2,2,3,1,1,1,2,1,1,4,5,1,13,5,1,13,7,3,13,5,6,12,8,6,13,3,8,3,9,9,6,13,6,7,11,7,7,15,4,11,7,20,4,10,9,8,1,9,9,13,11,12,9,11,11,10,5,D C,1,1,1,1,1,1,20,1,1,1,1,1,1,1,1
19161088,Vitor Prada,1651,04/08/1992,23,0,0,0,0,187,84,14,10,8,3,14,14,10,14,9,9,11,5,1,2,1,3,9,1,1,1,3,3,1,1,6,9,10,14,6,8,7,14,5,1,9,1,11,8,6,12,6,8,9,16,2,9,20,2,8,9,7,2,8,9,10,13,9,11,13,4,15,6,GK ,20,1,1,1,1,1,1,1,1,1,1,1,1,1,1
19161089,Rodinei,1651,29/01/1992,24,0,0,0,0,179,70,3,1,1,1,3,3,2,3,1,3,3,9,11,12,12,11,4,9,9,12,9,11,5,11,12,9,12,13,12,12,11,12,14,12,10,12,12,11,14,14,13,12,12,10,13,14,20,16,12,13,7,12,11,11,12,12,12,12,10,7,11,4,D/WB R,1,1,1,1,1,13,1,1,20,1,1,1,13,1,19
19161091,Johnny Dias,1651,07/05/1993,23,0,0,0,0,172,74,4,2,3,3,1,1,1,3,2,2,2,4,6,12,14,11,7,13,7,1,7,8,8,3,10,9,11,4,9,8,4,14,5,9,8,14,6,7,8,14,14,8,6,9,16,14,20,5,8,9,9,4,4,9,17,10,11,7,13,9,6,2,S ,1,1,20,1,1,1,1,1,1,1,1,1,1,1,1
19161092,Léo Campos,1651,03/07/1992,23,0,0,0,0,184,80,2,1,1,2,2,2,4,3,2,3,3,9,13,7,7,14,8,8,8,8,10,6,4,12,10,5,9,4,10,9,7,13,9,4,4,9,12,9,10,14,13,3,12,20,5,14,10,14,9,10,10,6,10,9,10,12,11,12,10,6,10,4,D/WB L,1,1,1,1,1,1,1,20,1,1,1,15,1,18,1
19161143,Tayron,1651,07/01/1990,26,0,0,0,0,181,0,1,1,3,3,2,3,2,3,2,2,1,6,4,1,2,7,4,11,2,1,13,7,1,13,4,8,9,9,2,8,1,13,2,5,9,5,13,6,7,13,13,7,8,1,11,13,20,4,6,9,2,1,8,9,18,10,11,11,11,5,19,5,D C,1,1,1,1,1,1,20,1,1,1,1,1,1,1,1
19161180,Néris,1651,17/06/1992,24,0,0,0,0,190,88,2,2,2,2,1,3,2,1,3,3,3,8,9,6,8,12,8,13,8,11,13,12,8,13,10,14,12,12,12,11,11,12,17,10,12,10,12,12,13,11,11,5,15,6,13,11,20,12,15,11,15,11,10,10,7,12,10,11,12,1,9,7,D C,1,1,1,1,1,1,20,1,1,15,10,1,1,1,1
19161251,Mariano,1651,10/07/1993,22,0,0,0,0,186,0,1,2,3,3,1,3,1,2,1,2,1,4,1,12,12,12,1,7,5,1,3,5,1,1,8,8,6,6,4,5,4,11,6,9,12,12,5,4,5,12,12,5,11,12,10,12,20,6,8,8,8,8,7,8,13,11,12,13,12,5,14,5,S ,1,1,20,1,1,1,1,1,1,1,1,1,1,1,1
19161291,Bruno Brigido,1651,09/03/1991,25,0,0,0,0,188,75,14,11,11,6,14,10,10,12,10,5,12,3,2,2,1,6,8,1,1,2,3,3,4,3,3,7,10,15,10,11,9,14,13,2,6,1,8,10,9,13,15,10,14,11,16,14,20,9,8,11,9,5,7,11,9,12,12,12,12,11,12,6,GK ,20,1,1,1,1,1,1,1,1,1,1,1,1,1,1
19161292,Guilherme,1651,10/06/1992,24,0,0,0,0,172,66,2,3,1,1,2,1,2,2,4,2,2,4,6,7,6,13,5,5,7,1,7,9,1,12,9,8,10,6,7,7,6,13,4,9,11,7,7,6,7,13,13,6,5,20,12,13,9,6,4,8,8,5,8,16,18,10,11,8,11,1,6,8,DM/M LC,1,1,7,15,11,9,1,15,6,17,20,11,8,13,7
19161573,Jean Patrick,1651,25/06/1992,24,0,0,0,0,172,72,2,1,3,3,1,3,1,2,1,1,1,5,9,11,10,13,8,10,6,1,11,11,1,12,11,11,9,10,8,11,12,13,14,12,3,9,12,12,11,13,11,11,11,11,14,11,20,13,12,11,11,5,9,11,8,11,12,9,11,4,10,8,D/WB/DM R,1,1,1,1,1,1,1,1,18,20,14,1,1,1,18
19161671,Misael,1651,15/07/1994,21,0,0,0,0,176,79,2,1,1,1,3,2,1,3,2,2,3,10,9,9,8,9,8,13,7,8,14,7,9,14,11,12,10,11,9,12,9,11,10,10,6,6,12,12,13,12,12,12,8,11,10,12,20,12,12,10,12,7,10,11,13,9,12,7,12,5,7,6,DM ,1,1,1,1,1,1,1,1,1,20,10,1,1,1,1
19162158,Mário Sérgio,1651,26/04/1994,22,0,0,0,0,170,0,3,3,4,2,1,2,2,1,3,3,3,9,12,9,4,13,6,13,9,8,11,13,5,13,13,7,12,10,10,11,10,12,5,12,6,9,11,15,11,13,13,13,6,20,12,13,11,10,9,11,7,10,8,13,19,14,10,11,11,6,16,1,D/WB L,1,1,1,1,1,1,1,20,1,1,1,1,1,17,1
19162449,Jairo,1651,06/05/1992,24,0,0,0,0,183,78,3,3,3,3,2,3,2,1,1,2,3,9,12,14,10,14,9,9,8,4,4,12,10,5,14,10,12,11,10,7,12,8,12,12,8,13,7,8,12,13,13,15,11,8,10,13,20,12,14,10,10,9,9,13,12,13,13,12,12,12,7,7,AM/S RLC,1,1,20,16,18,19,1,1,1,1,10,14,14,1,1
19162450,Vitinho,1651,09/10/1993,22,0,0,0,0,180,75,3,2,3,1,2,3,2,2,2,1,3,10,12,15,12,13,12,5,15,7,7,11,7,9,15,2,12,5,12,12,13,12,11,15,3,13,7,11,12,15,15,12,9,17,14,14,20,13,9,12,2,10,3,11,3,7,5,7,13,10,12,5,AM RLC,1,1,13,17,20,19,1,1,1,1,1,1,1,1,1
19162530,Rudigullithi,1651,10/08/1993,22,0,0,0,0,191,97,3,3,2,4,3,1,1,1,3,1,3,6,6,7,7,13,6,6,13,1,10,13,2,13,11,9,9,8,8,8,8,13,9,8,7,7,10,7,8,13,13,3,13,9,15,13,20,5,8,9,8,3,8,9,14,11,12,12,11,9,3,6,DM C,1,1,1,1,1,1,1,1,1,20,15,1,1,1,1
19162531,Ewerton,1651,01/12/1992,23,0,0,0,0,175,66,1,3,1,2,2,2,2,1,3,2,4,8,9,12,12,13,8,11,12,9,13,15,13,12,14,12,12,13,12,13,12,12,11,9,12,10,13,14,13,13,12,10,11,5,14,13,20,14,10,12,8,12,8,9,14,10,14,12,12,12,12,5,DM/M C,1,1,1,13,1,1,1,1,1,18,20,1,1,1,1
19162534,Kadu Fernandes,1651,02/03/1995,21,0,0,0,0,187,83,3,3,2,3,3,4,1,3,3,1,2,9,5,3,8,11,7,12,9,10,12,11,7,12,11,8,13,11,6,13,5,11,14,8,12,10,12,10,11,11,12,13,14,7,14,11,20,14,13,10,6,10,6,10,7,10,11,10,11,5,12,3,D C,1,1,1,1,1,1,20,1,1,1,1,1,1,1,1
19162567,Bruno Nunes,1651,08/07/1990,25,0,0,0,0,186,87,1,3,2,3,1,2,1,4,3,3,3,8,7,11,11,12,9,12,10,6,5,11,12,4,11,12,10,9,12,10,10,10,13,12,7,11,7,9,11,11,12,9,12,10,13,10,20,14,10,13,11,6,10,7,19,12,10,12,13,11,8,4,S ,1,1,20,1,1,1,1,1,1,1,1,1,1,1,1
19162568,Charles,1651,16/03/1993,23,0,0,0,0,174,70,2,2,2,3,2,1,4,1,3,3,2,6,9,8,5,11,1,9,7,7,9,8,4,14,7,6,11,9,8,6,8,12,9,2,4,7,9,8,9,14,12,8,6,17,11,11,20,13,6,9,9,9,9,9,8,9,10,12,14,3,9,8,D/WB R,1,1,13,1,1,1,1,14,20,1,1,1,1,11,16
19162570,Reynaldo,1651,12/03/1991,25,0,0,0,0,189,86,13,11,9,1,13,11,11,11,10,9,8,6,2,2,3,4,9,1,1,3,1,1,2,2,5,10,10,10,7,9,7,13,10,3,13,1,13,8,7,12,9,8,11,9,14,13,20,7,8,10,10,5,6,10,18,11,9,10,12,7,18,6,GK ,20,1,1,1,1,1,1,1,1,1,1,1,1,1,1
19162578,Felipe,1651,16/05/1989,27,0,0,0,0,191,87,2,1,2,3,1,2,3,2,2,1,1,6,7,8,8,11,7,17,7,7,15,12,11,14,11,18,14,14,12,12,12,13,15,10,13,10,13,14,14,13,13,15,17,8,14,13,20,14,16,13,7,12,10,12,10,13,12,12,12,10,9,9,D C,1,1,1,1,1,1,20,1,13,12,1,1,1,1,1
19162579,Bruno Guterres,1651,25/05/1989,27,0,0,0,0,185,0,3,3,3,3,1,1,2,1,3,1,3,5,1,11,8,12,5,12,10,1,5,6,3,1,12,9,8,4,9,2,2,11,9,13,13,8,6,5,7,11,9,11,12,20,14,11,9,11,13,9,9,5,8,9,7,11,12,8,12,2,8,5,S ,1,1,20,1,1,1,1,1,1,1,1,1,1,1,1
19162580,Felipe Moreira,1651,28/11/1988,27,0,0,0,0,173,65,1,2,2,1,1,2,2,3,2,3,3,7,7,11,14,9,7,11,7,1,3,7,9,1,12,9,14,7,11,7,4,10,2,11,1,14,8,7,8,14,14,8,5,10,13,14,20,12,6,9,9,3,6,9,17,11,12,10,9,7,14,2,S ,1,1,20,1,1,1,1,1,1,1,1,1,1,1,1
19162581,Mineiro,1651,06/06/1986,30,0,0,0,0,177,71,2,2,4,1,2,1,1,2,1,3,2,5,4,6,7,13,4,5,9,1,11,12,5,10,12,12,9,11,7,11,7,11,3,9,11,8,12,12,11,13,13,11,7,20,13,13,10,9,6,12,13,9,6,9,11,9,11,12,9,9,10,2,DM ,1,1,1,1,1,1,1,1,1,20,10,1,1,1,1
19162584,Renan Geraldeli,1651,27/11/1992,23,0,0,0,0,189,0,7,8,11,9,14,13,12,14,9,5,8,4,3,2,1,1,9,1,2,2,2,1,2,3,3,9,10,10,7,8,7,14,3,2,7,3,13,8,6,11,11,8,10,6,8,12,20,1,11,9,3,5,9,9,18,12,13,11,10,3,13,7,GK ,20,1,1,1,1,1,1,1,1,1,1,1,1,1,1
19162606,Arnaldo,1651,15/04/1992,24,0,0,0,0,173,70,1,2,1,3,3,2,2,2,1,3,2,7,11,11,5,13,8,8,9,8,9,10,1,14,10,5,9,9,8,8,8,14,6,12,13,8,10,9,10,14,14,9,6,11,10,14,20,14,6,10,5,9,8,10,13,9,11,11,11,9,8,1,D/WB/DM R,1,1,1,1,1,1,1,1,20,17,1,1,1,1,17
19162608,Diogo Calixto,1651,26/01/1993,23,0,0,0,0,183,74,2,1,3,2,1,1,2,3,1,3,2,6,10,10,6,11,3,8,7,8,10,9,2,13,10,10,11,9,10,9,6,14,2,10,9,8,10,9,10,14,12,9,11,20,12,12,10,9,10,10,6,10,7,10,10,12,13,13,11,2,17,4,D/WB L,1,1,1,1,13,1,1,20,1,1,1,13,1,17,1
19162613,Romarinho,1651,09/11/1988,27,0,0,0,0,161,0,2,3,1,3,1,2,3,2,4,2,3,6,5,13,9,11,6,8,7,1,6,11,3,7,13,9,10,4,10,7,11,10,6,13,10,10,6,7,8,13,12,4,1,9,11,12,20,13,9,9,9,6,9,9,15,9,9,10,10,7,16,2,AM/S C,1,1,17,20,1,1,1,1,1,1,13,1,1,1,1
19162630,Tatui,1651,14/10/1991,24,0,0,0,0,170,60,1,3,3,2,3,2,2,3,3,2,3,6,6,8,6,13,6,6,8,4,5,11,4,8,13,9,7,4,10,7,12,13,9,14,14,12,9,10,12,12,14,7,4,10,14,12,20,13,6,9,9,1,9,8,7,10,10,11,9,9,12,3,M/AM C,1,1,1,20,1,1,1,1,1,1,17,1,1,1,1
19162631,Vinicius Kiss,1651,08/06/1988,28,0,0,0,0,184,70,3,2,1,1,3,4,2,2,2,1,1,7,6,10,10,14,8,8,8,7,7,13,8,7,12,10,9,4,10,10,8,13,3,9,6,10,8,10,11,14,14,7,6,9,7,13,20,14,7,10,9,9,8,10,16,10,13,10,11,7,8,5,M/AM C,1,1,1,20,1,1,1,1,1,1,17,1,1,1,1
19162645,Guilherme Bernardinelli,1651,21/07/1992,23,0,0,0,0,185,79,4,1,3,3,3,3,1,4,1,3,2,5,1,1,7,7,5,10,4,3,14,5,2,14,6,7,10,9,6,10,4,14,7,9,7,6,14,7,8,14,8,8,12,9,12,13,20,6,7,9,9,3,9,9,10,10,10,12,11,7,19,2,D C,1,1,1,1,1,1,20,1,1,1,1,1,1,1,1
19162646,Reinaldo,1651,28/09/1989,26,0,0,0,0,178,79,2,2,3,1,1,2,3,3,3,2,1,12,13,14,13,12,13,10,12,10,10,13,12,9,12,9,12,11,12,13,13,12,13,15,7,14,9,11,13,16,14,9,9,20,12,14,7,13,8,12,9,11,6,13,7,11,12,12,13,11,12,1,D/WB L,1,1,1,9,15,1,1,20,1,1,1,15,1,17,1
19162679,Diego Cardoso,1651,06/03/1994,22,0,0,0,0,175,66,1,3,4,3,3,1,3,3,3,1,1,6,9,12,12,12,7,10,11,7,5,9,9,5,11,7,13,11,13,12,12,13,10,12,7,13,7,12,12,12,12,12,9,10,15,12,20,12,12,12,9,7,9,10,20,12,8,10,10,10,12,3,AM/S L,1,1,20,1,16,1,1,1,1,1,1,1,1,1,1
19162680,Gabriel Gasparotto,1651,09/02/1993,23,0,0,0,0,196,94,11,12,12,8,13,11,11,13,11,11,11,5,3,2,3,9,9,2,1,1,1,2,3,3,5,12,13,12,12,12,10,11,9,8,12,7,12,11,11,12,12,12,17,7,14,12,20,12,12,13,8,15,4,11,19,10,11,10,10,1,6,5,GK ,20,1,1,1,1,1,1,1,1,1,1,1,1,1,1
19162683,Paulo Henrique,1651,30/01/1993,23,0,0,0,0,180,75,2,1,1,1,2,1,2,1,2,1,4,8,11,10,9,8,7,9,8,11,11,11,9,11,10,11,10,10,10,11,7,11,12,5,10,10,11,10,10,12,12,10,6,20,12,12,10,12,10,10,4,8,15,9,20,11,11,13,10,7,11,13,D L,1,1,1,1,1,1,11,20,1,1,1,1,1,1,1
19162684,Vitor Hugo,1651,07/02/1994,22,0,0,0,0,175,68,1,1,1,3,1,3,2,1,2,1,1,4,9,12,14,11,5,12,11,6,5,10,9,5,11,5,10,5,11,9,8,9,13,8,8,11,7,11,11,12,12,10,11,20,9,12,10,11,11,12,5,11,10,5,9,11,13,12,9,7,11,5,AM/S R,1,1,20,1,1,18,1,1,1,1,1,1,1,1,1
19162727,Yuri Mamute,1651,07/05/1995,21,0,0,0,0,177,86,3,2,3,3,1,3,1,2,3,3,3,5,8,12,11,11,6,11,10,4,7,12,13,5,13,10,13,13,10,11,12,11,15,12,7,12,10,12,13,13,10,14,9,12,15,13,20,12,18,10,8,10,6,9,7,14,13,14,13,11,8,12,AM/S RL,1,1,20,10,16,17,1,1,1,1,1,10,10,1,1
19162730,Pedro Paulo,1651,10/02/1994,22,0,0,0,0,186,80,1,3,1,2,2,1,2,1,2,1,3,4,8,11,12,10,9,12,8,6,6,11,12,7,11,13,11,10,11,8,9,11,10,12,6,12,4,9,10,14,13,11,13,20,13,14,8,12,10,9,3,10,3,12,11,12,7,12,9,10,9,9,AM/S C,1,1,20,17,12,10,1,1,1,1,1,1,1,1,1
19162783,Deivity,1651,26/03/1991,25,0,0,0,0,185,83,6,8,10,1,14,12,10,11,5,1,9,1,1,1,2,3,6,1,2,3,2,1,1,2,6,6,10,13,8,12,7,14,4,2,13,3,14,8,6,12,6,6,13,4,13,9,20,2,9,9,4,4,9,9,14,10,11,12,10,3,8,1,GK ,20,1,1,1,1,1,1,1,1,1,1,1,1,1,1
19162786,Marcão,1651,26/04/1990,26,0,0,0,0,184,82,3,2,2,3,3,2,3,2,3,1,3,3,1,1,5,7,1,11,3,1,12,7,2,13,5,7,13,9,7,9,1,12,9,7,10,6,13,6,7,13,10,7,11,20,15,13,10,5,7,9,5,9,5,9,17,11,10,12,12,3,14,8,D C,1,1,1,1,1,1,20,1,1,1,1,1,1,1,1
19162787,Maceió,1651,13/04/1991,25,0,0,0,0,177,75,1,3,1,2,2,2,3,2,4,1,2,5,6,13,13,13,7,13,8,3,5,8,6,4,10,10,11,7,7,8,7,7,5,10,11,9,5,7,6,13,13,8,12,9,13,13,20,10,8,10,7,10,8,10,17,10,12,10,10,1,10,6,S ,1,1,20,1,1,1,1,1,1,1,1,1,1,1,1
19162788,Rogerinho,1651,01/03/1991,25,0,0,0,0,177,69,2,2,3,1,2,2,2,2,3,2,2,5,9,9,9,11,7,7,7,2,6,12,6,6,14,8,9,1,9,8,9,9,3,13,4,9,9,8,11,14,14,12,8,10,9,14,20,14,7,9,8,9,5,9,20,11,10,12,10,1,7,2,M C,1,1,1,15,1,1,1,1,1,1,20,13,13,1,1
19162789,Guto,1651,05/02/1992,24,0,0,0,0,179,72,3,3,1,1,2,2,2,2,1,3,3,6,6,8,7,9,6,5,11,1,8,9,3,6,13,9,6,8,11,6,10,7,9,13,8,7,6,7,12,13,13,7,9,10,9,13,20,12,5,7,9,1,8,9,19,11,11,13,11,3,8,4,M/AM C,1,1,1,18,1,1,1,1,1,1,20,1,1,1,1
19162813,Abuda,1651,22/01/1989,27,0,0,0,0,176,73,1,1,3,1,3,2,2,4,3,1,1,9,11,12,8,12,7,12,11,8,13,11,8,15,11,16,14,13,11,13,11,12,14,10,10,12,12,15,15,13,12,13,11,7,13,13,20,13,13,12,8,11,8,13,15,12,11,13,11,8,4,7,DM/M C,1,1,1,2,1,1,1,1,14,20,18,1,1,1,5
19162817,Claudinho,1651,19/05/1990,26,0,0,0,0,183,0,3,1,1,2,1,1,2,2,1,2,2,5,5,3,1,7,5,12,1,1,11,4,5,12,6,9,10,9,3,11,4,12,9,5,8,4,12,5,7,12,11,5,10,10,13,12,20,9,11,9,9,7,9,9,10,11,13,10,9,8,16,7,D C,1,1,1,1,1,1,20,1,1,15,5,1,1,1,1
19162819,Julio Abú,1651,13/04/1988,28,0,0,0,0,170,73,1,3,2,3,2,1,1,2,2,3,2,6,4,12,13,13,6,8,7,1,6,10,5,7,8,7,9,7,8,7,12,10,1,8,10,12,6,7,8,13,13,13,4,10,9,13,20,13,6,9,7,1,9,9,11,11,13,11,11,1,15,6,AM C,1,1,15,20,1,1,1,1,1,1,1,1,1,1,1
19162820,Paulo Sérgio,1651,17/08/1989,26,0,0,0,0,177,77,2,2,2,1,3,2,1,2,2,3,2,6,8,12,9,12,5,9,6,1,5,5,3,4,7,9,9,6,8,6,7,11,9,9,11,10,6,4,7,12,12,10,6,15,16,12,20,12,9,9,9,9,7,9,9,10,10,14,10,7,9,6,S R,1,1,20,1,1,15,1,1,1,1,1,1,1,1,1
19162830,Alex Telles,1651,15/12/1992,23,0,0,0,0,181,73,2,1,3,1,3,2,1,2,1,3,1,14,16,13,8,14,12,8,9,8,12,13,8,14,14,14,14,13,13,13,11,13,13,14,9,14,13,13,14,16,14,13,11,20,14,15,9,14,10,14,6,13,7,13,13,12,12,15,14,10,12,7,D/WB L,1,1,1,1,10,1,1,20,1,1,1,15,1,19,1
19162831,Celsinho,1651,15/03/1988,28,0,0,0,0,183,73,1,2,1,1,2,3,2,3,3,2,3,7,7,8,8,9,14,8,7,3,10,9,6,9,9,10,11,10,8,7,7,13,1,2,13,8,10,9,9,14,14,9,11,11,11,14,20,14,11,10,8,10,10,10,8,10,12,9,9,5,6,1,D R,1,1,1,1,1,1,1,1,20,1,1,1,1,1,15
19162856,Quiroga,1651,07/06/1994,22,0,0,0,0,173,65,1,3,3,3,2,2,2,4,2,2,4,5,5,4,5,14,8,8,11,7,11,13,1,14,14,10,11,9,10,8,11,14,10,7,1,5,10,9,12,9,11,9,4,7,7,13,20,8,8,10,7,10,10,10,10,12,12,12,13,6,12,2,DM/M C,1,1,1,1,1,1,1,1,1,20,18,1,1,1,1
19162857,Samir,1651,05/12/1994,21,0,0,0,0,188,88,1,1,2,1,1,1,2,3,2,1,1,6,7,10,6,11,7,12,7,8,13,11,10,14,11,13,13,10,13,11,10,11,12,12,11,9,13,14,14,14,14,14,12,20,9,13,12,14,13,9,10,11,15,13,20,11,13,13,9,8,14,7,D C,1,1,1,1,1,1,20,14,1,14,1,1,1,1,1
19162859,Fernandinho,1651,16/03/1993,23,0,0,0,0,174,74,2,1,2,1,2,2,3,2,4,1,1,8,10,14,11,12,8,7,14,1,6,12,10,5,12,9,10,8,12,11,11,12,2,15,5,12,5,11,12,16,13,9,10,20,12,15,8,10,9,10,7,13,9,8,10,10,10,9,10,11,8,1,AM RLC,1,1,15,20,20,20,1,1,1,1,13,13,1,1,1
19162860,Jonas Maia,1651,08/03/1993,23,0,0,0,0,176,64,2,1,2,2,1,1,1,2,1,4,3,10,8,9,8,13,6,3,8,6,5,11,1,6,13,7,7,7,5,7,10,12,5,13,4,8,7,7,5,13,13,7,7,20,10,13,8,5,6,9,7,9,4,9,17,11,14,9,5,1,12,14,M/AM LC,1,1,1,20,18,1,1,1,1,1,18,16,1,1,1
19162944,Rayro,1651,04/12/1985,30,0,0,0,0,175,0,1,4,3,2,2,1,3,1,1,2,3,9,13,12,5,9,8,6,3,13,11,11,5,11,12,10,12,12,11,12,12,10,11,7,9,13,12,13,13,14,13,12,9,20,13,13,8,14,9,10,8,11,8,12,10,11,10,11,12,11,8,9,D L,1,1,1,1,1,1,1,20,1,1,1,13,1,15,1
19162952,Robinho,1651,09/08/1988,27,0,0,0,0,162,62,3,1,3,2,3,1,2,1,1,1,1,8,8,12,11,14,5,8,10,5,4,11,6,5,12,8,11,7,8,6,14,10,3,10,6,11,7,8,11,14,13,6,3,10,13,15,20,12,4,10,10,10,7,10,18,9,12,12,11,6,9,6,AM C,1,1,1,20,1,1,1,1,1,1,10,1,1,1,1
19162953,Djalma,1651,01/01/1990,26,0,0,0,0,166,65,4,1,1,3,4,3,3,3,3,1,3,12,14,12,10,14,8,6,5,8,8,11,5,6,14,10,9,8,11,8,7,14,5,13,2,10,6,9,13,12,11,6,4,20,11,14,10,13,5,10,6,10,3,10,10,11,9,12,11,4,9,7,M/AM LC,1,1,1,20,20,1,1,1,1,1,1,18,1,1,1
19162954,Tobias,1651,09/02/1991,25,0,0,0,0,193,0,1,2,3,1,1,1,1,2,2,2,2,3,1,1,5,6,1,12,1,1,8,6,1,12,5,9,8,6,5,10,2,12,5,8,6,5,12,5,6,12,11,6,13,9,13,10,20,8,8,9,8,4,9,9,7,12,11,12,10,1,19,1,D C,1,1,1,1,1,1,20,1,1,1,1,1,1,1,1
19163097,Alessandro Celin,1651,11/09/1989,26,0,0,0,0,191,85,3,3,2,1,1,1,1,3,1,3,2,2,5,9,11,6,4,10,7,4,5,9,8,5,9,11,9,10,10,12,11,10,5,9,9,11,8,10,10,12,11,9,14,7,10,11,20,12,12,7,8,10,7,6,12,11,12,11,9,11,15,3,S ,1,1,20,1,1,1,1,1,1,1,1,1,1,1,1
19163101,Morato,1651,01/09/1992,23,0,0,0,0,170,70,2,1,2,3,3,1,2,3,1,2,3,8,8,13,11,13,7,8,11,6,8,14,3,8,13,9,10,6,8,9,11,14,8,14,10,12,9,8,10,12,13,9,4,10,14,13,20,10,11,10,10,3,6,10,15,11,10,12,12,6,8,6,AM C,1,1,1,20,1,1,1,1,1,1,10,1,1,1,1
19163111,Ronan,1651,29/08/1994,21,0,0,0,0,177,66,3,3,3,2,3,3,3,2,3,2,1,11,10,12,5,13,8,8,12,8,8,12,11,8,13,11,11,11,11,12,11,10,11,13,10,12,7,12,12,13,13,12,8,20,12,13,5,13,8,10,6,11,10,13,6,12,12,12,8,7,11,8,D/WB L,1,1,1,1,1,1,1,20,1,1,1,1,1,18,1
19163115,Fábio Alves,1651,29/03/1988,28,0,0,0,0,184,72,3,3,2,1,4,2,4,1,2,4,1,7,5,9,6,11,4,8,8,7,10,7,5,14,9,9,10,9,4,8,6,12,3,7,11,7,12,10,10,10,13,10,11,20,16,14,10,14,11,10,7,7,10,10,9,11,11,14,13,12,7,8,D/WB L,1,1,1,1,1,1,1,17,1,1,1,1,1,20,1
19163179,Charles,1651,26/04/1988,28,0,0,0,0,188,83,3,2,3,2,4,2,3,1,1,2,3,3,4,6,5,8,8,13,7,6,13,8,8,15,9,13,12,14,10,9,6,12,13,11,11,11,13,14,15,13,11,10,14,10,13,12,20,14,15,12,13,13,6,5,13,12,9,10,10,9,6,6,D C,1,1,1,1,1,1,20,1,1,1,1,1,1,1,1
19163197,Tony,1651,17/07/1993,22,0,0,0,0,186,83,2,1,3,1,2,3,2,3,4,1,2,1,7,9,10,9,6,10,8,4,4,8,4,4,9,7,7,8,9,9,9,9,8,8,9,5,6,8,7,9,10,10,11,13,13,9,20,11,14,9,5,3,8,8,20,10,13,11,9,7,15,8,S ,1,1,20,1,1,1,1,1,1,1,1,1,1,1,1
19163219,Luan,1651,08/03/1994,22,0,0,0,0,182,75,3,3,3,1,1,2,3,1,2,1,3,4,2,6,4,3,1,10,6,3,13,8,2,13,6,10,9,13,6,6,4,13,3,1,12,6,6,6,8,13,13,7,11,9,16,13,20,6,8,9,10,9,9,9,15,13,7,13,9,1,10,5,D C,1,1,1,1,1,1,20,1,1,13,3,1,1,1,1
19163220,Paulinho,1651,27/08/1993,22,0,0,0,0,173,0,1,3,3,1,3,2,1,1,1,1,1,7,10,9,2,14,3,6,8,1,9,10,1,13,10,4,10,8,7,14,10,12,9,8,2,9,8,9,10,15,12,4,6,20,11,11,10,14,8,9,9,9,9,9,12,12,12,13,10,4,18,3,D/WB L,1,1,1,1,1,1,1,18,1,1,1,1,1,20,1
19163221,Wemerson,1651,20/02/1994,22,0,0,0,0,174,70,2,2,3,3,1,3,2,2,2,1,1,4,3,3,2,13,5,6,4,3,7,12,1,13,8,6,11,4,6,8,5,14,8,8,10,6,7,7,9,9,12,7,7,10,12,11,20,6,4,8,8,8,8,8,9,12,11,12,13,5,2,1,DM ,1,1,1,1,1,1,1,1,1,20,10,1,1,1,1
19163223,Deco,1651,01/06/1994,22,0,0,0,0,177,0,1,1,4,2,1,2,1,2,1,2,1,5,5,6,1,8,1,7,3,3,9,9,2,12,9,9,6,8,8,10,6,6,8,9,1,8,7,8,8,14,14,8,6,20,13,14,9,11,7,9,6,1,4,9,13,10,11,11,10,4,1,3,D/WB L,1,1,1,1,1,1,1,18,1,1,1,1,1,20,1
19163257,Jocinei,1651,05/12/1993,22,0,0,0,0,178,0,1,3,2,1,3,2,3,3,3,1,2,8,8,7,2,12,6,5,4,4,10,9,3,13,10,9,12,6,7,12,8,13,9,9,6,9,10,9,9,15,12,6,6,8,12,12,20,6,7,9,7,9,6,9,11,12,13,11,10,5,5,1,D/WB R,1,1,1,1,1,1,1,1,18,1,1,1,1,1,20
19163288,Edilberto,1651,04/01/1991,25,0,0,0,0,167,65,3,3,2,3,3,2,3,4,1,2,2,3,4,1,6,9,6,10,6,2,13,8,1,14,6,9,13,9,7,9,4,14,8,7,12,7,14,7,8,14,14,8,4,20,13,12,6,11,5,9,6,5,8,9,12,12,10,11,12,1,8,4,D C,1,1,1,1,1,1,20,13,1,1,1,1,1,1,1
19163332,Sander,1651,03/10/1990,25,0,0,0,0,185,0,1,3,1,2,1,1,3,2,2,3,2,8,10,9,4,14,5,7,5,6,8,10,1,14,10,9,11,6,9,8,7,14,10,10,7,9,11,10,10,14,13,10,14,20,17,12,10,14,8,10,6,10,8,10,11,11,11,11,13,1,4,3,D/WB L,1,1,1,1,1,1,1,17,1,1,1,1,1,20,1
19163417,Rildo,1651,20/03/1989,27,0,0,0,0,180,67,2,2,2,2,3,3,2,1,2,3,1,10,13,15,11,12,5,9,11,8,8,11,10,5,12,15,12,15,11,11,12,11,12,14,8,12,6,13,14,16,16,8,9,7,10,16,20,13,10,12,14,11,15,13,12,12,9,10,7,5,7,12,AM RLC,1,1,15,18,20,18,1,1,1,1,1,1,1,1,1
19163419,Jérson,1651,23/11/1986,29,0,0,0,0,176,66,1,1,3,3,3,2,1,3,4,4,4,8,6,4,11,13,8,8,14,3,6,12,13,5,13,10,12,9,9,9,13,14,4,13,9,12,5,9,11,15,12,6,5,10,11,12,20,12,6,10,10,10,9,10,18,11,12,11,10,8,14,2,M C,1,1,1,10,1,1,1,1,1,15,20,1,1,1,1
19163428,Ruan,1651,28/03/1990,26,0,0,0,0,195,89,15,9,9,1,14,12,9,12,7,10,8,3,3,3,3,6,6,1,1,1,1,3,5,1,5,5,8,13,9,11,8,13,5,1,13,2,9,9,8,11,10,14,16,11,3,9,20,7,14,10,7,9,8,10,13,13,12,11,9,1,5,4,GK ,20,1,1,1,1,1,1,1,1,1,1,1,1,1,1
19163483,Thiago Cazé,1651,12/03/1990,26,0,0,0,0,184,0,3,1,4,2,3,2,2,3,1,2,3,3,7,8,4,9,3,10,6,10,11,10,6,12,11,13,8,11,9,9,6,8,10,6,7,5,12,9,13,12,10,11,12,9,14,13,20,12,11,14,7,13,4,17,11,13,11,11,10,4,16,6,D/WB RLC,1,1,1,1,1,1,20,19,19,1,1,13,12,18,18
19163495,Marquinhos,1651,14/05/1994,22,11,0,0,0,183,72,3,3,2,3,3,1,2,1,3,2,2,4,11,9,8,13,4,14,10,7,15,12,8,16,14,14,15,15,14,16,12,14,18,10,12,8,16,18,15,14,13,15,13,12,14,15,20,15,13,15,8,15,8,15,14,14,12,14,16,15,15,7,D RC,1,1,1,1,1,1,20,1,15,13,1,1,1,1,1
19163496,Matheus Barbosa,1651,18/08/1994,21,0,0,0,0,184,0,2,2,3,1,2,2,2,3,3,3,1,6,4,4,5,14,7,8,8,1,7,5,5,13,9,9,14,8,6,7,5,12,9,5,14,7,13,6,11,14,13,8,12,9,12,13,20,7,8,9,9,2,6,9,16,10,11,11,13,7,17,4,DM ,1,1,1,1,1,1,13,1,1,20,10,1,1,1,1
19163501,Jonathan,1651,11/07/1994,21,0,0,0,0,178,72,1,1,4,2,2,2,1,1,3,2,4,4,4,6,5,12,1,8,7,7,9,9,4,8,7,9,7,9,7,11,6,14,6,9,8,7,6,8,8,14,11,6,9,20,10,12,8,7,7,9,9,3,6,9,17,14,13,11,10,11,3,3,D/WB L,1,1,1,1,1,1,1,20,1,1,1,1,1,18,1
19163503,Hernâni,1651,27/03/1994,22,0,0,0,0,188,77,2,3,3,3,3,2,1,3,3,3,1,10,10,11,12,12,12,13,12,13,14,12,11,15,12,11,13,11,13,13,13,12,11,10,13,11,13,12,14,12,13,12,14,12,15,11,20,12,12,11,12,11,12,12,17,10,11,11,11,12,10,7,DM ,1,1,1,1,1,1,1,1,1,20,10,1,1,1,1
19163504,Matheus Kayser,1651,29/12/1994,21,0,0,0,0,194,93,12,6,5,1,12,11,7,12,8,8,7,5,1,3,2,2,8,1,1,1,3,1,1,1,1,7,5,11,3,10,4,12,4,2,10,3,2,5,3,10,15,5,15,7,13,8,20,1,9,8,6,8,8,8,19,11,9,10,11,6,12,7,GK ,20,1,1,1,1,1,1,1,1,1,1,1,1,1,1
19163540,Dória,1651,08/11/1994,21,1,0,4,0,189,84,1,2,2,3,2,3,2,3,1,3,2,5,5,10,6,11,11,15,10,12,14,11,11,14,11,10,13,12,11,12,10,11,12,12,12,10,12,14,12,14,13,14,15,20,15,13,6,14,15,11,5,15,5,6,6,8,10,12,10,12,10,12,D C,1,1,1,1,1,1,20,1,1,1,1,1,1,1,1
19163897,Igor Julião,1651,23/08/1994,21,0,0,0,0,175,62,1,3,2,2,2,3,1,3,3,2,1,12,12,12,11,13,11,9,11,8,9,12,11,11,14,12,12,10,12,12,13,11,12,12,9,13,8,12,11,15,13,5,7,10,12,15,20,13,7,11,6,10,7,13,9,13,10,10,11,6,10,7,D/WB R,1,1,1,1,1,1,1,12,20,1,10,1,10,11,19
19164028,Dieguinho,1651,07/06/1992,24,0,0,0,0,178,65,1,1,1,4,3,4,1,3,1,2,3,11,11,14,9,13,11,8,11,3,4,12,12,4,14,11,7,8,8,6,11,8,12,16,4,11,5,7,7,15,15,13,8,10,11,15,20,10,10,8,6,11,9,12,7,14,9,12,12,5,12,8,AM/S RLC,1,1,16,15,20,17,1,1,1,1,1,12,12,1,1
19164155,Edigar Junio,1651,06/05/1991,25,0,0,0,0,174,72,3,3,3,2,2,1,2,1,3,1,2,5,10,12,13,13,7,12,12,6,10,12,13,10,13,12,11,13,11,10,11,10,13,13,11,13,10,12,14,14,14,11,7,12,13,13,20,14,11,11,6,11,13,10,12,11,12,11,13,7,10,6,AM/S L,1,1,20,1,17,14,1,1,1,1,1,1,1,1,1
19164157,Erwin,1651,29/04/1994,22,0,0,0,0,182,0,2,2,2,3,2,2,3,1,4,1,2,2,3,2,1,7,1,13,3,1,13,5,1,13,6,9,8,9,6,11,4,13,9,7,13,6,13,6,7,13,10,7,10,10,12,11,20,5,7,9,3,8,9,9,19,11,12,9,12,12,8,1,D C,1,1,1,1,1,1,20,1,1,1,1,1,1,1,1
19164167,Gideão,1651,19/12/1987,28,0,0,0,0,191,89,14,11,11,11,10,12,7,14,8,14,10,4,2,2,2,4,7,5,1,3,3,5,2,1,6,10,10,12,8,12,6,11,9,1,12,1,13,13,13,8,11,14,16,8,7,11,20,10,14,13,2,10,3,10,13,10,10,4,9,12,10,5,GK ,20,1,1,1,1,1,1,1,1,1,1,1,1,1,1
19164169,Douglas Santos,1651,02/02/1991,25,0,0,0,0,173,76,1,3,3,1,3,2,1,1,2,3,1,6,13,9,8,13,5,8,8,4,10,9,3,14,10,7,8,9,10,7,6,13,2,5,4,9,11,9,9,14,14,9,5,10,10,14,20,14,6,10,10,4,10,10,17,10,11,10,11,6,14,4,D/WB R,1,1,1,1,1,1,1,1,20,1,1,1,15,1,18
19164174,Philip,1651,08/05/1991,25,0,0,0,0,166,64,3,2,2,2,3,2,1,1,1,3,3,9,8,8,10,12,9,4,10,6,11,11,8,11,12,10,9,10,11,11,11,15,6,10,2,12,11,10,14,15,15,10,2,1,9,15,20,11,9,10,9,10,10,10,17,10,11,12,9,6,4,3,M C,1,1,1,1,1,1,1,1,1,1,20,1,1,1,1
19164176,Marcos Vinícius,1651,24/12/1994,21,0,0,0,0,177,74,1,3,1,4,1,1,3,3,4,4,3,9,10,15,13,13,9,9,13,5,6,11,10,7,12,10,12,13,11,11,13,12,11,14,8,13,7,9,14,15,16,10,10,10,13,14,20,11,11,10,7,10,13,14,9,11,10,11,10,7,11,7,AM/S C,1,1,18,20,1,1,1,1,1,1,15,1,1,1,1
19164217,Kénnio,1651,04/09/1986,29,0,0,0,0,191,0,2,3,3,1,3,1,3,2,2,2,4,4,9,10,8,9,2,7,6,3,5,7,5,5,10,9,8,8,5,8,7,13,1,13,11,10,4,7,8,13,13,7,15,10,7,13,20,12,10,9,8,9,9,9,20,10,12,11,10,6,11,1,D/WB R,1,1,1,1,1,1,1,1,20,1,1,1,1,1,18
19164261,Diogo Campos,1651,31/12/1990,25,0,0,0,0,174,73,3,2,3,1,2,1,2,2,3,2,3,7,11,13,11,13,8,6,10,7,3,11,8,5,13,11,12,11,12,11,12,13,12,13,6,12,5,10,11,15,14,10,7,10,13,14,20,7,10,10,11,3,9,10,7,10,12,9,10,6,11,9,S ,1,1,20,1,1,1,1,1,10,1,1,1,1,1,10
19164366,Pablo,1651,23/06/1992,24,0,0,0,0,185,77,3,1,2,2,2,3,2,3,2,2,4,11,12,13,13,11,11,12,12,10,10,15,12,12,13,12,13,12,12,13,13,12,15,11,11,12,12,11,14,14,14,12,11,12,13,13,20,13,14,12,12,12,11,15,14,8,12,10,9,7,10,12,S ,1,1,20,7,10,13,1,1,10,1,10,1,1,1,10
19164401,Alexandre Cajuru,1651,12/07/1992,23,0,0,0,0,190,84,10,13,11,12,14,11,12,12,12,12,13,5,1,2,1,4,8,1,3,3,2,2,3,3,6,11,12,12,12,12,13,10,10,12,12,12,12,11,12,11,12,12,12,11,12,12,20,12,12,11,11,10,12,10,9,12,12,12,11,8,6,3,GK ,20,1,1,1,1,1,1,1,1,1,1,1,1,1,1
19164405,Vitor Miranda,1651,07/04/1992,24,0,0,0,0,174,0,3,3,3,3,2,3,2,1,3,3,3,6,6,5,10,15,9,5,11,6,12,15,6,11,13,8,11,9,9,10,8,14,5,1,12,9,11,10,13,15,13,10,8,1,15,14,20,12,10,10,5,10,9,10,17,10,10,13,12,8,6,1,DM ,1,1,1,1,1,1,1,1,1,20,10,1,1,1,1
19164511,Matheus Nogueira,1651,15/09/1993,22,0,0,0,0,186,86,1,1,1,3,4,2,3,3,1,1,2,5,8,10,12,11,9,12,11,7,5,10,13,4,9,11,9,12,11,9,8,10,4,10,4,11,10,12,12,11,10,13,13,8,13,11,20,12,13,9,10,8,4,10,18,11,13,11,13,10,14,4,S ,1,1,20,1,1,1,1,1,1,1,1,1,1,1,1
19164545,Hugo Ragelli,1651,02/05/1995,21,0,0,0,0,186,80,3,2,1,1,1,3,3,3,2,3,2,4,8,10,12,12,5,13,10,5,5,11,13,7,12,8,12,11,11,11,10,12,11,10,8,13,9,11,12,12,11,13,12,12,11,11,20,13,13,9,6,11,8,10,14,12,5,10,12,10,11,11,S ,1,1,20,1,1,1,1,1,1,1,1,1,1,1,1
19164586,Tom,1651,30/10/1991,24,0,0,0,0,196,0,14,8,14,10,14,12,11,8,10,5,8,6,3,3,2,3,10,1,2,3,1,1,3,1,6,8,7,12,9,11,8,14,4,2,13,3,13,9,8,13,13,4,16,10,11,13,20,7,11,10,4,7,8,9,20,10,11,12,11,9,5,4,GK ,20,1,1,1,1,1,1,1,1,1,1,1,1,1,1
19164656,Daniel Amorim,1651,15/09/1989,26,0,0,0,0,191,83,2,2,2,2,3,1,2,1,1,1,1,8,8,12,12,14,6,14,8,5,7,6,5,1,13,10,10,5,11,9,7,14,7,12,3,14,9,8,9,14,11,6,12,11,16,12,20,10,10,10,10,5,8,10,11,9,11,13,11,7,6,7,S ,1,1,20,1,1,1,1,1,1,1,1,1,1,1,1
19164664,Fabrício,1651,07/01/1986,30,0,0,0,0,192,93,13,9,7,1,13,9,7,13,4,6,8,7,1,2,2,2,9,1,2,2,2,1,2,2,4,9,11,10,6,6,6,13,4,2,12,1,9,7,6,12,11,5,15,10,13,10,20,4,16,9,6,9,8,9,14,11,13,12,10,4,14,1,GK ,20,1,1,1,1,1,1,1,1,1,1,1,1,1,1
19164696,Guilherme Placca,1651,01/07/1994,22,0,0,0,0,180,74,3,1,2,1,4,2,1,1,3,4,3,8,7,4,7,13,8,8,8,5,12,10,3,12,12,10,11,9,8,9,9,14,10,7,8,8,10,9,12,11,13,4,6,9,14,14,20,8,9,10,5,10,7,10,14,13,11,9,13,3,8,2,DM ,1,1,1,1,1,1,1,1,1,20,13,1,1,1,1
19164699,João Emir,1651,17/03/1989,27,0,0,0,0,176,70,3,2,3,1,3,1,1,2,1,2,2,12,9,11,7,13,12,7,6,9,11,13,11,8,14,9,13,10,12,12,13,13,2,13,5,11,12,12,10,6,8,11,6,10,6,7,20,15,10,9,9,9,9,9,16,12,9,12,8,6,10,2,M/AM C,1,1,1,19,1,1,1,1,1,15,20,1,1,1,1
19164730,Zé Mário,1651,20/02/1992,24,0,0,0,0,175,0,3,3,1,1,3,1,1,3,1,3,4,10,9,12,9,11,9,9,10,9,13,13,10,13,13,13,13,11,12,11,12,10,11,14,10,11,12,12,13,15,15,5,8,20,12,13,11,13,5,11,12,12,7,14,13,12,11,12,10,9,10,7,DM C,1,1,1,1,1,1,1,13,1,20,15,1,1,13,1
19164857,Victor Esquerdinha,1651,08/01/1992,24,0,0,0,0,166,65,1,2,1,2,2,1,3,3,1,3,1,5,8,9,9,13,7,2,7,7,4,12,4,3,12,6,9,9,10,8,11,13,3,12,12,10,4,8,7,14,14,5,2,20,16,12,10,10,5,10,4,10,6,10,20,11,12,10,11,5,4,7,AM LC,1,1,1,20,13,1,1,1,1,1,15,15,1,1,1
19164859,Bruno Pires,1651,05/12/1992,23,0,0,0,0,184,80,2,3,3,4,1,2,2,3,2,1,1,9,6,12,5,11,7,11,7,8,12,10,1,11,10,7,13,12,13,14,9,15,11,8,6,9,12,10,13,12,13,12,10,8,14,14,20,12,12,12,5,10,11,11,14,10,11,11,10,7,10,5,D C,1,1,1,1,1,1,20,1,1,1,1,1,1,1,1
19164863,Diogo Mateus,1651,13/02/1993,23,0,0,0,0,173,67,2,1,2,2,3,3,1,1,2,3,3,12,12,12,11,14,10,8,12,12,8,12,11,10,12,11,13,11,12,8,11,10,12,14,5,14,8,12,13,15,15,13,6,7,13,14,20,15,7,11,12,10,5,14,10,12,11,13,12,6,12,6,D/WB R,1,1,1,1,1,1,1,1,20,1,1,1,11,1,18
19164866,Marquinhos Lopes,1651,15/01/1991,25,0,0,0,0,187,0,3,1,1,3,3,1,4,3,1,2,2,7,3,1,6,8,2,12,2,1,9,8,4,14,7,9,11,9,8,7,6,8,9,8,11,7,14,7,8,14,12,8,14,17,15,10,20,10,12,9,9,9,5,9,13,11,12,12,9,2,9,3,D C,1,1,1,1,1,1,20,1,1,1,1,1,1,1,1
19164867,Marcos Vilela,1651,10/07/1992,23,0,0,0,0,177,0,1,3,1,2,2,3,3,4,3,2,2,5,6,8,8,10,6,4,5,1,7,9,3,8,13,9,12,5,9,7,13,9,3,13,13,11,5,7,10,13,13,7,6,10,16,13,20,13,7,9,8,9,9,9,8,13,11,12,11,7,7,1,AM C,1,1,1,20,1,1,1,1,1,1,15,1,1,1,1
19164900,Luan,1651,10/05/1993,23,0,0,0,0,188,79,3,3,1,2,2,3,3,1,2,1,2,5,10,12,10,13,8,13,6,8,15,11,13,15,13,15,14,16,13,12,11,12,12,7,14,11,14,15,15,14,13,13,14,6,15,14,20,15,13,14,6,15,7,13,11,13,12,12,11,7,12,7,D C,1,1,1,1,1,1,20,1,14,1,1,1,1,1,12
19164939,David,1651,29/01/1992,24,0,0,0,0,190,73,14,10,8,1,13,14,10,14,4,4,7,1,1,3,2,4,6,1,1,3,2,1,3,3,4,8,8,9,8,11,7,13,9,2,7,1,10,8,7,12,7,7,13,9,5,13,20,5,11,9,9,9,4,9,18,13,9,12,12,8,10,4,GK ,20,1,1,1,1,1,1,1,1,1,1,1,1,1,1
19164940,Welthon,1651,21/06/1992,24,0,0,0,0,180,74,3,2,2,3,4,1,3,1,3,1,2,10,11,14,12,12,11,9,13,6,5,13,9,6,14,14,12,14,11,14,13,12,13,11,8,14,8,12,14,14,13,16,11,20,16,15,8,13,13,12,13,12,4,11,13,12,8,11,13,7,12,5,AM/S R,1,1,20,1,13,17,1,1,1,1,1,1,1,1,1
19165023,Jefferson Maranhão,1651,06/08/1993,22,0,0,0,0,162,60,1,3,1,3,1,1,3,2,2,1,1,11,12,12,15,11,10,11,9,8,9,10,7,4,10,12,12,10,7,10,10,8,5,10,5,9,9,10,11,13,14,6,6,20,10,12,5,10,7,10,11,10,10,10,9,12,11,11,12,8,10,1,M/AM/S L,1,1,19,7,20,10,1,10,1,1,6,16,7,10,1
19165026,Diego Lima,1651,24/04/1986,30,0,0,0,0,190,90,13,6,5,1,13,13,11,13,9,4,10,3,1,2,3,2,5,1,3,1,1,2,2,1,2,9,6,13,5,8,6,9,6,3,10,2,8,7,5,11,15,7,14,10,14,10,20,1,10,9,7,9,9,9,7,10,11,12,9,9,3,1,GK ,20,1,1,1,1,1,1,1,1,1,1,1,1,1,1
19165029,Renato Camilo,1651,23/09/1993,22,0,0,0,0,184,73,2,3,2,3,3,2,3,2,2,2,1,4,1,1,2,4,2,13,6,1,13,7,4,13,3,9,12,9,6,7,4,13,9,6,5,5,13,6,7,10,8,7,10,10,8,9,20,6,8,9,9,3,9,9,9,12,10,12,12,7,6,8,D C,1,1,1,1,1,1,20,1,1,1,1,1,1,1,1
19165030,Renatinho,1651,14/09/1991,24,0,0,0,0,157,59,3,1,1,2,2,1,2,3,2,2,1,11,11,13,11,14,9,5,10,8,5,12,12,5,14,9,10,5,10,11,13,12,8,15,9,13,4,10,11,15,15,4,2,20,6,13,7,11,3,11,5,11,6,16,7,8,10,11,7,4,12,5,D/AM LC,1,1,1,20,16,1,1,19,1,1,14,15,1,15,1
19165097,William Pottker,1651,22/12/1993,22,0,0,0,0,180,78,3,3,3,2,1,2,2,1,2,2,2,10,10,14,14,12,12,9,12,10,6,12,13,5,14,10,12,12,14,13,11,14,12,14,10,12,6,12,12,15,13,12,10,20,11,16,12,11,12,15,9,11,6,8,18,14,10,9,10,7,10,7,AM/S R,1,1,20,1,13,19,1,1,1,1,1,7,10,1,1
19165124,Fábio Lima,1651,23/10/1993,22,0,0,0,0,178,71,3,1,3,2,3,3,3,3,3,2,3,6,8,10,12,14,8,8,12,2,8,14,8,9,14,4,12,4,12,9,12,13,10,13,1,7,9,8,12,14,14,9,5,11,14,14,20,8,8,10,6,10,7,10,20,13,11,11,12,6,11,6,AM C,1,1,1,20,1,1,1,1,1,1,10,1,1,1,1
19165130,Gustavo Rosa,1651,04/03/1992,24,0,0,0,0,190,76,2,2,2,1,1,2,3,2,2,3,2,3,2,3,1,9,5,14,6,7,9,9,2,14,5,10,10,10,8,10,5,11,10,4,14,7,14,8,8,14,14,9,16,5,12,14,20,6,12,10,6,10,4,10,15,10,12,11,10,7,8,2,D C,1,1,1,1,1,1,20,1,1,1,1,1,1,1,1
19165131,Bruno Felipe,1651,16/12/1993,22,0,0,0,0,174,64,3,2,3,3,2,3,1,1,4,2,3,4,9,9,9,14,8,8,7,8,10,10,7,14,11,10,10,9,10,9,6,14,13,10,6,9,12,9,10,14,14,9,8,20,9,14,11,8,7,10,9,10,9,10,9,9,13,10,10,6,11,4,D/WB/AM LC,1,1,1,18,1,1,1,20,1,1,1,1,1,18,1
19165133,Gabriel,1651,18/07/1989,26,0,0,0,0,187,80,1,1,3,2,3,3,1,2,3,3,3,6,5,5,4,9,2,14,4,3,12,9,6,14,8,10,11,10,6,7,8,14,10,1,11,6,14,8,9,14,11,9,8,8,15,11,20,14,12,10,7,2,9,10,20,11,9,8,9,8,11,7,D C,1,1,1,1,1,1,20,1,1,1,1,1,1,1,1
19165158,Alison,1651,01/03/1993,23,0,0,0,0,180,70,3,2,3,1,2,3,1,3,1,2,2,4,8,8,9,12,7,13,10,7,14,12,7,13,10,16,15,16,10,14,10,13,15,10,13,11,13,14,14,12,12,14,11,11,13,12,20,12,15,13,15,2,13,11,17,12,12,12,13,10,9,7,DM ,1,1,1,1,1,1,1,1,1,20,12,1,1,1,1
19165271,Daivison,1651,10/07/1992,23,0,0,0,0,180,75,3,3,3,1,1,1,3,3,1,2,2,6,3,13,13,13,6,13,6,6,6,5,9,1,13,9,12,8,10,7,7,8,4,13,13,11,6,6,7,13,11,4,5,8,10,13,20,11,9,9,6,8,8,9,16,11,9,11,7,9,6,4,S ,1,1,20,1,1,1,1,1,1,1,1,1,1,1,1
19165273,Zé Antônio,1651,13/08/1990,25,0,0,0,0,187,77,3,3,1,4,3,1,4,3,3,1,1,7,3,2,5,8,3,14,6,3,14,8,3,11,4,9,12,9,8,7,1,9,1,2,4,7,12,7,7,14,10,8,14,10,16,13,20,7,11,8,6,9,6,9,7,10,9,12,11,4,2,4,D C,1,1,1,1,1,1,20,1,1,1,1,1,1,1,1
19165275,Richardson,1651,17/08/1991,24,0,0,0,0,173,69,1,2,3,2,3,2,3,4,1,2,3,8,8,9,9,11,6,11,11,8,15,10,7,15,10,15,11,14,9,8,9,11,13,8,12,11,14,15,15,13,13,10,9,10,13,13,20,15,15,14,14,12,8,7,13,10,12,12,10,9,10,9,DM/M C,1,1,1,1,1,1,1,1,1,20,18,1,1,1,1
19165278,Pingo,1651,10/01/1991,25,0,0,0,0,176,63,3,2,3,1,1,3,2,2,2,1,3,10,12,7,16,16,10,12,9,9,10,11,8,7,11,10,11,10,11,11,9,7,9,8,13,13,10,7,12,12,11,11,11,7,14,13,20,12,9,10,7,6,8,10,13,11,10,13,6,5,6,2,AM/S RL,1,1,16,1,16,20,1,1,1,1,1,1,1,1,1
19165313,Eduardo Mota,1651,24/02/1992,24,0,0,0,0,192,0,12,11,11,6,12,12,8,12,6,8,7,4,2,1,2,1,6,1,2,2,2,1,2,2,3,9,7,8,6,6,5,12,2,1,10,1,8,6,5,12,14,5,12,8,11,12,20,5,11,9,9,9,3,9,16,13,10,9,13,2,11,5,GK ,20,1,1,1,1,1,1,1,1,1,1,1,1,1,1
19165336,Nick,1651,27/10/1989,26,0,0,0,0,178,0,3,1,3,1,3,2,3,3,1,2,2,7,5,8,7,14,5,7,11,3,9,8,4,14,12,9,13,8,8,9,12,11,9,9,14,6,14,8,7,14,13,7,9,2,12,14,20,11,7,9,8,5,8,9,16,11,11,11,10,1,6,8,DM C,1,1,1,1,1,1,1,1,1,20,15,1,1,1,1
19165368,Maringá,1651,22/08/1990,25,0,0,0,0,194,0,14,14,7,9,7,8,13,14,9,9,10,6,2,1,3,6,9,1,2,3,2,3,4,1,7,5,8,12,8,9,7,11,3,2,4,1,8,8,7,11,11,7,15,8,15,10,20,3,11,9,6,9,9,9,18,8,13,14,12,7,16,5,GK ,20,1,1,1,1,1,1,1,1,1,1,1,1,1,1
19165370,Hildo,1651,10/05/1990,26,0,0,0,0,176,0,2,3,1,3,2,3,2,4,1,1,3,7,4,9,9,13,7,7,6,1,7,13,6,7,13,10,10,3,10,4,10,9,4,13,9,10,9,8,11,13,13,8,6,10,17,13,20,10,5,10,9,10,9,10,14,11,9,10,12,10,15,7,AM C,1,1,1,20,1,1,1,1,1,1,15,1,1,1,1
19165409,Adriano,1651,15/02/1992,24,0,0,0,0,180,78,1,1,2,2,2,3,1,3,2,3,2,10,10,11,10,11,8,8,10,6,8,9,7,9,10,12,10,11,10,9,10,10,2,12,10,9,9,9,10,11,11,10,7,8,10,11,20,10,10,9,5,9,9,9,14,9,12,9,10,9,8,5,AM RLC,1,1,14,15,16,20,1,1,1,10,14,1,1,1,1
19165426,Jean Dutra,1651,27/01/1993,23,0,0,0,0,174,0,3,3,2,2,3,1,2,1,2,3,3,5,3,8,8,11,6,4,10,1,4,14,3,6,14,5,6,1,7,7,9,11,6,13,5,9,7,7,4,14,10,7,9,1,9,11,20,9,4,8,8,8,8,8,14,10,10,10,10,1,14,2,AM C,1,1,1,20,1,1,1,1,1,1,15,1,1,1,1
19165429,Renato,1651,12/09/1994,21,0,0,0,0,163,0,3,2,1,1,1,1,3,2,1,2,3,7,7,9,4,14,7,7,10,1,6,14,3,8,13,7,11,4,7,8,12,10,7,12,9,6,8,8,12,14,12,8,1,11,8,9,20,14,5,9,12,4,6,9,14,10,11,12,13,11,9,4,AM C,1,1,1,20,1,1,1,1,1,1,15,1,1,1,1
19165431,Alef,1651,10/09/1993,22,0,0,0,0,186,80,1,3,2,1,2,1,3,1,1,2,3,8,6,7,5,9,5,10,8,9,15,11,5,12,10,10,7,10,11,8,5,14,10,4,1,9,12,9,11,15,15,11,14,20,7,15,11,7,9,10,10,10,5,10,7,13,10,13,11,8,20,1,D LC,1,1,1,1,1,1,20,16,1,1,1,1,1,13,1
19165531,Caio,1651,14/12/1989,26,0,0,0,0,187,76,1,1,2,1,3,2,3,3,2,1,1,5,2,1,2,2,3,9,2,1,13,6,2,12,1,8,11,8,6,7,1,11,3,1,9,4,8,5,6,12,9,6,13,9,14,11,20,11,9,8,8,2,8,8,13,10,13,11,12,12,10,4,D C,1,1,1,1,1,1,20,1,1,1,1,1,1,1,1
19165537,Allan,1651,18/10/1989,26,0,0,0,0,189,90,3,3,1,2,3,3,1,2,1,3,2,4,2,9,12,11,4,8,2,2,4,6,9,1,7,8,5,1,10,4,7,10,7,8,3,12,5,4,6,12,12,5,12,7,12,12,20,11,7,8,8,8,7,8,18,10,10,12,10,5,2,7,S C,1,1,20,15,1,1,1,1,1,1,1,1,1,1,1
19165558,Jéferson Bahia,1651,28/05/1992,24,0,0,0,0,193,85,1,2,2,3,1,4,3,1,1,3,2,5,7,8,6,9,6,14,6,8,11,9,7,12,8,12,12,11,10,11,7,9,13,7,9,12,12,10,13,11,12,10,14,20,12,11,6,12,13,12,11,10,9,10,13,10,5,10,12,11,11,6,D C,1,1,1,1,1,1,20,1,1,1,1,1,1,1,1
19165576,Kattê,1651,16/09/1991,24,0,0,0,0,178,75,2,1,1,3,2,1,2,3,2,3,3,10,12,12,13,12,11,12,11,4,5,12,11,4,12,10,11,10,12,10,12,12,12,8,8,11,11,11,11,13,12,10,7,6,13,13,20,12,10,11,7,9,7,11,12,10,11,11,13,7,10,10,AM/S C,1,1,18,20,1,1,1,1,1,1,1,1,1,1,1
19165585,Walace,1651,25/05/1993,23,0,0,0,0,189,85,3,3,1,2,4,1,1,1,4,1,3,2,4,2,8,9,1,11,4,4,11,9,5,12,6,6,12,9,7,11,7,15,8,6,13,7,11,8,9,11,12,8,13,9,9,11,20,6,11,9,9,9,4,9,11,8,11,9,13,11,13,4,D C,1,1,1,1,1,1,20,1,1,1,1,1,1,1,1
19165586,Felipe Alves,1651,06/05/1990,26,0,0,0,0,183,71,2,2,4,1,1,1,2,2,2,2,3,7,12,11,12,11,5,12,7,1,6,7,5,4,12,9,10,11,6,7,4,12,2,13,12,11,6,6,7,12,12,7,10,14,16,12,20,12,8,10,8,2,7,10,8,9,14,10,12,1,2,7,AM/S R,1,1,20,1,13,17,1,1,1,1,1,1,1,1,1
19165587,André Nunes,1651,06/05/1992,24,0,0,0,0,184,79,1,3,2,3,2,2,2,1,4,1,3,6,4,5,7,10,8,11,9,1,9,10,6,13,9,7,12,10,9,10,6,14,11,7,10,8,14,8,10,14,14,9,9,20,8,14,10,12,7,10,4,10,10,10,11,12,11,10,13,11,12,9,D/DM C,1,1,1,1,1,1,20,1,1,18,1,1,1,1,1
19165588,Danilo Bahia,1651,18/11/1990,25,0,0,0,0,184,0,2,2,1,3,2,1,3,2,1,2,2,3,3,5,6,11,5,6,13,1,10,13,6,13,12,9,10,9,9,9,6,13,7,7,9,8,7,8,12,13,13,8,8,9,13,13,20,13,8,10,10,10,10,10,14,11,10,12,12,6,11,6,DM C,1,1,1,1,1,1,1,1,1,20,15,1,1,1,1
19165590,Jorginho,1651,15/08/1990,25,0,0,0,0,178,77,1,3,1,3,2,3,2,1,1,2,3,6,7,4,4,4,6,3,15,4,15,11,3,15,4,13,13,15,10,12,10,11,12,13,12,10,12,13,13,14,13,12,11,11,12,15,20,14,16,9,12,10,8,2,10,11,14,13,11,13,14,13,DM C,1,1,1,1,1,1,1,1,1,20,15,1,1,1,1
19165591,Magal,1651,28/07/1987,28,0,0,0,0,172,68,3,1,1,3,3,4,3,2,1,3,1,7,13,13,10,13,4,8,11,11,9,12,8,11,12,7,11,10,11,11,13,12,10,13,13,13,12,14,13,14,15,9,6,20,12,13,9,14,6,13,11,11,10,11,15,12,9,11,10,8,13,4,D/WB L,1,1,1,1,1,1,1,20,1,1,1,1,1,17,1
19165597,Hélder,1651,01/08/1991,24,0,0,0,0,177,70,3,3,3,2,1,3,2,2,1,1,1,8,6,3,8,13,7,8,12,7,11,12,4,14,14,10,13,9,9,8,9,14,4,5,10,7,11,9,12,14,13,9,4,10,8,14,20,13,5,10,10,9,8,10,20,12,13,9,11,5,15,7,DM ,1,1,1,1,1,1,1,1,1,20,10,1,1,1,1
19165602,Paulista,1651,28/04/1988,28,0,0,0,0,175,72,3,1,4,2,3,4,2,1,3,2,2,6,4,14,11,14,8,14,6,5,5,7,7,3,11,6,11,3,10,8,9,13,9,10,9,10,9,8,9,14,14,9,8,9,17,14,20,14,9,10,10,10,10,10,13,12,10,12,11,3,12,2,S ,1,1,20,1,1,1,1,1,1,1,1,1,1,1,1
19165603,Branquinho,1651,14/11/1989,26,0,0,0,0,170,65,3,1,3,2,3,3,3,3,1,2,1,8,11,13,12,10,8,6,6,8,6,12,11,6,13,9,10,9,11,8,11,10,10,12,9,10,11,10,10,14,14,6,8,10,12,13,20,10,6,11,9,11,10,12,19,10,12,10,8,4,7,4,AM/S R,1,1,20,1,1,18,1,1,1,1,1,1,1,1,1
19165604,Leandro Cearense,1651,22/04/1985,31,0,0,0,0,182,84,2,3,1,2,2,3,1,3,1,3,2,9,10,8,12,11,9,15,8,8,9,10,12,5,15,10,11,13,10,9,10,14,7,13,13,15,8,9,13,12,11,13,11,8,4,12,20,11,13,9,4,1,10,10,15,11,13,12,13,2,3,6,S ,1,1,20,1,1,1,1,1,1,1,1,1,1,1,1
19165607,Mateus,1651,30/08/1991,24,0,0,0,0,184,78,1,2,3,4,2,1,3,2,3,2,1,7,7,10,9,12,8,10,8,8,11,12,11,13,12,13,13,12,11,15,9,12,12,8,8,13,14,14,14,12,12,13,13,9,12,13,20,15,13,12,8,13,10,10,13,12,11,12,14,12,13,8,DM ,1,1,1,1,1,1,1,1,1,20,10,1,1,1,1
19165608,Renê Júnior,1651,16/09/1989,26,0,0,0,0,180,72,1,1,1,2,3,2,2,1,3,2,1,9,13,12,11,12,12,9,14,10,13,13,9,12,13,10,13,11,12,12,12,12,13,13,8,13,13,14,12,13,14,10,9,9,13,13,20,13,11,13,11,12,6,14,11,14,9,12,11,11,10,7,DM/M C,1,1,1,1,1,1,1,1,1,20,18,1,10,1,1
19165609,Janílson,1651,04/02/1986,30,0,0,0,0,181,0,2,3,1,3,2,1,3,2,1,3,3,4,7,12,1,7,4,8,7,1,9,9,4,11,9,9,13,13,7,13,7,11,4,9,14,7,7,8,13,14,14,8,10,20,12,13,10,11,7,9,6,6,9,9,19,10,11,9,13,1,12,7,D/WB L,1,1,1,1,1,1,1,20,1,1,1,1,1,18,1
19165628,Jefersom Berger,1651,15/12/1987,28,0,0,0,0,174,0,2,3,3,2,3,2,3,3,2,1,3,7,6,13,13,12,7,3,9,1,7,9,3,8,8,6,9,9,7,7,12,11,10,10,14,11,8,8,12,13,13,8,7,20,6,13,10,13,5,9,10,10,10,10,15,8,13,13,10,6,16,6,AM C,1,1,1,20,1,1,1,1,1,1,1,1,1,1,1
19165967,Léo Artur,1651,23/03/1995,21,0,0,0,0,177,68,2,3,3,3,2,1,2,2,4,1,3,14,10,13,12,11,8,10,10,7,8,12,2,4,14,6,9,4,9,9,12,13,13,14,1,11,9,9,6,13,13,9,9,15,16,13,20,13,7,14,9,8,10,10,8,13,14,13,13,6,12,5,AM/S LC,1,1,20,18,19,1,1,1,1,1,10,1,1,1,1
19165968,Yuri,1651,28/06/1994,22,0,0,0,0,181,76,3,3,3,2,2,1,2,2,2,2,2,6,7,9,9,13,6,12,6,1,6,6,9,6,12,6,11,7,13,7,4,12,9,12,10,13,5,6,7,13,13,7,9,10,15,13,20,6,7,9,7,9,9,9,13,14,11,10,12,7,9,6,S ,1,1,20,1,1,1,1,1,1,1,1,1,1,1,1
19166012,Igor João,1651,23/04/1993,23,0,0,0,0,184,79,3,3,3,2,2,1,2,2,3,3,1,1,2,1,3,6,2,10,5,1,13,7,3,12,2,9,6,9,4,5,4,13,6,3,12,6,13,6,7,13,13,7,11,10,10,12,20,8,9,9,9,3,9,9,8,12,11,11,12,10,10,8,D C,1,1,1,1,1,1,20,1,1,1,1,1,1,1,1
19166036,Lourival,1651,01/05/1995,21,0,0,0,0,168,57,1,2,3,2,2,3,2,2,2,4,1,6,9,12,13,12,8,10,11,5,4,11,12,4,13,8,12,9,11,7,11,9,7,15,4,14,7,10,9,14,15,7,6,9,10,13,20,11,6,12,6,10,4,11,8,10,10,11,8,6,8,8,AM/S L,1,1,20,10,18,11,1,1,1,1,1,12,7,1,1
19166115,Natanael,1651,25/12/1990,25,0,0,0,0,166,65,2,1,3,1,4,2,1,2,2,3,3,11,15,14,10,11,14,9,13,12,12,13,11,13,14,14,12,15,13,11,14,10,15,14,10,15,13,13,15,15,16,11,6,20,14,14,8,15,10,13,10,13,9,13,14,12,15,14,14,5,5,7,D L,1,1,1,1,10,1,1,20,6,1,1,10,1,15,6
19166117,Jean,1651,29/01/1987,29,0,0,0,0,178,69,3,2,2,1,3,1,2,3,2,1,3,6,4,2,7,12,4,6,4,1,12,11,2,13,8,9,10,8,7,8,8,8,5,9,5,7,11,7,12,13,13,6,8,20,14,13,4,11,6,9,9,6,9,9,20,11,12,9,8,10,12,7,DM/M C,1,1,1,1,1,1,1,1,1,20,18,1,1,1,1
19166175,Iuri,1651,27/05/1992,24,0,0,0,0,177,73,2,1,3,1,3,3,3,1,1,1,3,10,12,12,11,12,8,8,12,11,11,12,8,11,12,11,10,12,11,10,11,9,13,12,3,12,11,12,12,14,14,10,9,20,12,13,7,12,11,12,10,8,6,12,11,12,12,10,14,8,8,10,D/WB L,1,1,1,1,1,1,1,20,1,13,12,14,1,19,1
19166176,Agdon,1651,26/01/1993,23,0,0,0,0,176,75,1,2,2,3,3,3,1,1,1,3,1,4,6,11,11,12,4,12,10,4,3,9,13,4,12,11,10,9,11,7,9,8,12,13,6,13,7,9,12,13,11,11,8,10,14,13,20,10,9,12,7,1,5,6,8,13,10,11,12,11,8,3,AM/S L,1,1,20,14,17,1,1,1,1,1,1,1,1,1,1
19166179,Édson Magal,1651,21/06/1993,23,0,0,0,0,174,0,2,1,1,3,2,2,3,4,1,1,3,5,7,8,9,10,5,8,11,5,12,10,9,12,10,14,11,14,11,8,9,8,13,11,5,9,12,14,14,13,13,13,7,9,14,13,20,14,12,12,12,11,4,5,12,14,8,13,7,5,5,14,DM/M C,1,1,1,1,1,1,1,1,1,20,16,1,1,1,1
19166270,Guilherme Biteco,1651,12/03/1994,22,0,0,0,0,173,67,2,1,2,3,2,2,3,4,3,2,3,9,10,15,11,12,13,7,9,4,5,13,10,7,13,6,11,10,11,11,15,12,13,14,6,14,7,10,13,15,15,6,6,20,9,16,10,12,6,10,6,11,9,13,9,11,10,11,10,6,11,7,AM C,1,1,13,20,1,1,1,1,1,1,14,1,1,1,1
19166339,Odail Júnior,1651,25/10/1988,27,0,0,0,0,183,0,1,1,1,3,1,2,1,1,1,3,3,3,3,5,5,10,1,12,7,9,10,10,5,15,5,8,11,11,7,9,5,15,10,3,6,9,15,9,8,8,7,10,10,10,14,8,20,11,9,10,3,10,10,10,15,11,11,11,11,2,17,4,D C,1,1,1,1,1,1,20,1,1,1,1,1,1,1,1
19166366,Kariri,1651,21/02/1988,28,0,0,0,0,178,0,1,3,2,3,2,3,4,3,3,4,1,9,7,11,10,12,10,8,7,6,4,9,9,4,11,9,11,9,8,9,8,8,8,13,10,12,7,7,9,12,13,11,7,20,11,12,10,10,11,9,6,9,8,9,8,10,8,9,7,7,7,14,AM C,1,1,1,20,1,1,1,1,1,1,15,13,1,1,1
19166390,Kall,1651,22/12/1983,32,0,0,0,0,185,85,3,3,2,2,1,2,1,3,1,3,4,8,1,6,5,8,14,12,6,1,14,8,4,11,6,6,11,9,7,10,4,14,8,6,10,7,11,7,8,7,6,13,12,10,12,6,20,13,13,9,15,9,6,9,8,8,10,10,5,10,5,8,D C,1,1,1,1,1,1,20,1,1,1,1,1,1,1,1
19166458,Agnaldo,1651,11/03/1994,22,0,0,0,0,176,65,1,1,3,2,2,1,2,2,2,4,3,11,12,16,7,14,12,6,14,2,2,12,11,4,14,5,13,7,11,10,14,10,15,17,2,12,3,11,9,14,13,7,9,20,5,14,12,11,7,12,8,9,6,10,11,14,11,12,11,14,5,2,AM RLC,1,1,14,20,18,17,1,1,1,1,12,11,11,1,1
19166995,Leandro,1651,16/05/1990,26,0,0,0,0,190,0,2,3,2,3,3,1,3,3,1,2,1,3,1,2,1,6,5,9,3,1,11,6,1,11,3,8,10,8,6,8,1,8,5,1,7,5,13,5,6,13,9,6,12,4,13,10,20,10,10,8,8,6,7,8,20,10,12,9,9,1,1,8,D C,1,1,1,1,1,1,20,1,1,1,1,1,1,1,1
19167152,Fabinho,1651,26/07/1984,31,0,0,0,0,180,0,2,3,2,4,2,2,2,3,1,2,2,6,9,11,9,12,5,12,5,6,4,8,5,1,14,6,7,1,7,4,9,7,9,14,8,11,7,7,8,14,11,7,6,9,14,13,20,12,5,9,9,9,9,9,16,13,10,11,11,6,17,6,AM/S L,1,1,19,13,20,1,1,1,1,1,10,10,1,1,1
19167339,Renan,1651,19/03/1993,23,0,0,0,0,189,80,11,10,10,4,12,10,11,11,12,8,11,5,3,3,3,7,10,7,1,1,3,7,2,1,7,11,9,12,8,9,5,10,2,2,5,11,11,13,11,10,11,11,11,11,12,10,20,11,11,10,6,10,5,10,19,9,14,9,10,5,9,1,GK ,20,1,1,1,1,1,1,1,1,1,1,1,1,1,1
19167340,Mansur,1651,17/04/1993,23,0,0,0,0,182,74,3,3,3,3,2,2,1,2,2,1,3,11,12,12,11,11,4,6,11,12,12,12,10,11,12,11,12,12,11,9,11,11,13,13,4,12,11,12,12,15,15,10,11,20,13,15,5,14,8,12,7,12,8,13,11,11,8,12,11,12,12,12,D/WB L,1,1,1,1,12,1,1,20,1,1,1,13,1,19,1
19167341,Laércio,1651,03/02/1993,23,0,0,0,0,183,73,2,3,1,1,1,2,2,1,1,3,1,3,4,4,4,6,4,9,4,3,9,5,5,8,4,11,5,8,6,6,3,6,4,8,8,6,8,7,8,8,7,9,8,12,12,8,20,9,9,12,11,5,4,6,19,9,10,10,10,11,1,4,D C,1,1,1,1,1,1,20,1,1,1,1,1,1,1,1
19167342,Amorim,1651,04/01/1993,23,0,0,0,0,177,72,3,2,1,3,2,3,3,2,3,1,2,7,10,11,9,11,10,9,10,9,12,11,11,11,11,11,11,13,10,9,10,9,13,12,4,10,12,11,12,12,13,10,7,7,12,12,20,11,10,11,7,10,5,14,9,11,9,11,10,2,7,6,DM/M C,1,1,1,13,1,1,1,1,1,20,17,1,1,1,1
19167343,Ítalo Melo,1651,25/05/1993,23,0,0,0,0,175,71,3,3,1,2,2,3,2,3,3,3,4,11,10,11,10,11,11,6,11,5,5,11,11,5,12,6,10,8,10,10,12,10,12,15,7,11,7,7,10,14,14,5,6,8,13,13,20,11,7,12,6,4,5,8,12,9,13,9,10,7,7,7,M/AM RC,1,1,14,20,14,19,1,1,1,1,17,10,14,1,1
19167344,Rodrigo Thompson,1651,01/06/1993,23,0,0,0,0,189,77,3,2,1,1,1,3,1,1,4,3,3,7,7,9,12,12,7,10,7,6,5,9,8,4,10,11,12,10,10,9,8,9,4,13,4,9,9,11,11,11,11,12,12,10,13,12,20,11,11,9,7,10,15,10,7,12,10,12,10,1,9,1,S ,1,1,20,1,1,1,1,1,1,1,1,1,1,1,1
19167358,Lucas Garcia,1651,16/07/1991,24,0,0,0,0,170,0,1,2,1,1,2,2,1,3,3,1,3,5,6,8,8,11,5,9,10,3,12,11,6,12,11,13,10,12,8,11,8,9,20,9,11,7,11,13,12,11,12,12,5,7,13,11,20,12,13,9,9,9,9,9,7,12,12,11,11,4,15,3,DM/M C,1,1,1,1,1,1,1,1,1,20,17,1,1,1,1
19167359,Júnior,1651,28/02/1994,22,0,0,0,0,190,0,14,10,9,3,13,13,8,10,4,9,10,3,3,2,3,2,1,1,3,3,3,1,3,3,2,9,10,10,5,10,7,14,2,1,11,1,8,8,7,8,8,4,13,8,9,9,20,6,10,9,9,9,7,9,11,10,10,11,10,1,2,1,GK ,20,1,1,1,1,1,1,1,1,1,1,1,1,1,1
19167360,João Gabriel,1651,22/03/1992,24,0,0,0,0,190,80,11,10,9,4,11,9,10,12,6,9,10,6,1,1,1,6,8,1,2,3,2,3,3,3,7,9,11,10,8,9,9,10,1,2,11,3,11,12,9,8,11,10,15,6,12,9,20,11,11,9,5,3,7,9,9,12,12,12,14,4,11,4,GK ,20,1,1,1,1,1,1,1,1,1,1,1,1,1,1
19167419,Alex Santana,1651,13/05/1995,21,0,0,0,0,182,74,1,1,1,2,1,3,3,1,1,2,1,7,9,13,15,11,9,11,11,4,4,13,7,3,11,10,9,6,11,6,13,13,3,14,1,13,6,7,7,15,13,6,12,11,6,13,20,11,6,10,10,9,3,10,13,13,8,7,8,8,10,13,AM C,1,1,13,20,1,1,1,1,1,1,1,1,1,1,1
19167420,Lucas Morelatto,1651,25/05/1994,22,0,0,0,0,180,78,3,2,1,1,3,1,2,3,3,2,1,10,9,11,12,12,13,9,12,9,9,12,11,12,11,13,12,11,10,11,11,13,3,9,8,9,10,9,10,12,11,9,8,20,11,11,5,9,12,11,12,10,10,10,17,13,11,9,13,12,11,4,M/AM C,1,1,1,20,1,1,1,1,1,1,16,1,1,1,1
19167489,Guilherme Almeida,1651,29/01/1993,23,0,0,0,0,183,0,3,2,2,2,3,3,2,2,2,3,2,1,3,4,2,7,1,14,3,5,14,8,1,14,2,9,11,9,8,11,4,10,9,3,8,6,12,7,8,12,10,8,6,17,15,14,20,8,10,9,8,5,6,9,19,11,10,12,10,9,7,3,D C,1,1,1,1,1,1,20,1,1,1,1,1,1,1,1
19167493,Neto Volpi,1651,01/08/1992,23,0,0,0,0,191,90,13,13,10,1,10,14,8,14,5,9,8,4,1,3,2,3,6,1,2,1,1,1,3,2,5,10,8,10,9,9,8,14,8,1,2,1,13,9,6,12,11,7,14,10,10,14,20,3,15,10,10,4,10,10,20,9,13,11,11,1,7,6,GK ,20,1,1,1,1,1,1,1,1,1,1,1,1,1,1
19167494,Américo,1651,19/03/1993,23,0,0,0,0,188,81,2,3,3,3,2,1,2,3,3,3,1,3,1,2,2,5,1,13,1,2,13,7,3,13,5,9,11,9,6,9,4,13,9,1,4,6,13,6,7,10,10,7,13,4,7,10,20,7,11,9,12,7,7,9,15,11,12,11,11,2,11,2,D C,1,1,1,1,1,1,20,1,1,1,1,1,1,1,1
19167497,Douglas,1651,20/04/1995,21,0,0,0,0,194,89,1,2,2,1,2,1,1,1,1,3,3,6,6,13,13,13,6,11,4,4,6,7,4,3,13,9,7,2,7,7,3,7,4,13,10,8,5,6,7,13,13,7,16,8,9,13,20,4,12,9,9,7,5,9,16,12,10,8,11,2,4,5,S ,1,1,20,1,1,1,1,1,1,1,1,1,1,1,1
19167498,Fabiano,1651,01/12/1994,21,0,0,0,0,182,76,2,2,2,3,3,3,3,2,1,2,1,9,8,8,10,15,9,9,13,5,9,15,3,14,15,9,13,10,8,9,11,15,10,8,10,9,12,10,13,8,8,10,11,10,13,8,20,9,8,10,5,5,5,10,17,11,10,11,12,5,9,1,DM ,1,1,1,1,1,1,1,1,1,20,10,1,1,1,1
19167500,Gustavo,1651,28/04/1995,21,0,0,0,0,174,0,3,3,3,3,2,3,3,2,1,1,2,5,5,4,5,10,4,3,10,1,7,12,1,13,13,3,6,7,6,3,7,13,8,8,13,5,11,7,10,13,12,13,6,8,15,12,20,5,6,8,5,8,8,8,9,11,11,11,14,6,5,3,DM ,1,1,1,1,1,1,1,1,1,20,10,1,1,1,1
19167504,Iago,1651,09/01/1993,23,0,0,0,0,178,65,1,1,3,1,2,2,2,2,2,2,1,8,6,9,4,10,6,8,6,4,10,10,2,15,10,9,11,8,7,12,7,10,9,7,5,8,9,9,9,15,12,9,9,10,10,10,20,14,8,9,10,1,9,9,17,10,9,12,11,1,11,6,D/WB R,1,1,1,1,1,1,1,1,18,1,1,1,1,1,20
19167505,Jonatan Ponciano,1651,30/08/1991,24,0,0,0,0,184,74,2,4,2,3,2,1,1,1,3,2,4,7,3,13,13,13,5,13,8,1,5,8,6,2,13,10,9,9,11,8,5,10,2,13,10,13,6,7,8,13,13,8,12,10,17,13,20,13,9,10,3,10,12,10,11,11,12,11,10,8,8,7,S ,1,1,20,1,1,1,1,1,1,1,1,1,1,1,1
19167507,Lenon,1651,07/04/1993,23,0,0,0,0,181,0,3,3,2,2,1,2,1,2,2,4,1,3,1,3,3,7,5,8,4,4,14,4,1,14,5,6,8,8,5,6,2,14,2,1,10,6,7,6,7,13,14,7,10,1,13,14,20,6,9,8,4,8,7,8,9,12,9,13,9,1,13,3,D C,1,1,1,1,1,1,20,1,1,1,1,1,1,1,1
19167508,Luan Polli,1651,06/04/1993,23,0,0,0,0,188,86,12,10,10,5,13,14,12,12,10,12,13,1,1,5,3,8,4,3,1,1,2,4,1,2,10,6,10,8,11,11,10,10,13,1,10,1,12,11,10,11,10,11,14,6,11,11,20,6,14,13,9,10,9,10,12,12,9,12,12,10,10,13,GK ,20,1,1,1,1,1,1,1,1,1,1,1,1,1,1
19167511,Marquinhos Pedroso,1651,04/10/1993,22,0,0,0,0,175,73,3,2,3,1,3,3,1,2,1,3,1,12,12,10,9,11,7,8,9,9,9,11,9,13,12,13,12,12,12,11,12,11,12,12,7,12,9,12,12,16,13,14,7,20,14,14,8,14,8,11,14,11,11,10,18,12,13,12,10,7,7,7,D/WB L,1,1,1,1,13,1,1,18,1,1,1,10,1,20,1
19167512,Matheus Leoni,1651,20/09/1991,24,0,0,0,0,182,76,3,3,3,2,2,3,3,1,2,2,1,3,4,7,6,11,1,8,7,7,9,7,5,14,7,9,10,9,9,9,9,11,9,9,13,5,9,9,9,14,10,9,10,20,10,12,6,14,7,9,9,9,3,8,7,10,12,12,11,4,10,6,D/WB L,1,1,1,1,1,1,1,20,1,1,1,1,1,19,1
19167514,Paulo Ricardo,1651,13/07/1994,21,0,0,0,0,185,79,2,2,3,2,2,1,2,1,2,2,3,7,7,8,10,11,10,13,12,12,14,12,10,14,12,15,12,14,12,13,10,12,11,7,11,9,13,14,14,12,12,15,13,8,14,12,20,14,14,12,12,11,10,12,8,11,11,11,12,4,1,1,DM ,1,1,1,1,1,1,13,1,1,20,1,1,1,1,1
19167517,Diguinho,1651,10/05/1993,23,0,0,0,0,179,0,4,1,2,1,1,1,2,3,2,3,1,7,7,9,8,12,4,6,8,8,10,10,5,12,10,9,12,6,8,6,8,10,3,5,4,6,8,9,10,15,15,9,8,10,11,14,20,6,9,9,7,8,5,9,14,10,13,9,11,9,11,7,D/WB R,1,1,1,13,1,9,1,1,18,1,10,1,11,1,20
19167519,Roger Deniro,1651,20/03/1993,23,0,0,0,0,182,0,1,1,2,1,2,3,3,1,3,2,2,1,1,1,2,8,1,13,4,5,14,8,4,14,6,9,12,7,8,9,3,14,8,2,12,6,11,7,8,14,10,7,10,10,8,12,20,6,8,9,6,6,9,9,14,9,10,8,9,2,5,1,D C,1,1,1,1,1,1,20,1,1,1,1,1,1,1,1
19167521,Maranhão,1651,26/07/1994,21,0,0,0,0,176,0,1,3,1,1,1,1,2,4,3,1,3,8,8,9,3,14,8,8,10,3,7,12,6,13,14,9,10,9,10,7,10,14,19,7,9,9,10,9,13,14,14,10,9,9,15,12,20,8,9,10,10,10,5,10,18,11,10,10,11,4,7,3,DM C,1,1,1,1,1,1,12,1,1,20,15,1,1,1,1
19167523,Wilker,1651,04/10/1994,21,0,0,0,0,171,71,1,1,3,1,3,1,2,2,2,1,2,9,9,11,10,10,7,10,8,2,4,8,6,4,10,6,10,6,10,6,10,12,5,7,12,10,2,7,9,14,14,14,7,10,9,14,20,10,8,9,9,9,3,9,9,11,9,11,12,6,3,7,AM/S L,1,1,20,1,16,1,1,1,1,1,1,1,1,1,1
19167576,Gustavo Henrique,1651,24/03/1993,23,0,0,0,0,193,84,1,3,2,2,2,1,1,3,3,3,3,5,6,5,11,11,3,15,3,9,15,13,11,15,13,11,14,13,13,12,10,11,14,8,8,14,15,12,12,13,13,13,16,8,14,13,20,14,14,12,12,13,14,12,8,13,12,12,9,9,12,6,D C,1,1,1,1,1,1,20,1,1,1,1,1,1,1,1
19167577,Bruno Lamas,1651,13/04/1994,22,0,0,0,0,176,75,3,3,3,2,3,4,1,3,1,3,1,12,14,14,10,11,13,7,12,6,9,14,13,8,15,8,12,10,13,9,14,14,10,14,8,12,7,12,11,11,13,13,8,20,10,12,9,16,10,9,8,12,6,12,14,11,8,11,8,9,9,7,AM C,1,1,15,20,1,7,1,1,1,1,15,1,1,1,1
19167578,Neilton,1651,17/02/1994,22,0,0,0,0,167,58,3,3,3,3,2,4,2,3,2,2,1,7,13,16,12,12,5,6,9,10,2,13,10,10,14,6,12,8,10,12,14,13,11,14,8,13,10,14,13,16,16,10,5,10,14,14,20,15,11,14,5,14,11,11,7,13,5,12,12,6,10,12,AM/S L,1,1,19,13,20,13,1,1,1,1,1,1,1,1,1
19167579,Geuvânio,1651,05/04/1992,24,0,0,0,0,178,70,3,1,1,1,3,1,4,2,3,3,1,12,14,15,13,13,3,9,15,8,5,14,9,6,14,10,13,13,12,12,14,13,14,12,11,14,7,14,15,15,14,14,6,20,14,14,10,15,14,12,13,10,4,13,9,10,15,12,15,7,12,6,AM L,1,1,14,1,20,14,1,1,1,1,1,1,1,1,1
19167584,Alan,1651,29/10/1994,21,0,0,0,0,183,78,1,2,1,3,1,3,1,1,3,1,2,7,9,11,9,14,7,7,9,1,7,12,5,3,14,8,6,8,5,8,8,14,5,13,10,9,7,8,13,12,14,9,12,20,16,14,2,8,11,9,9,9,5,9,10,12,11,14,12,5,15,1,AM LC,1,1,1,20,16,1,1,1,1,1,1,1,1,1,1
19167585,Danrlei,1651,01/08/1994,21,0,0,0,0,186,76,2,2,3,1,2,3,2,2,2,2,2,8,9,4,8,9,8,11,9,1,11,10,5,11,8,10,11,12,9,10,10,14,10,10,11,8,12,9,10,14,11,11,13,11,7,12,20,8,10,10,9,10,6,12,19,11,11,9,10,9,2,3,D/DM RC,1,1,1,1,1,1,20,1,15,18,6,1,1,1,10
19167722,Felipe Nunes,1651,20/05/1990,26,0,0,0,0,176,72,2,4,2,3,3,2,1,2,3,2,2,9,8,12,9,13,10,7,11,2,4,12,7,4,13,9,9,5,9,9,12,10,9,11,5,10,8,10,11,12,12,13,7,20,13,12,10,11,9,9,5,9,5,8,18,12,8,12,10,2,11,1,AM C,1,1,12,20,1,1,1,1,1,1,10,1,1,1,1
19168131,Maílson,1651,23/12/1990,25,0,0,0,0,177,73,3,3,3,4,2,4,4,3,3,3,2,8,10,11,10,10,6,8,9,5,7,11,10,7,11,10,9,11,9,8,10,9,5,10,9,11,9,11,10,14,12,11,8,11,14,13,20,12,8,11,8,11,8,13,13,11,9,9,11,7,6,1,AM/S R,1,1,20,13,12,18,1,1,1,1,1,1,1,1,1
19168148,David Batista,1651,14/03/1989,27,0,0,0,0,181,76,2,1,1,1,2,2,2,2,2,2,1,7,5,13,13,13,7,11,7,3,7,4,11,3,9,10,9,3,9,8,8,7,4,10,10,11,5,7,8,13,10,10,9,15,4,11,20,13,11,10,10,10,7,10,13,10,11,12,13,8,6,4,S ,1,1,20,1,1,1,1,1,1,1,1,1,1,1,1
19168154,Louriano,1651,24/03/1989,27,0,0,0,0,180,0,2,3,2,3,1,3,1,2,2,2,1,4,3,12,12,12,5,13,6,1,2,4,8,3,11,7,7,1,7,6,5,13,4,11,1,9,6,5,6,13,13,4,5,8,7,13,20,10,7,8,8,8,8,7,10,9,12,15,12,3,8,4,S ,1,1,20,1,1,1,1,1,1,1,1,1,1,1,1
19168451,Manoel,1651,17/02/1992,24,0,0,0,0,171,75,3,1,3,3,2,1,3,3,1,2,2,6,6,7,8,10,3,2,5,1,4,9,6,5,10,8,7,1,10,7,9,11,4,9,5,10,6,7,11,14,14,7,5,6,6,14,20,14,4,8,6,4,8,8,18,11,10,10,10,6,7,7,AM C,1,1,1,20,1,1,1,1,1,1,15,1,1,1,1
19168517,Ronan,1651,07/04/1989,27,0,0,0,0,184,0,2,3,3,2,3,1,3,4,3,3,1,6,4,1,1,7,2,13,2,5,13,7,4,13,5,7,11,7,4,8,4,13,4,6,6,4,13,6,7,13,13,7,5,3,13,13,20,8,11,9,8,8,9,9,15,12,9,11,10,12,10,8,D C,1,1,1,1,1,1,20,1,1,1,1,1,1,1,1
19168545,Mateus,1651,22/01/1992,24,0,0,0,0,183,78,1,1,1,2,2,3,1,2,3,1,1,4,6,9,8,9,7,7,8,2,8,6,6,9,10,9,9,8,9,9,8,14,6,9,8,8,6,8,9,14,10,8,11,20,10,13,1,8,7,9,9,9,5,9,9,10,11,12,11,7,1,8,D/AM LC,1,1,1,20,1,1,1,19,1,1,10,1,1,15,1
19168591,Getterson,1651,06/05/1991,25,0,0,0,0,180,78,3,3,2,4,1,2,1,1,4,2,3,7,4,8,11,13,3,13,8,4,7,8,5,1,13,10,11,8,12,8,4,12,3,13,12,13,6,7,8,13,13,8,9,12,15,13,20,13,8,10,10,10,10,10,19,12,11,10,14,8,11,2,S ,1,1,20,1,1,1,1,1,1,1,1,1,1,1,1
19168616,Jorge Elias,1651,05/06/1991,25,0,0,0,0,184,79,2,2,1,4,1,3,1,3,1,1,3,7,5,14,14,14,9,14,8,4,7,9,4,2,12,11,14,8,7,9,8,14,6,11,6,14,9,9,10,14,14,10,10,8,14,14,20,9,13,11,6,3,11,11,17,12,10,11,11,8,18,5,S ,1,1,20,1,1,1,1,1,1,1,1,1,1,1,1
19168667,Tontini,1651,16/07/1995,20,0,0,0,0,183,69,1,1,3,3,3,3,3,2,1,1,2,8,10,10,10,14,8,9,10,4,7,12,2,8,12,10,10,9,8,7,13,11,13,9,2,6,7,10,13,14,12,10,11,11,8,13,20,10,9,10,10,10,7,10,15,12,11,13,10,4,11,6,AM LC,1,1,1,20,16,13,1,1,1,1,10,1,1,1,1
19168812,Richardson,1651,21/05/1992,24,0,0,0,0,183,81,3,1,3,1,2,2,2,3,1,2,2,3,2,3,1,8,1,9,3,1,13,6,2,13,7,10,12,10,5,8,2,13,10,4,12,7,11,7,8,13,13,8,11,2,10,13,20,13,13,10,10,10,7,10,11,13,11,10,11,1,17,8,D C,1,1,1,1,1,1,20,1,1,1,1,1,1,1,1
19168904,Epitácio,1651,10/05/1995,21,0,0,0,0,181,84,1,2,3,1,1,2,4,3,3,3,3,5,2,12,13,9,6,12,7,1,6,7,11,3,13,9,12,7,13,7,5,13,3,13,6,13,7,6,7,10,6,12,10,9,12,10,20,10,11,9,7,8,6,9,14,10,11,12,10,6,17,4,S ,1,1,20,1,1,1,1,1,1,1,1,1,1,1,1
19169352,Paulo Henrique,1651,02/07/1993,23,0,0,0,0,185,89,2,1,1,3,1,3,2,1,4,1,2,5,6,13,13,13,7,13,8,1,6,6,9,7,8,8,10,5,12,8,7,10,1,10,5,12,8,7,8,13,11,8,8,8,12,13,20,7,9,10,10,5,10,10,12,13,10,11,10,7,5,5,S ,1,1,20,1,1,1,1,1,1,1,1,1,1,1,1
19169681,Bruno Cantanhede,1651,22/07/1993,22,0,0,0,0,185,71,1,1,2,3,1,2,2,4,2,1,2,7,8,11,10,9,9,7,7,12,5,8,11,10,11,14,11,7,6,6,10,9,10,10,9,12,7,6,12,12,9,10,11,20,14,13,13,14,10,7,12,10,12,12,13,9,10,9,13,9,8,5,AM/S RLC,1,1,17,20,17,18,1,1,1,1,10,1,1,1,1
19169914,Judivan,1651,21/05/1995,21,0,0,0,0,177,72,2,2,3,1,3,2,2,2,2,1,3,5,11,13,13,12,6,7,8,4,5,12,12,6,13,10,12,11,12,10,11,12,10,14,7,13,5,12,14,14,15,11,9,8,13,14,20,13,10,10,4,11,16,10,7,10,10,9,10,6,12,3,S ,1,1,20,11,12,14,1,1,1,1,1,1,1,1,1
19170139,Marcos Paulo,1651,16/05/1992,24,0,0,0,0,171,0,1,1,3,3,2,1,1,2,2,1,3,7,6,5,6,14,5,6,13,1,7,14,1,13,12,8,12,8,8,8,10,13,19,9,14,5,10,7,11,11,13,8,4,4,9,13,20,8,6,9,14,2,9,9,8,14,14,10,12,2,1,7,DM ,1,1,1,1,1,1,1,1,1,20,13,1,1,1,1
19170166,Paulinho,1651,10/07/1994,21,0,0,0,0,166,58,3,2,1,2,2,3,1,1,1,3,2,12,11,15,9,15,13,4,7,11,8,16,11,10,15,4,7,4,10,10,15,10,12,15,5,9,15,9,11,14,14,6,5,20,11,12,12,12,6,12,13,9,4,8,17,11,8,13,12,6,10,4,M/AM RLC,1,1,1,20,18,15,1,1,1,1,19,17,1,1,1
19170170,Eduardo Enrique,1651,09/04/1992,24,0,0,0,0,192,85,2,1,1,2,3,3,4,3,2,2,2,3,5,5,6,8,3,12,6,4,12,7,5,11,7,12,11,13,9,8,5,8,13,7,10,9,11,12,11,10,8,13,13,10,13,10,20,12,13,11,11,9,5,9,19,11,10,11,12,9,16,2,D C,1,1,1,1,1,1,20,1,1,10,7,1,1,1,1
19170189,Jayme,1651,20/03/1993,23,0,0,0,0,175,64,3,1,3,1,3,2,2,3,1,2,2,6,4,13,13,12,6,13,7,1,5,7,9,1,13,9,12,4,9,6,7,9,6,15,4,12,5,6,7,15,12,6,6,10,13,14,20,5,6,9,9,9,8,9,7,11,9,9,9,5,6,5,S ,1,1,20,1,1,1,1,1,1,1,1,1,1,1,1
19170206,Maycon Canário,1651,28/07/1994,21,0,0,0,0,174,70,1,3,2,1,3,1,2,2,2,2,1,7,7,6,8,14,7,7,13,4,10,14,4,14,13,9,5,8,8,5,9,14,9,9,1,7,6,8,9,14,12,4,7,9,9,13,20,7,7,9,9,9,7,9,19,8,10,12,8,3,9,4,DM ,1,1,1,1,1,1,1,1,1,20,10,1,1,1,1
19170209,Marcos Guilherme,1651,05/08/1995,20,0,0,0,0,172,65,2,2,3,3,3,3,2,2,2,1,1,11,12,13,13,13,11,12,13,10,10,12,12,10,13,11,12,11,12,12,12,12,13,15,11,13,6,11,11,17,12,11,12,13,12,16,20,13,11,11,10,12,11,15,14,13,12,13,11,6,12,6,AM C,1,1,10,20,10,10,1,1,1,1,13,13,12,1,1
19170212,Marcelinho,1651,23/05/1994,22,0,0,0,0,181,0,2,1,1,3,2,4,3,3,2,3,3,7,4,13,13,11,7,13,6,3,7,7,11,3,13,7,11,8,13,8,6,13,10,13,7,11,8,7,8,13,13,8,9,8,16,13,20,12,7,10,9,6,4,10,9,10,10,9,10,6,12,3,S ,1,1,20,1,1,1,1,1,1,1,1,1,1,1,1
19170216,Paulinho,1651,29/05/1993,23,0,0,0,0,177,74,1,2,2,2,3,3,3,2,3,1,3,10,12,17,13,14,11,9,12,10,12,13,10,9,16,8,11,8,15,9,13,12,10,14,11,11,12,7,10,13,13,13,11,12,12,14,20,10,10,11,8,5,11,11,12,11,9,10,11,5,11,4,AM/S RC,1,1,20,18,14,15,1,1,1,1,1,1,1,1,1
19170232,Lima,1651,10/05/1991,25,0,0,0,0,177,66,2,2,1,2,3,2,3,1,2,2,3,6,6,4,6,12,6,4,10,3,10,12,3,13,13,3,11,8,5,9,9,13,4,2,4,6,9,7,10,13,13,11,7,9,14,13,20,6,11,9,7,8,8,9,9,9,9,11,12,4,8,8,DM ,1,1,1,1,1,1,10,1,1,20,10,1,1,1,1
19170239,Caculé,1651,18/04/1992,24,0,0,0,0,170,0,1,2,1,3,3,1,3,2,3,2,1,8,10,12,13,12,6,8,11,4,6,12,13,5,13,6,12,7,12,10,12,11,11,14,4,13,7,10,12,14,15,7,5,7,11,14,20,11,7,12,6,5,5,10,14,13,10,10,9,6,14,5,AM RC,1,1,15,20,1,17,1,1,1,1,14,1,13,1,1
19170387,Higor Leite,1651,02/06/1993,23,0,0,0,0,177,62,1,1,1,1,3,2,2,2,2,2,4,12,11,11,11,14,14,11,14,6,5,10,11,6,13,6,11,6,11,12,13,12,1,13,5,13,7,13,11,13,12,12,8,12,12,12,20,11,12,12,9,5,6,12,13,11,11,12,10,6,8,4,AM C,1,1,1,20,1,1,1,1,1,1,10,1,1,1,1
19170571,Taiberson,1651,18/11/1993,22,0,0,0,0,172,74,3,2,3,2,3,3,1,2,2,3,2,5,10,12,12,12,10,7,8,7,6,8,7,5,12,11,10,11,12,11,10,11,12,12,6,13,7,10,8,16,13,6,5,20,9,14,16,10,7,11,6,10,10,7,10,11,8,12,9,6,12,8,S ,1,1,20,1,1,1,1,1,1,1,1,1,1,1,1
19170626,Valdívia,1651,04/10/1994,21,0,0,0,0,174,66,1,2,1,1,2,1,2,1,2,1,2,13,12,15,12,12,15,11,13,5,7,12,12,6,14,11,13,12,12,13,13,11,14,15,11,13,6,12,12,16,13,12,9,12,12,15,20,12,11,10,10,15,14,14,11,13,12,13,12,7,11,6,M/AM LC,1,1,1,18,20,14,1,1,1,1,14,19,13,1,1
19171002,Caíque,1651,03/06/1995,21,0,0,0,0,185,0,14,14,6,1,14,10,11,14,10,10,7,2,3,3,1,6,6,1,2,1,3,2,1,3,4,10,11,12,7,9,8,14,4,2,5,1,13,9,6,14,8,4,11,20,10,13,10,2,9,8,10,10,9,10,8,10,10,10,11,4,7,2,GK ,20,1,1,1,1,1,1,1,1,1,1,1,1,1,1
19171003,Matheus Vidotto,1651,10/04/1994,22,0,0,0,0,189,82,9,15,7,1,15,15,12,15,7,10,13,6,3,2,1,3,8,2,2,3,1,3,3,1,7,8,12,12,8,9,9,15,10,2,14,3,13,5,9,12,8,10,14,11,9,11,20,5,13,10,9,7,15,10,17,11,10,13,11,11,6,8,GK ,20,1,1,1,1,1,1,1,1,1,1,1,1,1,1
19171004,Cristiano,1651,29/06/1993,23,0,0,0,0,183,0,3,2,2,1,1,2,3,2,3,3,1,6,7,10,8,9,4,8,3,6,11,8,7,15,9,10,12,9,10,12,6,13,9,6,13,10,11,10,10,15,14,6,12,10,7,15,20,11,8,8,10,10,10,10,15,11,10,11,9,6,6,7,D/WB R,1,1,1,1,1,1,1,1,16,1,1,1,1,1,20
19171005,Fernando Gomes,1651,18/09/1993,22,0,0,0,0,177,73,2,3,2,2,2,2,3,2,2,3,2,8,8,9,9,14,8,11,11,6,10,14,6,14,14,12,12,9,5,10,14,14,6,7,9,8,12,9,7,9,9,9,11,11,8,9,20,7,11,11,7,10,10,10,12,13,12,11,13,6,1,3,DM ,1,1,1,1,1,1,1,1,1,20,12,1,1,1,1
19171006,Giovanni,1651,04/04/1994,22,0,0,0,0,174,72,2,1,2,3,3,2,1,4,3,1,1,11,13,12,10,12,12,5,14,11,8,12,11,8,13,11,10,9,10,11,10,10,19,14,11,12,12,8,10,13,13,12,11,15,13,12,20,13,6,11,7,11,11,11,9,12,11,12,12,2,16,8,AM RC,1,1,12,20,1,16,1,1,1,1,1,1,1,1,1
19171008,Matheuzinho,1651,21/02/1993,23,0,0,0,0,170,62,2,3,1,1,1,3,4,2,1,2,1,11,12,14,11,13,11,5,11,5,7,13,6,6,14,6,11,8,11,11,12,12,9,12,8,12,7,9,12,13,13,12,6,20,11,13,6,12,7,8,6,7,10,10,20,11,8,10,11,6,4,6,AM LC,1,1,7,20,15,13,1,1,1,1,7,1,1,1,1
19171009,Antônio Carlos,1651,07/03/1993,23,0,0,0,0,191,79,2,2,1,3,4,2,1,3,1,3,3,8,3,8,8,12,10,12,7,8,12,10,5,12,10,14,12,10,12,12,11,16,12,3,12,9,13,11,12,11,11,12,16,12,14,11,20,14,12,12,12,11,4,10,12,13,10,13,13,12,11,12,D C,1,1,1,1,1,1,20,1,1,1,1,1,1,1,1
19171051,Luiz Phellype,1651,27/09/1993,22,0,0,0,0,188,86,1,2,1,1,3,1,4,1,1,1,1,6,9,11,12,11,12,10,11,5,4,10,14,5,13,13,11,11,12,13,9,11,12,8,10,13,9,12,12,12,10,11,14,7,13,13,20,13,13,14,6,10,6,5,7,8,11,8,12,11,7,8,S ,1,1,20,1,1,1,1,1,1,1,1,1,1,1,1
19171052,Chico,1651,29/01/1993,23,0,0,0,0,168,76,3,3,1,3,1,3,3,4,1,3,1,10,6,11,11,11,8,10,11,5,5,7,7,6,10,10,11,14,12,11,9,9,11,11,11,12,5,10,13,13,12,12,4,20,17,12,15,11,11,10,7,10,5,10,10,10,12,11,12,13,13,5,S ,1,1,20,1,1,1,1,1,1,1,1,1,1,1,1
19171079,Railan,1651,06/09/1994,21,0,0,0,0,174,72,1,2,2,3,1,2,1,2,2,3,2,10,12,12,11,13,9,7,11,12,10,12,11,9,12,12,11,15,8,8,11,9,15,15,7,13,10,11,14,13,14,13,6,10,12,13,20,13,7,12,7,11,7,11,9,13,8,9,12,7,9,14,D/WB R,1,1,1,14,1,14,1,1,20,1,13,1,13,1,18
19171080,Anderson Mello,1651,21/05/1993,23,0,0,0,0,173,70,2,1,3,3,2,2,1,2,2,2,2,5,7,10,10,12,7,7,11,10,12,11,10,11,12,13,10,13,9,10,10,9,12,12,5,10,11,12,12,12,12,11,6,10,12,12,20,12,11,11,9,6,4,9,9,10,14,13,12,8,1,1,DM/M C,1,1,1,1,1,1,1,1,1,19,20,1,1,1,1
19171084,Paulo Cézar,1651,08/12/1993,22,0,0,0,0,184,77,4,1,2,2,2,3,1,1,3,3,2,6,5,7,10,13,6,13,14,3,5,4,3,1,8,5,13,1,10,6,3,7,5,8,14,13,7,6,7,9,9,10,9,8,11,9,20,8,10,9,9,9,9,9,18,12,13,11,9,8,18,2,S ,1,1,20,1,1,1,1,1,1,1,1,1,1,1,1
19171099,Willie,1651,15/05/1993,23,0,0,0,0,170,61,3,2,1,1,2,1,1,2,3,1,2,11,12,13,12,14,10,7,12,4,5,13,11,5,13,8,13,11,12,11,13,12,14,14,3,13,6,10,13,15,14,7,5,5,13,14,20,13,6,12,6,14,5,13,12,11,11,12,7,13,12,13,AM/S RC,1,1,19,18,13,20,1,1,1,1,14,9,12,1,1
19171100,Giva,1651,03/01/1993,23,0,0,0,0,186,74,3,1,3,1,4,3,3,3,1,3,1,6,6,13,13,10,6,12,8,7,7,12,9,8,11,8,11,8,13,11,11,11,13,12,5,13,5,11,11,15,13,8,13,10,10,14,20,13,10,13,9,7,15,2,5,13,12,11,8,7,6,5,AM/S L,1,1,20,1,17,14,1,1,1,1,1,1,1,1,1
19171102,Matheus Salustiano,1651,19/04/1993,23,0,0,0,0,185,81,3,1,2,3,1,2,2,3,1,1,1,2,4,4,4,7,3,14,6,5,13,6,8,12,5,14,9,15,7,8,3,10,14,12,9,11,13,15,14,13,12,8,12,9,15,13,20,15,15,12,15,13,5,4,13,9,12,12,13,7,8,12,D C,1,1,1,1,1,1,20,1,1,1,1,1,1,1,1
19171103,Adauto,1651,22/10/1992,23,0,0,0,0,173,0,2,3,3,2,2,2,3,1,3,3,1,7,6,8,4,11,6,7,10,1,12,12,6,13,12,9,8,8,9,9,12,14,3,9,1,7,12,8,11,14,14,8,6,9,14,12,20,8,5,9,9,9,9,9,8,10,12,10,10,5,4,6,DM/M C,1,1,1,1,1,1,1,1,1,20,18,1,1,1,1
19171104,Mauri,1651,06/03/1993,23,0,0,0,0,171,65,3,2,2,1,1,1,3,3,3,2,3,12,11,13,10,12,8,6,11,9,9,12,12,8,13,11,13,10,11,9,12,11,13,14,5,13,11,11,12,13,14,13,5,20,13,13,8,12,5,13,8,13,4,14,12,11,13,14,14,12,13,2,M/AM LC,1,1,14,20,18,11,1,1,1,14,18,14,10,1,1
19171128,Jhon Cley,1651,09/03/1994,22,0,0,0,0,180,78,1,1,3,1,4,3,1,3,4,3,3,12,10,13,10,11,12,9,12,4,12,12,11,12,13,13,13,11,11,11,12,12,11,15,11,13,11,13,13,12,13,9,11,12,14,12,20,12,12,11,10,10,8,15,19,11,11,10,11,7,8,7,AM RLC,1,1,1,20,15,15,1,1,1,15,15,1,1,1,1
19171129,Dieyson,1651,30/06/1993,23,0,0,0,0,174,0,2,3,1,4,3,3,2,2,2,3,2,10,11,13,10,10,9,8,12,10,10,12,8,11,12,11,12,13,9,12,10,11,8,12,9,12,11,13,14,14,14,9,8,20,14,14,8,14,8,11,9,11,7,13,9,13,12,12,11,9,9,5,D L,1,1,1,1,1,1,1,20,1,1,1,1,1,15,1
19171130,Cícero Bobbio,1651,05/05/1993,23,0,0,0,0,185,0,3,3,3,1,1,2,2,3,2,1,4,4,5,10,12,10,5,12,10,4,1,9,6,4,6,5,15,7,15,7,11,12,10,7,7,15,9,9,10,12,11,12,12,20,12,12,10,12,12,10,4,10,4,9,13,11,10,10,7,10,18,2,S ,1,1,20,1,1,1,1,1,1,1,1,1,1,1,1
19171246,Alex Araújo,1651,19/12/1993,22,0,0,0,0,174,76,2,3,2,1,2,4,2,1,2,1,3,6,6,15,11,14,8,15,8,3,8,9,2,2,12,6,12,5,6,9,6,7,5,10,4,10,8,7,9,14,14,8,5,20,11,14,1,11,8,9,9,9,9,9,8,10,10,9,9,7,10,5,S ,1,1,20,1,10,1,1,1,1,1,1,1,1,1,1
19171250,Zé Rafael,1651,16/06/1993,23,0,0,0,0,175,71,3,1,3,1,2,2,3,2,2,3,1,7,12,14,11,12,8,9,11,3,5,12,10,4,14,13,11,13,14,11,11,11,14,14,5,14,6,12,14,14,13,13,7,12,12,14,20,12,8,8,12,12,5,11,11,13,11,12,11,8,12,8,AM LC,1,1,15,20,18,1,1,1,1,1,15,1,1,1,1
19171315,Victor Brasil,1651,01/05/1993,23,0,0,0,0,192,85,8,14,10,1,14,14,11,14,9,10,14,2,2,2,1,2,7,1,2,2,1,2,3,1,6,10,11,12,9,9,8,9,11,3,7,3,9,9,8,13,10,9,16,9,12,14,20,7,10,12,8,10,10,10,19,12,8,11,11,4,8,2,GK ,20,1,1,1,1,1,1,1,1,1,1,1,1,1,1
19171406,Clacson,1651,14/04/1993,23,0,0,0,0,185,78,2,1,2,2,1,2,3,1,2,1,2,4,2,1,6,5,3,13,6,1,13,7,3,10,6,8,8,9,7,8,2,13,5,1,5,6,13,6,7,13,12,7,9,20,16,13,9,7,9,9,8,7,5,9,12,9,13,10,11,2,5,2,D C,1,1,1,1,1,1,20,1,1,1,1,1,1,1,1
19171407,Renan Lemos,1651,15/01/1993,23,0,0,0,0,175,64,2,2,3,2,1,1,3,3,1,2,2,10,15,10,7,10,9,9,3,8,10,8,3,11,11,10,13,10,10,11,11,12,4,9,9,10,11,10,11,15,13,10,10,20,9,15,2,15,7,10,9,2,8,10,8,11,14,11,11,10,11,6,D/WB/M L,1,1,1,1,1,1,1,17,1,1,1,17,1,20,1
19171408,Elber,1651,05/04/1992,24,0,0,0,0,178,74,3,1,2,1,1,3,3,2,1,2,2,6,3,3,7,7,3,6,13,5,8,12,1,13,8,9,8,5,7,9,9,13,9,6,10,6,10,7,5,13,13,12,8,9,14,13,20,11,7,9,14,9,9,9,17,9,10,11,11,5,18,1,DM ,1,1,1,1,1,1,1,1,1,20,10,1,1,1,1
19171409,Sassá,1651,11/01/1994,22,0,0,0,0,174,73,4,2,3,1,2,1,3,1,2,1,1,2,10,13,13,13,6,13,10,2,5,14,14,13,13,5,13,12,13,9,10,12,7,13,6,14,13,14,10,15,15,14,8,12,13,13,20,13,12,10,8,12,5,12,5,7,11,9,7,10,8,14,AM/S L,1,1,20,1,17,1,1,1,1,1,1,1,1,1,1
19171410,Allano,1651,24/04/1995,21,0,0,0,0,173,62,3,3,3,1,3,2,1,3,1,3,3,8,9,13,9,12,6,5,8,6,8,12,9,10,11,12,13,10,8,9,10,9,8,13,5,13,8,12,16,14,15,9,7,20,14,14,5,14,9,11,10,10,7,15,17,10,6,6,7,7,7,4,WB/M/AM RL,1,1,12,1,20,19,1,15,1,1,1,19,18,16,1
19171411,Gilberto,1651,03/07/1993,22,0,0,11,3,181,74,1,3,2,2,1,1,2,3,2,1,4,10,13,14,10,12,10,11,12,14,11,13,5,12,14,10,10,13,12,10,13,12,14,13,11,13,11,12,13,15,14,10,13,7,14,13,20,12,11,10,10,12,5,13,10,12,12,13,12,7,16,15,D/WB R,1,1,1,1,1,7,1,1,19,1,1,1,15,1,20
19171412,Rafael Castro,1651,04/07/1991,24,0,0,0,0,187,86,3,2,2,2,2,1,3,3,2,2,1,8,9,14,14,14,6,14,9,3,6,9,7,4,13,10,10,7,7,9,9,12,11,12,11,14,7,8,9,14,14,9,10,8,13,14,20,6,9,10,10,10,6,10,19,12,13,10,10,11,16,4,S ,1,1,20,1,1,1,1,1,1,1,1,1,1,1,1
19171413,Octávio,1651,29/12/1993,22,0,0,0,0,186,77,3,1,3,1,1,3,3,1,3,2,1,13,12,13,12,13,13,11,13,13,5,13,12,10,13,5,5,5,10,8,13,12,10,10,7,12,11,10,10,13,13,12,11,9,12,11,20,12,11,10,5,12,5,10,8,11,9,10,12,1,15,3,AM RLC,1,1,1,20,18,15,1,1,1,1,14,11,1,1,1
19171414,Wellington,1651,21/01/1993,23,0,0,0,0,174,72,2,2,2,2,1,1,1,1,3,3,2,5,5,10,13,12,6,13,7,4,4,7,4,1,8,5,11,8,12,7,7,8,5,9,8,13,6,6,7,13,13,7,6,8,15,11,20,7,8,9,3,2,9,9,14,13,9,10,12,3,17,4,S ,1,1,20,1,1,1,1,1,1,1,1,1,1,1,1
19171416,Sidney,1651,28/01/1994,22,0,0,0,0,184,80,2,3,2,3,3,4,1,2,2,2,4,5,9,9,5,10,2,11,9,6,11,11,12,11,10,5,12,14,12,11,11,11,4,11,10,9,12,13,12,12,13,10,13,10,13,11,20,10,12,13,11,10,8,8,12,13,12,11,14,6,2,4,DM/M C,1,1,1,1,1,1,1,1,1,17,20,1,1,1,1
19171419,Victor Hugo,1651,04/02/1993,23,0,0,0,0,188,80,10,8,6,1,12,8,4,13,8,7,12,3,2,1,2,4,6,1,2,3,3,2,3,2,5,8,5,13,5,7,5,12,4,1,7,1,9,6,4,10,10,6,13,14,8,12,20,2,12,8,6,8,4,8,10,9,14,12,11,8,1,8,GK ,20,1,1,1,1,1,1,1,1,1,1,1,1,1,1
19171503,Feliphe,1651,24/02/1992,24,0,0,0,0,179,82,1,1,1,4,4,3,2,2,3,2,2,7,8,13,13,13,7,12,7,3,6,8,6,5,12,7,11,7,9,7,8,6,10,12,1,11,7,7,8,13,13,8,14,10,10,13,20,13,10,10,9,10,10,10,20,12,8,12,14,3,7,6,S ,1,1,20,1,1,1,1,1,1,1,1,1,1,1,1
19171585,Aílton Machado,1651,17/04/1994,22,0,0,0,0,173,0,3,2,3,3,3,3,3,3,3,3,2,6,5,7,13,13,6,13,8,3,5,9,7,5,13,9,4,8,8,7,7,8,1,13,14,8,7,7,8,12,13,2,1,16,9,13,20,11,5,9,9,6,7,9,16,9,8,10,12,7,13,2,AM/S C,1,1,18,20,1,1,1,1,1,1,1,1,1,1,1
19171586,Arthur Henrique,1651,17/05/1994,22,0,0,0,0,176,68,2,3,1,2,1,3,2,2,2,3,1,6,8,9,8,11,2,10,8,6,10,9,7,15,10,9,11,11,8,10,9,15,9,6,11,9,10,10,7,15,15,7,7,20,12,14,11,12,8,10,4,6,6,10,12,13,10,11,11,8,4,2,D L,1,1,1,1,1,1,1,20,1,1,1,1,1,12,1
19171588,Daniel Guedes,1651,02/04/1994,22,0,0,0,0,180,71,1,1,2,2,2,3,2,2,2,3,1,10,15,13,11,12,8,8,11,13,11,13,7,12,13,11,13,10,12,13,11,12,15,11,11,14,10,13,14,13,14,11,8,15,18,13,20,13,12,12,11,11,9,11,10,12,10,11,10,8,4,2,D R,1,1,1,1,1,1,1,1,20,1,1,1,1,1,12
19171589,Danilo Mohamed,1651,06/03/1994,22,0,0,0,0,181,0,3,3,4,3,2,2,3,3,2,3,3,4,7,6,3,11,3,4,3,8,10,10,6,10,8,6,8,9,9,11,9,10,8,8,6,8,7,8,10,14,11,10,12,12,5,12,20,9,8,8,8,8,7,8,14,12,10,9,12,5,13,4,D/WB R,1,1,1,1,1,1,1,12,20,1,1,1,1,10,16
19171591,Felipe Passoni,1651,06/11/1993,22,0,0,0,0,188,84,13,7,4,1,11,12,5,13,9,9,13,4,1,2,3,1,8,1,1,2,1,1,4,1,4,7,6,12,7,5,6,13,5,1,10,1,12,7,6,12,13,5,13,9,6,12,20,5,13,9,8,9,9,9,10,8,10,9,8,4,18,3,GK ,20,1,1,1,1,1,1,1,1,1,1,1,1,1,1
19171593,Gabriel Novaes,1651,12/08/1995,20,0,0,0,0,181,0,2,1,1,3,2,1,2,3,1,1,1,1,1,1,3,7,4,13,4,1,13,7,3,13,4,9,9,9,7,7,6,13,9,7,13,3,13,6,7,12,9,7,10,12,16,12,20,4,8,9,9,9,8,9,10,11,12,12,9,11,15,5,D C,1,1,1,1,1,1,20,1,1,1,1,1,1,1,1
19171595,Gabriel Xavier,1651,15/07/1993,22,0,0,0,0,170,70,2,2,2,3,1,3,1,1,2,1,1,11,11,13,13,12,11,10,13,5,9,13,12,10,13,11,12,11,13,11,11,13,16,13,8,12,6,14,13,13,14,8,6,20,14,12,8,12,9,13,10,15,12,13,9,10,12,9,8,6,7,2,M/AM RC,1,1,1,20,12,19,1,1,1,1,19,10,18,1,1
19171596,Guilherme Correia,1651,01/03/1993,23,0,0,0,0,176,0,2,3,1,1,1,1,2,1,1,3,2,4,7,13,13,13,6,13,6,3,5,6,8,1,10,9,12,8,8,5,5,10,9,10,1,13,7,6,7,13,13,7,6,8,9,13,20,8,7,9,8,7,4,9,17,13,10,9,12,7,14,3,S ,1,1,20,1,1,1,1,1,1,1,1,1,1,1,1
19171600,Léo Paoli,1651,23/03/1995,21,0,0,0,0,177,0,2,2,3,1,3,3,4,1,1,2,3,4,7,14,14,14,8,14,9,5,7,9,8,5,11,9,14,7,8,6,8,10,8,10,7,13,8,8,9,14,14,9,7,6,14,14,20,10,9,10,10,10,7,10,17,12,10,9,12,11,1,2,S ,1,1,20,1,1,1,1,1,1,1,1,1,1,1,1
19171601,Lucas Douglas,1651,19/01/1994,22,0,0,0,0,180,77,3,1,2,3,1,1,2,2,1,2,2,5,5,8,10,8,5,10,11,10,12,11,12,5,13,10,8,11,11,12,12,10,11,11,13,13,14,12,12,12,11,9,10,10,12,11,20,11,12,10,11,8,2,10,6,8,8,7,10,10,5,20,S ,1,1,20,1,1,13,1,1,1,1,1,1,1,1,1
19171602,Lucas Possignolo,1651,11/05/1994,22,0,0,0,0,185,79,2,1,3,1,4,2,2,4,1,2,2,6,5,8,8,11,15,14,7,8,13,11,8,15,11,11,13,14,11,13,8,10,13,6,13,10,14,13,13,12,11,14,12,5,13,11,20,12,13,13,5,11,5,8,10,8,8,13,16,15,13,6,D C,1,1,1,1,1,1,20,1,1,1,1,1,1,1,1
19171603,Matheus Barreto,1651,02/03/1995,21,0,0,0,0,194,0,1,1,2,2,2,1,3,3,2,3,2,6,6,2,5,13,6,6,10,3,10,13,1,13,8,9,8,8,6,6,7,13,3,9,11,7,5,7,9,13,10,2,10,8,13,13,20,6,10,9,5,2,7,9,17,10,13,9,12,11,16,1,DM C,1,1,1,1,1,1,1,1,1,20,15,1,1,1,1
19171604,Matheus Reis,1651,18/02/1995,21,0,0,0,0,184,79,3,1,2,1,3,3,3,1,2,4,4,8,12,11,10,11,8,12,12,13,13,11,11,11,13,13,12,11,12,12,12,11,11,11,7,12,12,12,11,14,12,13,9,20,15,13,6,15,14,11,7,8,2,12,20,11,9,10,10,2,9,5,D/WB/DM L,1,1,1,1,1,1,1,18,1,16,12,12,1,20,1
19171605,Michael,1651,08/04/1995,21,0,0,0,0,186,0,14,10,8,1,9,8,10,13,8,7,10,5,2,1,1,3,8,1,2,1,3,1,1,3,6,5,9,12,8,11,7,14,3,3,9,1,11,8,7,14,6,8,10,9,9,14,20,7,9,9,4,7,7,9,18,11,13,11,13,5,3,5,GK ,20,1,1,1,1,1,1,1,1,1,1,1,1,1,1
19171606,Nelsinho,1651,24/06/1994,22,0,0,0,0,172,0,1,2,1,3,2,3,3,1,1,3,2,8,8,10,10,15,8,8,13,6,9,13,5,9,15,8,13,8,6,9,11,10,6,13,14,11,9,9,12,15,11,4,8,1,13,10,20,7,6,9,9,8,9,9,16,11,11,11,13,9,17,5,AM C,1,1,1,20,1,1,1,1,1,1,15,1,1,1,1
19171607,Patrick Cruz,1651,01/04/1993,23,0,0,2,0,184,76,2,4,1,4,2,2,2,1,2,1,2,6,3,13,13,13,7,13,7,5,5,8,5,5,13,7,9,8,12,8,8,12,10,13,9,13,7,7,8,13,13,7,8,10,15,13,20,13,9,10,6,10,8,10,7,10,11,11,12,9,9,8,S ,1,1,20,1,1,1,1,1,1,1,1,1,1,1,1
19171608,Patric,1651,05/07/1994,21,0,0,0,0,181,74,3,1,3,2,2,1,2,3,2,3,4,3,10,10,10,11,3,9,10,6,8,10,10,8,11,14,9,12,6,6,9,6,13,13,3,11,8,11,11,13,11,11,9,20,13,12,3,12,11,12,14,11,5,14,11,11,10,11,11,10,6,10,D/WB/M/AM L,1,1,15,10,20,1,1,18,1,5,9,17,1,16,1
19171609,Paulo Marcelo,1651,20/07/1995,20,0,0,0,0,181,75,3,2,2,3,2,1,1,3,3,2,2,6,3,13,13,12,6,13,3,3,4,4,7,3,8,9,6,8,13,7,7,9,6,9,9,13,4,6,8,13,13,7,8,1,16,13,20,12,8,9,9,5,9,9,10,13,12,14,13,4,12,2,S ,1,1,20,1,1,1,1,1,1,1,1,1,1,1,1
19171611,Dener,1651,21/09/1995,20,0,0,0,0,176,68,2,1,2,2,2,2,3,2,3,1,3,4,1,8,10,12,3,8,5,1,3,5,8,1,8,8,9,6,12,4,6,10,8,9,12,8,5,4,6,12,11,1,5,7,11,12,20,5,5,8,8,1,8,8,10,12,10,14,11,11,12,8,S ,1,1,20,12,1,1,1,1,1,1,1,1,1,1,1
19171680,Bruninho,1651,18/09/1992,23,0,0,0,0,178,73,3,1,2,2,2,1,3,3,1,3,1,7,7,9,9,13,7,7,6,7,12,11,6,11,13,13,10,9,9,9,11,13,12,5,10,7,10,9,11,13,13,9,9,7,13,11,20,7,8,12,14,4,4,10,7,12,9,10,10,6,8,1,DM/M C,1,1,1,1,1,1,1,1,10,20,17,1,1,1,7
19171683,Fabricio,1651,30/01/1994,22,0,0,0,0,172,0,3,2,3,3,2,3,1,3,1,2,3,7,6,3,8,10,7,7,14,5,5,8,5,8,14,9,9,6,8,8,13,10,9,9,8,8,10,8,12,12,13,8,6,8,15,13,20,8,7,9,7,8,9,9,8,13,13,12,9,7,17,2,M C,1,1,1,1,1,1,1,1,1,1,20,1,1,1,1
19171738,Gustavo Costa,1651,20/03/1995,21,0,0,0,0,175,69,3,3,1,1,3,3,3,1,2,3,1,9,8,9,8,11,13,9,11,7,10,12,12,7,13,5,8,9,11,12,11,11,10,9,6,8,12,11,10,10,12,9,11,10,13,12,20,10,12,6,13,7,10,7,16,11,11,11,11,2,11,7,AM C,1,1,1,20,1,1,1,1,1,1,15,1,1,1,1
19171739,Humberto,1651,26/04/1991,25,0,0,0,0,191,0,1,3,3,1,3,1,3,1,1,3,3,6,3,5,4,8,2,14,4,1,12,8,4,14,7,9,9,9,8,7,5,14,7,1,10,4,14,7,8,14,10,8,11,8,14,13,20,11,10,9,9,9,3,9,8,10,11,11,9,2,10,6,D C,1,1,1,1,1,1,20,1,1,1,1,1,1,1,1
19171740,Jerfferson Recife,1651,13/06/1993,23,0,0,0,0,175,69,3,1,2,2,1,2,1,2,2,3,3,9,11,12,7,11,10,7,7,10,10,12,5,8,12,8,12,10,9,10,10,10,4,13,11,11,9,9,11,14,14,8,8,20,12,13,14,10,8,10,9,10,6,10,16,14,11,12,11,8,13,3,D/WB/M/AM L,1,1,1,1,18,1,1,20,1,1,1,19,1,17,1
19171743,Roni,1651,26/01/1991,25,0,0,0,0,171,63,3,1,2,1,4,3,2,2,1,2,1,12,12,12,12,12,11,10,10,5,6,12,13,7,12,1,11,10,13,9,13,9,13,14,6,14,8,11,10,15,15,8,6,9,12,14,20,12,7,12,7,11,7,11,16,10,11,11,14,9,10,5,AM RLC,1,1,13,20,17,18,1,1,1,1,10,1,1,1,1
19171744,Piva,1651,16/02/1994,22,0,0,0,0,182,73,2,1,1,3,4,3,1,1,2,2,3,5,1,13,13,12,5,13,4,4,5,6,9,1,7,8,12,7,12,6,6,10,8,8,10,7,6,5,6,13,12,6,8,5,8,13,20,11,5,8,8,8,7,8,18,12,9,12,12,8,11,4,S ,1,1,20,1,1,1,1,1,1,1,1,1,1,1,1
19171746,Vitinho,1651,08/06/1990,26,0,0,0,0,176,67,2,2,2,2,2,1,1,3,3,2,2,9,9,11,11,15,12,9,10,5,7,11,7,8,11,4,11,9,9,11,10,15,10,10,2,15,10,11,8,12,12,8,8,20,13,12,14,12,8,10,4,7,10,10,7,14,11,11,11,1,15,8,M/AM C,1,1,1,20,1,1,1,1,1,1,17,1,1,1,1
19171747,Walber,1651,18/06/1987,29,0,0,0,0,173,70,1,1,3,2,3,3,1,2,3,3,3,9,10,10,8,10,5,10,11,7,10,9,4,7,10,10,12,11,11,11,7,11,5,13,15,11,13,10,11,13,13,12,6,7,10,12,20,11,8,11,10,11,7,10,19,11,9,14,10,10,10,1,D/WB R,1,1,1,1,1,1,1,1,20,1,1,1,1,1,17
19171781,Paulo Vitor,1651,21/11/1988,27,0,0,0,0,195,90,15,14,10,14,14,17,10,15,9,7,8,6,2,3,3,7,9,3,2,3,2,7,1,3,7,7,12,9,11,7,8,9,12,11,10,11,12,10,14,10,13,12,13,5,12,9,20,12,11,11,7,9,8,10,12,17,6,5,8,4,17,11,GK ,20,1,1,1,1,1,1,1,1,1,1,1,1,1,1
19171782,Daniel Borges,1651,23/03/1993,23,0,0,0,0,174,68,2,1,2,2,2,1,3,3,1,3,3,12,11,11,10,12,10,7,10,11,10,11,10,9,11,12,12,11,11,11,10,11,11,14,5,11,10,12,12,13,14,9,5,9,13,13,20,12,9,11,5,12,5,11,20,7,12,7,12,7,12,8,D/WB R,1,1,1,1,1,1,1,1,20,1,1,1,13,1,17
19171783,Edmar,1651,06/12/1987,28,0,0,0,0,175,0,1,2,1,2,2,2,2,2,1,1,2,5,6,6,1,9,1,4,6,5,7,8,1,10,6,9,9,8,6,10,8,13,2,9,8,6,9,8,8,13,13,8,4,9,10,13,20,13,7,9,7,9,6,9,19,11,14,11,12,10,3,1,D/WB R,1,1,1,1,1,1,1,1,20,1,1,1,1,1,17
19171785,Caio Gardim,1651,21/12/1992,23,0,0,0,0,184,80,3,2,3,1,2,3,3,3,3,2,1,7,9,12,11,10,7,12,9,1,7,9,6,2,10,7,10,9,7,4,10,7,4,8,3,13,8,7,7,13,13,10,9,14,15,13,20,7,8,10,10,10,10,10,8,9,10,10,11,8,11,4,AM/S C,1,1,20,17,1,1,1,1,1,1,1,1,1,1,1
19171811,Leandro,1651,28/07/1994,21,0,0,0,0,184,80,2,4,1,1,3,2,1,2,3,2,3,1,7,8,6,8,3,11,7,7,12,8,8,12,7,11,8,12,7,11,4,10,2,7,8,10,12,12,10,10,10,12,12,6,12,10,20,11,12,10,10,9,12,9,8,9,10,12,9,1,16,2,D C,1,1,1,1,1,1,20,1,1,1,1,1,1,1,1
19171812,Vinicius Limão,1651,17/08/1993,22,0,0,0,0,185,0,11,11,8,1,14,14,6,14,9,9,6,4,3,2,3,6,9,1,3,3,1,2,4,2,6,9,8,9,7,14,7,12,9,3,11,2,10,8,7,12,10,8,9,10,10,11,20,4,7,9,5,9,7,9,12,8,11,13,12,1,13,3,GK ,20,1,1,1,1,1,1,1,1,1,1,1,1,1,1
19171814,Ygor,1651,15/04/1994,22,0,0,0,0,196,0,8,12,9,4,12,14,9,14,9,9,9,1,3,3,3,1,4,1,1,2,2,1,1,1,5,10,7,14,9,12,8,14,5,1,5,2,9,9,7,13,14,9,17,6,12,9,20,3,11,10,8,10,8,10,14,11,13,10,12,6,18,4,GK ,20,1,1,1,1,1,1,1,1,1,1,1,1,1,1
19171815,Eduardo Praes,1651,03/11/1988,27,0,0,0,0,188,77,3,2,1,2,1,2,1,3,1,2,1,2,4,4,7,6,6,14,9,8,12,8,3,13,6,15,8,11,7,9,7,8,4,6,9,4,12,14,11,13,9,14,14,6,14,9,20,10,14,10,15,5,10,10,8,11,12,11,10,10,4,4,D C,1,1,1,1,1,1,20,1,10,1,1,1,1,1,1
19171885,Alex Baiano,1651,09/07/1988,27,0,0,0,0,193,81,1,2,1,3,2,2,3,3,2,1,2,6,4,1,4,6,3,12,1,2,13,7,3,13,2,9,13,9,6,8,6,13,8,6,12,6,13,6,7,13,10,7,15,9,9,12,20,7,10,9,9,9,9,9,15,11,11,10,10,1,4,2,D C,1,1,1,1,1,1,20,1,1,1,1,1,1,1,1
19172044,Matheus Zauli,1651,06/12/1994,21,0,0,0,0,179,70,2,2,3,2,1,2,2,2,3,1,3,5,4,9,6,12,2,4,7,5,6,10,3,12,9,5,8,5,6,7,9,11,6,8,6,5,5,11,12,8,9,7,4,9,8,9,20,8,7,8,8,6,8,8,12,11,8,9,11,5,2,5,DM/M C,1,1,1,1,1,1,1,1,1,17,20,1,1,1,1
19172046,Adelino,1651,06/07/1994,21,0,0,0,0,182,76,2,3,4,3,3,3,2,3,3,2,3,7,3,14,14,14,7,11,8,1,7,8,8,7,13,7,13,8,8,6,3,11,9,12,11,14,6,7,8,13,8,8,11,10,5,11,20,8,8,9,9,9,9,9,10,10,11,11,13,7,3,4,S ,1,1,20,1,1,1,1,1,1,1,1,1,1,1,1
19172047,Alexandre,1651,05/11/1994,21,0,0,0,0,186,70,2,3,1,1,3,4,1,1,2,3,2,6,3,3,1,3,1,13,1,1,13,4,2,13,2,9,8,9,7,8,3,13,1,4,4,6,6,6,7,13,10,9,12,9,13,12,20,8,9,9,5,6,9,9,8,10,11,11,7,5,7,7,D C,1,1,1,1,1,1,20,1,1,1,1,1,1,1,1
19172048,Bruno Mendes,1651,02/08/1994,21,0,0,0,0,184,76,1,3,4,1,3,3,3,1,3,1,1,1,3,11,12,13,1,13,11,1,1,11,6,6,10,8,12,9,13,13,12,11,7,12,8,12,13,11,13,14,13,14,14,10,14,13,20,12,13,10,6,12,9,2,9,8,12,14,13,10,11,7,S ,1,1,20,10,8,14,1,1,1,1,5,1,1,1,1
19172049,Eduardo Henrique,1651,17/05/1995,21,0,0,0,0,184,73,4,4,3,3,1,3,2,3,3,3,3,10,14,11,10,14,12,8,11,6,10,14,12,11,14,12,13,12,11,12,13,13,8,12,3,14,11,14,12,12,13,6,9,10,13,11,20,14,11,11,5,7,11,14,10,13,12,11,10,7,14,6,DM/M C,1,1,1,13,1,13,1,1,1,18,20,1,12,1,1
19172095,Matheus,1651,08/01/1993,23,0,0,0,0,173,73,1,2,2,2,1,2,2,1,2,3,4,5,8,10,7,7,5,7,6,5,6,6,4,7,9,8,7,5,6,7,4,9,6,9,10,7,7,6,7,13,10,7,1,9,8,12,20,6,5,8,8,8,8,8,12,12,13,11,10,3,15,5,D/WB/AM/S R,1,1,18,1,1,20,1,1,19,1,1,1,1,1,17
19172096,Wilian Simões,1651,08/03/1988,28,0,0,0,0,170,69,3,3,3,3,2,2,3,1,1,1,3,10,10,12,5,9,12,8,5,10,10,12,7,10,12,7,9,11,12,10,9,16,10,9,5,10,11,7,11,14,14,14,5,20,7,14,11,10,8,10,3,4,5,10,7,10,11,14,11,4,10,2,D/WB L,1,1,1,1,1,1,1,20,1,1,1,1,1,17,1
19172097,Guilherme Queiróz,1651,23/05/1990,26,0,0,0,0,179,75,1,1,1,4,3,1,2,2,1,3,3,5,7,11,13,11,9,9,10,4,5,10,13,5,11,12,12,11,12,11,11,11,17,10,6,13,11,10,14,13,12,12,10,14,14,13,20,14,9,12,12,12,8,9,11,12,11,11,12,4,14,3,S L,1,1,20,8,15,1,1,1,1,1,1,1,1,1,1
19172116,Alex Muralha,1651,10/11/1989,26,0,0,0,0,188,87,14,12,12,7,13,13,16,15,12,16,12,9,2,2,3,8,12,2,1,2,2,4,5,3,10,5,11,16,11,14,7,12,9,1,13,1,11,13,12,13,13,13,15,13,14,14,20,14,14,12,10,3,7,12,11,8,8,11,10,4,4,2,GK ,20,1,1,1,1,1,1,1,1,1,1,1,1,1,1
19172117,Marcelo Ferreira,1651,10/01/1990,26,0,0,0,0,180,76,3,2,2,1,2,3,2,2,2,2,2,6,7,3,2,13,3,6,5,7,9,9,1,11,9,8,12,9,8,12,6,12,4,9,10,7,11,9,9,14,14,10,10,10,14,14,20,14,10,9,7,4,9,9,18,9,13,11,12,9,6,2,D/WB R,1,1,1,1,1,1,1,1,20,1,1,1,1,1,17
19172118,Rafael Longuine,1651,30/05/1990,26,0,0,0,0,174,64,1,1,2,2,2,2,2,3,3,1,3,12,12,13,13,12,12,9,12,10,10,15,12,11,15,10,12,10,13,14,15,11,8,13,14,13,12,13,13,13,13,13,7,5,13,13,20,14,12,14,8,10,11,13,11,8,9,14,12,7,19,4,M/AM C,1,1,1,20,1,1,1,1,1,1,17,1,1,1,1
19172148,Vitor,1651,20/05/1991,25,0,0,0,0,189,80,1,4,1,3,4,3,1,2,1,3,3,3,1,1,4,8,1,13,1,2,12,7,1,13,6,9,10,7,7,10,6,13,9,2,13,6,12,5,8,11,12,7,11,5,10,12,20,12,11,9,9,9,7,9,8,12,11,10,9,9,1,6,D C,1,1,1,1,1,1,20,1,13,1,1,1,1,1,1
19172149,Rossi,1651,22/04/1993,23,0,0,0,0,170,70,3,2,3,3,3,3,1,2,2,1,2,7,9,12,11,10,5,6,6,5,7,9,9,6,9,11,10,11,9,10,10,8,9,13,8,11,6,11,13,15,13,14,4,11,15,13,20,13,6,9,6,11,11,10,16,11,11,9,10,7,12,9,AM/S RL,1,1,17,13,17,20,1,1,1,1,1,1,1,1,1
19172151,Lucas,1651,25/02/1988,28,0,0,0,0,182,80,1,3,2,2,3,1,2,1,2,1,2,3,8,8,8,11,7,7,9,1,9,14,5,11,13,17,11,16,9,9,9,13,6,10,9,8,12,14,9,13,13,8,10,11,6,13,20,13,12,10,4,7,14,10,9,15,11,10,12,3,13,1,DM/M C,1,1,1,1,1,1,1,1,1,20,17,1,13,1,7
19172197,Matheus,1651,27/04/1992,24,0,0,0,0,191,81,13,10,9,1,13,11,7,13,9,9,11,4,1,3,1,1,9,1,3,1,1,1,1,3,1,7,9,12,7,11,6,13,8,2,3,3,6,7,6,11,8,5,15,10,14,12,20,6,13,9,6,9,9,9,9,10,9,11,14,2,9,3,GK ,20,1,1,1,1,1,1,1,1,1,1,1,1,1,1
19172326,Ednei,1651,05/07/1990,25,0,0,0,0,185,81,4,1,2,3,4,4,3,3,2,1,1,5,7,8,8,7,6,13,8,8,12,8,8,12,7,13,8,14,8,6,6,9,12,14,9,12,12,14,13,14,13,8,13,13,13,13,20,15,12,10,11,8,7,12,11,9,12,8,12,10,10,10,D C,1,1,1,1,1,1,20,1,8,9,1,1,1,1,1
19172362,João Vitor,1651,14/06/1991,25,0,0,0,0,190,84,13,9,8,5,13,12,8,9,8,9,12,1,2,3,1,2,4,1,1,1,1,1,2,1,1,9,9,14,6,8,6,13,6,2,4,3,5,7,6,10,12,6,14,10,13,11,20,6,10,9,9,8,9,9,18,14,10,12,12,8,12,2,GK ,20,1,1,1,1,1,1,1,1,1,1,1,1,1,1
19172363,Wanderson,1651,13/09/1991,24,0,0,0,0,183,77,3,2,1,3,1,2,2,2,2,3,3,11,13,12,8,6,10,9,10,13,8,11,6,9,12,6,9,12,8,11,12,10,5,13,9,13,10,13,14,12,12,8,12,20,14,13,10,15,10,11,6,11,10,12,15,11,10,10,13,10,15,3,D/WB L,1,1,1,1,12,1,1,20,1,1,1,15,1,17,1
19172364,Paulinho,1651,07/01/1993,23,0,0,0,0,173,73,1,3,3,4,2,2,3,1,2,1,2,10,10,12,10,11,10,11,12,15,11,13,10,11,13,7,12,10,11,12,10,13,5,13,8,12,11,12,15,13,11,12,4,10,7,13,20,10,8,10,10,8,9,10,12,11,12,12,10,8,9,4,DM/M RC,1,1,1,14,1,1,1,1,1,18,20,1,16,1,1
19172374,Jubal,1651,29/08/1993,22,0,0,0,0,190,78,1,3,1,2,1,3,3,1,4,3,3,3,5,8,9,8,4,14,6,3,14,12,2,14,11,12,15,13,13,13,9,14,14,8,11,10,14,13,13,12,13,13,15,10,14,13,20,11,13,13,11,13,7,2,14,13,8,11,13,13,8,5,D C,1,1,1,1,1,1,20,1,1,1,1,1,1,1,1
19172375,Leandrinho,1651,25/09/1993,22,0,0,0,0,178,70,2,1,2,3,2,2,3,1,2,3,1,7,7,12,11,11,7,9,12,6,12,14,6,13,14,11,12,11,12,12,14,12,13,11,8,13,13,13,12,13,13,10,7,9,10,13,20,11,11,12,6,9,4,10,8,13,13,10,14,1,16,8,M C,1,1,1,1,1,1,1,1,1,13,20,1,1,1,1
19172376,Caique,1651,26/04/1994,22,0,0,0,0,175,64,2,1,2,2,3,2,1,3,3,2,3,6,8,7,2,9,4,8,5,4,9,7,2,12,9,9,5,9,8,13,7,11,5,5,8,6,8,4,9,14,14,8,7,9,14,12,20,13,6,9,1,2,9,9,19,11,10,12,10,7,4,5,D R,1,1,1,1,1,1,1,1,20,1,1,1,1,1,15
19172378,Lucas Crispim,1651,19/06/1994,22,0,0,0,0,178,72,4,1,3,3,4,1,1,2,2,2,1,8,11,14,12,13,11,12,12,2,3,13,8,4,13,11,12,8,11,12,10,12,13,13,10,13,7,11,12,14,13,8,8,10,13,14,20,13,10,11,11,7,10,14,20,12,11,12,12,6,11,12,AM RLC,1,1,13,20,15,15,1,1,1,1,1,1,1,1,1
19172380,Douglas,1651,23/06/1993,23,0,0,0,0,173,68,1,1,4,4,1,2,2,1,2,2,1,8,7,8,2,12,6,9,5,9,10,9,7,15,11,10,9,11,7,7,7,13,1,10,3,9,10,10,10,15,12,10,7,10,11,14,20,9,7,10,9,10,10,10,11,11,10,12,11,10,9,5,D R,1,1,1,1,1,1,1,1,20,1,1,1,1,1,13
19172381,Pedro Maratta,1651,25/04/1994,22,0,0,0,0,176,72,4,1,3,3,1,1,3,2,2,3,1,7,4,8,4,14,7,7,13,5,10,11,6,14,12,7,9,8,4,9,10,14,5,9,8,7,11,8,12,13,9,5,8,7,16,12,20,9,6,9,7,5,9,9,8,9,11,12,9,7,6,5,DM ,1,1,1,1,1,1,1,1,1,20,13,1,1,1,1
19172382,Zeca,1651,16/05/1994,22,0,0,0,0,170,66,3,3,1,3,2,2,1,3,2,4,2,13,14,15,13,13,12,9,16,13,12,14,9,13,15,10,12,12,12,12,13,13,13,15,11,14,12,13,13,15,13,11,8,13,13,14,20,13,12,13,5,13,5,15,8,11,12,10,10,1,3,4,D L,1,1,1,1,1,1,1,20,10,1,1,1,1,13,1
19172383,Kauê Rivera,1651,15/06/1994,22,0,0,0,0,166,63,2,3,4,3,2,3,1,1,3,4,3,5,5,6,5,6,5,5,6,5,7,10,1,10,7,8,6,5,4,8,10,13,8,1,13,5,8,7,12,13,11,14,2,9,11,11,20,9,3,8,8,8,8,8,20,11,13,11,11,1,6,3,D/DM/M RC,1,1,1,1,1,1,1,1,18,20,16,1,1,1,12
19172384,João Victor,1651,13/03/1993,23,0,0,0,0,183,82,2,1,1,3,2,3,3,2,2,2,1,6,2,13,13,13,6,13,7,1,6,7,7,1,9,6,13,7,13,7,5,13,3,9,7,9,5,6,7,13,11,7,10,3,13,12,20,8,6,9,7,5,9,8,7,12,11,12,13,1,7,7,S ,1,1,20,1,1,1,1,1,1,1,1,1,1,1,1
19172398,Littibask,1651,15/12/1994,21,0,0,0,0,182,0,3,1,3,2,4,3,2,3,2,3,4,5,3,1,1,6,4,14,7,3,13,7,3,14,6,9,7,9,7,5,7,14,2,1,9,7,14,7,8,12,12,8,6,8,11,10,20,8,10,9,6,9,9,9,18,9,12,11,13,3,1,2,D C,1,1,1,1,1,1,20,1,1,1,1,1,1,1,1
19172406,Paulo Otávio,1651,23/11/1994,21,0,0,0,0,173,69,1,2,2,1,2,3,1,3,3,2,1,9,13,14,8,14,12,12,10,12,7,12,6,7,13,1,14,11,14,10,13,15,10,14,4,12,6,13,12,16,16,5,6,20,7,14,9,7,5,11,5,8,11,14,12,9,11,9,12,5,10,6,D/WB L,1,1,1,1,1,1,1,20,10,1,1,15,1,18,10
19173158,Braga,1651,20/02/1995,21,0,0,0,0,182,74,3,4,3,1,2,1,3,2,1,1,2,8,10,8,7,9,8,9,9,9,11,10,8,11,9,11,11,10,12,12,8,15,7,9,12,7,12,11,15,12,11,10,11,11,4,12,20,13,9,10,13,10,4,11,15,10,9,5,5,7,5,15,DM C,1,1,1,1,1,1,1,1,1,20,15,1,6,1,1
19173159,Vinícius Silveira,1651,08/01/1995,21,0,0,0,0,174,70,3,2,3,1,2,1,2,1,2,3,1,8,11,10,14,12,8,15,11,1,9,11,9,9,9,9,8,1,10,10,7,13,6,10,6,13,10,10,11,15,11,7,10,10,17,12,20,11,8,10,7,6,7,10,14,11,9,10,8,7,14,8,S C,1,1,20,15,12,14,1,1,1,1,1,1,1,1,1
19173160,Felipe Alves,1651,18/11/1990,25,0,0,0,0,179,80,2,3,1,1,2,1,3,1,2,2,1,7,7,13,13,13,7,13,8,1,7,6,6,4,13,10,12,6,12,6,5,13,6,13,10,12,8,7,8,13,13,8,9,10,12,13,20,13,5,10,10,8,6,10,8,13,11,14,11,11,16,2,S ,1,1,20,1,1,1,1,1,1,1,1,1,1,1,1
19173179,Mateus Gonçalves,1651,28/09/1994,21,0,0,0,0,172,66,1,1,1,1,1,1,2,1,3,1,3,10,15,12,9,15,9,10,11,3,9,11,4,9,12,6,12,7,10,4,11,14,2,9,14,11,8,10,10,15,13,10,5,8,11,14,20,7,7,9,7,10,10,10,18,10,14,14,11,4,1,6,AM RLC,1,1,13,15,19,20,1,1,1,1,12,1,1,1,1
19173180,Cesinha,1651,31/03/1994,22,0,0,0,0,170,61,3,1,4,3,1,1,3,1,1,2,1,8,10,9,9,14,6,9,9,9,11,9,4,11,10,10,12,9,10,12,10,11,8,10,1,10,9,10,10,14,13,10,5,10,11,11,20,14,10,10,6,3,8,10,19,12,13,11,13,3,8,7,D/WB R,1,1,1,1,1,1,1,1,18,1,1,1,1,1,20
19173182,João Denoni,1651,06/02/1994,22,0,0,0,0,172,75,1,2,3,2,1,3,1,2,3,1,1,4,11,11,11,11,11,8,12,6,13,12,10,12,12,13,12,13,13,12,11,11,3,10,7,10,12,13,12,12,12,13,6,8,15,12,20,13,7,12,13,1,8,10,17,13,12,9,11,4,8,2,DM/M C,1,1,1,12,1,1,1,1,1,18,20,1,1,1,1
19173183,Lima,1651,14/05/1994,22,0,0,0,0,176,66,2,2,1,3,3,1,4,1,3,2,3,4,2,3,1,4,1,5,5,4,7,7,1,9,6,8,9,7,5,8,3,11,5,8,9,4,5,6,6,13,13,6,6,20,12,13,9,13,12,8,7,3,4,8,10,9,13,11,10,3,14,6,D/WB L,1,1,1,1,1,1,1,18,1,1,1,1,1,20,1
19173184,Vinícius Silvestre,1651,28/03/1994,22,0,0,0,0,195,82,12,8,8,1,14,12,8,14,7,6,6,5,1,2,1,5,7,1,1,1,3,1,4,2,1,10,7,13,9,8,8,14,8,3,10,2,11,9,8,9,17,9,17,11,16,10,20,5,12,10,9,8,5,10,8,12,15,11,11,1,4,7,GK ,20,1,1,1,1,1,1,1,1,1,1,1,1,1,1
19173187,Lucas Taylor,1651,10/04/1995,21,0,0,0,0,176,0,1,1,1,1,3,1,1,2,3,4,1,6,10,11,11,10,4,11,6,6,11,10,6,11,11,9,11,10,9,12,10,12,2,6,11,10,8,10,10,15,14,10,7,11,12,12,20,11,8,10,10,12,6,10,15,12,10,8,10,1,11,2,D/WB R,1,1,13,1,1,8,1,1,20,1,1,1,9,1,19
19173188,Cléber Pacheco,1651,05/05/1992,24,0,0,0,0,183,80,3,1,1,2,2,3,2,1,2,2,3,6,6,7,5,10,6,12,7,8,12,10,6,13,12,13,14,13,8,13,8,8,4,8,8,13,11,8,12,13,13,14,11,8,12,12,20,12,12,8,11,8,6,11,16,12,12,11,8,4,15,6,D C,1,1,1,1,1,1,20,1,1,13,1,1,1,1,1
19173189,Juninho,1651,05/08/1992,23,0,0,0,0,172,0,3,3,3,1,1,3,1,2,4,3,3,7,5,9,8,13,7,7,8,1,7,10,6,7,13,10,8,4,9,7,13,13,4,13,10,11,9,8,11,12,13,8,4,10,11,13,20,7,5,10,6,10,9,10,11,13,9,10,11,1,3,1,AM C,1,1,1,20,1,1,1,1,1,1,15,1,1,1,1
19173190,Rodrigo Soares,1651,01/10/1992,23,0,0,0,0,175,68,1,1,3,1,2,1,3,1,3,3,2,4,5,9,5,11,1,8,4,2,10,14,5,11,10,9,13,9,8,6,9,14,7,9,14,9,9,9,10,12,10,15,7,20,16,13,10,10,8,9,9,9,9,13,16,13,11,12,10,8,7,3,D/WB L,1,1,1,1,11,1,1,20,1,10,14,13,1,18,1
19173191,Caio Mancha,1651,22/09/1992,23,0,0,0,0,188,82,3,2,1,2,1,2,3,2,2,3,2,8,8,10,10,10,8,13,8,4,5,10,11,5,11,11,10,12,11,11,10,10,2,10,5,11,7,12,11,12,11,12,14,11,13,12,20,13,11,11,9,12,11,7,7,12,14,12,10,1,16,3,S ,1,1,20,1,1,1,1,1,1,1,1,1,1,1,1
19173192,Cleiton,1651,17/08/1992,23,0,0,0,0,167,0,1,2,4,2,3,1,1,3,2,3,2,3,5,9,6,9,2,8,7,8,10,9,5,15,10,9,9,6,9,9,10,11,7,7,4,9,8,10,10,13,14,5,3,20,10,14,7,7,8,9,11,6,7,9,15,11,10,11,11,12,5,4,D/WB L,1,1,1,1,1,1,1,17,1,1,1,1,1,20,1
19173234,Badalotti,1651,16/03/1994,22,0,0,0,0,170,0,3,3,1,1,2,4,3,2,2,3,3,5,5,3,7,12,5,4,8,1,4,13,2,6,8,4,6,6,7,5,13,13,8,8,7,8,5,7,11,13,13,6,3,12,10,13,20,7,3,8,6,1,8,8,16,9,9,10,8,9,1,8,AM C,1,1,1,20,1,1,1,1,1,1,15,1,1,1,1
19173236,Jhonatan,1651,08/05/1991,25,0,0,0,0,189,75,15,13,9,1,15,15,8,14,8,10,13,3,2,3,2,6,5,2,1,3,1,1,3,3,8,12,10,15,6,11,9,8,10,1,6,3,9,10,9,15,13,7,14,11,17,13,20,6,13,10,13,10,10,10,10,12,12,10,14,7,15,2,GK ,20,1,1,1,1,1,1,1,1,1,1,1,1,1,1
19173261,Brendo,1651,24/06/1994,22,0,0,0,0,185,79,3,1,3,1,1,4,2,2,2,3,3,6,5,8,4,11,2,8,8,7,10,7,1,8,6,1,9,8,9,10,9,10,3,6,10,9,12,9,9,15,14,6,15,20,9,14,9,8,10,9,9,8,8,9,19,9,9,11,11,7,5,8,D/WB L,1,1,1,1,1,1,1,18,1,1,1,1,1,20,1
19173262,Bruno Nazário,1651,09/02/1995,21,0,0,0,0,178,70,1,1,3,1,3,2,2,1,2,3,1,11,12,14,10,13,10,9,11,8,6,12,11,6,14,10,11,9,11,11,13,13,12,15,9,12,5,8,10,12,13,6,7,20,11,12,11,10,6,11,10,9,8,14,10,14,9,10,10,6,12,8,AM C,1,1,1,20,14,1,1,1,1,6,10,14,1,1,1
19173263,Lucas Freitas,1651,06/08/1994,21,0,0,0,0,181,0,3,1,1,3,3,2,1,1,2,3,1,1,5,2,2,10,1,4,5,5,8,8,2,13,8,7,4,7,4,10,7,6,1,8,4,7,5,7,7,13,14,7,10,8,14,14,20,6,7,8,8,8,8,8,18,12,7,12,11,12,11,5,D/WB R,1,1,1,1,1,1,1,1,18,1,1,1,1,1,20
19173264,Clayton,1651,23/10/1995,20,0,0,0,0,173,69,1,3,1,2,2,2,2,3,3,2,3,11,12,14,12,12,10,11,10,6,9,13,13,6,13,12,12,11,13,13,12,13,12,13,11,12,6,13,13,15,14,13,7,13,14,14,20,13,8,12,11,11,11,13,12,12,12,14,9,6,11,6,AM/S RC,1,1,20,16,13,15,1,1,1,1,1,1,1,1,1
19173298,Kapa,1651,07/12/1992,23,0,0,0,0,171,63,4,1,1,1,2,2,4,2,3,2,1,10,10,11,9,12,10,7,10,10,12,11,9,10,11,13,11,11,11,11,10,11,9,5,8,12,10,12,12,14,14,15,5,20,14,14,12,14,4,11,13,7,10,14,11,11,9,11,11,12,10,4,D L,1,1,1,12,11,2,1,20,10,1,5,13,6,15,11
19173299,Tiaguinho,1651,07/10/1988,27,0,0,0,0,173,0,3,3,2,3,2,3,2,3,1,2,3,6,8,10,6,12,7,7,9,6,8,10,3,6,13,10,7,9,4,7,10,13,2,13,8,9,8,9,8,13,13,8,1,20,8,12,10,14,5,10,6,5,10,14,7,12,10,9,10,8,10,4,D/WB/M/AM LC,1,1,1,20,16,1,1,18,1,1,8,18,1,18,1
19173326,Ítalo,1651,27/11/1993,22,0,0,0,0,172,60,3,3,2,3,3,1,4,2,1,3,1,7,5,14,9,14,7,8,9,3,7,11,7,8,14,9,8,3,11,7,8,11,3,13,10,11,8,8,9,13,13,4,4,20,15,12,9,11,5,9,4,6,4,9,17,11,11,12,11,6,15,2,AM C,1,1,12,20,1,1,1,1,1,1,10,1,1,1,1
19173437,Deoclécio,1651,04/04/1991,25,0,0,0,0,177,0,2,1,1,1,2,2,1,2,2,1,3,8,8,8,9,14,4,3,14,1,8,14,6,14,13,7,10,9,7,12,13,9,9,10,4,8,12,9,13,11,14,9,5,9,16,14,20,14,12,10,8,10,8,10,16,10,13,12,11,9,12,1,DM ,1,1,1,1,1,1,1,1,1,20,10,1,1,1,1
19173447,Jean Felipe,1651,18/03/1994,22,0,0,0,0,180,74,2,3,3,1,3,1,2,2,4,1,1,9,11,13,5,11,13,8,10,5,5,11,7,6,13,9,10,10,11,11,10,10,10,14,8,10,8,11,12,14,11,12,8,5,10,13,20,11,12,10,8,9,9,15,14,9,12,11,10,6,6,2,D/WB R,1,1,1,1,1,1,1,1,20,1,1,1,14,1,18
19173572,Micheel,1651,26/11/1990,25,0,0,0,0,185,82,2,1,3,1,1,2,2,2,3,1,1,8,5,7,7,9,7,7,9,2,10,14,11,14,14,8,12,9,12,10,13,14,4,6,11,9,10,7,11,14,12,9,13,10,10,13,20,9,8,10,10,10,7,10,16,11,9,12,11,1,9,7,DM/M C,1,1,1,1,1,1,1,1,1,20,18,1,1,1,1
19173579,Michel,1651,22/03/1990,26,0,0,0,0,175,67,1,3,3,1,3,3,3,1,3,1,2,7,9,11,12,14,9,7,10,1,12,13,6,12,14,10,11,10,10,11,12,14,8,13,3,9,9,12,11,12,12,11,10,20,11,12,15,11,11,12,10,8,11,11,9,12,11,11,12,13,8,8,DM/M C,1,1,1,11,1,1,1,12,1,20,18,1,1,12,1
19173585,João Ananias,1651,12/01/1991,25,0,0,0,0,174,68,1,3,1,1,2,2,1,1,1,1,1,8,11,11,6,8,6,8,8,6,14,13,6,12,12,11,13,11,11,13,11,11,15,8,4,13,12,11,12,12,12,10,10,11,13,12,20,15,9,11,3,3,11,11,20,11,8,11,12,7,17,7,D/WB/DM R,1,1,1,1,1,1,1,1,19,20,10,1,1,1,18
19173588,Bryan,1651,28/03/1992,24,0,0,0,0,176,72,1,3,1,3,1,1,4,2,2,1,4,11,11,12,11,11,10,9,10,14,11,11,8,10,13,9,14,12,14,13,13,14,12,15,8,15,11,13,10,14,15,10,8,20,14,15,9,15,8,12,9,14,6,14,12,14,12,10,11,7,10,11,D/WB L,1,1,1,1,1,1,1,20,1,1,1,1,1,19,1
19173716,Rafinha,1651,05/08/1993,22,0,0,0,0,177,74,2,2,1,1,1,3,2,1,3,1,2,9,12,12,11,12,8,10,11,8,9,12,11,9,12,9,11,12,11,11,11,12,12,12,9,11,9,12,14,14,12,13,8,13,8,12,20,13,7,8,11,10,14,16,20,12,12,13,9,6,9,5,DM/M C,1,1,1,9,1,9,1,1,10,19,20,1,13,1,9
19173721,Anderson Paraíba,1651,25/01/1991,25,0,0,0,0,170,68,3,1,4,1,2,1,3,2,2,2,2,7,7,13,7,11,5,5,10,5,7,13,5,5,13,9,10,3,9,5,13,13,10,14,13,12,4,8,12,13,12,5,4,20,13,11,10,9,4,10,10,10,10,10,7,10,7,11,9,6,10,3,AM C,1,1,1,20,1,1,1,1,1,1,14,1,1,1,1
19173724,Oswaldo,1651,27/12/1992,23,0,0,0,0,188,78,2,3,3,2,2,1,2,3,1,1,3,2,2,1,1,9,1,11,1,1,13,10,5,12,7,5,13,10,8,12,6,13,14,8,9,7,13,7,8,13,13,8,14,11,11,13,20,9,10,4,10,10,10,10,20,11,8,10,11,4,14,3,D C,1,1,1,1,1,1,20,1,12,1,1,1,1,1,1
19173877,Yago Pikachu,1651,05/06/1992,24,0,0,0,0,169,63,4,1,2,2,1,2,2,3,3,1,1,13,12,13,12,12,14,10,12,10,8,12,13,8,13,12,13,11,12,13,13,12,13,13,11,12,10,13,13,14,14,8,6,5,14,14,20,13,8,13,8,13,6,13,17,14,12,13,12,9,12,9,D/WB/M/AM R,1,1,1,5,1,19,1,1,20,1,1,1,18,1,19
19173879,Neto,1651,08/05/1992,24,0,0,0,0,173,0,3,2,2,3,1,1,1,1,3,3,2,6,3,5,2,13,4,6,13,1,7,9,5,13,13,7,9,8,6,8,7,11,9,8,8,6,9,7,11,13,13,7,5,6,5,13,20,6,10,9,7,3,4,9,8,11,14,11,13,2,12,7,DM ,1,1,1,1,1,1,1,1,1,20,10,1,1,1,1
19173880,Anderson Costa,1651,19/05/1994,22,0,0,0,0,167,63,3,3,3,1,3,3,2,2,1,3,1,7,3,13,13,13,5,13,7,1,7,8,5,3,13,9,9,9,8,3,8,13,10,13,14,11,8,7,8,13,13,8,3,9,17,13,20,9,7,10,10,9,6,10,9,11,13,11,11,1,11,4,S ,1,1,20,1,1,1,1,1,1,1,1,1,1,1,1
19173885,Pablo,1651,18/03/1992,24,0,0,0,0,185,78,2,2,2,2,2,3,1,2,3,4,3,6,7,7,3,9,8,15,6,8,13,6,6,12,9,10,11,11,11,11,8,9,5,6,14,9,14,9,11,15,11,11,12,20,17,14,11,15,11,10,8,10,10,10,11,10,9,10,11,6,11,6,D LC,1,1,1,1,1,1,20,19,1,1,1,1,1,1,1
19173886,Joaelton,1651,03/11/1988,27,0,0,0,0,179,82,3,1,1,3,1,1,2,2,4,1,3,2,7,9,13,10,5,9,10,7,4,8,8,4,9,11,9,10,7,9,7,9,5,10,7,10,7,10,8,12,11,12,11,9,13,12,20,10,14,9,7,3,9,9,7,13,10,10,8,7,15,1,S ,1,1,20,13,1,1,1,1,1,1,1,1,1,1,1
19173890,Fabinho Cambalhota,1651,14/10/1986,29,0,0,0,0,171,66,1,3,2,2,3,4,2,4,3,2,3,6,5,13,10,12,6,13,6,2,3,7,4,1,13,9,12,8,9,5,7,8,1,13,4,12,7,6,7,13,11,7,5,9,15,11,20,12,13,9,4,3,9,9,14,10,10,10,12,5,4,2,S ,1,1,20,1,1,1,1,1,1,1,1,1,1,1,1
19173912,Alex,1651,10/02/1988,28,0,0,0,0,176,70,1,1,1,2,3,1,1,1,1,2,2,3,6,13,13,13,7,7,11,2,11,12,12,8,12,13,13,13,12,13,11,12,15,8,8,13,13,11,11,12,11,11,8,11,15,12,20,11,9,12,10,9,9,12,12,11,14,13,14,11,12,13,S ,1,1,20,13,1,7,1,1,1,1,1,1,1,1,1
19174100,Jociel,1651,27/01/1992,24,0,0,0,0,192,87,13,10,7,1,13,11,9,13,7,6,11,6,3,1,3,2,10,1,2,3,2,2,2,1,3,6,12,15,8,13,7,8,10,1,5,3,11,8,7,12,10,8,13,12,7,13,20,2,9,10,9,2,10,10,14,13,12,12,12,11,15,2,GK ,20,1,1,1,1,1,1,1,1,1,1,1,1,1,1
19174104,Thiago Rodrigues,1651,20/10/1988,27,0,0,0,0,190,80,11,10,11,7,12,11,13,13,13,13,10,1,3,3,2,6,6,6,3,2,2,6,1,2,6,9,11,14,11,11,8,12,10,13,9,3,12,12,10,11,13,7,15,5,13,10,20,13,13,12,15,1,11,11,7,11,12,12,10,5,12,7,GK ,20,1,1,1,1,1,1,1,1,1,1,1,1,1,1
19174108,Marquinhos,1651,28/05/1992,24,0,0,0,0,168,63,3,3,1,2,2,1,4,2,2,3,3,9,10,12,8,12,12,9,12,9,9,9,16,9,13,11,10,10,6,8,10,6,8,14,10,9,7,9,8,14,13,8,5,15,10,11,20,10,6,10,10,10,3,10,10,12,6,6,10,5,9,3,AM RLC,1,1,1,20,16,19,1,1,1,1,8,10,14,1,1
19174110,Fransuar,1651,10/03/1993,23,0,0,0,0,184,69,1,2,1,4,3,2,2,1,2,1,2,7,3,3,6,7,4,14,1,3,11,8,7,14,8,4,14,10,4,6,6,10,9,7,4,7,14,8,9,14,11,9,10,8,15,14,20,8,10,10,6,6,6,10,19,10,9,11,8,6,16,2,D C,1,1,1,1,1,1,20,1,1,1,1,1,1,1,1
19174112,Alex Alves,1651,25/08/1992,23,0,0,0,0,182,82,3,1,3,3,1,1,2,1,3,2,3,6,8,5,2,9,6,13,5,7,14,13,8,15,9,16,12,12,11,10,6,12,15,4,13,11,13,7,10,13,13,13,11,20,15,11,11,7,13,11,12,10,10,11,15,10,15,13,15,10,14,10,D C,1,1,1,1,1,1,20,10,1,1,1,1,1,10,1
19174271,Nílson,1651,09/09/1991,24,0,0,0,0,190,78,1,1,2,2,2,3,3,1,1,3,3,2,4,3,4,7,1,11,4,5,6,7,1,12,6,8,8,8,4,6,6,11,8,4,6,5,9,6,7,13,8,6,14,20,12,11,9,9,8,8,8,8,7,8,19,13,9,12,12,8,11,5,D LC,1,1,1,1,1,1,20,17,1,15,1,1,1,1,1
19174275,Jeorge,1651,20/08/1991,24,0,0,0,0,177,70,2,1,2,3,3,2,3,3,1,3,3,8,6,14,14,14,8,14,9,1,8,7,8,4,14,6,12,4,10,9,8,14,1,13,8,14,7,8,9,14,11,9,8,1,12,9,20,7,8,9,10,10,9,10,20,10,12,10,11,9,6,6,S ,1,1,20,1,1,1,1,1,1,1,1,1,1,1,1
19174436,Tiago,1651,12/10/1993,22,0,0,0,0,181,0,2,2,3,3,3,1,2,1,2,1,1,2,2,7,5,14,1,4,6,2,8,13,1,11,14,6,13,7,7,7,6,14,8,8,7,5,9,8,11,9,10,10,11,9,14,8,20,6,9,8,8,1,8,8,20,14,11,12,13,3,10,6,DM ,1,1,1,1,1,1,1,1,1,20,10,1,1,1,1
19174843,Paulinho,1651,19/10/1985,30,0,0,0,0,180,75,1,2,2,2,1,1,2,2,2,1,1,6,5,11,13,12,3,13,7,4,5,7,10,1,9,8,13,2,13,6,7,12,4,9,7,10,7,6,7,13,13,7,7,9,14,13,20,11,9,9,8,4,8,9,18,10,11,9,11,2,12,6,S ,1,1,20,1,1,1,1,1,1,1,1,1,1,1,1
19174874,Hélton Leite,1651,02/11/1990,25,0,0,0,0,196,90,13,12,12,8,13,14,14,14,13,10,13,5,2,3,2,5,8,1,1,1,3,4,1,1,6,11,13,14,8,14,10,15,16,2,4,1,12,11,10,13,12,11,16,4,14,14,20,6,12,11,11,11,11,11,11,10,11,12,13,4,11,6,GK ,20,1,1,1,1,1,1,1,1,1,1,1,1,1,1
19174894,Thiago,1651,12/06/1996,20,0,0,0,0,186,75,11,12,12,8,14,12,12,13,10,8,10,1,1,8,1,8,5,8,1,1,1,9,12,7,9,8,9,9,9,11,9,10,12,8,8,1,11,12,12,9,10,10,9,8,14,9,20,14,9,14,5,14,8,1,16,14,11,14,12,12,12,8,GK ,20,1,1,1,1,1,1,1,1,1,1,1,1,1,1
19174904,Leleco,1651,11/01/1989,27,0,0,0,0,187,0,1,3,2,2,3,1,1,2,1,3,1,6,5,11,14,13,5,14,6,3,5,8,10,1,14,8,12,3,10,7,5,13,10,13,9,12,9,7,9,13,11,9,14,2,11,14,20,13,8,10,6,4,10,9,13,12,12,9,12,8,5,5,S ,1,1,20,1,1,1,1,1,1,1,1,1,1,1,1
19174929,Lucas Souza,1651,04/07/1990,25,0,0,0,0,185,80,2,2,1,1,1,2,2,3,2,3,3,8,9,10,8,12,7,12,9,8,12,12,8,13,12,17,13,15,12,12,10,11,15,5,8,8,14,13,15,12,11,15,13,10,15,11,20,13,14,11,14,10,12,11,7,14,10,11,14,12,6,10,DM C,1,1,1,10,1,1,1,1,1,20,15,1,1,1,1
19174948,Leomir,1651,24/03/1990,26,0,0,0,0,172,72,1,2,1,4,3,2,2,2,2,3,2,7,6,3,8,13,7,7,13,1,10,10,3,10,8,9,8,5,8,11,9,10,3,2,3,6,11,8,10,14,14,13,6,20,7,14,10,7,7,9,4,9,8,9,15,9,10,10,12,5,14,2,DM ,1,1,1,1,1,1,1,1,1,20,10,1,1,1,1
19174954,Téssio,1651,27/01/1993,23,0,0,0,0,167,57,3,2,3,1,1,2,3,2,2,1,2,11,12,8,8,11,12,6,6,6,8,9,4,8,8,6,8,7,8,8,9,13,9,9,1,8,7,8,8,12,10,8,2,20,9,12,9,10,4,9,9,4,9,9,14,11,11,10,11,12,10,3,D/M/AM LC,1,1,1,13,17,1,1,20,1,1,18,16,1,15,1
19174973,Formiga,1651,28/01/1992,24,0,0,0,0,179,0,2,3,1,2,3,3,3,2,1,1,2,5,5,12,12,12,5,10,6,1,4,3,4,1,11,9,8,5,12,6,2,9,2,12,12,12,5,5,7,12,12,6,6,8,12,12,20,11,6,9,8,9,6,9,13,10,12,10,12,5,11,1,S ,1,1,20,1,1,1,1,1,1,1,1,1,1,1,1
19174981,Francesco,1651,08/07/1991,24,0,0,0,0,185,74,2,1,3,2,1,1,1,1,1,1,1,8,7,6,8,14,8,8,9,4,12,12,1,14,14,10,13,9,7,9,13,14,5,5,11,8,13,9,12,14,11,9,12,2,11,11,20,14,7,10,10,10,6,10,10,11,10,12,14,9,16,4,DM ,1,1,1,1,1,1,1,1,1,20,10,1,1,1,1
19174987,Bruno,1651,16/03/1994,22,0,0,0,0,195,83,14,11,11,1,14,11,13,13,5,7,9,7,1,2,2,2,9,1,1,3,2,2,2,3,3,4,8,13,8,9,7,14,5,1,9,2,6,8,7,11,11,8,13,10,13,10,20,6,11,9,9,6,9,9,19,9,11,8,13,6,4,5,GK ,20,1,1,1,1,1,1,1,1,1,1,1,1,1,1
19174998,Douglas Lima,1651,26/08/1992,23,0,0,0,0,193,83,10,8,10,1,14,14,13,14,6,7,10,4,1,2,3,1,7,1,1,2,3,1,5,3,2,9,10,13,9,8,8,14,5,2,13,2,11,9,6,12,8,9,11,13,7,13,20,1,10,10,7,4,8,10,15,11,11,11,10,7,17,2,GK ,20,1,1,1,1,1,1,1,1,1,1,1,1,1,1
19174999,Renê,1651,14/09/1992,23,0,0,0,0,174,71,4,3,3,1,1,2,3,3,3,2,2,12,14,12,9,13,10,8,11,11,12,13,10,11,13,13,12,11,12,11,11,13,13,14,12,12,13,13,12,13,13,10,8,20,15,12,13,14,10,12,10,11,8,13,20,11,13,12,9,5,12,12,D/WB L,1,1,1,1,1,1,1,20,1,1,1,1,1,18,1
19175002,Conrado,1651,08/01/1991,25,0,0,0,0,189,85,13,10,9,1,9,12,11,10,9,9,8,6,1,2,3,1,8,1,1,1,3,2,3,1,3,9,11,15,3,9,6,11,13,1,5,1,11,7,6,11,10,6,13,20,15,12,5,6,13,9,5,9,9,9,7,12,12,7,12,8,11,8,GK ,20,1,1,1,1,1,1,1,1,1,1,1,1,1,1
19175005,Kaio Wilker,1651,05/02/1993,23,0,0,0,0,185,68,3,3,1,3,3,2,2,3,2,2,2,8,8,14,10,13,8,8,8,4,5,12,8,9,15,5,10,9,8,9,14,13,6,14,11,13,7,9,13,15,14,9,11,5,8,14,20,11,9,10,10,6,10,10,12,12,13,9,11,5,18,3,AM C,1,1,1,20,1,1,1,1,1,1,10,1,1,1,1
19175007,Ygor,1651,31/05/1992,24,0,0,0,0,178,0,3,2,4,4,2,1,2,2,3,1,2,7,7,12,13,13,7,7,13,2,6,11,6,4,13,9,12,3,9,8,10,13,8,13,11,9,7,8,12,13,13,8,6,11,8,13,20,13,6,10,7,2,10,10,10,10,12,12,8,1,7,4,AM C,1,1,1,20,1,1,1,1,1,1,10,1,1,1,1
19175010,Hugo Valente,1651,12/06/1992,24,0,0,0,0,175,74,4,3,1,1,2,3,2,1,2,1,1,5,4,8,1,11,3,8,5,8,10,4,1,14,10,6,8,10,4,11,7,8,8,4,10,8,10,9,9,14,14,9,5,10,8,14,20,14,7,10,6,5,8,10,14,9,10,11,11,6,8,7,D/WB R,1,1,1,1,1,1,1,1,20,1,1,1,1,1,18
19175012,Clayton,1651,15/01/1992,24,0,0,0,0,167,61,2,3,1,2,1,2,2,3,3,2,3,6,9,13,8,13,6,4,8,1,6,8,5,7,13,9,7,8,6,4,6,13,5,13,12,8,6,7,11,13,13,16,3,10,16,13,20,8,2,9,9,3,5,9,12,11,12,12,12,6,15,3,AM RLC,1,1,1,20,15,17,1,1,1,1,6,1,1,1,1
19175014,Thiago Mendes,1651,15/03/1992,24,0,0,0,0,176,73,2,2,3,2,2,1,2,1,1,3,1,4,8,11,10,12,12,11,13,7,13,13,9,13,13,14,12,14,12,11,13,13,13,12,11,13,13,14,15,14,14,12,11,12,15,14,20,16,12,13,13,13,8,12,7,12,12,12,12,6,11,6,DM/M C,1,1,1,1,1,1,1,1,1,20,18,1,14,1,1
19178621,Douglas Baggio,1651,02/02/1995,21,0,0,0,0,170,71,4,2,4,1,4,2,1,1,3,3,3,7,6,11,13,11,10,11,11,1,7,11,14,6,12,11,12,10,13,11,11,11,14,14,7,13,5,13,12,13,12,11,11,14,14,13,20,14,9,13,7,14,7,6,14,12,12,14,12,10,14,6,S ,1,1,20,1,1,1,1,1,1,1,1,1,1,1,1
19178714,Hugo Marchi,1651,19/01/1988,28,0,0,0,0,180,75,2,3,1,2,3,1,2,1,1,3,1,4,6,6,1,12,5,5,3,5,6,5,2,9,7,9,8,7,6,9,7,12,9,4,8,5,7,6,7,12,12,6,7,18,13,12,20,12,7,9,6,9,9,9,14,11,9,10,10,1,11,6,D/WB/DM R,1,1,1,1,1,1,1,1,20,18,1,1,1,1,19
19178829,Marcos,1651,10/12/1983,32,0,0,0,0,184,0,3,1,2,2,2,3,3,2,1,1,2,3,3,8,9,13,5,13,6,2,5,6,4,3,9,8,9,7,12,6,4,6,7,9,6,13,5,5,6,13,13,6,10,20,11,13,9,5,9,8,8,8,8,8,8,11,10,9,14,8,10,6,S ,1,1,20,1,1,1,1,1,1,1,1,1,1,1,1
19178840,Marquinho,1651,24/02/1988,28,0,0,0,0,173,71,2,4,2,3,3,3,3,2,3,1,2,9,9,11,12,12,9,8,12,7,7,11,4,10,12,3,11,10,13,10,11,10,12,10,10,14,7,10,14,11,10,12,6,10,13,11,20,11,7,10,6,10,10,10,12,10,9,11,12,10,11,9,AM C,1,1,1,20,1,1,1,1,1,1,10,1,1,1,1
19178896,Juninho,1651,29/08/1990,25,0,0,0,0,174,68,2,1,2,2,4,3,2,3,2,2,3,3,8,11,12,12,6,7,8,1,6,8,4,6,8,3,6,8,5,7,10,10,4,9,5,8,7,7,8,13,13,8,7,20,9,13,8,13,5,9,9,2,9,9,13,12,13,11,11,2,10,3,AM/S LC,1,1,16,20,17,1,1,1,1,1,10,10,1,1,1
19178964,Lucas Surcin,1651,03/12/1993,22,0,0,0,0,173,67,2,1,2,2,2,3,1,2,2,3,3,6,8,12,7,13,6,6,8,4,6,13,3,3,12,9,5,5,6,6,11,9,9,12,11,8,6,7,11,13,13,3,1,9,3,13,20,6,4,9,4,9,9,9,7,11,9,11,10,8,11,3,M/AM RC,1,1,1,20,1,1,1,1,1,1,10,1,16,1,1
19179669,Mosquito,1651,06/01/1996,20,0,0,0,0,174,74,3,4,1,1,3,1,4,2,2,1,3,6,11,13,11,13,9,7,10,6,4,9,7,4,13,12,12,6,11,10,12,10,6,15,6,14,4,11,11,14,14,12,11,15,7,13,20,12,12,10,6,2,11,10,5,6,4,6,7,7,12,13,S ,1,1,20,1,1,1,1,1,1,1,1,1,1,1,1
19180528,Tinga,1651,01/08/1993,22,0,0,0,0,179,78,1,2,1,2,2,1,3,1,1,1,2,6,11,10,9,12,5,9,10,9,11,11,12,11,11,12,9,14,7,8,10,10,12,7,5,11,11,12,12,14,13,10,10,12,15,13,20,15,14,12,8,15,5,9,11,12,11,6,12,10,10,7,D/WB R,1,1,1,1,1,1,1,11,20,1,1,1,11,10,18
19180529,Davi Ferrari,1651,15/03/1996,20,0,0,0,0,177,72,2,1,2,2,2,3,2,1,3,2,1,7,4,8,4,14,7,7,11,4,6,10,1,11,10,7,12,8,7,7,8,14,8,5,3,6,12,8,12,13,14,8,9,10,11,14,20,8,6,9,5,4,9,9,10,10,9,9,12,7,1,4,DM ,1,1,1,1,1,1,1,1,1,20,10,1,1,1,1
19180530,Arthur,1651,15/06/1992,24,0,0,0,0,176,75,1,1,2,2,2,2,1,3,1,1,2,5,12,13,14,13,7,4,7,7,7,12,13,7,12,10,11,11,12,12,11,12,12,13,10,13,10,11,11,14,12,14,5,10,12,13,20,12,11,11,11,10,9,10,12,12,11,10,11,6,9,8,AM/S R,1,1,18,1,1,20,1,1,1,1,1,1,1,1,1
19180531,Wangler,1651,18/08/1992,23,0,0,0,0,170,74,3,3,4,3,2,3,2,1,3,2,3,10,10,13,10,12,11,7,10,9,7,12,11,6,13,8,10,8,11,9,11,12,3,16,7,12,10,10,11,13,14,4,5,20,12,13,11,11,5,12,7,3,5,10,12,11,10,11,12,5,11,8,M/AM C,1,1,1,20,1,1,1,1,1,1,17,1,1,1,1
19180532,Jádson,1651,30/08/1993,22,0,0,1,0,171,67,1,1,3,3,2,1,1,3,3,2,3,10,12,12,12,11,11,12,11,11,13,12,12,13,12,10,13,11,13,12,13,12,13,12,12,11,12,12,11,13,11,12,11,12,11,12,20,12,13,11,11,12,10,12,11,11,10,9,10,5,10,12,DM/M C,1,1,1,1,1,1,1,1,1,17,20,1,1,1,1
19180534,Murilo,1651,31/10/1994,21,0,0,0,0,177,68,1,3,1,1,4,1,2,2,1,1,1,10,10,12,10,10,10,5,10,12,5,12,10,10,11,8,10,5,12,11,11,12,19,12,8,12,8,13,12,13,14,13,8,20,13,11,8,14,8,10,9,10,5,12,19,13,9,8,11,1,3,4,AM L,1,1,15,1,20,11,1,1,1,1,1,1,1,1,1
19180543,Paulinho,1651,13/04/1987,29,0,0,0,0,183,0,2,3,3,3,3,2,3,1,2,1,1,6,5,6,5,11,7,7,9,1,10,12,2,14,13,9,10,5,8,7,6,8,7,2,9,7,11,8,12,14,13,8,7,10,8,14,20,7,12,8,9,9,9,9,12,12,10,11,13,4,15,7,DM ,1,1,1,1,1,1,1,1,1,20,10,1,1,1,1
19180567,Rondinelly,1651,08/02/1991,25,0,0,0,0,172,69,2,2,3,2,1,1,2,3,1,2,2,12,11,12,9,11,12,5,8,3,3,12,13,5,12,11,9,10,13,12,12,10,10,12,5,9,8,12,10,12,13,8,8,12,11,12,20,11,8,9,5,10,12,8,10,11,10,12,11,13,12,5,M/AM C,1,1,1,20,1,1,1,1,1,1,16,1,1,1,1
19180751,Pedro Poppe,1651,21/03/1995,21,0,0,0,0,185,0,3,1,2,2,2,1,1,3,1,2,3,6,6,13,13,13,5,14,6,1,6,7,7,6,11,9,11,3,9,5,5,13,3,10,13,7,4,7,7,13,10,7,11,9,11,12,20,8,9,9,7,9,3,9,18,11,13,13,12,3,9,3,S ,1,1,20,1,1,1,1,1,1,1,1,1,1,1,1
19180830,Vacaria,1651,04/04/1994,22,0,0,0,0,179,76,3,1,2,2,3,3,2,2,3,3,3,6,7,9,9,12,8,8,13,4,14,14,5,14,9,16,10,14,10,8,11,14,9,4,14,8,11,9,6,11,11,12,9,11,10,10,20,7,12,10,10,10,10,10,15,10,11,13,12,1,5,8,DM ,1,1,1,1,1,1,1,1,7,20,13,1,1,1,7
19182870,Careca,1651,26/10/1990,25,0,0,0,0,189,0,3,1,1,3,3,1,2,2,3,3,3,1,3,10,12,11,4,10,2,1,1,4,6,2,6,7,9,5,11,5,4,7,1,7,9,9,3,4,6,12,10,5,7,9,12,11,20,11,11,8,8,8,8,8,16,11,11,12,8,4,4,2,S ,1,1,20,1,1,1,1,1,1,1,1,1,1,1,1
19182874,Sandro Bacabal,1651,10/01/1982,34,0,0,0,0,175,68,1,1,1,3,3,3,2,1,3,3,2,6,10,3,6,14,6,6,12,3,9,14,2,14,13,7,11,7,5,8,6,11,2,8,13,7,7,8,10,9,6,8,4,9,14,6,20,6,6,8,8,4,8,8,10,14,11,12,13,1,13,2,DM/M C,1,1,1,1,1,1,1,1,1,20,19,1,1,1,1
19182972,Luís Ricardo,1651,30/01/1993,23,0,0,0,0,190,91,3,4,3,3,2,3,1,2,2,1,1,6,4,13,10,11,6,12,7,1,6,6,1,5,13,9,11,8,9,5,6,10,4,13,7,13,7,6,7,13,9,7,12,20,10,11,10,6,12,9,5,9,9,9,13,11,9,10,11,5,12,5,S ,1,1,20,1,1,1,1,1,1,1,1,1,1,1,1
19183024,Val Barreto,1651,06/02/1986,30,0,0,0,0,188,83,1,1,3,1,1,3,2,2,1,2,4,7,7,13,9,12,7,10,8,4,7,6,2,4,9,7,11,9,9,8,8,10,9,7,8,12,7,7,8,13,10,8,13,10,16,9,20,13,13,10,10,10,8,10,8,12,12,13,11,1,18,7,S ,1,1,20,1,1,1,1,1,1,1,1,1,1,1,1
19183232,Allan,1651,24/02/1994,22,0,0,0,0,173,0,2,2,3,3,2,2,2,2,2,1,3,8,6,9,8,12,7,8,11,5,10,12,4,14,14,10,11,9,10,5,11,14,8,7,14,9,8,9,6,14,14,9,6,12,11,14,20,6,6,10,6,10,8,10,14,13,12,12,7,7,2,3,DM C,1,1,1,1,1,1,1,1,1,20,15,1,1,1,1
19183233,Ewandro,1651,15/03/1996,20,0,0,0,0,174,61,3,1,1,3,3,2,2,3,3,2,2,12,13,13,12,13,11,11,11,10,5,12,5,5,12,10,12,10,12,12,13,11,12,15,10,13,6,12,12,14,13,7,5,20,13,13,11,13,7,12,8,10,8,11,14,12,12,13,12,7,12,6,AM/S RL,1,1,18,1,20,19,1,1,1,1,1,1,1,1,1
19183234,Hugo Gomes,1651,04/01/1995,21,0,0,0,0,185,0,1,3,1,3,1,3,1,1,3,2,2,3,4,4,6,5,5,11,6,5,10,8,5,13,6,10,13,10,8,6,2,13,2,8,10,7,13,7,5,13,13,8,10,9,10,13,20,9,6,10,6,10,8,10,17,9,9,12,9,2,13,6,D C,1,1,1,1,1,1,20,1,1,1,1,1,1,1,1
19183235,Pedrinho,1651,04/05/1994,22,0,0,0,0,180,73,2,3,1,2,3,1,3,2,3,4,3,8,6,12,9,11,8,4,11,2,7,12,4,10,14,10,7,9,10,9,11,14,8,13,12,12,6,9,12,11,13,9,10,10,16,14,20,7,9,9,7,7,9,10,7,10,12,11,10,8,5,1,AM C,1,1,1,20,1,1,1,1,1,1,15,1,1,1,1
19183236,Stanly,1651,23/04/1994,22,0,0,0,0,187,74,2,3,3,3,3,2,1,2,3,3,1,4,6,10,12,12,7,11,8,4,3,11,10,5,11,10,12,10,13,10,11,12,14,12,9,13,8,9,8,10,9,10,12,5,13,11,20,11,12,12,5,13,9,5,13,14,8,10,14,19,13,10,S ,1,1,20,1,1,1,1,1,1,1,1,1,1,1,1
19183252,Lineker,1651,13/07/1992,23,0,0,0,0,169,62,1,1,2,4,3,1,2,2,3,3,2,7,4,13,8,13,7,2,8,4,7,13,5,8,9,10,9,6,9,6,12,13,5,10,14,13,7,8,11,13,12,8,5,9,10,12,20,13,5,10,10,7,3,10,12,9,10,9,11,1,12,2,AM C,1,1,1,20,1,1,1,1,1,1,1,1,1,1,1
19183259,Jhonnatan,1651,18/02/1992,24,0,0,0,0,177,70,2,2,4,1,1,2,2,2,2,2,1,5,8,7,10,14,7,8,12,6,11,12,8,14,13,4,13,9,7,10,11,11,1,3,3,10,9,10,8,14,14,10,9,11,13,14,20,12,9,10,7,8,4,10,12,13,11,10,12,3,11,6,DM/M C,1,1,1,1,1,1,1,1,1,19,20,1,1,1,1
19183260,Reis,1651,06/01/1993,23,0,0,0,0,174,67,2,1,2,2,1,1,2,3,3,1,3,8,6,10,9,14,8,8,12,6,8,10,6,9,14,9,12,6,10,8,7,14,4,13,4,12,10,9,8,14,12,7,7,10,14,12,20,12,6,10,10,7,4,10,10,11,11,10,12,10,13,7,M/AM C,1,1,1,20,1,1,1,1,1,1,16,1,1,1,1
19183261,Tiago Cametá,1651,05/05/1992,24,0,0,0,0,167,64,2,1,3,3,3,1,3,4,1,3,1,12,11,12,10,13,10,8,11,11,12,12,10,11,12,11,13,13,11,11,11,12,17,12,8,12,12,13,14,14,14,10,5,10,11,13,20,14,7,12,8,12,11,11,8,13,13,9,11,5,15,1,D/WB R,1,1,1,1,1,1,1,1,20,1,1,1,1,1,19
19183597,Henrique,1651,23/08/1993,22,0,0,0,0,178,66,1,1,2,1,2,1,3,2,1,2,3,10,12,14,11,12,6,11,11,5,8,13,9,7,13,13,12,11,9,11,12,11,12,8,5,11,6,13,11,14,14,12,9,10,15,14,20,12,7,12,13,13,8,10,16,12,11,12,12,7,10,7,AM RL,1,1,15,1,20,15,1,1,1,1,1,1,1,1,1
19183676,Fabinho,1651,23/10/1993,22,4,0,13,1,188,78,2,3,1,2,2,2,4,1,3,1,2,10,13,14,10,13,11,13,11,12,12,13,19,14,14,13,14,14,14,13,13,12,16,13,13,14,13,15,15,15,14,14,14,8,17,15,20,16,15,16,10,15,5,15,15,16,14,16,15,15,14,6,DM/M RC,1,1,1,1,1,1,12,1,15,20,19,1,1,1,12
19183683,Hyoran,1651,25/05/1993,23,0,0,0,0,174,72,3,3,2,1,1,1,3,3,3,1,3,9,9,13,12,12,12,7,12,6,10,10,10,10,13,11,11,11,12,11,12,11,17,14,7,12,8,10,13,14,13,14,7,12,12,13,20,11,8,12,13,12,7,10,12,10,10,10,8,4,12,1,AM RC,1,1,1,20,1,15,1,1,1,1,14,1,10,1,1
19183983,Braem,1651,16/01/1992,24,0,0,0,0,174,70,2,1,1,1,2,1,2,2,2,1,1,1,3,7,12,12,4,6,6,1,1,6,7,4,7,8,7,4,9,5,7,12,4,8,6,6,4,5,7,12,9,4,5,7,13,12,20,11,8,8,8,7,6,8,16,10,10,13,12,8,6,2,AM/S C,1,1,16,20,1,1,1,1,1,1,15,1,1,1,1
19183984,David,1651,16/06/1995,21,0,0,0,0,192,77,13,5,10,1,12,13,11,13,6,6,9,1,3,1,1,1,3,1,2,2,1,1,1,3,3,9,6,13,6,9,6,13,5,2,11,2,9,7,6,13,12,5,15,15,15,12,20,3,11,9,7,9,6,9,11,9,11,12,12,6,5,3,GK ,20,1,1,1,1,1,1,1,1,1,1,1,1,1,1
19184032,Carlos Alberto,1651,10/04/1995,21,0,0,0,0,170,0,1,2,2,3,2,3,4,1,2,1,3,5,3,8,6,12,5,5,3,1,4,11,3,5,9,6,9,8,5,6,12,12,5,10,7,8,6,6,11,12,8,5,4,14,12,11,20,8,3,8,9,9,9,9,11,12,10,12,10,11,15,3,AM C,1,1,1,20,1,1,1,1,1,1,10,1,1,1,1
19184034,Dener,1651,12/04/1995,21,0,0,0,0,181,80,3,3,3,3,2,2,1,4,3,1,3,9,11,11,8,12,8,11,8,10,13,12,9,13,12,13,13,12,12,12,11,12,17,10,8,11,12,14,13,13,13,11,11,8,13,13,20,14,14,12,13,10,9,9,13,15,10,10,10,5,6,6,DM ,1,1,1,1,1,1,1,1,1,20,10,1,1,1,1
19184036,Kauê Patrick,1651,04/04/1996,20,0,0,0,0,178,73,3,2,1,1,1,2,1,2,3,1,3,7,6,4,8,14,7,7,8,3,9,12,4,14,9,9,13,8,7,7,11,9,5,9,7,7,7,8,12,7,10,11,9,9,9,8,20,7,9,9,9,1,9,8,8,12,9,11,11,2,14,7,DM ,1,1,1,1,1,1,1,1,12,20,10,1,1,1,10
19184037,Brendo,1651,20/01/1996,20,0,0,0,0,182,78,1,3,1,3,2,4,1,1,2,2,1,4,2,6,1,8,2,14,6,1,11,8,1,11,4,8,8,8,8,11,1,11,1,1,12,6,9,6,8,11,12,8,11,20,13,11,4,5,10,8,7,8,8,8,19,11,11,11,10,1,10,1,D LC,1,1,1,1,1,1,20,15,1,1,1,1,1,12,1
19184087,Rafael Santos,1651,06/02/1992,24,0,0,0,0,186,79,2,3,3,2,3,2,3,2,3,3,3,5,1,1,1,6,3,12,4,4,12,6,1,9,2,9,10,8,6,6,1,12,1,1,1,5,11,4,6,12,12,6,11,16,11,12,20,6,12,8,7,9,6,9,18,12,11,11,11,6,5,7,D C,1,1,1,1,1,1,20,1,1,1,1,1,1,1,1
19184088,Fernando Viana,1651,20/02/1992,24,0,0,0,0,178,77,1,2,3,1,1,3,2,1,1,3,2,7,9,10,12,11,8,12,9,6,7,10,12,8,12,7,11,11,11,11,10,11,7,13,10,12,10,11,11,11,11,13,10,12,13,11,20,13,11,12,12,12,5,8,20,13,13,12,8,9,20,3,S R,1,1,20,1,11,15,1,1,1,1,1,1,1,1,1
19184111,Abner,1651,21/09/1995,20,0,0,0,0,178,70,2,4,1,1,2,2,1,2,3,3,3,3,4,12,12,10,4,11,3,3,3,2,2,1,6,7,8,5,6,2,1,12,8,8,8,12,5,4,5,12,12,5,4,8,10,12,20,4,5,8,8,6,8,8,11,10,11,10,8,1,14,3,S ,1,1,20,1,1,1,1,1,1,1,1,1,1,1,1
19184126,Renato,1651,10/10/1993,22,0,0,0,0,179,84,1,1,2,2,1,3,2,3,4,3,3,8,13,14,11,14,8,10,9,4,6,9,4,8,12,10,11,9,6,8,8,14,8,11,11,14,8,9,10,11,12,12,8,11,16,12,20,6,12,10,6,10,10,10,20,12,12,9,11,6,1,6,AM/S RL,1,1,17,1,20,17,1,1,1,1,1,1,1,1,1
19184129,Nathan,1651,16/05/1994,22,0,0,0,0,179,64,3,3,3,3,1,3,3,1,2,3,3,4,7,7,1,13,1,6,4,4,5,8,3,10,8,8,8,7,7,9,6,10,1,7,4,7,6,7,7,14,13,6,9,20,10,11,7,11,6,8,8,8,8,8,13,11,12,13,14,8,3,7,D/WB L,1,1,1,1,1,1,1,18,1,1,1,1,1,20,1
19184132,Matheus Sales,1651,13/05/1995,21,0,0,0,0,174,69,3,3,1,1,3,2,3,2,1,3,2,6,9,10,10,11,8,9,11,7,12,11,10,12,11,11,12,12,12,12,11,12,17,12,8,12,12,12,13,14,14,14,7,15,13,14,20,14,9,12,13,12,11,10,10,10,11,12,11,1,3,4,DM/M C,1,1,1,7,1,1,1,1,1,18,20,1,1,1,1
19184142,Fabrício,1651,14/09/1992,23,0,0,0,0,180,0,3,1,1,3,1,1,2,3,1,2,1,7,8,4,6,10,2,6,4,7,9,9,1,11,9,6,11,8,6,6,7,11,6,6,1,6,7,8,8,14,12,8,8,9,13,14,20,7,6,9,5,3,9,9,9,12,11,11,9,8,19,2,D/WB R,1,1,1,1,1,1,1,1,18,1,1,1,1,1,20
19184143,Tiago Silva,1651,30/10/1993,22,0,0,0,0,186,0,1,4,1,3,2,1,1,1,1,2,3,6,2,10,13,10,3,13,7,6,5,7,8,1,13,6,10,6,10,6,6,9,8,13,5,12,5,6,7,12,10,7,8,12,15,9,20,7,10,9,6,9,9,9,9,11,13,9,11,8,12,7,S ,1,1,20,1,1,1,1,1,1,1,1,1,1,1,1
19184144,Bruno Silva,1651,24/03/1996,20,0,0,0,0,187,0,3,2,2,1,2,3,3,2,3,3,2,4,5,11,12,14,6,14,7,2,3,3,1,4,10,5,9,7,5,5,7,12,8,9,2,14,6,6,7,14,9,7,10,2,13,10,20,8,9,8,8,8,6,7,8,12,12,12,10,9,8,3,S ,1,1,20,1,1,1,1,1,1,1,1,1,1,1,1
19184147,Pedro Hulk,1651,20/09/1994,21,0,0,0,0,182,0,1,2,3,3,3,2,3,2,3,3,1,7,5,13,13,12,4,13,5,1,6,8,6,3,13,4,9,7,9,7,7,10,2,13,10,13,8,7,8,13,12,3,10,16,14,12,20,6,8,10,10,10,9,10,10,11,11,13,12,1,15,5,S ,1,1,20,1,1,1,1,1,1,1,1,1,1,1,1
19184215,Dudu Lima,1651,14/03/1989,27,0,0,0,0,175,71,3,1,2,3,1,1,2,2,3,3,3,7,7,5,8,11,7,6,12,3,9,14,5,14,14,9,13,8,8,8,11,7,9,6,13,8,8,8,8,12,13,8,7,9,14,12,20,11,7,9,12,9,9,9,10,13,11,12,11,9,10,1,DM/M C,1,1,1,1,1,1,1,1,1,20,18,1,1,1,1
19184247,Roninho,1651,16/08/1990,25,0,0,0,0,176,72,2,3,1,1,3,1,4,3,3,2,3,5,7,14,10,11,11,14,5,3,4,8,1,1,11,9,11,8,9,8,3,14,9,15,10,11,8,7,9,13,13,8,10,20,11,12,10,13,8,9,9,2,4,9,17,11,10,11,9,7,18,3,S ,1,1,20,1,1,1,1,1,1,1,1,1,1,1,1
19184252,Tauã,1651,29/12/1993,22,0,0,0,0,181,75,4,4,1,2,2,3,2,4,2,3,3,9,10,11,10,15,8,10,9,9,8,11,7,8,15,10,13,10,13,10,9,12,2,13,10,11,9,7,10,14,11,11,10,9,10,13,20,7,10,10,10,4,9,10,9,10,8,9,13,2,12,3,AM R,1,1,13,13,12,20,1,1,1,1,1,1,1,1,1
19184255,Casarotto,1651,29/01/1996,20,0,0,0,0,186,0,1,4,3,2,3,4,2,1,1,4,2,5,5,1,5,7,5,5,9,1,7,9,2,13,12,8,7,7,6,7,8,13,8,5,1,5,6,7,11,13,10,6,11,10,15,12,20,6,10,8,6,5,8,8,12,10,10,10,9,4,10,4,DM ,1,1,1,1,1,1,1,1,1,20,10,1,1,1,1
19184256,Lucas de Sá,1651,04/01/1996,20,0,0,0,0,170,67,2,3,2,1,1,1,1,1,3,3,3,10,11,10,10,11,10,7,11,5,8,11,10,12,8,12,12,6,11,11,10,16,13,10,8,10,9,11,12,14,14,15,5,8,14,14,20,12,5,11,11,4,10,13,13,10,11,12,10,2,6,4,M/AM C,1,1,1,20,1,6,1,1,1,9,18,1,8,1,1
19184261,Nildo,1651,23/08/1993,22,0,0,0,0,182,71,1,3,1,3,2,3,3,3,1,2,2,6,4,5,7,13,6,6,8,5,9,13,4,13,10,9,8,8,2,9,6,13,5,6,4,6,13,7,9,13,13,7,10,9,10,13,20,9,7,9,9,6,9,9,16,11,12,8,13,1,15,8,DM ,1,1,1,1,1,1,1,1,1,20,10,1,1,1,1
19184263,Walace,1651,04/04/1995,21,1,0,5,0,188,75,1,1,2,3,2,2,1,1,2,3,3,5,8,11,8,13,7,10,12,10,15,13,7,16,12,16,14,17,11,12,10,13,15,10,11,12,13,15,16,13,12,17,16,10,14,15,20,14,16,13,14,15,5,8,9,12,12,13,10,9,8,6,DM/M C,1,1,1,1,1,1,1,1,1,20,20,1,1,1,1
19184434,Carlinhos,1651,29/12/1996,19,0,0,0,0,188,81,13,9,6,1,9,13,11,13,7,7,8,3,1,1,2,4,7,1,3,1,1,1,3,2,1,9,7,12,6,11,6,13,9,2,11,2,11,7,6,12,14,7,11,9,9,12,20,6,9,9,9,9,9,9,7,9,11,11,13,8,20,1,GK ,20,1,1,1,1,1,1,1,1,1,1,1,1,1,1
19184435,Jéferson Nem,1651,10/04/1996,20,0,0,0,0,166,62,1,1,2,2,1,2,2,4,1,2,3,9,10,10,11,15,9,3,9,4,9,15,2,7,15,10,11,6,9,10,15,11,10,13,1,9,10,10,12,15,15,10,1,10,11,15,20,10,7,10,9,6,10,10,15,11,13,11,12,12,8,4,AM RC,1,1,1,20,14,15,1,1,1,1,1,1,1,1,1
19184436,Joelinton,1651,14/08/1996,19,0,0,0,0,186,77,1,1,1,1,4,1,3,3,3,1,1,7,9,12,11,14,8,12,9,7,8,12,11,7,13,14,12,16,10,10,12,10,13,13,8,13,7,10,14,13,14,12,14,11,12,16,20,11,14,12,8,12,9,8,9,14,10,12,10,8,11,8,AM/S C,1,1,20,16,1,12,1,1,1,1,1,1,12,1,1
19184478,Biro-Biro,1651,22/11/1994,21,0,0,0,0,164,55,2,2,2,1,1,1,3,2,3,2,1,11,10,16,10,13,13,8,11,8,6,10,10,6,13,12,12,11,12,12,12,11,11,15,11,14,5,9,10,15,16,4,5,11,13,16,20,14,7,12,14,9,11,12,8,14,12,12,9,5,6,6,AM/S RLC,1,1,19,17,20,18,1,1,1,1,1,10,7,1,1
19185669,Matheus Queiroz,1651,12/02/1996,20,0,0,0,0,177,72,2,4,1,3,1,3,1,3,2,2,3,7,8,12,10,10,8,5,11,1,11,12,2,13,11,10,14,9,10,10,13,14,14,12,8,10,8,9,12,12,14,9,4,10,8,12,20,7,7,9,10,10,4,9,7,13,10,11,12,7,11,8,DM/M C,1,1,1,13,1,1,1,1,1,20,18,1,1,1,1
19185682,Paulo Vítor,1651,17/01/1991,25,0,0,0,0,192,90,14,14,7,1,11,10,9,12,10,6,12,3,1,3,3,4,8,1,2,3,3,3,1,3,5,7,10,15,8,10,8,14,10,1,5,1,9,9,8,11,9,9,14,7,14,12,20,8,10,10,5,10,5,10,7,11,10,11,11,4,6,5,GK ,20,1,1,1,1,1,1,1,1,1,1,1,1,1,1
19185684,Renan Diniz,1651,27/02/1993,23,0,0,0,0,186,79,3,2,1,2,3,2,2,1,2,3,3,8,8,5,1,10,6,10,1,3,13,9,4,14,7,10,11,10,9,14,7,14,2,2,1,8,12,8,9,14,13,9,8,20,8,14,10,7,11,10,3,10,10,10,10,12,12,10,11,10,11,4,D LC,1,1,1,1,1,1,20,15,1,1,1,1,1,1,1
19185685,Sandoval,1651,28/04/1986,30,0,0,0,0,188,81,2,3,3,4,3,1,3,4,2,3,2,6,6,2,3,8,5,11,3,4,14,8,1,14,8,10,12,10,9,11,6,7,10,1,9,8,14,8,9,14,12,9,14,2,8,10,20,14,11,10,8,10,10,10,11,10,13,11,8,3,5,5,D C,1,1,1,1,1,1,20,1,1,1,1,1,1,1,1
19185686,Lucas Louzã,1651,27/07/1990,25,0,0,0,0,174,69,3,4,2,2,4,3,3,1,1,3,1,7,7,5,8,9,7,7,12,4,8,13,6,13,13,10,9,9,9,9,11,13,4,4,1,8,12,8,10,13,13,8,4,9,8,13,20,13,8,10,4,9,10,10,13,10,11,11,12,9,1,1,DM/M C,1,1,1,1,1,1,1,1,1,20,18,1,1,1,1
19185688,Djalma,1651,15/04/1988,28,0,0,0,0,176,76,4,1,2,3,2,3,1,4,3,2,1,8,8,8,10,14,6,8,13,2,9,12,7,10,12,7,10,7,10,9,14,12,3,11,5,9,9,9,11,14,13,9,12,6,10,13,20,12,10,10,9,5,10,10,9,9,10,9,11,4,5,8,M/AM C,1,1,1,20,1,1,1,1,1,1,18,1,1,1,1
19185743,Luís Gustavo,1651,19/02/1995,21,0,0,0,0,178,80,2,3,2,3,3,1,2,3,1,1,3,5,5,7,7,11,5,4,13,2,8,3,3,10,13,8,8,7,7,2,6,9,8,5,4,3,11,7,11,11,13,7,3,16,8,12,20,6,5,8,8,8,8,8,9,10,15,10,13,9,9,7,DM/M C,1,1,1,1,1,1,1,1,1,20,17,1,1,1,1
19185747,Renan Luís,1651,20/08/1990,25,0,0,0,0,178,73,1,2,1,2,1,1,1,1,1,1,3,9,11,14,9,11,6,11,9,8,10,12,7,11,11,5,12,11,12,12,12,11,1,16,12,12,13,12,11,14,14,9,9,20,13,14,9,13,9,10,6,7,10,10,15,12,11,9,9,5,5,7,D/WB L,1,1,1,1,1,1,1,20,1,1,1,1,1,17,1
19185748,Bruninho,1651,29/09/1989,26,0,0,0,0,180,78,3,2,1,1,2,2,3,3,3,3,3,11,12,13,15,13,5,6,11,6,4,12,13,3,13,16,15,15,12,7,13,6,15,16,5,13,4,3,16,14,12,13,10,20,14,16,16,9,15,9,13,12,6,12,6,16,7,12,8,5,7,10,AM/S R,1,1,20,14,14,17,1,1,1,1,8,10,12,1,1
19185802,Alex Reinaldo,1651,08/03/1991,25,0,0,0,0,170,67,1,3,2,2,2,2,3,1,2,3,3,5,11,12,7,11,2,9,7,9,11,11,9,15,12,6,13,11,10,7,5,12,14,12,6,13,12,11,11,14,14,8,6,10,13,13,20,12,9,9,8,9,5,10,14,12,11,10,13,6,9,7,D/WB R,1,1,1,1,1,1,1,1,20,1,1,1,1,1,17
19185858,Raoni,1651,21/03/1995,21,0,0,0,0,175,0,2,2,3,2,2,1,1,3,1,3,3,8,10,12,9,10,3,10,9,10,11,11,7,9,10,8,10,8,9,9,10,9,4,13,4,13,10,8,10,14,13,8,9,10,12,13,20,13,8,10,10,10,9,10,10,14,10,9,14,10,4,2,D/WB R,1,1,1,1,1,1,1,1,20,1,1,1,1,1,17
19185861,Jonathan,1651,23/03/1995,21,0,0,0,0,180,72,3,3,1,2,2,3,1,2,3,2,2,6,8,10,9,10,11,13,7,4,5,9,8,3,10,5,10,5,10,7,10,10,11,12,1,8,7,10,8,13,13,8,9,20,12,13,10,11,7,9,7,6,11,9,18,10,10,5,11,9,13,2,S ,1,1,20,1,13,13,1,1,1,1,1,1,1,1,1
19185862,Bruno Santa Rosa,1651,01/08/1989,26,0,0,0,0,175,0,3,4,2,1,1,1,2,3,1,1,2,6,8,9,7,10,4,6,8,4,6,10,3,6,9,8,11,9,8,8,6,8,8,11,5,10,10,11,9,12,11,9,8,10,12,11,20,10,10,10,9,3,5,9,18,10,10,10,11,1,4,2,D/WB L,1,1,1,1,1,1,1,20,1,1,1,1,1,17,1
19185878,Renan,1651,21/04/1991,25,0,0,0,0,186,78,3,3,3,3,3,2,1,3,3,2,3,5,6,7,1,8,3,14,7,2,10,8,5,10,7,9,11,9,8,9,7,14,9,3,4,7,9,7,8,14,14,8,12,20,9,14,1,13,10,9,5,9,5,9,20,9,12,14,11,5,4,2,D C,1,1,1,1,1,1,20,1,1,1,1,1,1,1,1
19185941,Sapé,1651,23/11/1991,24,0,0,0,0,178,65,3,1,3,3,2,1,2,2,2,3,3,7,10,9,11,16,10,10,9,7,15,14,8,12,11,14,12,12,11,11,10,8,7,4,9,14,15,12,15,11,12,11,10,12,11,12,20,14,9,6,7,6,8,14,12,12,10,9,8,10,19,7,DM C,1,1,1,1,1,1,1,1,11,20,15,1,1,1,9
19186017,Caio Rangel,1651,16/01/1996,20,0,0,0,0,172,70,3,3,1,3,1,2,2,2,3,1,1,3,9,15,8,11,7,4,11,1,6,12,12,6,14,7,11,9,11,11,12,11,10,18,7,11,7,6,11,15,15,10,11,8,13,14,20,14,9,12,4,12,8,12,11,8,14,12,12,14,15,12,AM RLC,1,1,14,20,15,15,1,1,1,1,10,12,12,1,1
19186020,Lucas Alcântara,1651,14/07/1995,20,0,0,0,0,172,81,3,3,3,3,1,2,1,1,3,1,3,12,8,6,7,9,14,6,9,1,8,12,14,8,9,14,10,10,12,10,12,10,8,8,12,7,10,12,12,8,8,9,9,8,14,8,20,14,9,12,13,12,5,12,17,8,12,12,5,6,8,14,DM/M C,1,1,1,14,1,1,1,1,1,18,20,1,1,1,1
19186021,Cafú,1651,22/01/1996,20,0,0,0,0,169,70,4,1,3,2,3,2,3,3,3,2,2,5,7,11,11,11,9,5,12,1,4,11,12,3,11,12,10,12,10,9,8,8,14,14,2,10,3,12,14,14,11,11,8,20,12,13,8,14,9,12,10,12,5,10,19,12,12,10,12,8,5,14,AM/S C,1,1,19,20,14,14,1,1,1,1,1,1,1,1,1
19186023,Leandro,1651,12/01/1993,23,0,0,0,0,180,74,2,3,2,1,2,3,1,3,3,3,1,5,2,14,14,13,6,10,6,1,6,4,4,3,9,8,10,7,9,7,6,8,10,8,7,11,6,6,7,13,9,4,8,8,15,11,20,7,5,8,6,5,8,8,12,10,12,12,8,1,10,14,S ,1,1,20,1,1,1,1,1,1,1,1,1,1,1,1
19186024,Rafael Dumas,1651,13/03/1995,21,0,0,0,0,181,79,3,3,1,2,3,1,3,2,2,1,2,3,3,5,6,9,5,13,3,3,11,7,5,11,8,13,10,11,10,9,8,11,14,3,12,5,12,13,14,12,8,13,13,20,14,11,7,14,12,14,12,12,7,10,7,12,14,12,14,12,14,6,D C,1,1,1,1,1,1,20,1,1,1,1,1,1,1,1
19186025,Renato Maceió,1651,05/02/1995,21,0,0,0,0,176,0,3,3,3,1,3,2,2,3,1,2,2,8,6,14,14,14,8,14,9,1,7,9,7,2,13,9,8,9,11,9,5,12,12,12,14,14,8,8,9,13,11,8,5,8,10,14,20,7,7,10,6,10,10,10,11,12,10,12,10,10,10,12,S ,1,1,20,1,1,1,1,1,1,1,1,1,1,1,1
19186026,Rodolfo,1651,03/05/1993,23,0,0,0,0,183,0,2,3,3,2,1,3,3,1,3,1,1,12,10,13,10,11,11,7,8,7,7,12,9,7,13,5,10,7,11,11,12,10,10,14,8,12,8,7,9,12,12,9,11,20,12,12,10,11,9,10,5,12,12,10,11,11,11,10,12,7,9,4,DM/M/AM/S RC,1,1,18,18,1,17,1,1,1,18,20,1,14,1,1
19186027,Thiago Medeiros,1651,19/12/1991,24,0,0,0,0,184,78,3,2,3,3,3,1,2,2,1,2,1,5,5,2,4,9,8,14,5,7,13,8,1,14,7,10,11,10,7,10,4,14,4,3,6,8,14,8,9,14,12,9,7,6,15,13,20,13,9,10,7,10,10,10,16,11,10,10,12,7,3,8,D C,1,1,1,1,1,1,20,1,1,1,1,1,1,1,1
19186028,Recife,1651,14/10/1994,21,0,0,0,0,182,77,3,1,3,2,2,3,1,2,3,3,2,3,5,7,8,10,3,9,7,3,14,10,8,15,10,13,13,14,12,13,10,11,15,5,10,11,14,14,15,12,11,12,10,8,14,12,20,14,10,13,14,14,8,5,8,12,13,12,14,12,10,6,DM/M C,1,1,1,1,1,1,1,1,1,20,16,1,1,1,1
19186029,Jorge Luiz,1651,03/01/1988,28,0,0,0,0,178,0,2,2,4,3,1,3,2,2,4,3,4,6,4,9,7,11,8,8,12,4,8,14,4,9,14,10,11,6,7,8,7,14,2,13,12,12,10,9,10,14,14,7,6,8,9,14,20,14,7,10,10,4,10,10,12,12,13,13,12,3,14,7,M/AM C,1,1,1,20,1,1,1,1,1,1,18,1,1,1,1
19186030,Lincoln Fernando,1651,07/03/1996,20,0,0,0,0,180,79,1,1,1,4,1,3,1,3,2,3,1,1,5,5,4,6,8,12,3,5,12,6,12,12,10,10,12,11,10,8,7,10,14,5,14,7,12,12,14,9,12,11,12,20,14,12,7,14,10,12,8,11,11,5,17,12,12,14,16,14,14,5,D C,1,1,1,1,1,1,20,1,1,13,1,1,1,1,1
19186160,Thuram,1651,01/02/1991,25,0,0,0,0,183,79,3,2,2,2,3,2,2,3,1,1,2,7,8,10,13,10,8,13,10,7,6,9,12,7,12,11,12,12,11,11,9,10,14,13,7,14,8,12,13,14,13,14,13,7,16,14,20,15,15,11,6,12,4,8,13,13,11,11,14,13,10,7,S ,1,1,20,1,10,14,1,1,1,1,1,7,10,1,1
19186200,Rafael Furlan,1651,24/11/1994,21,0,0,0,0,177,74,3,3,1,1,2,1,3,1,2,2,3,6,8,10,8,13,6,4,8,6,5,9,1,6,13,9,8,5,9,6,9,13,9,13,2,7,7,7,8,13,13,12,7,20,12,13,9,9,5,9,7,5,6,14,13,12,11,11,11,1,20,4,AM LC,1,1,13,20,17,1,1,8,1,1,15,12,1,11,1
19186209,Kozlinski,1651,18/06/1991,25,0,0,0,0,190,92,13,8,8,1,10,11,8,13,9,10,5,2,1,3,3,1,1,1,3,2,2,1,1,1,3,8,11,13,8,8,7,13,4,2,4,2,11,8,7,13,12,7,14,10,13,12,20,7,16,10,2,4,4,9,16,11,11,11,13,6,10,8,GK ,20,1,1,1,1,1,1,1,1,1,1,1,1,1,1
19186267,João Victor,1651,27/03/1994,22,0,0,0,0,178,72,2,2,2,2,3,3,1,3,3,3,2,10,14,14,14,14,9,11,10,9,8,11,8,10,14,11,11,10,11,10,11,14,16,13,5,12,9,5,9,14,14,10,8,20,13,14,6,11,8,11,11,3,7,11,12,9,11,13,12,5,14,1,M/AM/S L,1,1,20,1,20,10,1,1,1,1,1,20,10,1,1
19186268,Vinícius Alexandre,1651,12/04/1996,20,0,0,0,0,187,72,1,3,3,1,3,3,3,2,3,3,1,7,6,9,9,14,7,7,9,4,8,13,7,14,13,8,9,8,9,9,10,13,12,14,6,9,6,8,12,13,11,14,8,9,9,13,20,8,14,9,7,9,8,9,8,12,13,12,12,9,12,6,DM C,1,1,12,15,1,1,1,1,1,20,15,1,1,1,1
19186269,Rafael Litholdo,1651,30/04/1993,23,0,0,0,0,173,72,3,2,3,2,2,4,2,3,1,4,3,6,7,3,4,14,7,7,13,1,8,14,5,13,12,9,12,8,8,9,8,14,7,9,6,4,14,8,12,13,9,8,7,1,13,10,20,7,7,9,9,9,6,9,14,7,11,11,14,1,9,2,DM ,1,1,1,1,1,1,1,1,1,20,10,1,1,1,1
19186270,Bruno Moura,1651,13/07/1992,23,0,0,0,0,183,78,2,3,1,2,1,2,1,2,2,3,3,4,7,8,5,16,1,7,7,9,11,11,4,15,11,9,12,9,10,11,9,11,1,7,12,10,8,10,10,13,11,8,12,5,8,12,20,10,10,7,6,6,9,9,13,12,10,11,11,8,12,4,D/WB R,1,1,1,1,1,1,1,1,18,1,1,1,1,1,20
19186272,Rafael,1651,05/04/1993,23,0,0,0,0,180,0,1,3,2,3,2,2,3,2,3,3,3,4,4,7,6,11,1,7,3,6,7,9,1,9,9,8,9,4,8,8,8,7,2,8,14,8,8,8,7,15,15,8,12,1,12,15,20,6,7,8,8,8,8,8,14,12,10,12,15,2,1,8,D/WB R,1,1,1,1,1,1,1,1,18,1,1,1,1,1,20
19186350,Magno Alves,1651,10/06/1990,26,0,0,0,0,190,81,2,1,3,3,3,1,2,1,1,1,2,10,6,4,10,9,5,9,10,4,12,10,4,10,9,10,9,10,9,5,8,12,10,1,10,10,11,10,14,16,12,11,15,10,11,12,20,10,8,9,10,6,10,10,16,11,12,10,13,9,12,7,D C,1,1,1,1,1,1,20,1,1,1,1,1,1,1,1
19186352,Ibson Melo,1651,08/10/1989,26,0,0,0,0,179,72,1,2,3,3,3,1,3,2,3,2,3,8,12,13,9,12,7,6,7,4,3,11,9,4,13,7,9,7,10,9,11,10,13,14,4,9,4,9,6,13,13,9,9,20,13,12,15,13,5,12,6,8,8,8,14,8,5,11,12,13,15,3,AM RL,1,1,8,12,20,17,1,1,1,6,10,15,14,1,1
19186433,Etinho,1651,29/11/1984,31,0,0,0,0,190,87,3,1,1,3,3,1,2,3,3,2,1,6,5,4,13,12,7,14,8,4,7,10,13,4,5,8,13,12,11,8,10,11,2,8,10,9,12,9,9,12,11,12,14,20,12,12,10,13,14,10,9,11,7,6,18,11,8,11,10,12,5,8,S ,1,1,20,1,1,1,1,1,1,1,1,1,1,1,1
19186443,Ricardo,1651,07/01/1993,23,0,0,0,0,178,75,1,1,1,1,3,2,1,1,2,1,3,6,8,7,2,7,2,5,4,6,8,6,2,14,4,6,9,4,7,4,6,5,3,4,7,6,7,7,7,14,10,7,9,9,9,13,20,12,8,8,8,8,8,8,11,9,13,10,11,9,11,6,D/WB R,1,1,1,1,1,1,1,1,18,1,1,1,1,1,20
19186444,Fernando Fonseca,1651,29/12/1993,22,0,0,0,0,190,85,3,2,2,2,2,1,3,2,1,2,1,8,6,1,5,9,4,14,1,3,10,9,6,9,8,10,10,10,7,9,8,10,4,1,11,8,14,8,9,14,14,9,15,8,15,14,20,6,12,11,8,5,5,10,8,8,10,10,13,2,7,3,D C,1,1,1,1,1,1,20,1,1,1,1,1,1,1,1
19186563,Maurides,1651,10/03/1994,22,0,0,0,0,189,86,2,3,2,1,1,1,2,2,2,3,2,8,12,12,11,12,6,12,11,5,6,11,11,6,12,13,12,14,11,12,11,12,18,13,7,13,6,11,11,12,11,6,14,20,14,12,9,12,15,11,12,10,11,6,8,13,13,11,12,15,12,7,S ,1,1,20,1,1,1,1,1,1,1,1,1,1,1,1
19186565,Doriva,1651,29/07/1996,19,0,0,0,0,170,0,3,3,3,1,3,1,4,1,1,4,1,4,5,8,8,14,6,1,4,1,7,13,4,6,11,8,6,4,6,7,8,12,8,10,1,6,7,8,12,14,13,5,3,3,13,10,20,11,5,8,7,3,6,8,11,12,12,12,11,2,13,3,M/AM C,1,1,1,20,1,1,1,1,1,1,18,1,1,1,1
19186795,Wamberson,1651,29/09/1992,23,0,0,0,0,175,0,4,2,3,2,2,3,2,1,3,1,1,7,7,4,7,12,7,7,8,4,11,10,6,14,10,9,10,8,9,9,13,9,3,8,9,8,12,9,10,12,12,9,8,20,11,11,8,7,6,9,5,9,4,9,16,10,11,10,8,2,11,6,DM/M C,1,1,1,1,1,1,1,1,1,17,20,1,1,1,1
19186901,Otávio,1651,09/02/1995,21,0,0,4,1,172,62,3,1,1,2,1,3,1,2,4,2,4,5,12,15,11,14,11,9,13,11,7,15,12,6,17,13,14,13,14,13,15,15,15,15,8,15,8,11,12,14,15,15,6,13,13,14,20,13,8,11,5,11,5,10,7,15,12,14,13,5,9,11,AM LC,1,1,10,20,18,14,1,1,1,1,13,13,10,1,1
19186992,França,1651,21/04/1991,25,0,0,0,0,182,88,3,3,1,2,4,4,3,3,1,2,3,6,10,9,8,10,6,12,6,12,13,12,7,12,10,17,9,17,8,11,9,10,10,8,11,10,12,12,16,11,10,14,12,14,11,12,20,12,16,12,15,12,10,14,5,14,11,7,3,5,4,18,DM/M C,1,1,1,1,1,1,10,1,1,20,18,1,1,1,1
19187009,Willian Sotto,1651,10/01/1994,22,0,0,0,0,171,0,3,3,2,1,2,3,2,3,3,4,3,4,6,5,8,13,6,2,13,1,3,9,6,8,13,5,11,3,7,7,8,13,3,13,13,11,3,7,10,13,10,7,5,9,7,11,20,9,5,9,4,3,9,9,14,12,11,11,10,2,9,8,M/AM C,1,1,1,20,1,1,1,1,1,1,18,1,1,1,1
19187010,Gustavo Marmentini,1651,08/03/1994,22,0,0,0,0,179,71,1,2,3,2,2,2,3,2,1,2,3,9,10,11,10,11,10,10,12,10,11,12,10,10,13,11,10,12,10,10,11,10,10,11,12,10,11,10,11,11,10,11,11,20,11,11,11,12,11,12,11,10,10,12,11,12,11,9,9,13,1,6,M/AM C,1,1,1,20,1,1,1,1,1,13,17,1,1,1,1
19187168,Rayllan,1651,10/06/1989,27,0,0,0,0,178,78,1,1,2,3,2,1,1,2,1,2,2,7,7,13,8,11,7,6,7,2,3,13,5,6,12,5,7,3,9,8,11,13,10,12,6,11,8,8,12,13,13,8,3,10,13,13,20,13,5,10,10,5,7,10,20,11,10,11,12,6,5,6,AM C,1,1,1,20,1,1,1,1,1,1,10,1,1,1,1
19187185,Reinaldo,1651,18/03/1989,27,0,0,0,0,184,78,2,3,4,1,1,1,3,2,3,3,2,6,3,1,1,7,1,10,3,1,12,8,1,10,3,6,11,9,8,13,3,10,4,9,14,7,13,7,8,14,14,8,9,9,7,14,20,13,11,9,8,6,8,9,17,8,9,9,12,9,4,1,D C,1,1,1,1,1,1,20,1,1,1,1,1,1,1,1
19187196,Cléberson,1651,17/08/1992,23,0,0,0,0,185,75,2,1,3,2,3,3,1,4,1,1,2,10,11,10,10,12,10,15,10,10,14,12,10,13,12,10,13,13,13,13,10,11,12,12,11,11,14,13,12,13,13,12,12,12,13,13,20,13,13,13,10,11,10,10,11,12,12,12,10,9,9,11,D/DM C,1,1,1,1,1,1,20,1,1,18,1,1,1,1,1
19187201,Hugo,1651,25/01/1995,21,0,0,0,0,185,0,1,1,1,3,3,1,3,1,3,3,1,7,3,5,4,7,2,14,5,2,14,8,1,14,3,9,11,9,4,7,3,14,15,9,8,5,13,7,8,10,10,8,9,1,14,9,20,5,9,9,6,9,9,9,12,13,12,11,12,1,7,5,D C,1,1,1,1,1,1,20,1,1,1,1,1,1,1,1
19187202,Stéfano Yuri,1651,27/04/1994,22,0,0,0,0,187,83,2,1,1,2,4,4,1,3,3,2,1,4,9,11,13,12,9,13,11,7,7,11,11,7,11,9,12,11,12,11,12,12,12,8,9,12,8,13,13,13,13,13,14,10,13,12,20,11,13,11,5,13,9,9,15,12,10,11,10,9,10,7,S ,1,1,20,1,1,1,1,1,1,1,1,1,1,1,1
19187313,Perema,1651,27/07/1992,23,0,0,0,0,185,81,2,2,3,1,2,2,3,3,1,2,2,3,1,1,1,7,3,14,4,7,11,8,4,14,3,9,13,9,8,8,7,14,5,1,1,6,14,7,8,13,14,8,10,1,7,14,20,7,8,9,9,9,5,9,9,10,13,12,12,2,9,2,D C,1,1,1,1,1,1,20,1,1,1,1,1,1,1,1
19187382,Juan Felipe,1651,03/08/1995,20,0,0,0,0,170,64,1,3,2,2,3,1,1,3,1,2,1,6,6,3,7,13,6,6,8,3,8,13,1,13,10,7,11,8,8,3,11,13,12,8,12,7,8,7,11,13,12,4,1,7,12,13,20,6,5,8,8,8,9,9,14,12,10,10,10,10,12,6,DM/M C,1,1,1,1,1,1,1,1,1,20,16,1,1,1,1
19187383,Marquinhos,1651,09/02/1995,21,0,0,0,0,170,65,2,3,4,3,2,3,1,3,2,2,1,8,11,13,10,8,7,6,10,5,7,11,9,8,9,14,9,10,9,8,8,8,12,11,6,11,9,10,10,13,10,7,7,20,14,13,7,14,7,12,8,11,7,14,20,12,10,10,10,10,10,12,D/WB/M/AM LC,1,1,1,15,20,1,1,17,1,1,1,19,1,18,1
19187398,Fernando,1651,25/02/1993,23,0,0,0,0,183,82,2,3,2,2,4,2,2,1,3,4,1,2,4,4,4,8,1,11,7,2,14,8,3,14,7,8,11,9,8,11,3,14,9,4,4,7,11,8,8,13,11,8,11,1,16,14,20,8,10,8,9,4,9,9,19,12,11,11,11,10,6,2,D C,1,1,1,1,1,1,20,1,1,1,1,1,1,1,1
19187411,Bruno Lopes,1651,16/05/1995,21,0,0,0,0,176,75,4,2,1,4,2,3,1,1,2,3,1,5,11,12,10,11,7,11,12,7,7,10,6,9,12,14,13,15,7,9,11,8,15,10,10,14,10,13,14,13,13,14,8,13,13,13,20,12,13,9,13,8,4,12,14,14,12,8,11,9,5,3,S ,1,1,20,1,13,13,1,1,1,1,1,1,1,1,1
19187559,Tiago Costa,1651,13/04/1987,29,0,0,0,0,175,75,2,1,3,2,4,3,3,1,2,1,3,8,12,9,9,12,6,8,11,11,12,13,6,13,11,15,12,14,12,12,10,12,9,4,12,12,7,15,15,12,12,13,7,20,14,12,11,13,11,13,11,10,5,11,14,12,10,11,12,5,13,3,D/WB L,1,1,1,1,1,1,1,20,1,1,1,13,1,18,1
19187560,Rubinho,1651,28/04/1988,28,0,0,0,0,172,64,1,3,3,1,3,1,2,1,1,1,2,8,8,10,8,14,8,4,9,8,9,11,6,8,14,10,10,4,11,6,11,12,8,13,5,11,10,9,13,14,14,14,6,20,12,14,11,11,5,11,6,10,6,10,20,9,12,12,10,7,7,8,M/AM C,1,1,1,20,1,1,1,1,1,1,18,1,1,1,1
19187562,Henrique Dourado,1651,15/09/1989,26,0,0,0,0,185,77,3,2,2,3,3,2,2,1,3,2,1,3,8,10,13,11,8,15,12,6,5,10,14,6,10,11,13,15,13,13,11,13,14,10,11,13,8,11,10,12,12,9,14,20,14,12,11,14,14,12,13,12,6,5,20,12,13,11,13,5,9,6,S ,1,1,20,1,1,1,1,1,1,1,1,1,1,1,1
19187581,André Mensalão,1651,21/06/1990,26,0,0,0,0,174,76,3,1,3,1,1,3,3,2,2,2,2,7,7,8,9,13,7,4,12,1,6,13,2,9,11,11,8,4,11,8,13,12,7,11,9,12,8,8,12,13,13,8,6,10,7,13,20,13,5,10,10,10,10,10,9,10,11,11,9,8,4,2,M/AM C,1,1,1,20,1,1,1,1,1,1,18,1,1,1,1
19187582,Joécio,1651,10/11/1985,30,0,0,0,0,189,70,3,1,2,1,2,3,3,1,2,2,2,9,8,5,6,11,6,11,9,6,11,11,9,12,6,10,11,9,11,9,8,13,7,8,13,10,11,9,10,7,9,12,14,10,13,9,20,9,13,8,10,2,10,10,8,12,11,11,10,8,11,2,D C,1,1,1,1,1,1,20,1,1,1,1,1,1,1,1
19187620,Dão,1651,28/10/1984,31,0,0,0,0,187,82,3,3,3,3,3,2,3,1,3,3,3,6,7,7,7,9,7,13,8,7,12,9,10,12,8,14,11,15,10,9,4,11,17,11,12,11,12,14,12,11,10,13,13,11,14,11,20,13,12,13,13,13,11,5,9,12,12,11,10,7,8,4,D C,1,1,1,1,1,1,20,1,1,1,1,1,1,1,1
19187641,Rodrigo Souza,1651,27/10/1987,28,0,0,0,0,186,86,1,2,3,2,1,1,3,2,1,1,1,5,7,8,8,8,6,12,8,6,13,9,7,14,9,15,12,16,12,12,9,12,10,8,11,9,13,13,12,12,10,8,13,10,13,12,20,12,16,11,12,11,7,10,16,9,12,10,11,11,12,5,DM ,1,1,1,1,1,1,14,1,1,20,10,1,1,1,1
19187642,Gílson,1651,05/11/1985,30,0,0,0,0,175,72,2,3,2,1,1,2,3,2,1,1,3,6,5,3,8,13,7,7,13,1,11,13,2,13,8,9,11,9,8,11,9,13,4,3,12,7,11,8,7,13,13,8,8,16,15,13,20,12,6,10,10,8,6,10,11,9,12,11,10,5,5,2,DM ,1,1,1,1,1,1,1,1,1,20,10,1,1,1,1
19187643,Ramón Pereira,1651,29/04/1991,25,0,0,0,0,178,74,3,4,2,3,2,3,3,2,3,1,3,3,7,8,4,8,7,7,6,7,8,12,4,13,9,8,8,8,4,10,9,14,9,2,10,6,14,9,9,14,14,9,4,20,15,14,8,12,6,9,6,9,4,9,9,12,12,12,12,12,14,1,D/WB/DM L,1,1,1,1,1,1,1,19,1,20,10,1,1,19,1
19187645,Daniel,1651,31/01/1992,24,0,0,0,0,187,81,4,2,2,3,2,1,2,3,3,1,1,5,2,1,2,6,5,13,6,3,10,6,6,13,4,10,13,10,8,8,7,13,1,1,12,6,12,7,8,13,10,8,13,10,16,12,20,5,13,10,4,10,8,10,11,12,10,12,11,13,6,7,D C,1,1,1,1,1,1,20,1,1,1,1,1,1,1,1
19187646,Paulo Vitor,1651,26/07/1988,27,0,0,0,0,166,67,2,1,3,2,3,1,2,2,4,4,1,4,4,6,3,9,1,8,7,7,9,9,2,13,9,9,10,8,7,10,6,12,5,3,9,7,8,8,8,14,14,8,1,20,12,14,10,7,10,9,4,8,5,9,16,12,13,10,14,1,12,5,D/WB L,1,1,1,1,1,1,1,20,1,1,1,1,1,18,1
19187647,Dida,1651,12/08/1987,28,0,0,0,0,181,0,10,11,11,9,12,14,7,14,9,3,11,3,3,3,1,4,8,1,1,2,2,1,1,3,2,4,9,12,6,10,7,12,4,1,10,2,11,8,7,14,10,5,8,5,9,13,20,6,8,9,4,7,9,9,13,10,13,13,10,9,5,8,GK ,20,1,1,1,1,1,1,1,1,1,1,1,1,1,1
19187649,Cabixi,1651,11/06/1983,33,0,0,0,0,179,0,2,2,2,1,3,3,2,2,4,3,4,7,8,4,9,15,8,7,9,2,11,15,8,8,12,7,8,8,9,9,15,13,2,9,6,10,8,9,11,12,8,4,5,9,12,11,20,9,9,9,9,9,8,9,10,10,10,12,10,3,18,3,M C,1,1,1,1,1,1,1,1,1,1,20,1,1,1,1
19187652,Badhuga,1651,04/02/1989,27,0,0,0,0,181,0,1,2,3,2,2,2,3,3,3,2,3,7,5,5,2,5,5,14,6,3,11,9,3,13,8,10,9,10,8,10,6,14,5,3,6,5,12,8,9,14,14,9,6,16,13,14,20,9,10,10,8,10,9,10,15,11,12,13,12,7,8,8,D C,1,1,1,1,1,1,20,1,1,1,1,1,1,1,1
19187653,Pedro Ferreira,1651,26/10/1989,26,0,0,0,0,184,0,8,9,9,2,14,7,9,11,7,8,8,2,3,3,2,1,5,1,2,2,3,3,3,3,1,8,11,11,7,9,6,14,5,1,8,1,11,7,6,12,6,7,7,8,10,13,20,6,8,8,8,8,8,8,12,9,8,10,10,5,7,2,GK ,20,1,1,1,1,1,1,1,1,1,1,1,1,1,1
19187679,Thallyson,1651,01/12/1991,24,0,0,0,0,175,70,2,3,1,2,2,2,1,3,2,2,1,11,12,13,11,11,13,6,13,8,11,12,8,11,13,9,12,10,9,10,9,11,20,13,3,14,9,11,11,14,14,11,8,20,13,14,5,14,8,11,7,10,11,15,12,13,11,9,9,6,4,7,D/WB LC,1,1,1,15,15,1,1,20,1,1,15,15,11,18,1
19187710,Moisés,1651,11/03/1995,21,0,0,0,0,181,77,1,3,3,3,3,1,2,1,1,2,3,10,12,11,10,13,9,11,11,10,12,12,8,11,12,13,12,13,12,12,11,11,14,11,6,13,13,13,14,14,13,11,10,20,13,14,4,15,13,14,12,13,9,10,13,12,12,12,13,5,11,8,D/WB L,1,1,1,1,1,1,1,20,1,1,1,12,1,19,1
19187713,Gian Luca,1651,23/06/1994,22,0,0,0,0,191,84,3,1,1,2,1,1,3,3,1,3,3,7,3,14,12,10,7,12,5,2,5,8,8,4,11,9,14,4,12,8,7,11,2,9,11,7,5,7,8,12,12,4,16,20,11,12,10,5,14,9,5,2,9,9,13,10,12,13,11,7,11,5,S ,1,1,20,1,1,1,1,1,1,1,1,1,1,1,1
19187719,Gustavo Tocantins,1651,11/01/1996,20,0,0,0,0,179,79,2,1,2,1,1,1,2,1,1,3,1,8,8,12,10,12,6,10,8,4,4,10,7,6,12,8,10,11,11,10,11,10,10,13,6,12,7,13,12,12,13,14,8,13,14,13,20,13,13,8,7,10,8,9,18,9,11,11,10,3,5,6,S ,1,1,20,1,10,13,1,1,1,1,1,1,1,1,1
19187720,Alison,1651,26/10/1995,20,0,0,0,0,182,80,3,1,3,3,1,2,2,2,1,3,3,8,6,14,14,14,6,14,6,3,7,9,8,1,14,6,12,8,9,4,9,7,10,13,11,14,8,8,9,14,10,9,11,8,13,14,20,11,10,9,6,7,9,10,9,9,10,11,12,6,8,6,S ,1,1,20,1,1,1,1,1,1,1,1,1,1,1,1
19187721,Douglas Santos,1651,22/03/1994,22,1,0,5,0,173,70,3,2,1,3,2,3,1,1,1,1,3,14,15,12,9,13,11,8,12,11,11,13,10,15,13,17,15,10,13,12,12,14,14,14,9,14,10,12,17,17,15,10,9,20,14,15,8,14,8,13,9,13,9,8,8,13,12,12,12,9,10,9,D/WB L,1,1,1,1,12,1,1,20,1,1,1,12,1,20,1
19187724,Jussandro,1651,11/03/1992,24,0,0,0,0,176,64,2,1,3,2,2,3,3,1,4,1,2,11,11,11,11,13,7,7,10,12,7,10,10,9,12,9,12,10,10,11,12,11,13,14,5,12,5,10,9,14,13,5,7,20,12,13,12,13,7,12,10,10,7,10,18,12,12,12,12,7,11,5,D/WB L,1,1,1,1,13,1,1,20,1,1,1,14,1,19,1
19187754,Potita,1651,30/07/1984,31,0,0,0,0,173,67,2,2,3,3,2,2,3,1,1,3,2,5,7,12,9,11,7,10,10,8,6,11,12,6,11,11,11,13,10,8,10,10,10,14,5,11,6,9,10,13,14,7,5,10,12,14,20,11,7,10,6,8,7,11,11,11,12,11,13,2,11,6,AM/S R,1,1,20,1,14,17,1,1,1,1,1,1,1,1,1
19187768,Diego Testa,1651,08/06/1993,23,0,0,0,0,187,76,1,2,1,2,3,3,4,3,1,2,3,8,8,14,14,14,8,12,7,2,5,8,4,6,14,7,14,8,11,8,9,13,10,13,1,11,5,8,9,12,9,11,16,9,9,11,20,7,11,10,7,10,10,10,20,13,11,12,11,8,3,5,S ,1,1,20,1,1,1,1,1,1,1,1,1,1,1,1
19187799,Fernando Karanga,1651,14/04/1991,25,0,0,0,0,189,79,2,2,1,2,2,1,1,1,1,1,3,9,7,13,14,14,9,14,10,4,9,9,7,4,12,11,14,6,10,9,8,14,8,11,12,14,8,9,10,14,14,9,8,10,16,14,20,14,10,13,8,11,8,11,12,12,11,11,12,7,8,5,S ,1,1,20,1,1,1,1,1,1,1,1,1,1,1,1
19187830,Marcelo Pastel,1651,17/05/1993,23,0,0,0,0,165,0,3,3,3,2,3,1,2,1,3,3,1,7,6,14,13,13,7,14,8,6,4,8,6,4,9,9,13,2,13,7,6,14,9,15,8,14,4,6,8,16,15,4,3,3,11,15,20,7,4,9,7,2,9,9,11,12,12,12,11,4,10,7,S ,1,1,20,1,1,1,1,1,1,1,1,1,1,1,1
19187876,Alysson,1651,23/10/1990,25,0,0,0,0,182,74,3,1,2,3,3,2,1,1,2,3,3,5,7,10,6,12,7,12,9,8,13,12,8,13,10,13,11,12,11,12,7,12,11,8,8,9,13,12,13,13,14,13,13,5,13,13,20,12,13,12,11,10,5,4,11,11,10,12,12,4,14,4,D C,1,1,1,1,1,1,20,1,1,1,1,1,1,1,1
19187878,Lucas Fonseca,1651,02/08/1985,30,0,0,0,0,191,85,2,3,2,1,2,3,1,3,3,3,3,7,9,9,9,10,9,13,9,8,14,11,8,13,11,12,12,13,12,10,8,11,14,12,12,11,13,14,13,11,10,10,16,8,13,11,20,14,15,11,11,12,6,5,13,11,13,12,14,12,11,6,D C,1,1,1,1,1,1,20,1,1,14,1,1,1,1,1
19187884,Lucas Lima,1651,09/07/1990,25,12,2,0,0,175,69,1,2,3,1,2,4,3,2,1,3,2,13,13,15,13,14,13,12,12,7,9,15,12,11,16,8,13,11,13,12,15,13,12,13,11,14,11,14,13,14,13,13,8,20,12,14,10,15,14,11,7,12,5,10,13,13,12,13,10,9,12,7,M/AM C,1,1,1,20,1,1,1,1,1,1,18,1,1,1,1
19187932,Romário,1651,13/03/1992,24,0,0,0,0,171,72,1,1,2,3,1,3,2,2,3,3,1,7,11,12,8,16,2,12,7,11,10,10,11,11,11,9,13,12,12,12,10,11,2,14,11,12,6,12,11,16,14,5,5,20,13,14,11,14,5,12,13,11,6,11,19,10,9,13,11,5,8,1,D/WB L,1,1,1,1,1,1,1,20,1,1,1,1,1,18,1
19187937,Tito,1651,01/07/1986,30,0,0,0,0,175,70,1,2,2,1,2,1,3,2,3,2,1,8,6,14,14,13,8,11,9,1,6,9,6,5,11,9,14,3,10,7,7,10,6,10,13,11,7,8,9,14,14,9,5,9,10,14,20,8,9,10,9,10,9,10,12,10,9,11,10,7,15,6,S ,1,1,20,1,1,1,1,1,1,1,1,1,1,1,1
19188274,George Jackson,1651,05/01/1987,29,0,0,0,0,177,67,3,2,1,3,4,1,1,3,3,3,2,6,11,7,3,5,5,4,5,5,6,5,1,5,10,13,4,7,7,7,7,11,12,10,9,6,7,7,8,13,12,6,3,20,4,13,5,12,7,8,14,8,8,8,12,7,7,11,12,13,8,3,D/AM L,1,1,1,1,20,1,1,17,1,1,1,15,1,14,1
19188286,Jackchan,1651,01/08/1985,30,0,0,0,0,172,0,2,2,3,3,1,2,2,3,2,1,2,6,1,13,12,10,6,3,10,5,3,13,6,6,11,5,11,6,7,7,7,13,8,11,4,9,7,7,12,13,13,7,4,9,7,13,20,12,7,9,9,6,7,9,10,11,10,10,11,5,13,2,AM C,1,1,1,20,1,1,1,1,1,1,10,1,1,1,1
19188414,Luizão,1651,22/10/1988,27,0,0,0,0,187,0,2,3,3,1,1,3,2,1,1,1,1,5,3,11,12,12,5,12,6,1,3,1,2,3,9,1,11,2,8,5,6,7,2,10,12,12,4,5,7,12,9,6,12,8,12,11,20,11,11,9,5,7,9,9,15,10,10,14,11,4,15,5,S ,1,1,20,1,1,1,1,1,1,1,1,1,1,1,1
19188438,Jefferson,1651,22/01/1994,22,0,0,0,0,181,80,3,3,2,4,3,1,1,3,3,2,3,10,11,11,8,11,9,11,9,11,12,10,9,12,11,11,11,13,11,10,11,11,18,10,7,12,12,14,13,13,11,10,12,8,13,14,20,13,13,10,14,11,11,14,13,12,11,10,12,3,3,6,DM R,1,1,1,1,1,8,1,1,15,20,10,1,10,1,13
19188461,Diego Miranda,1651,07/07/1991,24,0,0,0,0,169,0,3,1,3,2,1,2,1,2,1,3,1,6,6,4,8,9,6,6,13,6,7,9,1,6,12,9,8,9,8,7,10,11,4,12,11,8,5,7,10,13,13,10,3,9,10,13,20,13,4,12,6,9,9,9,8,14,10,10,14,1,8,1,AM C,1,1,1,20,1,1,1,1,1,1,15,1,1,1,1
19188525,Devyd,1651,10/12/1991,24,0,0,0,0,185,74,13,8,10,6,13,9,11,9,6,8,8,1,3,3,3,1,4,1,3,3,2,1,1,3,1,8,5,14,6,9,5,7,6,2,13,2,8,6,5,10,12,8,12,9,9,11,20,1,7,6,8,8,8,8,11,12,10,12,11,4,19,2,GK ,20,1,1,1,1,1,1,1,1,1,1,1,1,1,1
19188549,Jeferson,1651,29/12/1994,21,0,0,0,0,183,73,2,3,2,2,1,1,2,2,2,4,1,5,6,9,1,11,2,8,5,5,9,9,2,14,10,9,6,8,8,11,9,11,9,9,10,9,11,9,8,13,14,9,11,20,6,10,9,9,9,9,6,6,9,9,12,11,11,10,10,3,12,7,D/WB L,1,1,1,1,1,1,1,18,1,1,1,1,1,20,1
19188565,Igor,1651,15/01/1993,23,0,0,0,0,169,66,3,3,2,1,3,1,1,1,2,1,2,6,2,13,13,11,6,13,5,6,6,6,5,4,11,9,11,8,7,7,6,10,6,11,7,12,7,6,7,13,13,7,4,8,11,13,20,5,9,9,9,9,7,9,20,8,11,12,11,1,6,3,S ,1,1,20,1,1,1,1,1,1,1,1,1,1,1,1
19188566,Júlio César,1651,17/03/1993,23,0,0,0,0,184,74,1,2,2,2,3,1,2,3,1,2,2,8,6,7,9,13,8,8,15,7,9,8,3,15,15,9,11,8,7,10,9,14,8,8,14,9,9,9,13,9,12,9,12,10,15,11,20,8,8,9,8,6,8,9,20,11,11,11,10,4,12,6,DM C,1,1,1,10,1,1,1,1,1,20,15,1,1,1,1
19188567,Diego Carlos,1651,15/03/1993,23,0,0,0,0,185,79,1,2,3,2,1,1,2,2,3,2,3,5,5,7,7,11,9,14,8,10,14,12,10,15,12,16,13,14,12,13,8,12,13,9,9,8,13,13,13,12,12,14,12,9,15,12,20,13,15,13,12,13,6,8,13,13,11,11,16,12,10,11,D C,1,1,1,1,1,1,20,1,1,15,8,1,1,1,1
19188568,Edilson,1651,25/03/1993,23,0,0,0,0,180,75,3,2,1,1,3,1,2,4,2,3,1,7,3,13,11,10,7,9,9,1,7,11,3,7,12,7,12,5,8,8,12,10,4,9,4,13,8,8,9,10,10,7,10,20,14,11,7,13,8,9,9,9,4,9,16,9,12,10,12,6,10,4,AM C,1,1,15,20,1,1,1,1,1,1,10,1,1,1,1
19188606,Cleitinho,1651,29/08/1993,22,0,0,0,0,178,72,2,2,2,1,1,2,2,1,1,3,1,4,4,7,1,10,2,6,2,6,7,8,6,13,8,9,4,8,7,10,7,11,6,9,8,7,9,8,8,13,13,7,8,9,7,13,20,8,6,9,9,3,9,9,14,10,10,12,12,2,12,6,D/WB R,1,1,1,1,1,1,1,1,17,1,1,1,1,1,20
19188666,Guilherme,1651,03/06/1992,24,0,0,0,0,182,80,3,1,1,2,3,3,3,1,1,1,1,1,1,3,1,2,1,12,1,1,9,3,1,12,3,7,5,6,1,11,1,12,7,1,11,2,6,3,4,12,12,4,5,8,8,12,20,8,7,7,5,7,7,7,18,10,12,11,12,2,12,4,D C,1,1,1,1,1,1,20,1,1,1,1,1,1,1,1
19188694,Fernando Silva,1651,18/05/1991,25,0,0,0,0,174,68,1,2,3,2,3,4,3,1,4,1,2,13,11,12,10,12,12,8,10,8,6,11,10,7,12,15,8,12,11,7,10,8,13,9,8,9,9,9,10,14,14,10,9,20,11,13,8,13,10,10,14,10,8,13,12,12,8,7,8,6,5,18,M/AM R,1,1,14,14,14,20,1,1,1,1,12,12,18,1,1
19188700,Edmário,1651,25/09/1988,27,0,0,0,0,192,80,3,2,3,1,1,1,2,2,1,3,1,5,5,2,6,8,1,13,2,2,13,8,4,13,7,6,13,10,8,8,4,13,1,1,12,7,10,7,8,13,10,8,11,9,7,9,20,6,11,10,10,10,5,10,9,10,9,8,10,5,10,5,D C,1,1,1,1,1,1,20,1,1,1,1,1,1,1,1
19189017,Bruno Furtado,1651,17/09/1993,22,0,0,0,0,174,0,1,1,2,1,1,3,1,3,4,1,3,6,5,8,4,9,4,8,3,7,8,10,4,14,8,8,9,10,4,11,7,13,1,7,9,8,12,9,9,14,14,9,9,20,16,14,10,12,7,10,10,10,7,10,15,9,11,11,12,5,6,4,D/WB L,1,1,1,1,1,1,1,20,1,1,1,1,1,18,1
19189018,Naldo,1651,19/05/1990,26,0,0,0,0,185,76,3,3,2,2,4,3,3,3,1,1,1,7,9,7,9,10,7,12,8,6,12,12,8,13,11,14,12,13,12,13,10,12,14,2,12,9,12,14,14,12,12,10,13,7,14,12,20,14,11,12,14,11,11,12,8,12,10,12,11,8,13,4,D/DM C,1,1,1,1,1,1,17,1,1,20,8,1,1,1,1
19189022,Renatinho,1651,31/01/1992,24,0,0,0,0,178,70,2,2,2,2,1,2,2,3,2,1,1,8,8,5,8,14,8,8,13,1,11,11,2,14,14,8,10,9,9,11,13,11,10,1,9,8,14,9,13,14,14,9,8,11,12,14,20,12,6,9,5,3,7,10,15,10,11,12,10,4,3,5,DM ,1,1,1,1,1,1,1,1,1,20,10,1,1,1,1
19189023,Neílson,1651,15/09/1988,27,0,0,0,0,173,67,2,2,3,2,2,1,3,2,2,1,2,5,8,9,6,15,2,10,7,9,11,11,3,13,11,10,9,11,10,8,6,12,6,3,1,8,9,5,10,16,15,13,7,11,11,16,20,9,7,11,10,3,10,10,15,9,9,12,12,2,8,2,D/WB R,1,1,1,1,1,1,1,1,20,1,1,1,1,1,18
19189027,Michel Elói,1651,30/07/1991,24,0,0,0,0,186,0,1,2,1,1,3,1,1,3,3,2,3,6,6,13,13,13,6,13,3,1,5,7,6,1,13,8,13,4,9,7,7,12,9,13,10,12,7,6,7,13,13,7,11,8,12,13,20,12,8,9,4,6,7,8,15,10,10,11,10,3,12,7,S ,1,1,20,1,1,1,1,1,1,1,1,1,1,1,1
19189031,Moisés,1651,03/03/1991,25,0,0,0,0,179,74,3,1,3,1,1,1,2,3,1,3,2,7,8,9,7,11,7,10,7,8,12,11,8,12,10,12,11,14,11,11,9,11,4,10,8,10,11,13,13,13,13,12,9,7,10,13,20,13,11,11,15,1,10,7,14,11,10,11,13,11,10,8,DM ,1,1,1,1,1,1,1,1,1,20,12,1,1,1,1
19189034,Robertinho,1651,20/02/1990,26,0,0,0,0,188,81,2,1,3,1,2,3,3,3,3,1,3,7,10,10,9,8,4,11,10,5,10,11,8,10,10,10,11,13,12,9,11,10,17,11,5,11,11,12,12,13,11,8,14,11,15,13,20,12,13,10,12,7,8,12,18,11,11,12,11,5,8,8,D/WB R,1,1,1,1,1,1,1,1,20,10,10,1,1,1,19
19189035,Luiz Paulo,1651,09/07/1990,25,0,0,0,0,183,75,1,3,1,3,2,2,2,4,1,2,2,5,10,11,12,10,7,9,8,4,6,11,10,5,11,7,10,11,11,9,10,9,10,9,9,10,10,11,12,12,12,8,12,10,12,11,20,12,10,11,9,11,9,12,16,12,10,11,11,2,8,3,S ,1,1,20,1,1,1,1,1,1,1,1,1,1,1,1
19189038,Everton,1651,30/03/1992,24,0,0,0,0,184,0,3,1,1,3,2,3,2,4,2,3,3,5,4,7,9,14,9,5,11,3,11,14,9,14,14,11,14,10,11,10,10,14,3,9,3,10,14,10,11,14,14,10,9,10,15,14,20,9,7,12,7,11,6,11,15,11,12,13,12,3,15,3,DM C,1,1,1,1,1,1,1,1,1,20,15,1,1,1,1
19189039,Jonatan Lima,1651,04/01/1992,24,0,0,0,0,186,0,2,3,1,3,3,3,3,3,1,1,3,8,7,7,9,14,8,5,7,2,13,14,4,14,13,5,11,9,9,10,14,14,10,7,13,8,10,9,8,14,14,9,9,2,12,14,20,8,12,10,4,9,10,10,18,12,12,10,13,5,4,5,DM ,1,1,1,1,1,1,1,1,1,20,10,1,1,1,1
19189043,Mateus,1651,19/10/1993,22,0,0,0,0,180,0,3,1,2,2,3,3,2,3,3,2,3,8,7,7,3,14,6,9,5,8,10,8,3,14,9,10,9,10,4,8,7,13,2,7,1,8,11,9,9,14,14,9,11,10,14,13,20,14,9,10,6,10,10,10,19,11,11,11,12,8,19,6,D/WB R,1,1,1,1,1,1,1,1,20,1,1,1,1,1,18
19189044,Vinícius Casão,1651,18/02/1992,24,0,0,0,0,180,78,2,1,3,1,3,3,3,4,2,1,2,7,7,13,11,13,7,7,9,2,7,13,6,4,13,9,7,7,10,7,11,13,5,13,3,11,7,8,12,13,13,8,9,20,2,13,10,13,9,10,9,4,10,10,19,10,12,11,9,11,9,2,AM C,1,1,1,20,1,1,1,1,1,1,1,1,1,1,1
19189045,Gedeilson,1651,25/10/1992,23,0,0,0,0,174,0,1,3,3,3,3,3,1,2,1,3,2,5,7,7,2,13,1,9,8,8,10,8,5,10,8,8,9,10,9,10,7,14,1,9,6,8,9,9,9,14,14,9,4,10,11,14,20,10,7,10,9,8,10,10,13,10,13,9,10,11,7,5,D/WB R,1,1,1,1,1,1,1,1,20,1,1,1,1,1,18
19189046,Ângelo,1651,31/08/1988,27,0,0,0,0,172,67,3,3,1,3,1,1,4,2,2,2,2,6,11,11,10,16,3,11,9,10,7,10,5,6,12,9,13,11,11,8,8,7,10,7,13,12,6,10,10,15,12,8,8,10,9,14,20,13,7,6,10,4,9,9,15,9,11,5,11,9,13,3,D/WB R,1,1,1,1,1,1,1,1,20,1,1,1,1,1,19
19189048,Carlinhos,1651,20/03/1989,27,0,0,0,0,170,67,2,1,2,2,1,3,3,1,2,1,2,9,10,12,7,10,10,6,8,12,7,11,11,8,11,11,10,12,8,9,10,8,9,14,5,11,9,10,11,15,15,14,5,5,12,15,20,12,6,11,9,4,6,5,7,10,11,14,12,10,4,7,D/WB R,1,1,1,1,1,1,1,1,20,1,1,1,1,1,18
19189109,Vinícius Araújo,1651,22/02/1993,23,0,0,5,3,176,76,3,3,3,2,3,3,2,2,2,4,2,7,12,13,12,12,8,14,8,7,7,11,12,7,11,10,13,13,13,11,11,12,13,14,7,13,7,12,14,13,13,14,9,12,11,13,20,13,14,12,5,10,11,8,5,12,13,12,13,8,12,10,S ,1,1,20,1,1,1,1,1,1,1,1,1,1,1,1
19189110,Marlon,1651,07/09/1995,20,0,0,0,0,185,81,3,3,2,1,3,3,2,2,2,1,2,7,8,13,7,13,8,11,8,8,13,12,11,13,13,15,12,13,12,12,13,13,13,13,12,11,13,12,14,13,12,13,13,12,12,13,20,13,15,11,15,10,11,11,20,12,12,12,13,12,11,11,D/DM C,1,1,1,1,1,1,20,1,1,18,10,1,1,1,1
19189145,Talisca,1651,01/02/1994,22,0,0,2,0,188,78,3,3,4,1,3,3,3,3,2,2,2,15,15,14,17,14,17,12,18,8,9,14,13,9,16,8,13,8,15,8,13,11,11,13,9,14,9,8,10,13,13,13,14,20,15,13,12,12,13,11,11,14,4,11,12,11,13,14,11,7,12,13,AM C,1,1,15,20,12,14,1,1,1,5,12,11,12,1,1
19189147,Sávio,1651,01/08/1994,21,0,0,0,0,184,70,2,2,3,2,2,1,3,1,1,2,3,8,10,11,12,15,10,12,12,6,9,12,12,3,11,11,14,7,13,10,11,9,3,8,9,13,11,10,11,13,12,11,12,11,15,13,20,9,10,11,6,4,6,11,12,10,10,12,10,6,9,6,S ,1,1,20,1,1,1,1,1,1,1,1,1,1,1,1
19189148,Marquinhos,1651,17/08/1993,22,0,0,0,0,189,0,1,3,3,1,1,3,3,1,3,3,1,3,1,1,4,5,2,12,2,5,13,7,3,14,1,8,9,9,2,9,6,14,6,5,13,7,14,6,8,12,11,8,12,1,9,14,20,9,12,9,7,9,9,9,10,11,13,10,13,8,7,1,D C,1,1,1,1,1,1,20,1,1,1,1,1,1,1,1
19189170,Waguininho,1651,30/01/1990,26,0,0,0,0,178,69,3,1,2,1,2,3,1,4,3,3,3,8,7,13,11,11,8,14,7,8,7,9,6,4,11,4,7,4,10,6,7,12,7,13,10,14,9,8,9,14,14,9,8,11,17,14,20,14,8,11,8,9,10,10,12,12,10,12,8,11,20,2,S ,1,1,20,1,1,1,1,1,1,1,1,1,1,1,1
19189171,Pedro Rocha,1651,01/10/1994,21,0,0,0,0,178,74,3,2,3,1,2,2,1,4,3,2,2,6,10,13,12,11,8,12,11,5,12,11,12,10,13,9,13,12,11,12,10,9,12,14,6,14,8,13,12,14,15,12,12,12,14,14,20,13,13,10,9,9,7,13,13,13,13,12,12,6,10,9,AM/S L,1,1,19,1,20,1,1,1,1,1,1,1,1,1,1
19189285,Jean Mota,1651,15/10/1993,22,0,0,0,0,170,65,4,2,3,1,1,1,1,2,4,3,1,12,13,15,13,11,12,11,13,13,9,13,12,9,15,11,12,13,13,13,14,11,3,13,10,13,8,12,13,14,14,7,10,20,12,14,10,12,8,11,7,11,8,14,9,11,9,9,9,8,2,6,AM RLC,1,1,13,16,16,20,1,13,1,1,1,13,1,13,1
19189428,Robert,1651,28/09/1996,19,0,0,0,0,175,75,2,3,3,2,1,3,1,1,1,2,3,11,12,14,12,13,10,13,13,11,7,12,7,6,14,8,12,9,12,11,13,11,9,14,4,12,6,9,13,13,14,9,6,10,16,13,20,13,8,10,11,10,12,10,7,12,12,12,5,7,11,13,AM LC,1,1,15,20,19,10,1,1,1,1,10,1,1,1,1
19189433,Michael,1651,19/04/1993,23,0,0,0,0,186,81,2,2,3,2,3,1,3,1,1,2,3,11,9,12,14,12,11,15,11,4,7,12,11,7,12,7,12,7,12,11,10,11,13,10,10,12,12,12,13,13,11,14,15,10,7,12,20,10,14,10,11,8,11,11,11,12,12,12,12,7,12,6,S ,1,1,20,1,1,1,1,1,1,1,1,1,1,1,1
19189512,Derlan,1651,03/02/1996,20,0,0,0,0,185,77,3,3,3,3,3,2,3,2,4,2,3,11,2,3,3,9,15,14,7,4,14,5,5,11,8,10,10,10,9,11,6,14,9,10,3,6,13,8,7,13,12,9,8,10,11,13,20,12,8,9,8,10,5,10,18,12,10,13,10,5,6,3,D C,1,1,1,1,1,1,20,1,1,1,1,1,1,1,1
19189683,João Carlos,1651,18/05/1992,24,0,0,0,0,181,75,1,2,3,2,3,3,1,2,3,3,3,8,9,10,9,11,6,8,7,7,10,10,8,10,12,10,10,12,9,10,10,9,9,5,7,9,11,12,13,11,12,7,7,9,11,12,20,13,6,9,6,8,5,13,17,12,11,10,11,4,11,3,D/WB R,1,1,1,1,1,1,1,1,20,1,1,1,1,1,19
19189684,Alex Flávio,1651,21/01/1993,23,0,0,0,0,186,80,3,3,3,1,2,3,2,1,2,2,1,4,9,7,8,8,5,11,6,5,12,9,7,11,8,12,9,13,7,9,7,10,12,5,10,6,11,12,12,11,10,10,13,7,11,11,20,12,12,9,7,7,7,5,13,12,12,7,11,9,10,11,D C,1,1,1,1,1,1,20,1,1,1,1,1,1,1,1
19189685,Alisson,1651,25/06/1993,23,0,0,0,0,174,73,3,4,1,3,1,1,4,3,2,4,2,14,13,16,11,13,9,5,10,4,9,13,11,10,13,10,12,10,11,11,13,11,13,15,10,13,9,10,13,16,14,10,6,7,15,15,20,15,9,12,7,12,15,12,11,12,11,11,13,9,12,9,M/AM RL,1,1,14,13,20,15,1,1,1,1,12,19,13,1,1
19189686,Wallace,1651,14/10/1994,21,0,0,16,1,191,83,3,1,1,2,3,1,2,2,1,1,1,3,6,9,6,11,6,15,6,6,14,11,8,14,11,14,15,15,11,10,9,11,16,10,11,6,11,13,13,14,12,15,16,8,13,15,20,13,16,13,12,11,6,6,13,15,13,15,15,15,13,6,D C,1,10,1,1,1,1,20,1,1,1,1,1,1,1,1
19189687,João Paulo Penha,1651,06/09/1993,22,0,0,0,0,178,75,2,2,1,3,3,3,2,3,2,3,3,9,12,13,10,11,5,6,10,4,5,11,11,5,12,7,12,10,9,6,11,9,10,10,4,12,9,9,9,14,15,8,4,8,13,13,20,12,5,11,5,11,5,12,7,11,11,9,11,4,11,4,AM/S L,1,1,18,13,20,12,1,1,1,1,1,12,1,1,1
19189690,Eurico,1651,16/04/1994,22,0,0,0,0,181,78,1,1,2,2,3,3,2,2,2,2,2,6,10,11,11,11,12,9,13,5,12,13,12,13,12,13,13,13,11,12,11,11,12,9,10,10,13,14,14,12,12,10,6,6,12,12,20,13,9,11,7,10,10,12,10,11,12,10,10,10,9,2,DM/M C,1,1,1,1,1,1,1,1,7,20,19,1,1,1,1
19189691,Antônio Carlos,1651,17/09/1994,21,0,0,0,0,174,77,3,1,3,1,1,2,3,3,3,1,3,10,10,11,10,11,11,8,10,8,9,12,10,10,12,13,11,9,10,11,11,11,10,7,7,11,10,12,13,13,12,12,7,20,12,13,5,12,12,10,9,8,11,15,20,12,12,12,10,11,8,9,D L,1,1,9,1,11,1,1,20,1,9,8,12,1,7,1
19189692,Lynneeker,1651,11/01/1993,23,0,0,0,0,171,72,1,3,2,3,2,2,4,3,2,3,1,11,11,13,10,12,10,8,11,5,5,12,12,6,13,7,9,8,12,8,13,11,13,10,8,11,5,12,11,13,12,8,7,9,11,12,20,12,6,8,1,10,6,11,15,12,11,10,12,12,12,8,M/AM/S LC,1,1,18,20,16,14,1,1,1,1,19,15,13,1,1
19189693,Bruno Ramires,1651,18/03/1994,22,0,0,0,0,189,77,1,1,2,2,3,1,3,1,3,2,4,5,9,10,10,10,6,12,9,5,12,11,8,12,12,12,11,12,9,13,10,10,12,10,10,14,12,15,15,13,13,10,14,6,14,14,20,16,11,10,8,9,4,10,12,11,9,12,12,3,8,3,DM/M C,1,1,1,1,1,1,12,1,11,19,20,1,1,1,1
19189707,Diego,1651,09/03/1993,23,0,0,0,0,187,0,14,8,12,1,13,14,9,14,9,9,5,2,2,3,3,1,7,1,1,1,1,2,3,2,6,9,8,7,8,10,4,14,2,2,7,2,12,8,7,14,8,8,12,9,8,11,20,5,8,9,7,9,9,9,10,12,12,12,11,7,1,8,GK ,20,1,1,1,1,1,1,1,1,1,1,1,1,1,1
19189708,Murilo,1651,13/02/1993,23,0,0,0,0,186,73,3,2,3,3,2,2,2,1,2,1,1,5,4,7,4,10,3,8,6,7,9,8,1,14,8,9,11,9,6,12,8,12,9,7,1,6,8,9,9,14,10,9,14,20,10,13,10,10,10,9,9,2,8,9,8,12,11,11,12,8,15,5,D/WB L,1,1,1,1,1,1,1,20,1,1,1,1,1,19,1
19189709,Dill,1651,21/06/1994,22,0,0,0,0,182,0,2,1,4,3,2,2,4,1,3,2,2,3,7,7,4,6,7,9,7,4,9,9,4,9,8,9,12,8,6,8,7,14,7,9,10,5,9,8,11,10,13,10,11,11,13,14,20,6,10,9,7,9,9,9,16,10,10,12,13,2,14,6,DM C,1,1,1,1,1,1,15,1,1,20,1,1,1,1,1
19189716,Thalison,1651,11/01/1993,23,0,0,0,0,174,0,3,2,1,2,2,2,1,3,2,2,1,7,9,7,4,11,7,7,4,5,9,9,4,15,9,8,8,6,8,10,9,13,8,2,13,8,6,8,7,8,10,8,5,20,9,13,9,6,7,8,8,8,8,8,17,10,10,14,11,4,8,4,D/WB L,1,1,1,1,1,1,1,20,1,1,1,15,1,19,1
19189718,Memé,1651,31/05/1993,23,0,0,0,0,187,0,3,2,3,3,1,3,4,2,1,3,1,2,5,6,1,11,1,7,5,6,7,8,1,12,8,8,7,5,6,9,8,9,8,2,11,4,8,8,7,12,11,7,12,8,8,11,20,9,8,8,8,8,8,8,10,13,13,14,9,1,10,7,D/WB R,1,1,1,1,1,1,1,1,20,1,1,1,1,1,19
19189729,Gleidson,1651,17/07/1995,20,0,0,0,0,185,0,2,1,3,1,2,1,3,2,2,3,1,4,4,5,5,10,4,4,7,3,6,10,1,11,10,8,9,6,5,8,3,12,8,7,10,1,9,6,10,12,12,5,11,13,9,10,20,6,5,8,8,8,8,8,10,13,11,9,13,1,8,4,DM ,1,1,1,1,1,1,1,1,1,20,10,1,1,1,1
19189732,Romarinho,1651,01/03/1994,22,0,0,0,0,168,66,2,2,3,1,2,2,2,2,3,3,2,5,4,14,13,14,8,14,4,5,7,7,9,6,9,10,11,5,13,9,9,11,8,10,2,9,9,5,9,14,14,15,4,9,14,14,20,10,7,10,8,10,10,10,14,10,14,13,12,5,7,5,S ,1,1,20,1,1,1,1,1,1,1,1,1,1,1,1
19189744,Azul,1651,28/03/1993,23,0,0,0,0,179,78,2,3,3,1,3,1,2,3,2,3,1,4,12,13,10,9,5,4,4,5,6,9,8,8,11,9,10,13,9,8,11,9,12,7,9,12,10,12,12,14,13,12,7,8,13,12,20,14,14,10,8,10,8,12,12,13,10,11,12,11,8,8,AM/S R,1,1,18,1,1,20,1,1,1,1,1,1,15,1,1
19189746,Marcos Felipe,1651,13/04/1996,20,0,0,0,0,188,74,12,12,12,1,14,14,13,13,10,6,12,8,1,1,1,4,10,1,2,2,2,4,2,1,5,7,9,13,10,10,9,15,5,1,3,1,11,10,9,11,10,10,13,9,14,9,20,5,9,10,10,1,9,10,20,10,10,11,10,4,10,2,GK ,20,1,1,1,1,1,1,1,1,1,1,1,1,1,1
19189747,Izaldo,1651,03/06/1993,23,0,0,0,0,173,0,1,4,3,3,1,1,3,1,4,2,2,6,9,7,7,10,3,8,7,7,9,9,6,14,9,9,11,9,9,11,6,8,5,9,8,6,12,9,9,11,14,9,5,20,5,14,10,7,7,6,5,9,8,9,20,12,13,10,11,9,7,3,D/WB L,1,1,1,1,1,1,1,20,1,1,1,1,1,19,1
19189764,Paulo Fernando,1651,04/09/1992,23,0,0,0,0,171,69,2,3,3,2,2,2,3,3,1,3,3,9,7,9,2,13,5,10,7,8,11,11,9,14,11,10,13,11,9,12,7,8,4,8,3,9,10,11,11,15,15,11,6,10,8,15,20,8,8,10,9,5,10,10,17,13,11,8,9,9,16,8,D/WB R,1,1,1,1,1,1,1,1,20,1,1,1,1,1,19
19189810,Rômulo,1651,02/11/1991,24,0,0,0,0,186,77,4,2,3,1,3,1,2,2,1,1,1,7,9,11,10,12,9,8,9,5,5,9,9,6,12,11,10,10,11,11,9,10,9,11,4,13,6,11,11,12,13,11,15,11,10,12,20,12,11,10,9,5,5,6,10,9,9,8,12,7,12,2,S ,1,1,20,14,1,1,1,1,1,1,10,1,1,1,1
19189818,Gílson,1651,23/01/1990,26,0,0,0,0,184,76,2,3,1,3,1,2,4,2,2,3,3,7,5,8,7,13,7,4,13,6,12,13,6,12,13,6,10,5,6,3,11,13,10,5,8,10,10,8,12,13,13,8,11,11,8,13,20,13,10,10,10,5,10,10,12,10,10,9,9,4,3,1,M C,1,1,1,1,1,1,1,1,1,1,20,1,1,1,1
19189819,Juninho,1651,23/10/1987,28,0,0,0,0,173,66,4,1,2,1,3,2,3,2,1,1,2,7,10,13,9,11,11,6,9,10,12,12,7,11,11,6,10,13,11,13,13,12,4,14,2,12,10,13,14,15,14,12,6,11,14,15,20,9,7,12,11,11,10,17,9,10,10,11,11,8,14,5,WB/DM/M LC,1,1,1,13,1,1,1,13,1,17,20,17,1,17,1
19189914,Arthur,1651,21/03/1994,22,0,0,0,0,179,73,3,4,3,2,1,2,1,2,2,1,2,8,6,6,11,13,12,9,13,3,12,14,9,13,13,12,7,4,10,9,11,11,15,8,2,10,9,13,11,12,13,10,7,14,7,12,20,9,9,10,10,12,10,12,15,13,16,15,15,8,12,10,M C,1,1,1,10,1,1,1,1,1,1,20,1,1,1,1
19189916,Mário Lucas,1651,11/08/1992,23,0,0,0,0,175,0,2,1,1,1,2,2,4,3,3,1,2,7,5,13,13,13,7,13,4,1,7,8,7,3,13,8,10,3,8,8,8,13,10,13,3,12,8,7,8,13,13,8,5,10,10,13,20,8,9,10,10,3,10,10,10,14,10,11,12,10,11,1,S ,1,1,20,1,1,1,1,1,1,1,1,1,1,1,1
19189922,Erik,1651,18/07/1994,21,0,0,0,0,170,65,3,4,3,3,3,1,1,2,2,3,1,6,11,13,12,13,10,8,12,7,9,12,14,8,14,13,13,12,11,11,12,12,8,15,8,14,8,11,11,16,15,15,6,11,12,15,20,13,8,11,12,11,11,11,15,11,11,12,5,12,14,10,S R,1,1,20,10,12,15,1,1,1,1,1,1,1,1,1
19190043,Igor,1651,28/04/1993,23,0,0,0,0,187,81,1,4,1,3,1,3,3,2,2,3,2,7,11,8,8,10,3,7,5,6,11,10,4,12,11,10,12,10,7,8,8,14,4,9,7,8,10,10,10,12,12,10,12,20,8,12,10,14,8,10,9,10,10,10,14,13,10,9,10,1,12,7,D/WB L,1,1,1,1,1,1,1,20,1,1,1,1,1,19,1
19190044,Yago,1651,12/03/1993,23,0,0,0,0,175,66,2,2,3,2,2,2,4,2,1,1,3,7,9,7,4,14,5,8,7,7,9,8,4,10,9,9,8,9,9,8,8,13,5,5,14,7,10,9,9,14,14,9,5,9,9,14,20,8,7,8,9,9,7,9,19,11,11,13,11,1,13,4,D/WB R,1,1,1,1,1,1,1,1,20,1,1,1,1,1,19
19190049,Michael,1651,21/03/1993,23,0,0,0,0,187,0,2,3,1,3,2,1,3,3,3,3,1,8,5,14,14,7,8,14,9,7,8,8,6,4,12,10,8,4,12,9,8,11,4,11,10,14,9,8,9,14,12,9,14,1,14,14,20,7,10,10,7,10,10,10,8,12,13,11,9,7,7,8,S ,1,1,20,1,1,1,1,1,1,1,1,1,1,1,1
19190099,Jemerson,1651,24/08/1992,23,0,0,0,0,184,77,1,1,1,1,3,2,3,2,2,2,3,6,9,11,7,12,7,15,9,11,14,13,10,15,12,14,15,15,13,12,11,13,15,11,9,9,14,14,14,14,13,15,13,9,16,15,20,14,14,14,11,14,4,11,14,13,15,14,16,14,15,6,D C,1,1,1,1,1,1,20,1,12,1,1,1,1,1,10
19190101,Elder Santana,1651,07/04/1993,23,0,0,0,0,186,80,3,2,2,3,3,3,3,1,1,1,3,8,9,14,14,9,8,14,6,4,6,6,5,7,14,3,14,3,10,7,9,12,9,13,9,14,7,8,9,12,10,9,13,10,13,9,20,14,10,8,10,10,10,10,13,13,9,12,9,12,18,4,S ,1,1,20,1,1,1,1,1,1,1,1,1,1,1,1
19190102,Rafael Vitor,1651,05/01/1993,23,0,0,0,0,192,78,3,3,1,1,1,1,3,2,3,1,1,7,5,7,3,7,5,14,1,3,11,8,2,13,6,9,13,9,7,7,6,14,1,1,6,7,8,7,7,10,10,8,12,3,13,11,20,8,13,9,4,9,9,9,13,10,12,11,9,3,15,6,D C,1,1,1,1,1,1,20,1,1,10,1,1,1,1,1
19190107,Thiago Espíndola,1651,15/05/1993,23,0,0,0,0,175,66,2,1,2,2,1,3,1,2,1,3,4,7,7,9,3,8,8,10,4,7,11,11,6,14,11,4,13,11,5,8,11,15,5,7,14,9,9,11,11,10,13,13,7,20,10,15,10,8,6,10,10,10,8,10,17,12,11,11,11,3,15,5,D/WB L,1,1,1,1,1,1,1,20,1,1,1,1,1,19,1
19190108,Cácio,1651,18/02/1992,24,0,0,0,0,170,0,1,4,3,2,2,2,1,3,1,2,2,7,6,5,8,8,7,7,14,1,9,14,5,14,9,9,11,8,8,9,9,10,4,5,4,7,12,8,11,14,14,8,5,9,13,14,20,7,12,9,6,9,5,9,10,13,9,11,12,10,10,3,DM ,1,1,1,1,1,1,1,1,1,20,10,1,1,1,1
19190110,Lucas Cândido,1651,25/12/1993,22,0,0,0,0,186,81,3,2,2,2,2,1,1,3,2,3,1,6,8,12,8,14,10,13,14,8,13,13,8,13,12,12,12,13,12,12,9,11,14,9,11,10,12,12,12,13,15,13,11,20,9,13,17,14,13,10,12,9,20,11,20,13,12,13,12,6,10,6,DM LC,1,1,1,1,1,1,1,15,1,20,15,15,1,15,1
19190111,Emerson,1651,26/02/1994,22,0,0,0,0,190,0,3,2,1,3,3,2,1,1,3,1,3,7,4,5,1,9,5,14,7,1,13,8,2,14,7,8,8,9,7,6,5,14,9,5,9,5,11,7,7,10,10,8,14,20,15,11,1,9,10,9,9,9,9,9,12,13,12,14,9,4,5,8,D LC,1,1,1,1,1,1,20,15,1,1,1,1,1,1,1
19190112,Jordi,1651,03/09/1993,22,0,0,0,0,188,79,12,12,11,7,13,10,13,14,13,10,13,7,3,1,1,8,10,3,2,2,2,3,4,1,8,11,14,15,12,13,11,16,14,2,4,2,12,12,11,14,13,12,13,4,11,15,20,6,12,13,9,10,8,11,10,13,13,10,13,10,11,6,GK ,20,1,1,1,1,1,1,1,1,1,1,1,1,1,1
19190113,Richard,1651,03/04/1995,21,0,0,0,0,173,67,2,2,1,3,3,3,3,1,1,1,1,9,9,9,5,14,7,10,4,9,11,11,5,15,10,8,9,11,9,12,8,15,2,4,11,9,10,11,10,14,13,7,7,6,13,14,20,13,7,10,10,6,10,10,20,13,10,9,13,1,14,6,D/WB R,1,1,1,1,1,1,1,1,20,1,1,1,1,1,19
19190116,Henrique,1651,25/04/1994,22,0,0,0,0,173,63,1,4,1,2,2,1,2,1,1,1,3,7,11,12,10,11,7,8,11,8,11,11,7,12,12,12,13,12,12,13,12,13,13,13,9,13,13,12,13,14,13,10,10,20,14,14,5,13,10,12,10,11,10,12,12,13,12,12,10,7,11,5,D/WB L,1,1,1,1,1,1,1,20,1,5,1,1,1,19,1
19190117,Malco,1651,08/01/1993,23,0,0,0,0,179,0,3,2,3,3,3,4,2,2,1,3,1,5,1,6,7,11,3,6,8,1,9,13,4,13,13,9,12,8,6,12,10,11,5,8,12,6,9,7,11,13,13,2,7,16,9,13,20,7,6,9,6,7,7,9,14,11,9,10,9,5,14,4,DM ,1,1,1,1,1,1,1,1,1,20,10,1,1,1,1
19190118,Yago,1651,28/04/1994,22,0,0,0,0,172,68,3,3,1,1,3,3,2,1,2,1,1,10,8,13,11,10,8,9,12,5,6,10,8,7,12,11,12,12,11,10,11,11,9,12,10,13,7,12,12,15,14,7,8,7,14,15,20,14,7,11,9,10,10,14,11,11,11,11,10,10,17,1,S RL,1,1,20,1,15,15,1,1,1,1,1,1,1,1,1
19190119,Diego,1651,04/01/1994,22,0,0,0,0,195,89,9,11,7,1,14,10,7,14,9,9,6,3,2,2,2,1,8,1,3,3,2,2,2,3,1,9,5,12,8,11,7,7,4,3,4,1,7,8,6,14,14,6,13,3,7,12,20,4,11,9,5,9,9,9,14,14,12,11,10,10,14,4,GK ,20,1,1,1,1,1,1,1,1,1,1,1,1,1,1
19190120,Jair,1651,28/08/1994,21,0,0,0,0,178,0,1,2,4,3,3,2,4,3,2,1,2,8,10,9,7,12,8,5,7,6,10,10,4,14,10,8,9,9,9,11,10,13,3,8,3,8,10,9,10,12,14,9,6,11,16,11,20,11,7,10,10,7,4,10,18,12,10,12,11,5,6,6,D/WB/DM R,1,1,1,1,1,1,1,1,20,16,1,1,1,1,19
19190121,Raphinha,1651,21/04/1993,23,0,0,0,0,176,68,1,2,1,1,3,1,1,4,2,2,2,11,9,14,12,13,7,7,12,12,15,13,9,8,13,3,15,12,12,12,11,13,11,3,6,14,8,15,12,15,16,6,8,20,14,14,11,12,6,12,11,4,11,11,16,9,11,10,9,6,6,1,D/WB L,1,1,1,1,1,1,1,20,1,1,1,1,1,19,1
19190150,Irlan,1651,03/12/1993,22,0,0,0,0,182,80,2,3,2,3,2,3,1,1,3,1,1,6,4,8,8,13,6,3,9,1,3,13,4,5,8,9,10,8,6,7,7,13,5,9,6,8,8,7,11,13,11,7,10,9,13,11,20,7,7,9,6,3,9,9,11,11,10,10,13,4,8,1,M C,1,1,1,15,1,1,1,1,1,1,20,1,1,1,1
19190152,Thiago Rômulo,1651,11/06/1992,24,0,0,0,0,175,73,1,1,3,1,3,2,3,1,3,3,2,7,6,13,13,13,6,13,8,1,5,7,5,4,13,10,12,5,9,5,8,13,9,13,10,11,7,7,8,12,10,8,8,11,12,11,20,13,9,10,7,1,5,10,12,12,11,12,11,6,5,5,S ,1,1,20,1,1,1,1,1,1,1,1,1,1,1,1
19190159,Calyson,1651,25/02/1993,23,0,0,0,0,174,69,3,1,2,3,1,3,1,3,2,2,3,7,5,8,11,8,7,7,8,3,7,10,5,8,13,10,8,7,10,6,11,13,7,13,1,13,7,7,12,13,12,4,6,10,11,13,20,9,6,10,10,9,10,10,10,12,9,10,9,1,18,3,AM C,1,1,1,20,1,1,1,1,1,1,10,1,1,1,1
19190160,Jota,1651,29/08/1993,22,0,0,0,0,189,76,9,9,8,1,13,8,4,12,6,9,11,6,3,1,3,1,8,1,1,1,1,2,2,1,2,9,4,12,7,10,6,13,4,2,14,3,9,7,6,9,11,5,13,9,8,8,20,1,10,9,9,6,9,9,10,13,12,12,12,3,10,8,GK ,20,1,1,1,1,1,1,1,1,1,1,1,1,1,1
19190166,Sandrinho,1651,13/04/1992,24,0,0,0,0,167,0,2,1,2,2,2,1,3,3,1,2,2,7,3,12,13,11,7,13,6,1,4,8,5,3,12,8,13,4,10,7,7,9,10,14,13,13,3,7,8,15,14,8,4,10,10,14,20,10,9,3,10,10,10,10,11,11,10,11,12,5,13,7,S ,1,1,20,1,1,1,1,1,1,1,1,1,1,1,1
19190167,Welton,1651,17/06/1992,24,0,0,0,0,181,72,1,1,1,1,3,2,3,1,1,3,1,6,5,3,4,13,6,6,13,2,10,13,2,13,8,9,8,4,7,9,4,10,9,7,5,6,9,7,12,13,13,9,10,9,9,13,20,11,8,9,6,4,9,9,19,9,10,12,14,8,4,1,DM ,1,1,1,1,1,1,1,1,1,20,10,1,1,1,1
19190175,Cleidson Camutanga,1651,27/09/1993,22,0,0,0,0,184,80,3,3,3,3,1,1,3,3,2,2,2,1,1,1,2,6,1,13,4,1,13,3,2,12,3,5,7,8,6,10,2,13,3,5,9,4,12,5,6,13,13,6,8,8,8,12,20,5,6,8,8,8,5,8,9,12,12,10,9,7,11,3,D C,1,1,1,1,1,1,20,1,1,1,1,1,1,1,1
19190181,Matheus,1651,20/05/1995,21,0,0,0,0,179,0,3,3,2,1,2,1,2,4,1,1,3,6,4,12,9,12,6,6,11,2,4,10,5,5,9,6,8,5,9,7,10,13,4,13,4,10,4,7,10,12,11,2,6,8,11,11,20,9,6,9,6,7,7,9,20,11,12,8,11,5,1,7,AM C,1,1,10,20,1,1,1,1,1,1,5,1,1,1,1
19190183,Makson,1651,23/09/1994,21,0,0,0,0,190,0,1,3,1,2,3,2,3,1,2,2,2,7,6,10,13,10,7,5,14,4,6,14,3,7,14,7,7,8,5,7,14,13,9,13,10,9,8,8,10,14,12,8,12,9,15,12,20,5,10,9,9,9,4,9,7,13,10,11,13,4,11,5,AM C,1,1,1,20,1,1,1,1,1,1,5,1,1,1,1
19190244,Ronaldo Mendes,1651,16/08/1992,23,0,0,0,0,170,75,1,1,4,2,3,3,4,3,1,3,2,12,13,14,13,13,13,7,15,8,8,13,10,8,13,9,13,10,13,13,12,13,13,9,8,13,11,13,11,13,14,13,11,20,12,14,10,13,13,12,8,10,9,11,12,12,12,12,10,5,10,6,AM C,1,1,1,20,10,10,1,1,1,1,15,1,1,1,1
19190255,Sávio,1651,05/08/1996,19,0,0,0,0,165,65,3,3,3,1,2,1,1,3,3,3,3,4,6,7,6,10,7,5,7,5,13,11,7,12,10,14,12,13,11,11,10,11,6,6,11,8,11,12,13,13,14,8,4,7,14,13,20,14,7,9,10,6,6,9,11,10,10,11,10,6,7,5,DM C,1,1,1,1,1,1,1,1,1,20,15,1,1,1,1
19190291,Filipe Ramón,1651,15/01/1993,23,0,0,0,0,164,60,1,2,3,2,3,3,2,1,1,2,3,10,9,12,9,12,11,8,10,10,6,11,9,5,11,7,9,10,11,5,11,12,3,13,1,13,4,10,10,14,14,4,5,20,13,12,2,12,4,6,3,5,7,15,11,13,11,11,9,5,9,5,D/WB L,1,1,1,12,15,12,1,20,1,1,11,13,1,19,1
19190350,Júnior Oliveira,1651,02/01/1990,26,0,0,0,0,197,86,14,13,10,9,12,10,10,13,6,13,11,1,1,3,1,5,6,9,3,1,3,6,2,1,4,7,10,11,10,10,6,9,10,2,8,2,12,12,13,10,11,6,18,4,6,10,20,13,16,10,9,9,10,10,13,9,10,7,12,11,7,6,GK ,20,1,1,1,1,1,1,1,1,1,1,1,1,1,1
19190352,Nailson,1651,24/02/1994,22,0,0,0,0,190,84,3,1,1,3,4,2,1,1,3,2,4,4,8,8,4,12,5,12,5,4,12,9,4,13,8,8,12,11,11,9,5,12,20,4,12,4,12,12,11,12,10,13,15,5,14,11,20,12,14,11,9,11,8,9,10,11,11,9,13,9,16,7,D C,1,1,1,1,1,1,20,1,1,1,1,1,1,1,1
19190421,Pedro,1651,30/08/1993,22,0,0,0,0,187,0,1,3,1,2,3,3,3,2,3,2,3,7,7,11,9,14,7,7,9,1,7,11,3,6,14,9,7,6,8,6,12,14,9,13,13,9,8,8,9,13,11,8,10,8,13,12,20,8,8,9,9,9,4,9,11,11,12,12,11,6,18,4,AM C,1,1,13,20,1,1,1,1,1,1,10,1,1,1,1
19190440,Marcão,1651,05/06/1996,20,0,0,0,0,186,82,3,1,2,3,1,2,3,1,1,2,3,12,10,10,10,10,10,14,10,10,13,12,10,14,12,12,13,12,11,10,11,12,4,12,10,11,13,12,14,11,12,11,13,20,12,13,7,13,12,11,14,11,12,13,7,10,8,8,12,5,14,6,D C,1,1,1,1,1,1,20,1,1,15,1,1,1,1,1
19190441,Anderson Lopes,1651,15/09/1993,22,0,0,0,0,180,0,2,2,3,2,2,1,2,3,1,3,1,10,12,13,13,13,12,11,12,5,9,13,10,8,13,8,10,10,12,12,13,12,10,13,2,13,7,14,12,14,14,13,11,20,13,14,10,13,13,11,12,11,11,11,9,11,10,11,13,9,10,6,S ,1,1,20,1,1,1,1,1,1,1,1,1,1,1,1
19190474,José Lucas,1651,14/08/1992,23,0,0,0,0,181,70,3,2,1,2,4,3,3,2,3,2,1,6,6,3,6,13,6,6,9,1,11,9,2,13,13,13,13,6,6,4,7,13,3,7,3,6,13,7,9,13,12,4,9,9,7,12,20,5,7,8,14,4,9,9,15,10,11,12,12,8,16,7,DM ,1,1,1,1,1,1,1,1,1,20,10,1,1,1,1
19190486,Roberto Cunha,1651,26/04/1990,26,0,0,0,0,192,84,2,3,3,1,1,3,3,1,1,3,3,1,1,2,3,8,1,12,4,3,13,7,4,11,6,5,12,9,7,12,4,13,9,6,3,6,13,6,6,9,9,7,12,13,14,13,20,10,11,9,6,9,9,9,19,12,7,14,10,1,9,1,D C,1,1,1,1,1,1,20,1,1,13,1,1,1,1,1
19190507,Alex Silva,1651,12/04/1989,27,0,0,0,0,180,78,3,1,1,1,2,2,3,2,3,3,3,10,14,14,7,9,7,7,8,7,4,7,6,9,14,9,12,6,7,8,8,7,3,13,11,9,6,8,9,13,11,8,9,20,8,13,10,13,11,9,6,9,9,9,12,14,12,10,10,13,6,5,WB/M L,1,1,1,12,15,1,1,8,1,1,6,20,1,18,1
19190564,Léo Miranda,1651,19/04/1984,32,0,0,0,0,161,0,2,1,3,2,1,1,2,1,3,3,3,6,4,4,8,9,6,2,13,1,5,13,5,8,13,9,9,4,9,7,11,13,5,13,7,9,8,7,12,11,13,7,1,8,11,13,20,12,5,9,9,9,9,9,14,12,11,10,12,11,15,6,AM C,1,1,1,20,1,1,1,1,1,1,15,1,1,1,1
19190565,Victor Rangel,1651,08/09/1990,25,0,0,0,0,181,78,3,2,2,3,3,1,1,1,3,3,3,6,9,11,12,11,10,12,13,8,8,11,13,7,11,12,12,10,11,11,10,10,3,12,9,13,9,11,13,13,13,11,11,11,12,13,20,13,12,12,11,10,11,9,8,13,12,13,8,5,13,3,AM/S R,1,1,20,11,1,19,1,1,1,1,1,1,1,1,1
19190583,Gabriel,1651,28/02/1989,27,0,0,0,0,191,90,3,3,1,2,1,1,3,3,4,2,3,4,5,5,4,12,6,14,5,7,12,9,5,13,10,14,12,13,12,12,3,12,10,1,8,9,12,10,11,8,10,13,17,8,6,10,20,12,14,10,13,4,20,10,8,11,10,12,9,5,8,2,D C,1,1,1,1,1,1,20,1,1,1,1,1,1,1,1
19190592,Thalles,1651,13/04/1993,23,0,0,0,0,173,66,2,2,3,4,1,1,3,1,1,2,4,4,4,9,12,8,1,6,5,1,3,5,7,1,12,7,7,6,13,4,5,5,6,12,14,9,5,4,5,10,12,4,6,9,13,9,20,3,5,7,7,7,7,6,14,13,12,13,11,8,4,1,S ,1,1,20,1,1,1,1,1,1,1,1,1,1,1,1
19190593,Geovane,1651,29/11/1994,21,0,0,0,0,179,76,2,1,3,1,1,2,3,4,3,2,2,8,7,8,5,13,4,9,2,7,10,10,5,12,8,9,10,9,5,9,7,12,9,8,8,2,7,10,7,15,13,10,5,20,16,15,8,9,7,9,7,6,6,9,10,11,10,10,14,1,13,2,D/WB L,1,1,1,1,1,1,1,20,1,1,1,1,1,19,1
19190594,Bruno,1651,19/04/1993,23,0,0,0,0,175,72,1,1,2,1,2,3,2,3,3,1,2,5,7,6,3,13,7,9,7,7,14,9,3,14,9,9,11,8,8,9,9,14,7,2,8,7,14,8,13,8,7,15,7,9,6,7,20,8,5,8,9,5,4,9,14,11,12,10,11,4,16,2,DM C,1,1,1,1,1,1,15,1,9,20,10,1,1,1,7
19190657,Marcelo,1651,01/06/1994,22,0,0,0,0,184,0,3,3,2,2,1,2,1,1,1,3,2,7,3,12,14,14,5,14,8,6,5,8,6,3,10,7,10,5,10,8,6,11,1,9,5,14,7,7,8,14,13,8,11,2,10,11,20,7,11,9,6,7,9,9,15,9,9,8,11,7,13,7,S ,1,1,20,1,1,1,1,1,1,1,1,1,1,1,1
19190659,Guilherme Morassi,1651,08/01/1995,21,0,0,0,0,179,70,4,2,3,1,1,2,2,1,3,2,3,8,9,10,8,9,8,8,8,9,8,9,11,9,9,10,9,10,8,14,9,12,2,2,5,9,9,10,10,13,13,10,8,20,16,12,7,10,8,10,10,10,10,12,11,11,10,12,9,10,8,1,D/WB L,1,1,1,7,7,1,1,18,1,1,5,8,1,20,1
19190712,Léo Prigol,1651,14/09/1995,20,0,0,0,0,188,0,2,2,3,3,1,3,2,2,1,1,3,5,7,5,2,13,2,5,3,2,6,7,1,11,8,4,5,6,4,4,6,11,7,6,12,6,7,6,6,14,9,5,11,8,10,13,20,6,9,7,5,3,5,7,10,11,10,10,12,4,8,5,WB R,1,1,1,1,1,1,1,1,15,1,1,1,1,1,20
19190740,Caique,1651,13/02/1996,20,0,0,0,0,183,75,3,3,1,1,2,3,4,4,3,2,3,7,5,7,7,14,5,3,8,5,8,14,3,14,9,9,8,8,8,5,11,14,9,8,8,6,14,8,11,10,9,8,12,1,13,12,20,7,7,9,5,9,8,9,12,10,10,11,10,13,18,3,DM ,1,1,1,1,1,1,1,1,1,20,10,1,1,1,1
19190742,Juninho,1651,03/09/1995,20,0,0,0,0,175,70,4,2,4,1,2,2,2,2,3,2,2,10,10,12,10,12,9,10,9,5,8,12,10,8,12,11,10,9,11,11,13,10,8,13,6,13,10,10,11,13,14,13,7,10,12,12,20,11,9,9,11,8,10,9,12,12,9,13,6,3,6,6,AM LC,1,1,1,20,17,12,1,1,1,1,12,1,1,1,1
19190931,Da Silva,1651,26/06/1991,25,0,0,0,0,176,78,2,1,2,1,2,1,3,2,3,2,1,6,3,6,7,11,5,6,8,1,7,13,5,12,12,8,10,8,7,8,7,12,5,9,4,5,10,7,11,13,13,8,7,10,12,13,20,11,9,9,8,4,8,9,19,10,13,12,12,12,15,6,DM ,1,1,1,1,1,1,1,1,1,20,10,1,1,1,1
19190932,Tiago Baiano,1651,28/03/1987,29,0,0,0,0,170,65,1,1,2,2,3,3,2,2,2,2,2,4,9,8,5,11,4,9,8,7,10,9,4,7,10,7,8,10,9,9,8,12,10,9,13,8,9,9,9,14,14,9,6,10,12,14,20,14,8,10,10,10,10,10,13,12,10,11,9,5,10,7,D/WB R,1,1,1,1,1,1,1,1,20,1,1,1,1,1,18
19190933,Fio,1651,25/08/1987,28,0,0,0,0,178,78,3,1,1,3,2,3,4,3,1,4,2,4,2,11,13,13,6,13,7,2,5,3,7,3,10,8,9,4,13,5,7,12,8,10,12,13,7,6,7,13,13,7,8,9,15,13,20,9,11,9,9,9,9,9,11,12,11,8,12,8,9,6,S ,1,1,20,1,1,1,1,1,1,1,1,1,1,1,1
19191017,Alex Sandro,1651,21/02/1993,23,0,0,0,0,174,0,3,3,1,3,3,1,3,1,1,1,2,9,7,9,9,15,9,9,12,9,11,15,8,15,14,10,9,8,10,5,15,15,9,6,10,9,15,10,14,12,9,10,6,1,10,13,20,11,7,10,3,10,6,10,11,11,9,9,9,10,9,7,DM ,1,1,1,1,1,1,1,1,1,20,13,1,1,1,1
19191019,André,1651,03/08/1993,22,0,0,0,0,176,72,1,3,2,1,3,1,2,1,3,1,2,6,4,14,14,12,7,11,3,7,7,5,3,1,9,9,14,8,8,8,8,9,9,9,11,13,7,4,8,14,14,8,8,1,13,14,20,6,7,9,6,9,9,9,17,12,10,13,9,8,11,1,S ,1,1,20,1,1,1,1,1,1,1,1,1,1,1,1
19191020,Bruno Gonçalves,1651,29/12/1992,23,0,0,0,0,183,77,2,2,1,4,1,3,1,3,3,1,1,6,4,13,13,13,5,13,5,5,5,7,8,1,9,7,10,7,12,6,7,12,9,9,1,12,7,6,7,13,12,6,9,10,14,12,20,7,9,9,9,6,9,8,15,13,9,13,12,6,4,4,S ,1,1,20,1,1,1,1,1,1,1,1,1,1,1,1
19191021,Caio,1651,27/01/1993,23,0,0,0,0,187,77,2,1,3,4,1,2,1,1,1,2,1,9,9,10,10,9,9,11,9,9,5,9,9,5,10,9,10,9,9,11,10,12,9,11,9,13,10,13,14,11,14,10,11,8,10,11,20,10,10,10,3,10,11,9,20,12,11,13,11,9,18,2,S ,1,1,20,1,1,1,1,1,1,1,1,1,1,1,1
19191022,Caique,1651,06/02/1995,21,0,0,0,0,175,0,2,3,1,1,1,2,2,2,1,1,2,7,4,7,7,14,7,7,13,5,8,8,2,13,14,4,5,8,8,9,12,13,2,9,11,7,9,9,10,14,12,5,4,8,9,10,20,7,6,9,4,1,3,9,19,9,12,9,10,3,1,7,DM/M C,1,1,1,1,1,1,1,1,1,20,17,1,1,1,1
19191023,Cordeiro,1651,04/07/1995,20,0,0,0,0,169,70,2,2,2,1,1,1,2,2,3,2,1,7,6,9,14,14,7,12,7,2,5,8,3,3,14,9,11,2,5,6,6,10,1,13,2,14,8,7,7,14,11,8,4,11,9,11,20,10,9,9,9,9,9,9,15,12,12,10,12,3,8,4,S ,1,1,20,1,1,1,1,1,1,1,1,1,1,1,1
19191027,Mococa,1651,23/02/1996,20,0,0,0,0,164,56,3,2,1,2,3,3,1,1,2,1,3,7,7,9,9,12,7,7,11,6,6,11,2,9,14,9,8,6,5,9,14,14,3,13,10,7,8,9,10,14,11,9,1,9,14,12,20,8,5,9,9,7,3,9,9,11,9,12,10,11,14,4,M/AM C,1,1,1,20,1,1,1,1,1,1,17,1,1,1,1
19191028,Jaimes,1651,20/05/1993,23,0,0,0,0,185,0,3,3,1,2,1,3,1,3,3,2,1,7,3,1,1,8,3,14,3,2,13,8,4,14,6,9,9,9,8,11,4,13,2,4,3,7,11,7,7,10,10,8,8,8,10,9,20,7,10,9,9,7,3,9,10,11,12,10,11,3,10,5,D C,1,1,1,1,1,1,20,1,1,1,1,1,1,1,1
19191029,Jefferson,1651,25/08/1993,22,0,0,0,0,184,76,2,1,3,1,1,2,1,3,3,4,2,4,3,5,1,6,1,10,4,1,13,4,1,12,2,9,7,9,7,7,3,13,1,2,4,6,11,6,3,13,12,7,6,9,13,13,20,5,8,9,6,9,9,9,18,13,13,12,12,8,1,7,D C,1,1,1,1,1,1,20,1,1,1,1,1,1,1,1
19191031,Junior,1651,26/03/1993,23,0,0,0,0,188,74,1,1,3,1,1,1,2,1,2,1,1,1,1,5,2,6,1,13,1,1,11,6,2,13,5,8,13,8,6,13,4,6,8,5,10,4,9,5,6,13,13,6,10,8,13,13,20,7,9,8,8,8,5,8,16,11,12,13,10,9,2,4,D C,1,1,1,1,1,1,20,1,1,1,1,1,1,1,1
19191033,Luquinhas,1651,05/02/1995,21,0,0,0,0,185,79,1,3,3,1,2,2,2,1,4,3,1,1,1,1,1,3,1,13,2,1,12,6,1,13,1,8,5,8,2,10,5,7,2,2,6,3,13,5,6,10,10,6,10,8,9,12,20,3,7,7,6,4,8,8,18,11,11,10,10,10,16,6,D C,1,1,1,1,1,1,20,1,1,1,1,1,1,1,1
19191034,Luciano Martins,1651,12/04/1993,23,0,0,0,0,177,70,3,3,2,3,2,3,1,3,3,2,2,3,1,7,8,13,6,6,12,1,6,13,4,7,13,9,8,8,9,7,8,11,9,13,8,8,8,8,11,13,10,8,8,4,9,13,20,6,5,9,8,9,9,9,7,12,13,9,7,4,14,8,M/AM C,1,1,1,20,1,1,1,1,1,1,17,1,1,1,1
19191035,Luiz Daniel,1651,29/03/1993,23,0,0,0,0,186,84,14,11,8,6,14,14,9,12,6,9,11,2,3,1,3,1,7,1,1,3,3,1,3,2,2,9,9,11,6,9,7,14,6,2,2,2,10,8,6,9,12,6,9,8,10,11,20,2,9,9,9,9,9,9,7,12,10,11,12,6,13,5,GK ,20,1,1,1,1,1,1,1,1,1,1,1,1,1,1
19191036,Rafael Pastorelli,1651,25/05/1994,22,0,0,0,0,175,65,2,2,2,1,3,1,3,2,1,3,2,3,6,6,3,11,4,5,1,3,8,7,1,14,7,8,10,8,7,8,4,9,8,3,7,5,7,8,8,14,14,8,9,11,15,14,20,8,6,8,6,6,8,8,14,13,11,11,11,6,10,7,D/WB R,1,1,1,1,1,1,1,1,20,1,1,1,1,1,17
19191040,Victor,1651,25/03/1994,22,0,0,0,0,198,0,2,3,2,1,1,1,2,3,3,2,3,5,5,2,7,13,5,5,5,1,6,13,4,7,13,8,7,5,7,7,11,10,8,13,6,8,7,7,10,13,11,7,12,8,12,12,20,5,12,8,3,8,8,8,10,11,13,11,12,10,14,8,M/AM C,1,1,1,20,1,1,1,1,1,1,17,1,1,1,1
19191041,Walterson,1651,28/12/1994,21,0,0,0,0,180,67,1,2,3,1,2,3,2,2,2,3,3,10,14,14,13,12,8,12,9,5,9,10,7,9,14,7,12,9,12,8,11,14,13,14,5,14,6,5,12,13,13,13,6,11,11,12,20,11,14,11,7,2,10,11,19,12,10,12,11,7,7,5,AM/S R,1,1,18,13,1,20,1,1,1,1,12,1,1,1,1
19191092,Alef,1651,28/01/1995,21,0,0,0,0,186,79,3,3,3,2,1,3,3,2,4,2,3,7,6,10,7,12,11,12,11,10,12,12,11,13,12,13,12,13,12,13,8,11,13,12,10,13,12,11,13,13,12,13,11,8,13,13,20,14,12,12,11,11,11,11,7,13,10,12,11,10,12,7,DM/M C,1,1,1,1,1,1,1,1,1,20,17,1,1,1,1
19191095,Jeferson,1651,22/05/1996,20,0,0,0,0,170,60,3,3,2,2,3,3,3,2,3,1,2,11,12,12,6,13,9,12,5,10,9,11,5,8,11,11,11,12,7,13,10,16,20,12,14,11,11,13,12,13,12,11,5,11,13,13,20,16,9,11,8,9,8,11,18,14,8,12,11,7,10,1,D/WB R,1,1,1,1,1,1,1,1,20,1,1,1,1,1,17
19191096,Juninho,1651,12/05/1995,21,0,0,0,0,188,0,12,8,8,1,13,12,6,13,7,8,10,3,3,2,1,5,7,1,1,3,2,1,3,3,2,8,8,11,3,8,5,13,2,3,8,1,4,6,4,12,5,6,13,12,12,11,20,1,7,8,8,8,5,8,9,12,10,9,14,4,16,2,GK ,20,1,1,1,1,1,1,1,1,1,1,1,1,1,1
19191097,Citta Junior,1651,12/03/1996,20,0,0,0,0,163,57,2,1,1,3,1,3,1,1,2,1,1,5,5,7,10,15,8,8,11,8,12,12,3,11,11,4,12,6,8,8,15,10,9,5,1,7,9,10,7,15,10,8,1,9,16,12,20,10,7,9,9,8,9,9,15,8,9,11,11,5,13,3,DM/M C,1,1,1,11,1,1,1,1,1,20,17,1,1,1,1
19191098,Leornado,1651,12/07/1994,21,0,0,0,0,182,65,3,2,2,4,2,4,1,3,1,3,1,2,7,5,4,9,6,7,7,7,9,11,7,15,9,8,6,7,7,9,8,10,6,7,9,7,7,8,9,15,10,8,9,20,11,12,9,5,9,8,8,8,4,8,19,13,12,12,12,8,16,1,D/DM L,1,1,1,1,1,1,10,20,1,20,13,1,1,13,1
19191115,Matheus Galdezani,1651,13/03/1992,24,0,0,0,0,179,73,3,3,4,3,3,1,3,4,3,2,1,5,8,7,10,3,4,6,14,5,14,14,5,14,12,14,13,15,11,11,12,12,13,12,11,13,13,13,14,15,13,12,5,9,12,14,20,15,13,11,13,11,7,12,12,12,14,9,13,11,12,5,DM/M C,1,1,1,1,1,1,1,1,1,18,20,1,1,1,1
19191137,Victor,1651,22/03/1995,21,0,0,0,0,175,58,2,3,1,1,1,2,3,2,3,3,1,7,5,9,7,14,7,7,10,2,9,14,7,7,12,7,10,7,5,9,12,14,8,11,13,9,9,9,13,14,11,6,6,1,13,12,20,10,7,9,9,7,9,9,17,11,11,11,13,4,17,1,M/AM C,1,1,1,17,1,1,1,1,1,1,20,1,1,1,1
19191138,Romário,1651,20/06/1994,22,0,0,0,0,170,56,3,2,1,3,3,2,4,2,2,1,2,6,4,9,13,13,6,13,8,1,6,13,9,7,13,9,5,6,9,7,8,13,2,13,4,11,8,7,8,13,12,8,5,20,11,12,10,7,5,9,9,9,9,9,14,9,10,9,11,1,8,8,AM/S C,1,1,17,20,1,1,1,1,1,1,1,1,1,1,1
19191139,Robinho,1651,16/02/1996,20,0,0,0,0,169,60,2,2,3,2,2,2,1,3,2,1,2,8,8,10,10,15,8,4,13,3,5,14,6,8,14,7,8,8,9,9,10,12,4,12,6,12,10,9,8,15,13,9,4,2,12,15,20,8,6,9,8,4,9,9,14,12,10,12,10,2,12,4,AM C,1,1,1,20,1,1,1,1,1,1,13,1,1,1,1
19191144,Gabriel Esteves,1651,07/02/1995,21,0,0,0,0,171,58,1,1,2,2,2,1,2,4,1,4,3,9,10,12,11,11,9,9,9,10,6,9,3,6,11,8,13,8,11,10,11,10,5,13,6,12,6,12,12,15,14,17,5,8,12,15,20,12,3,11,10,10,6,9,8,9,10,13,10,10,12,3,AM R,1,1,15,1,12,20,1,1,1,1,1,1,1,1,1
19191166,Felipe Tavares,1651,24/02/1994,22,0,0,0,0,182,0,4,3,1,3,3,3,2,1,3,2,1,5,3,1,1,4,2,9,4,6,13,7,1,13,4,9,8,6,4,10,1,13,9,5,14,5,6,6,7,13,13,8,10,9,3,13,20,4,7,9,6,1,9,9,10,10,10,11,10,2,10,7,D C,1,1,1,1,1,1,20,1,13,1,1,1,1,1,1
19191194,Ligger,1651,18/05/1988,28,0,0,0,0,186,73,2,3,1,1,1,3,3,1,1,3,1,4,4,6,8,9,8,14,10,9,12,10,3,14,9,14,11,13,9,11,10,12,8,4,11,5,12,14,12,10,12,8,14,20,14,11,9,13,11,12,12,7,8,10,7,8,11,12,13,12,10,8,D/DM C,1,1,1,1,1,1,20,13,1,18,1,1,1,1,1
19191233,Erick,1651,26/12/1994,21,0,0,0,0,172,68,3,1,2,2,1,2,1,2,1,1,2,9,7,11,10,14,9,9,14,7,8,14,7,9,14,11,13,8,11,9,9,11,4,13,2,11,11,10,11,14,11,11,7,11,12,12,20,8,8,11,10,9,11,11,9,10,11,11,12,3,19,7,M/AM C,1,1,1,20,1,1,1,1,1,1,17,1,1,1,1
19191235,Marlon,1651,06/02/1995,21,0,0,0,0,185,80,2,1,3,3,1,1,2,1,1,2,4,6,3,11,13,13,6,13,5,1,5,7,10,4,13,6,10,5,11,3,4,8,2,13,10,13,7,6,7,13,12,7,7,8,12,12,20,4,9,9,9,9,8,9,11,10,13,11,12,4,3,8,S ,1,1,20,1,1,1,1,1,1,1,1,1,1,1,1
19191236,Maycon,1651,21/02/1995,21,0,0,0,0,180,68,2,2,2,1,3,1,3,1,1,3,2,6,4,4,6,12,6,6,13,6,11,12,2,13,13,9,12,8,8,5,10,13,5,1,5,6,10,7,11,13,9,3,9,10,16,12,20,7,7,9,9,9,8,9,15,12,13,10,11,3,1,5,DM ,1,1,1,1,1,1,1,1,1,20,13,1,1,1,1
19191237,Vitor Xavier,1651,27/03/1994,22,0,0,0,0,178,73,1,3,1,4,1,3,2,1,1,4,1,4,7,11,12,14,8,11,9,4,8,11,4,2,12,7,6,9,13,9,8,13,10,9,2,14,9,8,9,12,11,9,13,15,10,11,20,8,8,10,10,7,4,10,13,11,14,12,11,4,10,5,S ,1,1,20,1,1,1,1,1,1,1,1,1,1,1,1
19191238,Rodrigo,1651,17/07/1993,22,0,0,0,0,192,0,1,3,1,3,2,2,1,3,2,2,2,6,4,5,6,8,4,13,4,1,13,8,6,13,7,10,13,10,8,11,4,11,1,3,11,7,13,7,8,10,11,8,11,9,11,13,20,8,11,6,9,5,10,10,19,14,11,10,13,3,13,2,D C,1,1,1,1,1,1,20,1,1,1,1,1,1,1,1
19191285,Cássio,1651,03/01/1994,22,0,0,0,0,186,73,1,3,1,2,1,2,3,1,2,3,3,6,1,4,7,7,5,12,6,7,10,7,2,12,7,5,7,9,7,7,5,14,7,4,8,7,14,7,9,14,14,8,11,20,4,14,5,8,9,9,9,9,9,9,18,11,10,9,9,7,11,2,D C,1,1,1,1,1,1,20,1,1,12,1,1,1,1,1
19191286,Heliton,1651,13/11/1995,20,0,0,0,0,193,85,3,3,3,3,4,1,4,2,3,2,3,7,4,6,1,9,6,14,5,2,14,9,5,12,7,10,12,10,8,12,5,14,16,1,10,4,14,8,9,14,9,9,11,1,6,12,20,13,13,10,10,9,10,10,16,11,13,10,10,1,5,5,D C,1,1,1,1,1,1,20,1,1,1,1,1,1,1,1
19191292,Murilo Paccola,1651,21/05/1995,21,0,0,0,0,176,72,3,2,1,3,2,3,1,3,1,2,3,7,7,3,8,14,7,7,10,1,7,10,4,13,13,9,10,8,9,8,10,13,5,9,10,4,6,8,12,10,14,8,8,9,11,14,20,8,5,9,9,9,9,9,20,11,11,9,9,10,1,7,DM C,1,1,1,1,1,1,1,1,1,20,15,1,1,1,1
19191294,Vinícius Alves,1651,19/04/1995,21,0,0,0,0,176,71,1,2,1,2,1,3,1,3,3,3,3,7,4,7,5,13,5,7,8,6,8,14,5,12,9,8,10,5,9,8,12,14,5,9,6,7,12,8,12,14,14,8,5,4,13,14,20,8,7,9,7,3,7,9,9,7,10,10,11,9,9,3,DM C,1,1,1,1,1,1,1,1,1,20,15,1,1,1,1
19191295,Carlinhos,1651,21/10/1994,21,0,0,0,0,178,65,3,3,2,3,2,1,1,3,3,3,2,8,10,9,5,11,8,8,4,7,10,10,8,12,10,8,9,4,10,6,10,10,2,9,7,9,7,9,10,15,15,9,6,10,12,15,20,11,7,9,6,1,6,9,20,12,14,13,11,1,20,7,D/WB R,1,1,1,8,1,10,1,1,20,1,12,1,15,1,18
19191296,Guilherme Garré,1651,20/03/1993,23,0,0,0,0,173,0,3,1,1,3,1,2,4,1,1,2,2,8,10,9,10,14,7,6,10,5,8,13,7,7,14,8,13,4,10,9,7,13,10,13,9,10,7,9,10,14,13,9,3,20,10,13,12,7,6,10,6,10,6,10,11,12,10,12,13,8,7,6,AM C,1,1,12,20,14,14,1,1,1,1,15,1,1,1,1
19191362,Vinícius,1651,07/03/1993,23,0,0,0,0,183,79,2,3,2,2,3,1,2,3,3,3,2,10,13,12,9,13,13,9,9,8,10,12,10,12,13,9,11,9,9,11,12,11,12,10,7,12,10,12,13,13,14,8,7,20,12,13,10,13,10,8,6,11,10,8,12,14,12,13,15,9,11,7,D/WB/M L,1,1,1,1,1,1,1,20,1,1,1,16,1,17,1
19191582,Alef,1651,11/06/1996,20,0,0,0,0,180,71,3,3,2,3,3,2,1,1,2,2,3,10,12,12,10,12,5,3,12,10,11,12,13,10,12,8,10,8,9,9,12,9,13,14,4,12,10,11,12,14,14,10,10,6,10,14,20,13,8,13,5,10,4,11,15,11,8,10,12,9,8,5,D/WB R,1,1,1,1,1,1,1,11,20,1,1,1,1,10,19
19191669,Thiago Bonfim,1651,12/07/1992,23,0,0,0,0,190,77,2,3,3,3,1,4,3,3,3,1,2,7,10,10,12,12,7,12,9,1,10,11,1,10,14,6,6,8,9,9,11,12,9,1,7,9,12,8,13,12,10,7,14,7,12,11,20,12,11,9,5,9,5,14,10,11,11,11,12,8,7,3,DM/M C,1,1,11,13,1,1,1,1,1,18,20,1,1,1,1
19191670,Erick Daltro,1651,17/01/1993,23,0,0,0,0,180,68,1,1,1,2,3,1,3,2,1,1,1,5,11,12,8,11,8,9,10,11,10,10,7,11,10,10,10,11,10,9,10,10,4,14,7,10,9,10,11,13,13,7,10,20,13,13,11,12,7,11,9,10,9,12,15,12,10,11,10,7,1,4,D/WB L,1,1,1,1,1,1,1,20,1,1,1,1,1,18,1
19191673,Maracás,1651,27/04/1994,22,0,0,0,0,184,71,4,2,1,2,2,1,2,2,2,1,2,4,9,9,9,11,9,13,8,6,13,11,8,13,11,11,12,12,12,11,4,10,13,10,7,12,13,13,13,13,13,13,13,20,14,12,7,13,14,13,11,13,7,5,14,13,8,13,13,14,14,7,D C,1,1,1,1,1,1,20,14,1,1,1,1,1,10,1
19191674,Róbson,1651,14/02/1994,22,0,0,0,0,185,80,2,1,3,3,1,4,2,3,1,1,1,6,7,8,8,10,6,13,8,7,13,10,8,13,9,14,12,16,12,10,6,12,14,8,8,12,13,14,14,12,11,10,13,9,12,12,20,14,13,13,11,12,4,5,13,11,12,14,13,14,12,5,D C,1,1,1,1,1,1,20,1,1,1,1,1,1,1,1
19191688,Guilherme,1651,13/05/1994,22,0,0,0,0,161,59,2,3,3,2,4,1,1,3,1,2,3,10,11,12,11,12,6,5,11,12,9,12,11,8,12,11,12,12,9,8,12,9,13,14,3,12,7,11,11,13,14,9,1,5,12,13,20,12,6,12,4,10,4,15,16,10,11,12,11,2,2,4,D/WB/M/AM RC,1,1,12,15,1,16,1,1,20,11,13,1,17,1,19
19191689,Gabriel Soares,1651,02/04/1993,23,0,0,0,0,175,0,1,4,2,2,1,3,2,2,3,2,2,12,12,12,11,14,9,8,12,8,11,13,12,10,13,11,13,11,8,8,12,10,11,14,4,13,12,12,11,12,13,8,8,10,13,12,20,12,8,12,12,7,5,13,12,15,8,13,5,6,5,16,DM/M C,1,1,1,14,1,13,1,1,11,18,20,1,13,1,12
19191691,Nathan,1651,23/01/1993,23,0,0,0,0,174,63,3,3,3,3,3,1,2,2,4,1,1,7,11,12,9,15,9,9,10,9,4,15,6,4,12,10,11,5,11,9,12,11,12,9,3,11,8,7,11,13,14,5,7,7,11,13,20,11,5,10,10,10,4,10,9,10,12,10,11,7,10,3,M/AM RC,1,1,1,20,1,18,1,1,1,1,16,1,14,1,1
19191757,Matheus Nolasco,1651,21/04/1995,21,0,0,0,0,176,76,1,3,1,3,1,2,3,2,2,1,2,7,8,12,13,12,8,12,10,9,9,12,10,5,12,11,12,12,11,12,9,12,4,12,14,12,8,12,12,13,13,13,11,12,15,12,20,11,11,13,10,11,11,15,16,10,10,13,12,3,10,7,S ,1,1,20,1,1,12,1,1,1,1,1,1,1,1,1
19191871,Ualefi,1651,26/01/1994,22,0,0,0,0,173,70,1,3,3,1,1,1,2,2,3,1,3,7,7,8,6,13,7,7,11,6,10,13,2,13,9,10,11,9,9,9,11,13,5,10,6,8,11,8,12,9,11,11,6,10,11,11,20,8,7,10,10,10,9,10,9,11,10,10,13,7,10,1,DM/M C,1,1,1,1,1,1,1,1,1,20,20,1,1,1,1
19191902,Douglas Jardel,1651,30/08/1995,20,0,0,0,0,182,75,1,3,2,3,2,4,3,1,2,1,3,8,5,14,14,12,6,14,7,4,5,9,7,3,14,7,13,3,12,9,4,13,10,13,5,9,9,8,9,14,14,9,11,10,16,14,20,9,10,6,6,4,10,10,20,11,13,9,10,8,9,6,S ,1,1,20,1,1,1,1,1,1,1,1,1,1,1,1
19192094,Messinho,1651,19/03/1994,22,0,0,0,0,177,0,1,1,1,2,2,1,2,3,1,3,1,7,9,14,14,14,7,7,5,4,6,9,8,2,14,9,10,2,8,8,11,7,6,13,9,9,2,8,9,14,14,8,5,1,10,14,20,11,7,9,8,2,9,9,8,13,10,11,12,7,9,8,AM RLC,1,1,15,20,15,15,1,1,1,1,1,1,1,1,1
19192104,Foguete,1651,01/02/1996,20,0,0,0,0,168,68,3,2,3,2,1,2,3,1,2,3,3,8,12,12,7,13,5,10,7,8,5,12,9,7,13,10,12,11,12,10,12,16,19,14,1,12,6,12,12,16,14,6,6,9,15,15,20,11,6,11,10,10,10,10,10,13,11,11,11,6,15,4,D/WB R,1,1,1,1,1,1,1,1,20,1,1,1,1,1,19
19192105,Matheus Índio,1651,28/02/1996,20,0,0,0,0,179,70,3,3,2,3,2,1,3,2,2,2,2,15,15,14,11,14,15,8,10,4,5,13,8,5,16,10,11,10,13,11,14,10,13,15,8,12,6,10,11,14,14,12,8,20,13,13,10,12,10,10,3,10,5,11,12,12,12,12,11,6,12,7,AM RC,1,1,1,19,12,20,1,1,1,1,15,5,14,1,1
19192108,Danilo,1651,28/02/1996,20,0,0,0,0,182,78,2,2,3,1,3,3,2,3,2,3,3,8,10,13,8,11,11,14,14,8,13,13,12,14,14,13,11,15,10,13,13,12,12,14,12,13,14,14,14,13,13,12,13,12,14,13,20,14,13,14,13,14,6,12,12,15,8,12,12,14,10,12,DM/M C,1,1,1,10,1,1,1,1,1,20,19,1,1,1,1
19192215,Crislan,1651,13/03/1992,24,0,0,0,0,186,79,1,1,2,3,3,3,1,2,2,2,3,7,12,12,13,12,7,13,12,6,6,13,10,7,15,12,9,12,13,13,12,12,13,11,8,12,7,9,11,13,13,15,14,20,14,14,8,12,14,12,4,11,6,8,12,13,11,12,11,5,8,9,S ,1,1,20,1,1,1,1,1,1,1,1,1,1,1,1
19192261,Ebert,1651,25/05/1993,23,0,0,0,0,182,70,2,2,2,2,4,3,2,3,1,4,2,8,10,8,3,13,6,9,4,8,10,10,4,11,10,6,12,10,8,9,8,14,3,6,9,8,11,10,10,10,14,9,11,20,16,14,10,10,9,10,8,6,3,10,11,11,12,12,14,6,12,4,D/WB L,1,1,1,1,1,1,1,20,1,1,1,1,1,19,1
19192262,PV,1651,21/03/1993,23,0,0,0,0,188,82,3,2,3,3,2,1,3,2,2,3,3,6,3,2,5,9,1,10,4,4,14,7,5,14,6,8,10,10,9,9,5,14,10,2,11,8,7,8,9,12,11,9,14,5,16,13,20,6,10,10,7,10,10,10,19,9,12,11,10,10,10,8,D C,1,1,1,1,1,1,20,1,1,1,1,1,1,1,1
19192323,Kenedy,1651,08/02/1996,20,0,0,7,1,182,80,2,3,3,2,4,3,1,3,1,2,2,11,11,13,14,14,12,10,15,4,7,12,11,7,13,12,11,11,13,11,12,13,13,15,10,13,7,12,12,14,12,13,13,20,14,13,11,13,15,12,11,11,6,13,18,13,12,12,9,12,12,7,AM/S RL,1,1,17,10,17,20,1,11,12,1,1,10,12,13,14
19192325,Cyro,1651,09/09/1994,21,0,0,0,0,180,75,2,1,2,3,2,1,2,1,2,3,2,4,6,2,3,11,3,6,8,4,6,12,2,12,13,5,9,8,7,7,8,12,9,9,7,6,13,7,10,11,11,7,7,14,11,11,20,9,7,9,7,1,9,9,8,13,12,9,9,2,5,5,DM ,1,1,1,1,1,1,1,1,1,20,10,1,1,1,1
19192399,Gustavo Froner,1651,22/06/1992,24,0,0,0,0,182,73,2,2,2,3,1,1,1,3,2,1,1,5,7,3,7,9,7,7,12,4,10,14,4,14,6,5,9,8,8,9,8,14,8,7,12,6,14,8,13,14,12,8,6,1,10,13,20,9,6,9,8,8,9,9,20,13,10,10,9,8,5,1,DM ,1,1,1,1,1,1,1,1,1,20,10,1,1,1,1
19192699,Marquinhos do Sul,1651,22/02/1994,22,0,0,0,0,167,60,2,1,3,2,1,2,2,2,2,2,1,6,7,12,9,9,7,8,10,5,6,9,8,6,11,11,9,12,8,8,10,10,3,13,8,12,7,12,12,14,13,5,5,9,13,14,20,12,5,10,6,10,8,15,13,11,11,12,11,6,3,4,S RL,1,1,20,1,15,15,1,1,1,1,1,1,1,1,1
19192784,Élvis,1651,15/02/1996,20,0,0,0,0,172,65,3,3,3,3,1,2,3,3,1,1,3,11,11,12,8,12,11,4,10,7,5,11,12,5,12,9,12,9,10,10,11,10,4,15,9,10,6,8,8,9,11,5,5,20,11,10,6,6,5,11,8,10,10,9,12,9,9,12,10,6,3,3,AM C,1,1,1,20,1,1,1,1,1,1,13,1,1,1,1
19192946,Romulo,1651,24/01/1993,23,0,0,0,0,176,70,1,3,3,2,2,1,1,3,4,2,2,8,9,10,5,10,7,6,6,8,10,10,6,11,10,11,9,9,8,9,8,9,3,10,4,10,10,12,12,13,13,13,8,20,12,13,10,12,7,11,13,10,15,8,10,12,11,11,11,1,7,6,D/WB L,1,1,1,1,1,1,1,18,1,1,1,1,1,20,1
19192947,Róger Guedes,1651,02/10/1996,19,0,0,0,0,178,67,3,3,3,1,2,3,3,1,1,1,2,11,12,13,12,13,9,9,11,5,6,12,11,8,13,11,12,13,12,11,13,13,12,13,7,13,9,12,12,15,15,14,9,9,13,14,20,14,7,12,10,11,8,9,12,13,12,12,11,6,12,7,AM R,1,1,15,12,10,20,1,1,1,1,6,1,1,1,1
19193049,Léo Lisboa,1651,01/06/1994,22,0,0,0,0,175,68,3,1,4,3,2,1,3,1,2,2,1,11,11,12,9,12,12,8,10,10,6,11,10,7,13,10,12,7,11,11,12,12,12,14,11,12,7,12,11,13,13,6,4,20,11,12,12,10,6,12,10,6,9,12,9,13,12,13,9,7,10,5,AM C,1,1,1,20,13,1,1,9,1,1,15,11,1,10,1
19193050,Yago,1651,03/02/1995,21,0,0,0,0,173,69,1,3,2,3,3,1,3,1,3,1,2,9,10,11,10,11,8,8,10,6,10,12,10,9,13,12,10,11,11,11,12,11,14,12,7,12,10,11,13,14,14,15,7,9,12,14,20,12,6,11,13,11,9,16,14,10,11,10,11,7,9,1,M C,1,1,8,15,1,11,1,1,10,12,20,1,10,1,11
19193243,Diogo,1651,21/10/1993,22,0,0,0,0,184,0,3,3,2,2,3,3,3,3,3,3,2,3,1,5,4,12,2,1,3,1,5,12,1,3,9,7,8,3,4,4,12,12,3,10,11,4,5,5,8,12,8,4,9,8,9,11,20,7,7,7,7,4,6,7,11,14,9,10,9,1,8,1,M/AM C,1,1,1,18,1,1,1,1,1,10,20,1,1,1,1
19193274,Arthur,1651,12/08/1994,21,0,0,0,0,188,0,3,1,2,4,3,3,3,4,3,3,1,3,7,8,7,13,7,7,8,4,8,13,1,14,9,9,6,7,7,5,9,14,6,7,11,7,12,8,9,11,11,4,10,8,13,14,20,5,11,9,6,5,9,9,15,12,10,13,9,6,6,8,D/DM R,1,1,1,1,1,1,1,1,18,20,10,1,1,1,15
19193657,Paulo,1651,03/06/1994,22,0,0,0,0,182,0,3,8,7,1,12,8,11,12,8,8,7,3,1,1,1,1,5,1,3,2,1,1,1,3,3,8,7,10,1,9,4,12,2,2,12,3,11,5,4,11,14,5,9,5,10,10,20,1,5,8,8,8,8,8,10,11,12,13,9,8,10,2,GK ,20,1,1,1,1,1,1,1,1,1,1,1,1,1,1
19193659,Huliell,1651,21/05/1994,22,0,0,0,0,183,0,1,1,1,3,2,3,2,2,2,2,2,4,3,1,1,8,2,14,5,1,11,8,4,14,4,7,9,9,7,10,7,14,9,6,12,7,14,7,8,7,9,3,7,10,10,10,20,5,9,9,9,9,7,9,13,12,13,13,10,12,8,5,D C,1,1,1,1,1,1,20,1,1,1,1,1,1,1,1
19193668,Alex Ruan,1651,05/02/1993,23,0,0,0,0,175,68,2,3,1,4,1,1,2,1,2,1,1,9,11,8,6,13,6,11,6,7,10,10,6,15,11,8,15,11,10,9,9,9,3,3,14,10,10,11,11,13,14,9,6,20,10,14,10,8,9,10,10,10,10,10,9,13,13,11,12,7,19,1,D/WB L,1,1,1,1,1,1,1,20,1,1,1,1,1,18,1
19193785,Hugo Sanches,1651,09/07/1994,21,0,0,0,0,162,0,3,3,3,1,1,3,3,3,1,1,2,10,10,11,12,10,9,4,8,7,7,11,11,10,11,13,11,10,10,9,7,9,11,12,6,12,7,10,14,13,11,8,4,8,12,13,20,12,6,9,8,9,10,20,11,11,13,12,13,13,1,5,S R,1,1,20,1,1,15,1,1,12,1,1,1,14,1,13
19193786,Daniel,1651,22/01/1994,22,0,0,0,0,172,66,2,2,2,1,2,1,3,1,2,2,3,12,12,14,11,14,11,7,12,13,7,13,10,7,14,10,12,10,13,10,12,13,13,14,8,13,11,12,10,14,15,14,8,6,9,14,20,14,13,11,5,12,15,10,10,10,8,9,10,6,12,12,AM RLC,1,1,1,17,17,20,1,1,1,1,15,1,1,1,1
19193790,Rodrigo Dias,1651,26/01/1994,22,0,0,0,0,192,0,2,3,1,3,3,1,1,1,1,4,1,5,9,10,13,10,6,14,9,5,5,10,11,6,11,10,12,12,12,12,9,11,10,10,5,13,7,11,12,10,11,12,17,5,11,11,20,11,12,10,5,2,7,5,11,10,10,11,11,11,9,8,S ,1,1,20,1,1,1,1,1,1,1,1,1,1,1,1
19193796,Angstron,1651,16/06/1993,23,0,0,0,0,184,0,3,1,1,3,1,4,2,3,2,3,3,8,7,9,7,13,8,7,9,1,6,11,6,6,13,5,12,7,9,8,13,13,6,12,11,12,8,9,13,14,13,9,10,9,8,14,20,8,7,10,8,9,7,10,20,11,10,10,11,6,1,8,AM C,1,1,1,20,1,1,1,1,1,1,10,1,1,1,1
19193798,Igor Rabello,1651,28/04/1995,21,0,0,0,0,190,78,2,2,2,3,2,2,1,1,1,2,1,8,6,1,4,9,4,14,8,4,13,9,6,12,6,10,14,10,9,12,6,14,10,5,12,7,14,8,9,13,12,9,12,20,12,14,11,6,9,10,8,10,9,10,9,12,10,11,9,1,9,3,D C,1,1,1,1,1,1,20,1,1,1,1,1,1,1,1
19193812,Emerson Santos,1651,05/04/1995,21,0,0,0,0,184,80,1,1,4,2,1,1,3,3,3,1,3,2,10,10,10,14,13,14,13,13,15,13,10,11,14,5,14,10,14,15,14,11,12,11,13,12,16,14,13,15,14,13,13,8,14,13,20,11,13,12,5,11,5,12,7,11,11,12,12,1,8,6,D RC,1,1,1,1,1,1,20,1,17,12,1,1,1,1,1
19193813,Jeferson,1651,23/04/1995,21,0,0,0,0,177,0,1,3,3,1,1,1,1,2,3,1,3,4,7,13,13,13,6,11,7,1,5,10,6,1,13,3,9,8,10,6,7,13,3,13,8,10,7,6,7,13,12,7,5,10,9,13,20,8,6,9,9,9,9,9,11,10,9,13,9,5,15,4,S ,1,1,20,1,1,1,1,1,1,1,1,1,1,1,1
19193819,Fernandes,1651,21/02/1995,21,0,0,0,0,170,63,3,3,3,2,1,3,1,2,2,1,1,10,14,13,13,14,5,13,14,14,13,14,10,13,14,11,13,14,13,13,14,13,9,12,13,12,13,14,13,14,14,14,12,1,15,14,20,14,12,12,10,13,5,14,18,14,11,11,11,7,2,2,DM/M C,1,1,1,15,1,1,1,1,1,17,20,1,1,1,1
19193913,Gabriel Moraes,1651,22/04/1995,21,0,0,0,0,173,72,1,1,1,3,1,1,1,2,1,3,3,6,11,13,8,13,5,4,8,4,6,8,3,1,12,5,7,7,7,5,6,11,9,12,12,8,6,7,8,13,13,15,5,10,9,13,20,7,3,9,9,5,9,9,12,13,9,10,12,7,14,8,M/AM RC,1,1,13,15,1,20,1,1,1,1,7,1,16,1,1
19193920,Matheus Pato,1651,12/04/1996,20,0,0,0,0,183,0,8,10,9,1,13,13,9,13,9,9,8,2,3,2,1,3,3,1,2,2,1,1,2,3,5,7,9,14,4,9,6,13,6,2,1,2,9,7,6,8,9,7,5,8,15,11,20,5,8,9,9,9,9,9,20,14,14,10,9,6,8,5,GK ,20,1,1,1,1,1,1,1,1,1,1,1,1,1,1
19193957,Júlio César,1651,12/08/1994,21,0,0,0,0,172,69,3,2,3,1,3,3,1,1,1,2,2,9,12,12,12,13,7,1,7,6,6,6,7,7,12,6,9,6,7,6,7,9,2,15,11,8,6,7,4,14,10,14,5,10,15,12,20,8,4,9,8,9,9,9,19,12,11,12,12,6,5,8,AM RC,1,1,12,15,1,20,1,1,1,1,7,1,1,1,1
19194030,Ítalo Pica-Pau,1651,03/01/1995,21,0,0,0,0,173,72,3,3,2,1,2,2,1,2,1,1,1,7,5,12,10,13,7,13,8,2,6,9,2,5,12,10,10,6,8,8,9,8,3,15,7,10,8,7,9,13,12,11,5,15,13,12,20,10,12,10,10,6,9,10,11,10,10,11,12,6,15,8,S ,1,1,20,12,1,1,1,1,1,1,1,1,1,1,1
19194048,Douglas Xinxa,1651,11/04/1996,20,0,0,0,0,182,0,3,1,1,3,3,2,1,2,1,1,3,7,5,13,14,12,7,14,3,1,7,8,3,4,10,9,8,8,7,8,9,14,5,9,3,10,5,7,9,14,11,8,10,9,13,14,20,7,7,9,7,8,8,8,19,12,8,10,12,8,5,4,S ,1,1,20,1,13,13,1,1,1,1,1,1,1,1,1
19194050,Ewerton Ageu,1651,15/06/1993,23,0,0,0,0,173,67,2,1,4,1,1,1,1,2,3,3,1,8,6,8,7,7,8,1,7,2,9,13,2,10,12,5,10,3,10,10,13,14,3,11,12,10,10,9,11,14,12,9,6,10,10,13,20,8,6,10,10,10,10,10,12,9,10,13,10,1,10,5,M/AM C,1,1,1,20,1,1,1,1,1,12,19,1,1,1,1
19194051,Yuri,1651,17/11/1996,19,0,0,0,0,180,73,2,2,1,3,3,2,1,3,3,1,1,6,4,2,1,8,2,10,2,6,11,7,1,14,7,8,9,9,7,8,5,12,8,1,1,3,7,7,8,14,9,8,10,20,12,12,8,6,7,8,8,8,3,8,18,12,11,11,13,5,12,6,D LC,1,1,1,1,1,1,19,20,1,1,1,1,1,1,1
19194171,Patrick,1651,29/07/1992,23,0,0,0,0,176,77,2,2,3,1,2,1,1,2,2,3,1,8,7,10,14,11,6,11,13,7,14,13,3,14,11,12,13,13,13,13,12,11,13,6,11,11,12,14,14,14,13,14,8,12,15,13,20,13,12,10,12,12,10,12,16,13,12,12,11,10,10,12,DM/M C,1,1,1,1,1,1,1,1,1,17,20,1,1,1,1
19194175,Maykon,1651,10/03/1992,24,0,0,0,0,182,68,1,1,3,1,1,1,1,2,3,1,2,6,8,12,13,7,6,10,7,6,6,7,8,1,10,9,10,1,9,7,5,12,9,14,7,12,6,6,8,13,12,9,10,20,10,12,9,10,3,9,9,9,9,9,19,13,11,14,10,5,15,5,AM/S L,1,1,20,1,18,1,1,1,1,1,1,1,1,1,1
19194209,Flávio Kaká,1651,20/04/1988,28,0,0,0,0,174,72,2,2,2,3,3,2,3,3,3,3,1,4,5,7,3,13,1,9,4,8,9,10,4,15,9,9,9,9,6,11,5,11,5,8,7,7,9,9,10,14,13,9,6,10,6,12,20,14,14,9,9,9,7,9,15,8,12,9,14,8,10,4,D R,1,1,1,1,1,1,1,1,20,1,1,1,1,1,15
19194211,Rafinha,1651,23/07/1995,20,0,0,0,0,175,66,2,3,2,3,2,3,1,2,2,1,2,7,9,10,4,15,9,9,10,8,11,15,1,15,11,10,7,9,11,7,9,14,6,1,9,9,12,10,11,12,14,10,10,10,10,14,20,9,7,9,10,10,5,10,15,11,9,10,11,2,10,5,D/DM RC,1,1,1,1,1,1,1,1,20,20,15,1,1,1,15
19194361,Pablo Dyego,1651,08/03/1994,22,0,0,0,0,174,66,3,2,2,1,2,4,3,4,3,1,1,13,11,12,9,11,7,9,8,2,12,11,10,11,12,10,9,10,7,10,10,9,17,13,3,12,10,8,12,15,13,9,8,5,10,14,20,11,8,10,6,10,10,10,20,11,12,11,10,8,14,3,M/AM RL,1,1,12,1,15,20,1,1,15,1,1,10,19,1,10
19194365,João Paulo,1651,06/06/1993,23,0,0,0,0,197,0,13,12,9,1,8,13,11,13,8,8,9,1,2,3,1,2,5,1,3,3,2,2,2,2,3,9,9,14,7,13,6,13,5,2,13,3,9,7,6,6,15,6,13,9,11,5,20,2,10,9,9,9,7,9,19,10,11,10,12,4,9,8,GK ,20,1,1,1,1,1,1,1,1,1,1,1,1,1,1
19194724,Jean Theodoro,1651,25/02/1993,23,0,0,0,0,176,0,3,3,3,3,3,3,3,1,1,1,1,7,7,11,10,14,7,7,7,3,7,14,4,8,11,9,8,8,9,6,10,11,2,10,8,12,8,8,7,14,14,6,8,9,3,14,20,5,5,8,8,9,7,9,10,9,9,11,11,5,13,1,AM C,1,1,1,20,1,1,1,1,1,1,10,1,1,1,1
19194732,Leandro Augusto,1651,14/02/1994,22,0,0,0,0,184,73,1,1,3,1,1,2,3,1,2,4,1,7,10,8,13,11,9,12,9,6,9,10,10,8,10,8,10,4,12,10,9,10,9,7,3,12,8,9,10,11,11,10,8,9,12,9,20,8,11,9,6,9,5,9,20,11,11,11,11,7,8,6,S ,1,1,20,1,1,1,1,1,1,1,1,1,1,1,1
19194971,Brenner,1651,01/03/1994,22,0,0,0,0,182,82,1,2,3,1,3,3,3,2,3,2,3,9,6,12,13,14,8,14,10,7,9,10,9,4,12,11,12,4,13,12,8,11,11,13,6,13,6,9,12,13,11,9,11,11,11,13,20,12,13,14,6,11,6,11,8,12,10,12,9,6,7,4,S ,1,1,20,1,1,1,1,1,1,1,1,1,1,1,1
19195509,Felipe Correia,1651,23/05/1992,24,0,0,0,0,172,0,2,4,1,2,2,3,3,3,1,2,3,6,9,6,2,14,2,7,8,7,10,6,2,15,10,9,11,9,9,9,8,13,4,9,11,8,9,10,10,13,15,10,3,10,5,15,20,10,8,9,5,9,7,9,7,11,10,9,13,6,6,5,D/WB R,1,1,1,1,1,1,1,1,20,1,1,1,1,1,19
19196068,Parrudo,1651,18/06/1994,22,0,0,0,0,178,78,3,2,1,2,2,1,3,3,1,2,3,6,2,7,5,11,7,7,9,7,9,7,4,14,9,9,12,8,9,10,9,8,9,9,10,7,12,8,13,9,14,6,8,10,7,14,20,11,11,9,14,7,7,9,12,11,10,12,13,11,10,8,DM R,1,1,1,1,1,1,1,1,15,20,13,1,1,1,12
19196072,Robério,1651,16/09/1994,21,0,0,0,0,176,0,4,2,3,1,1,1,3,1,2,1,2,8,7,14,11,14,8,14,9,3,7,7,3,4,14,9,13,7,10,9,9,13,1,13,13,14,9,8,9,13,13,9,7,10,11,14,20,8,8,10,5,8,10,10,20,12,11,10,10,9,6,3,S ,1,1,20,1,1,1,1,1,1,1,1,1,1,1,1
19196572,André,1651,23/05/1994,22,0,0,0,0,194,83,11,7,8,1,11,13,8,13,5,8,8,2,2,3,1,3,7,1,3,2,3,2,1,3,1,9,4,9,5,12,5,11,9,1,14,3,6,7,6,10,8,7,11,8,12,12,20,5,10,9,4,9,9,9,14,10,11,12,12,3,1,2,GK ,20,1,1,1,1,1,1,1,1,1,1,1,1,1,1
19196577,Wanderson,1651,24/10/1994,21,0,0,0,0,187,85,1,3,1,2,2,2,2,3,2,3,3,4,4,1,6,8,2,13,2,1,14,8,5,14,6,9,12,9,8,6,1,13,8,1,12,7,14,7,8,9,10,8,9,8,12,14,20,6,8,9,9,9,9,9,20,9,12,10,10,1,1,6,D C,1,1,1,1,1,1,20,1,1,1,1,1,1,1,1
19196604,Patrick Príncipe,1651,14/01/1995,21,0,0,0,0,181,0,2,3,3,1,3,2,2,1,2,2,3,2,4,4,1,11,2,7,3,6,9,9,3,14,9,9,8,9,7,11,7,11,2,6,11,6,9,9,9,13,10,9,11,20,11,14,9,14,7,9,9,3,7,9,14,12,10,12,12,4,8,5,D/WB L,1,1,1,1,1,1,1,20,1,1,1,1,1,17,1
19196608,Carlinhos,1651,18/06/1995,21,0,0,0,0,168,60,3,3,1,1,2,3,3,3,3,2,3,9,9,11,8,11,8,7,7,5,6,10,9,6,11,8,8,8,10,10,10,11,12,11,7,13,7,7,7,12,12,8,7,9,10,12,20,9,9,12,5,9,6,6,14,10,12,11,11,1,18,5,M/AM C,1,1,1,17,1,1,1,1,1,1,20,1,1,1,1
19196609,Vinícius Tanque,1651,16/02/1995,21,0,0,0,0,180,0,2,2,2,2,2,3,3,3,2,1,1,4,4,10,12,12,4,12,10,2,3,8,12,6,10,7,12,12,12,13,10,13,9,10,10,12,12,11,12,12,12,12,12,20,12,12,7,12,14,12,5,11,5,10,11,10,12,10,12,2,9,5,S ,1,1,20,1,1,1,1,1,1,1,1,1,1,1,1
19196644,André Penalva,1651,01/12/1994,21,0,0,0,0,180,89,3,2,2,3,3,1,3,1,4,4,2,7,3,2,7,7,5,12,1,1,13,5,5,14,2,9,11,9,8,11,7,14,9,4,13,7,13,3,8,9,12,8,6,8,11,14,20,6,7,9,8,9,9,9,14,10,9,9,9,5,10,6,D C,1,1,1,1,1,1,20,1,1,1,1,1,1,1,1
19196646,Bruno,1651,24/12/1995,20,0,0,0,0,180,80,3,1,2,4,1,1,1,2,1,1,2,1,1,2,4,8,1,14,1,4,8,7,5,13,7,9,9,7,8,7,5,14,1,6,1,7,14,7,8,10,11,8,10,8,11,8,20,12,9,9,9,9,9,9,13,12,11,12,8,1,14,3,D C,1,1,1,1,1,1,20,1,1,1,1,1,1,1,1
19196648,Artur,1651,05/08/1994,21,0,0,0,0,178,75,3,1,3,1,1,2,2,4,1,1,2,11,12,13,12,13,11,10,12,11,11,12,10,11,13,10,13,9,12,12,13,12,14,13,10,13,13,13,13,14,14,13,8,20,13,14,8,13,12,12,10,11,8,13,9,13,12,12,10,9,13,6,D L,1,1,1,1,1,1,1,20,1,1,1,1,1,15,1
19196649,Jhonatas,1651,22/04/1994,22,0,0,0,0,174,0,1,3,3,1,3,3,1,1,2,4,2,4,3,2,1,10,1,7,4,6,9,6,1,11,7,8,5,8,7,9,4,14,8,4,13,6,6,7,7,13,11,7,6,20,13,9,8,9,5,7,3,8,8,8,7,9,11,12,10,4,17,3,D L,1,1,1,1,1,1,1,20,1,1,1,1,1,1,1
19196659,Lourency,1651,02/10/1996,19,0,0,0,0,178,74,3,4,1,1,1,2,3,3,1,1,3,9,10,9,10,11,7,9,9,5,6,10,9,4,11,9,10,9,10,10,10,10,10,12,5,10,7,9,10,14,13,12,9,8,12,13,20,12,10,10,8,10,5,10,11,12,9,11,8,6,13,5,AM R,1,1,12,12,1,20,1,1,1,1,8,1,15,1,1
19196724,Jonas,1651,08/10/1991,24,0,0,0,0,180,79,4,3,1,3,2,3,2,3,3,3,2,7,8,10,9,12,7,11,13,10,15,11,10,15,8,17,13,16,10,13,11,11,12,9,11,9,13,14,15,14,13,14,12,9,14,13,20,15,13,14,14,12,3,12,18,13,12,11,10,9,7,7,DM/M C,1,1,1,1,1,1,1,1,1,20,17,1,1,1,1
19196738,Souza,1651,30/08/1983,32,0,0,0,0,170,68,2,4,3,1,3,2,3,2,2,1,1,6,7,5,4,5,1,5,6,7,9,9,7,14,9,5,11,9,8,11,5,12,1,1,10,6,11,8,8,9,10,5,5,20,8,9,9,12,7,8,5,6,8,8,15,12,14,10,10,9,12,1,D/WB L,1,1,1,1,1,1,1,20,1,1,1,1,1,18,1
19196788,Ramiro,1651,22/05/1993,23,0,0,0,0,168,67,4,3,2,3,3,2,1,2,2,3,2,10,12,12,12,14,8,7,13,6,14,14,8,13,12,15,14,16,12,14,12,13,14,10,10,15,13,13,13,14,13,11,6,12,10,14,20,14,10,14,11,12,15,15,10,13,12,13,12,8,12,6,M RC,1,1,1,1,1,15,1,1,12,15,15,1,20,1,14
19196792,Lucas Coelho,1651,20/07/1994,21,0,0,0,0,183,80,1,1,4,3,2,3,1,1,1,2,2,8,9,10,12,11,11,12,12,7,8,12,8,7,11,5,12,7,10,12,9,12,14,8,9,11,5,6,10,14,13,9,12,10,13,13,20,12,14,11,10,12,11,11,15,13,13,12,12,6,10,8,S ,1,1,20,1,1,1,1,1,1,1,1,1,1,1,1
19197054,Marcelo,1651,29/04/1994,22,0,0,0,0,184,0,2,3,2,2,3,1,1,2,1,2,3,4,7,9,8,9,7,7,12,6,12,11,5,11,13,7,8,9,8,9,10,13,5,10,6,8,12,8,12,13,13,7,8,9,15,13,20,7,9,10,8,6,5,10,9,9,11,10,10,11,4,7,DM/M C,1,1,1,1,1,1,1,1,1,20,16,1,1,1,1
19197056,Zé Roberto,1651,14/09/1993,22,0,0,0,0,180,71,2,1,1,2,3,3,4,1,2,2,3,6,9,13,10,13,8,9,12,5,7,11,12,7,13,12,13,13,7,8,11,9,14,14,5,13,7,8,13,15,13,10,9,11,12,14,20,13,9,12,9,12,4,11,13,10,12,11,12,8,10,5,AM/S RL,1,1,20,1,18,15,1,1,1,1,1,1,1,1,1
19197057,Raí Ramos,1651,06/05/1994,22,0,0,0,0,179,78,1,1,1,1,3,2,3,3,3,2,1,3,11,12,6,10,11,7,8,13,10,11,6,11,12,11,13,9,10,13,7,11,12,9,11,11,10,12,12,13,14,11,7,10,11,13,20,12,6,13,4,8,4,8,11,13,10,11,11,12,12,5,D/WB R,1,1,1,1,1,1,1,1,20,1,1,1,1,1,18
19197120,José Welison,1651,11/03/1995,21,0,0,0,0,177,74,2,2,3,3,1,2,2,4,1,3,1,12,12,12,11,13,11,5,13,4,12,12,12,12,14,13,13,13,12,8,12,11,14,14,6,12,12,13,13,13,14,10,7,5,13,13,20,14,10,12,7,13,10,14,13,10,12,14,15,13,14,5,WB/DM/M RC,1,1,1,15,1,13,1,1,15,18,20,1,14,1,16
19197121,Alex Cruz,1651,13/05/1995,21,0,0,0,0,176,0,3,1,1,1,2,3,1,1,4,3,1,10,11,12,10,13,6,8,8,5,12,12,8,12,12,11,11,12,11,10,12,11,16,14,8,12,13,12,12,13,14,9,7,5,13,13,20,12,9,12,10,4,4,12,18,13,11,9,9,6,9,7,DM/M C,1,1,1,13,1,11,1,1,1,18,20,1,12,1,1
19197122,Eudair,1651,20/06/1995,21,0,0,0,0,182,0,2,1,4,1,2,3,1,4,2,2,3,11,11,13,11,13,10,9,11,5,5,12,12,4,13,10,12,9,10,8,12,9,14,14,3,13,9,10,12,14,14,6,13,7,11,14,20,12,6,13,10,5,5,12,16,9,11,12,11,1,9,4,M/AM RC,1,1,14,20,1,16,1,1,1,1,17,1,13,1,1
19197123,Venâncio,1651,12/05/1993,23,0,0,0,0,165,0,3,2,3,3,2,1,1,3,1,3,1,4,6,7,8,10,6,5,10,1,5,13,4,7,13,7,9,8,9,7,9,13,9,13,6,13,8,7,12,13,13,7,1,10,12,13,20,12,6,9,9,9,9,9,7,10,12,8,12,2,2,5,M/AM C,1,1,1,20,1,1,1,1,1,1,18,1,1,1,1
19197125,Darlan,1651,21/07/1994,21,0,0,0,0,172,72,3,1,3,3,3,1,3,1,1,3,3,10,10,10,10,12,11,8,12,9,13,12,11,12,12,12,12,13,11,9,10,11,19,13,8,10,13,13,13,12,12,7,5,7,13,12,20,13,14,12,11,1,5,12,18,13,14,9,10,11,4,1,DM/M C,1,1,1,12,1,1,1,1,1,18,20,1,1,1,1
19197126,Dênis,1651,03/03/1994,22,0,0,0,0,186,0,3,4,3,1,1,3,3,3,3,2,3,8,8,11,13,14,8,7,10,4,9,13,6,8,14,5,9,8,6,8,10,14,5,13,11,9,10,9,10,13,14,7,11,9,10,13,20,7,9,10,7,10,7,10,14,9,10,9,10,5,8,3,M/AM C,1,1,15,20,1,1,1,1,1,1,17,1,1,1,1
19197239,Bruno Viana,1651,05/02/1995,21,0,0,0,0,187,77,2,2,3,1,1,3,3,2,1,2,3,4,8,8,7,10,5,13,6,6,13,10,8,13,10,13,11,14,10,10,6,11,12,5,11,6,12,14,13,12,13,13,14,7,13,13,20,14,14,9,10,9,4,5,9,12,13,9,10,12,8,8,D C,1,1,1,1,1,1,20,1,1,1,1,1,1,1,1
19197565,Paulinho Moccelin,1651,16/03/1994,22,0,0,0,0,168,62,1,2,1,3,1,2,1,1,3,3,1,7,11,13,9,9,8,6,8,3,5,11,8,5,10,15,8,12,10,9,10,9,12,13,4,11,9,14,14,15,13,10,7,8,12,15,20,13,8,10,11,11,5,11,16,11,10,13,12,6,9,4,AM RL,1,1,14,1,20,17,1,1,1,1,1,12,8,1,1
19197567,Paulinho,1651,12/05/1994,22,0,0,0,0,184,76,13,13,13,11,13,13,12,13,5,5,13,8,2,2,3,5,11,2,2,2,1,1,3,2,9,11,11,16,11,11,10,15,11,1,12,1,8,11,10,11,12,12,11,11,12,8,20,7,10,11,10,11,5,11,18,9,10,11,9,2,7,6,GK ,20,1,1,1,1,1,1,1,1,1,1,1,1,1,1
19197569,Liniker,1651,08/03/1993,23,0,0,0,0,173,66,1,2,2,1,3,3,1,3,3,2,1,9,9,8,8,12,10,5,12,4,11,13,10,12,13,10,7,5,10,10,12,11,10,6,11,10,10,14,13,12,12,13,5,11,14,12,20,12,6,10,10,10,3,13,17,8,10,9,13,1,13,6,M/AM C,1,1,1,20,1,1,1,1,1,13,18,1,1,1,1
19198623,Djavan,1651,31/12/1987,28,0,0,0,0,184,78,1,3,1,3,1,1,3,3,2,2,2,12,13,13,9,13,10,9,10,12,9,12,10,12,13,11,13,12,11,11,9,10,13,14,9,14,10,14,15,14,14,14,13,20,15,15,6,14,13,13,7,10,5,11,11,13,13,13,15,12,12,5,D/WB L,1,1,1,1,1,1,1,20,1,1,1,10,1,19,1
19199126,Jarlan,1651,17/05/1994,22,0,0,0,0,170,67,2,1,2,1,3,3,3,1,2,3,2,13,12,12,9,12,8,6,7,4,6,12,8,8,12,11,8,9,10,9,12,12,4,13,6,10,5,10,14,12,11,9,6,11,12,13,20,12,7,10,8,12,5,12,13,12,12,7,11,7,8,1,AM LC,1,1,1,16,20,14,1,1,1,1,1,1,1,1,1
19199132,Igor Leandro,1651,07/01/1993,23,0,0,0,0,184,75,1,3,1,3,2,3,2,2,1,2,3,8,5,1,5,9,6,14,6,4,12,9,2,14,8,10,13,10,4,9,5,14,10,1,14,7,11,8,9,14,14,9,7,16,13,14,20,11,7,10,8,10,8,10,12,10,10,12,12,10,19,7,D C,1,1,1,1,1,1,20,1,1,1,1,1,1,1,1
19199151,Joãozinho,1651,08/05/1993,23,0,0,0,0,161,60,3,1,1,3,3,3,1,1,3,2,2,7,8,11,9,13,7,2,8,1,7,9,5,8,13,9,10,7,9,6,9,13,3,14,12,9,7,8,10,14,14,3,1,10,11,13,20,7,3,10,6,6,10,10,13,13,11,8,12,3,7,3,AM RLC,1,1,1,20,17,17,1,1,1,1,10,1,1,1,1
19199896,Denner,1651,06/05/1994,22,0,0,0,0,180,69,4,1,2,1,1,2,1,3,2,2,1,10,10,12,15,12,9,11,12,3,6,13,7,6,12,9,11,9,12,11,15,13,11,13,2,12,5,11,12,13,13,8,10,11,18,12,20,15,8,12,5,8,5,11,15,11,14,8,10,6,7,7,AM C,1,1,12,20,1,1,1,1,1,1,12,1,1,1,1
19200331,Igor,1651,06/06/1992,24,0,0,0,0,183,78,2,3,2,1,3,3,2,3,1,2,1,8,11,11,11,11,5,11,10,10,9,12,9,9,12,10,12,11,11,12,12,12,4,12,15,11,10,12,12,13,12,12,11,20,8,13,11,11,12,10,10,10,7,10,16,10,10,10,12,7,11,5,D/WB L,1,1,1,1,1,1,1,20,1,1,1,1,1,19,1
19200861,Douglas Coutinho,1651,08/02/1994,22,0,0,0,0,183,71,3,2,2,3,1,2,2,1,3,3,2,10,11,13,11,10,9,12,9,6,5,10,12,6,12,11,12,11,10,11,10,10,8,12,10,11,8,10,11,14,13,12,12,12,12,15,20,13,11,10,13,12,10,10,14,13,12,9,11,6,12,7,AM/S R,1,1,19,1,13,20,1,1,1,1,1,1,11,1,1
19200869,Marcão,1651,17/06/1994,22,0,0,0,0,186,78,3,4,1,1,3,3,2,2,3,2,2,1,8,12,12,12,3,12,11,4,7,10,10,5,12,10,9,10,10,11,9,10,3,13,3,14,10,12,11,12,12,13,12,11,14,12,20,11,14,10,8,7,10,10,11,11,12,11,11,7,3,1,S ,1,1,20,1,1,1,1,1,1,1,1,1,1,1,1
19201271,Diogo,1651,27/10/1981,34,0,0,0,0,175,78,3,3,1,1,4,2,3,2,1,1,1,7,3,7,8,14,7,7,12,1,8,13,5,13,13,9,11,8,7,6,12,14,9,9,5,7,9,8,6,13,7,8,8,9,14,8,20,7,8,8,9,9,9,9,13,11,11,13,14,9,10,2,DM ,1,1,1,1,1,1,1,1,1,20,1,1,1,1,1
19201274,Roberth,1651,19/02/1993,23,0,0,0,0,180,75,1,1,2,3,3,3,4,1,1,2,1,7,7,8,13,12,7,14,7,4,7,8,7,5,11,8,14,8,11,8,6,13,9,10,1,14,6,7,8,8,12,8,10,9,11,12,20,9,10,9,4,8,6,9,19,10,11,13,13,8,4,6,S ,1,1,20,1,1,1,1,1,1,1,1,1,1,1,1
19201294,Eduardo,1651,02/04/1989,27,0,0,0,0,177,0,1,3,1,3,1,1,3,1,2,3,3,6,7,12,13,11,5,11,7,1,6,8,9,5,11,7,7,4,10,8,6,13,4,11,6,10,8,6,8,13,13,8,7,20,12,13,10,12,6,9,9,9,6,9,14,13,11,8,12,7,15,2,AM/S C,1,1,20,17,1,1,1,1,1,1,1,1,1,1,1
19201658,Márcio Jonatan,1651,02/01/1992,24,0,0,0,0,180,0,2,4,4,1,1,4,3,3,3,1,4,5,5,13,13,13,6,13,2,3,5,6,9,3,12,5,11,8,10,7,7,9,9,12,4,13,5,6,7,13,13,10,9,10,16,13,20,6,11,9,5,9,9,9,14,13,11,10,11,11,7,6,S ,1,1,20,1,1,1,1,1,1,1,1,1,1,1,1
19201678,João Pedro,1651,22/04/1993,23,0,0,0,0,182,81,4,1,3,2,1,3,1,2,1,2,1,5,7,11,12,10,5,12,8,8,8,11,12,7,11,11,8,10,11,11,10,7,9,10,9,11,2,11,11,12,11,12,10,10,13,12,20,11,12,9,12,10,9,10,7,11,12,8,13,4,7,2,S ,1,1,20,1,1,1,1,1,1,1,1,1,1,1,1
19201680,Léo Cunha,1651,22/08/1995,20,0,0,0,0,173,67,2,2,1,2,1,1,2,3,3,3,2,12,11,6,5,10,8,9,6,8,9,10,1,11,7,9,9,10,9,9,9,11,6,9,12,8,8,9,9,15,11,9,7,10,9,12,20,8,6,9,6,6,9,9,18,11,11,12,10,5,14,4,D R,1,1,1,1,1,1,1,1,20,1,1,1,1,1,15
19201785,Danilo,1651,11/04/1991,25,0,0,0,0,186,75,1,2,3,2,3,1,1,3,3,1,3,10,12,12,13,12,12,12,11,5,11,11,10,7,11,3,12,8,12,11,12,11,8,10,8,12,12,11,12,13,12,12,14,9,17,12,20,11,12,10,10,10,9,10,20,11,10,10,10,12,17,7,S ,1,1,20,1,1,1,1,1,1,1,1,1,1,1,1
19201787,Gustavo Buso,1651,13/02/1991,25,0,0,0,0,174,0,2,1,1,2,1,3,2,3,1,3,1,8,7,3,8,11,6,9,8,5,8,7,4,13,10,10,10,10,6,10,6,12,7,10,4,6,11,9,9,14,14,9,7,8,16,14,20,14,8,10,13,10,10,10,17,11,12,10,12,1,4,7,D/WB R,1,1,1,1,1,1,1,1,20,1,1,1,1,1,18
19201788,Duda,1651,15/03/1995,21,0,0,0,0,191,0,12,9,7,1,12,7,9,13,7,8,10,1,3,3,2,1,3,1,1,1,2,1,3,3,2,7,7,11,5,6,5,13,6,2,9,2,7,6,5,12,9,2,11,20,10,12,2,1,9,8,8,8,8,8,9,13,11,10,9,1,9,2,GK ,20,1,1,1,1,1,1,1,1,1,1,1,1,1,1
19201832,Wanderley,1651,10/05/1990,26,0,0,0,0,181,79,1,2,1,1,3,2,3,2,3,1,3,9,12,7,6,6,7,4,6,3,6,7,1,7,8,9,7,5,5,7,5,10,5,9,14,6,7,6,7,12,12,7,9,20,13,12,9,12,10,9,9,9,9,14,15,10,11,9,10,4,3,3,D/WB/M L,1,1,1,7,15,1,1,16,1,1,5,20,1,18,1
19202241,Mazinho,1651,25/11/1988,27,0,0,0,0,175,66,1,3,2,1,3,3,1,3,1,1,1,4,8,7,11,14,7,7,6,2,9,8,3,9,14,9,8,8,8,8,10,9,2,13,2,9,9,8,9,14,14,8,7,20,11,14,10,10,6,9,8,9,9,9,19,13,12,9,10,3,14,2,D/WB/AM LC,1,1,1,20,1,1,1,18,1,1,15,1,1,18,1
19202410,Caio,1651,19/11/1992,23,0,0,0,0,174,65,2,1,3,2,3,2,1,3,2,3,4,6,5,13,11,13,6,6,10,2,5,12,2,5,13,9,12,7,5,7,12,12,9,13,6,12,7,7,12,13,10,5,3,8,11,10,20,9,5,9,9,9,9,9,10,10,9,10,10,2,9,6,AM C,1,1,1,20,1,1,1,1,1,1,10,1,1,1,1
19202414,Fernando Neto,1651,27/01/1993,23,0,0,0,0,178,68,4,3,2,3,3,4,1,1,3,1,3,11,13,13,11,11,11,8,13,11,10,12,6,12,12,9,13,11,13,10,10,10,2,9,1,13,9,11,12,13,14,10,10,20,16,12,11,12,9,11,7,8,11,14,16,11,8,13,11,7,9,3,D/WB/M/AM LC,1,1,1,20,1,1,1,19,1,12,16,13,1,19,1
19202416,Rafael Carioca,1651,18/07/1992,23,0,0,0,0,175,72,2,3,1,1,2,2,3,4,4,1,2,7,10,10,6,13,9,9,10,6,11,11,4,14,13,11,13,10,11,11,12,14,8,12,13,10,10,10,11,14,14,10,8,20,12,14,11,14,7,11,6,9,6,11,16,10,12,11,12,7,4,2,D/WB/AM LC,1,1,1,18,1,1,1,20,1,1,10,1,1,19,1
19202419,Thales,1651,06/04/1993,23,0,0,0,0,186,80,3,1,2,1,1,2,4,1,1,2,2,5,7,7,8,8,6,12,7,7,13,8,9,12,8,13,10,12,8,8,8,10,12,12,6,11,13,15,14,13,12,14,12,15,13,12,20,14,14,11,12,9,5,5,14,11,12,11,10,5,4,5,D C,1,1,1,1,1,1,20,1,1,1,1,1,1,1,1
19202421,Gustavo Xuxa,1651,22/02/1993,23,0,0,0,0,173,79,2,2,3,1,2,1,1,2,1,4,1,5,8,12,13,13,7,13,8,7,6,8,5,4,12,10,11,8,8,6,3,13,4,12,1,13,8,7,8,13,12,8,2,10,12,13,20,6,11,10,10,4,9,10,8,12,8,12,12,3,12,1,S ,1,1,20,1,1,1,1,1,1,1,1,1,1,1,1
19202437,Eberson,1651,06/07/1993,22,0,0,0,0,180,82,2,2,3,4,2,3,1,1,3,3,2,7,6,3,3,13,7,14,8,2,9,12,3,11,9,9,9,9,9,9,7,14,9,3,9,8,11,7,9,9,12,8,11,16,15,13,20,7,6,8,7,3,9,9,8,11,9,9,11,2,18,8,D/M C,1,1,1,1,1,1,20,1,1,1,18,1,1,1,1
19202439,Willian Rodrigues,1651,09/09/1993,22,0,0,0,0,181,71,1,1,1,1,1,1,4,1,1,1,3,2,5,4,3,7,3,13,2,2,11,7,1,13,2,9,8,9,7,9,6,12,1,4,11,3,10,6,7,10,11,7,10,8,14,13,20,7,7,8,9,7,9,9,9,9,11,8,8,2,16,8,D C,1,1,1,1,1,1,20,1,1,1,1,1,1,1,1
19202441,Bruno Pelissari,1651,03/01/1993,23,0,0,0,0,183,75,2,1,2,3,2,3,4,2,2,2,3,12,10,13,12,11,10,12,12,12,11,13,13,12,11,10,13,11,11,12,12,11,7,11,10,13,12,10,11,11,13,11,11,11,12,12,20,12,10,10,11,10,12,12,8,11,14,10,12,6,1,8,M/AM C,1,1,1,20,1,1,1,1,1,1,17,1,1,1,1
19202443,Júnior Barros,1651,19/04/1993,23,0,0,0,0,181,71,1,2,1,3,2,1,3,2,2,2,1,6,7,10,10,13,6,13,7,1,3,7,1,4,10,9,7,7,10,5,5,13,2,15,13,9,4,6,7,14,14,8,10,10,15,12,20,9,9,9,5,5,6,9,7,11,11,11,10,6,2,3,S ,1,1,20,1,1,1,1,1,1,1,1,1,1,1,1
19202445,Borges,1651,22/02/1992,24,0,0,0,0,178,81,2,3,2,1,1,3,3,3,3,1,1,5,5,2,6,11,6,4,10,2,9,11,4,13,13,4,9,8,6,8,4,13,5,5,11,4,9,7,11,13,11,9,8,10,12,12,20,11,7,9,2,4,9,9,7,11,11,11,13,9,7,1,DM ,1,1,1,1,1,1,1,1,1,20,10,1,1,1,1
19202448,Dudu,1651,05/11/1992,23,0,0,0,0,182,71,3,1,1,3,2,1,3,3,1,3,3,5,5,8,4,13,6,5,6,1,6,12,4,8,13,5,10,8,9,5,13,12,10,13,8,7,8,7,6,13,13,7,10,20,10,13,10,4,7,9,9,5,5,9,11,11,9,8,10,10,10,6,AM C,1,1,1,20,1,1,1,1,1,1,14,1,1,1,1
19202452,David,1651,17/01/1994,22,0,0,0,0,175,68,1,2,3,2,3,1,1,1,3,2,2,8,12,9,3,11,6,10,7,9,11,11,4,13,11,4,11,11,10,8,10,15,10,7,12,9,11,6,11,12,10,11,8,10,17,12,20,12,7,10,10,10,6,10,15,14,13,11,9,11,11,6,D/WB R,1,1,1,1,1,1,1,1,20,1,1,1,1,1,19
19202455,Diego Claudino,1651,26/03/1993,23,0,0,0,0,187,85,2,3,2,2,1,1,3,3,2,3,1,9,5,4,6,10,4,15,8,3,14,10,5,15,9,9,15,10,8,11,8,8,8,7,6,9,15,9,10,15,15,10,9,10,14,15,20,10,9,10,10,9,10,10,13,11,12,11,11,10,8,3,D C,1,1,1,1,1,1,20,1,1,1,1,1,1,1,1
19202456,Flávio Ramos,1651,12/05/1994,22,0,0,0,0,187,78,2,2,2,4,2,2,2,2,3,3,2,6,7,7,5,7,5,14,6,11,13,8,6,13,8,12,10,12,10,11,8,11,10,5,5,9,12,12,12,12,12,12,13,7,14,12,20,12,12,10,8,10,7,10,7,10,8,9,12,6,7,7,D C,1,1,1,1,1,1,20,1,1,1,1,1,1,1,1
19202458,Geraldo,1651,16/03/1994,22,0,0,0,0,187,0,2,3,3,3,2,2,2,3,4,2,2,8,8,10,10,14,8,8,8,1,9,14,8,9,14,10,12,6,14,10,14,14,10,13,5,11,10,10,13,14,9,4,13,1,11,13,20,8,11,10,4,2,10,10,11,11,12,11,13,6,13,4,M/AM C,1,1,1,20,1,1,1,1,1,1,17,1,1,1,1
19202460,Jefferson,1651,02/05/1993,23,0,0,0,0,189,81,11,9,9,1,13,13,6,13,6,10,10,6,2,2,1,2,10,1,2,2,1,1,2,2,5,10,10,15,8,8,7,12,10,1,3,1,9,8,6,13,15,8,7,10,10,11,20,2,9,10,3,10,7,10,12,13,14,9,13,3,14,1,GK ,20,1,1,1,1,1,1,1,1,1,1,1,1,1,1
19202462,João Paulo,1651,10/10/1995,20,0,0,0,0,175,62,1,3,1,3,3,3,1,1,1,1,1,8,9,16,11,14,7,12,12,5,9,12,6,6,11,10,11,8,11,10,10,16,7,12,6,13,8,10,12,14,13,10,8,11,13,12,20,8,9,10,10,10,6,10,17,12,8,9,9,6,1,3,S C,1,1,20,15,1,1,1,1,1,1,1,1,1,1,1
19202466,Liniker,1651,17/06/1993,23,0,0,0,0,182,0,3,1,2,1,1,2,3,3,2,3,4,2,5,12,7,13,5,3,10,1,5,10,3,5,13,5,8,3,5,5,8,12,5,13,9,9,6,7,11,9,10,6,10,8,12,13,20,10,6,8,6,5,6,8,9,9,9,12,10,1,10,8,AM C,1,1,1,20,1,1,1,1,1,1,10,1,1,1,1
19202469,Netto Imperador,1651,06/02/1992,24,0,0,0,0,180,79,2,3,3,2,1,3,3,1,1,1,3,7,6,13,13,13,7,13,7,1,5,8,5,4,13,10,12,4,9,8,7,13,10,13,13,13,5,7,8,13,13,8,8,20,9,13,10,13,12,8,10,3,6,10,11,10,10,10,8,5,10,7,S ,1,1,20,1,1,1,1,1,1,1,1,1,1,1,1
19202476,Guilherme Alves,1651,15/03/1990,26,0,0,0,0,184,80,1,3,1,2,2,1,2,3,2,3,1,4,2,4,3,5,6,13,1,4,13,4,4,13,4,9,11,9,5,6,4,13,8,1,5,6,13,6,8,13,12,7,10,9,12,12,20,12,7,9,9,9,8,9,15,12,10,12,12,7,11,6,D C,1,1,1,1,1,1,20,1,1,1,1,1,1,1,1
19202480,Wendell,1651,30/12/1991,24,0,0,0,0,200,92,13,10,11,1,13,8,10,13,9,6,12,6,2,2,1,2,9,1,1,1,3,1,1,1,3,9,9,14,7,7,6,13,9,2,13,1,9,7,6,12,7,7,15,2,13,12,20,6,13,9,9,9,6,9,9,9,10,11,12,5,9,2,GK ,20,1,1,1,1,1,1,1,1,1,1,1,1,1,1
19202486,Geovane,1651,23/04/1990,26,0,0,0,0,187,75,2,3,1,2,2,2,2,4,3,4,3,7,7,9,13,13,7,5,9,2,7,10,2,8,12,10,10,8,8,8,13,13,3,12,6,12,7,8,10,13,13,8,10,20,16,13,10,9,9,10,10,5,9,10,16,11,10,12,11,7,5,6,AM C,1,1,1,20,1,1,1,1,1,1,10,1,1,1,1
19202493,Michel Douglas,1651,16/01/1992,24,0,0,0,0,186,78,1,3,3,1,4,4,1,4,1,1,1,7,5,11,13,13,7,13,6,6,5,8,10,5,13,5,10,9,12,6,6,12,10,13,9,10,11,7,8,13,9,7,12,20,10,12,10,13,9,10,10,10,10,10,8,10,10,12,11,9,9,8,S ,1,1,20,1,1,1,1,1,1,1,1,1,1,1,1
19202498,Artur,1651,11/06/1990,26,0,0,0,0,189,78,1,2,3,3,3,3,3,3,1,2,2,9,7,1,7,10,5,14,1,5,14,10,6,14,9,6,12,11,10,8,8,14,9,1,11,9,14,9,10,14,10,10,13,10,10,13,20,14,9,12,8,4,5,11,19,10,8,12,12,1,17,1,D C,1,1,1,1,1,1,20,1,8,1,1,1,1,1,1
19202501,Jorginho,1651,05/01/1991,25,0,0,0,0,180,71,2,2,1,1,1,4,2,1,1,2,2,10,12,15,17,13,6,6,11,6,13,13,12,13,14,10,11,5,13,13,14,12,6,12,8,16,14,15,13,11,6,11,11,11,12,13,20,13,10,10,12,11,12,10,6,6,10,11,13,11,7,10,AM C,1,1,1,20,1,1,1,1,1,1,10,1,1,1,1
19202502,Luciano,1651,18/05/1993,23,0,0,0,0,179,69,2,2,2,2,3,1,1,2,2,3,2,7,9,13,13,13,10,12,13,9,8,12,13,7,13,12,12,10,13,12,11,11,12,14,11,13,7,11,12,16,13,11,9,20,10,15,14,12,11,11,7,11,13,11,14,12,13,13,12,6,12,7,S ,1,1,20,14,14,13,1,1,1,1,10,1,1,1,1
19202505,Yago Amaral,1651,25/05/1992,24,0,0,0,0,187,78,3,3,1,4,1,1,3,3,3,1,3,7,6,13,13,13,7,13,6,2,7,8,8,5,10,7,9,9,12,8,8,12,5,10,9,13,6,5,8,13,13,4,10,11,14,13,20,9,11,10,8,10,10,10,18,10,12,9,15,5,15,6,S ,1,1,20,1,1,1,1,1,1,1,1,1,1,1,1
19202506,Wandinho,1651,01/02/1991,25,0,0,0,0,169,61,2,2,1,3,2,2,2,2,3,1,1,8,6,14,10,14,8,6,10,2,8,12,5,9,11,4,11,4,8,8,10,14,10,10,13,14,7,9,13,14,14,9,3,1,17,14,20,10,6,7,8,10,10,10,14,11,11,10,11,6,13,3,AM C,1,1,1,20,1,1,1,1,1,1,10,1,1,1,1
19202603,John,1651,13/02/1996,20,0,0,0,0,192,0,14,13,14,1,14,13,11,14,3,10,14,9,2,1,2,7,11,1,2,1,2,2,3,2,6,4,12,15,10,11,9,14,10,3,8,3,10,10,9,11,15,7,13,8,15,7,20,9,10,11,11,7,9,11,13,13,11,9,13,5,7,6,GK ,20,1,1,1,1,1,1,1,1,1,1,1,1,1,1
19202608,Zé Lucas,1651,07/03/1994,22,0,0,0,0,185,78,2,3,1,3,1,2,2,3,2,3,3,10,8,13,13,11,6,10,9,10,11,11,10,8,12,8,9,9,12,10,11,10,2,13,7,11,11,10,10,12,10,10,12,3,10,12,20,11,10,7,9,5,7,9,15,11,11,13,13,7,12,8,S ,1,1,20,1,1,1,1,1,1,1,1,1,1,1,1
19202610,Christian,1651,30/07/1994,21,0,0,0,0,187,81,12,8,8,6,12,12,8,12,7,9,12,4,3,2,1,1,7,1,2,2,1,1,2,2,4,9,9,12,6,10,5,11,5,1,3,3,9,6,5,12,13,6,9,10,16,10,20,1,7,9,9,4,9,9,7,10,12,12,12,1,13,8,GK ,20,1,1,1,1,1,1,1,1,1,1,1,1,1,1
19202659,Ighort,1651,12/03/1994,22,0,0,0,0,188,88,3,3,1,2,3,1,1,2,2,1,4,2,1,1,5,6,2,7,4,2,12,6,2,12,2,9,12,9,7,6,3,13,1,8,3,4,13,6,7,13,12,4,13,5,9,11,20,5,15,9,9,9,9,9,13,12,12,10,10,4,12,3,D C,1,1,1,1,1,1,20,1,1,1,1,1,1,1,1
19202676,Hyuri,1651,26/09/1991,24,0,0,0,0,186,78,1,2,3,3,1,4,3,3,3,3,3,7,7,13,11,13,2,10,9,8,5,11,10,6,13,9,11,8,12,12,11,10,15,15,11,13,5,13,12,15,14,6,12,12,14,15,20,11,7,12,6,15,7,12,10,14,13,15,15,6,14,4,AM/S RLC,1,1,19,15,20,19,1,1,10,1,1,10,10,1,10
19202677,Auro,1651,23/01/1996,20,0,0,0,0,168,62,1,2,2,3,1,3,1,1,3,1,2,8,12,12,11,12,7,7,11,11,8,11,9,8,13,11,11,11,11,11,9,11,13,13,4,11,8,12,12,14,15,9,6,10,9,14,20,14,9,10,11,11,8,12,15,13,12,12,12,6,10,12,D/WB R,1,1,10,14,1,12,1,1,16,12,10,1,14,1,20
19202678,Denílson,1651,18/07/1995,20,0,0,0,0,187,72,3,1,2,3,2,2,1,2,2,2,3,5,5,9,13,13,4,13,7,5,6,9,5,4,10,8,11,8,11,9,4,12,10,10,11,9,7,7,8,13,11,8,13,9,11,12,20,10,9,10,10,5,9,9,10,10,12,10,11,1,7,8,S ,1,1,20,1,1,1,1,1,13,1,1,1,1,1,13
19202682,Gustavo Hebling,1651,05/04/1996,20,0,0,0,0,174,70,2,1,3,1,3,3,1,1,3,3,3,14,12,12,11,12,16,8,12,4,11,13,8,12,13,3,11,4,11,12,14,12,16,12,3,7,9,5,13,12,14,10,8,8,13,12,20,6,10,3,4,3,6,5,20,14,12,15,12,8,16,5,DM C,1,1,1,1,1,1,1,1,1,20,15,1,1,1,1
19202686,Abner,1651,30/05/1996,20,0,0,0,0,176,70,2,3,1,2,2,1,2,2,2,3,1,9,12,13,5,12,7,12,8,11,6,11,6,7,14,7,10,11,12,10,11,13,14,13,10,13,6,8,10,12,12,9,12,20,11,11,10,10,9,9,7,10,18,10,17,11,11,12,14,5,16,8,D/WB L,1,1,1,1,1,1,1,20,1,1,1,1,1,19,1
19202694,Pé de Ferro,1651,08/01/1985,31,0,0,0,0,184,0,3,2,3,4,2,2,3,1,3,3,2,5,1,7,6,8,4,14,3,3,11,8,1,14,5,9,10,9,6,6,7,14,8,5,13,6,12,7,8,13,10,8,7,8,15,10,20,10,9,9,9,6,9,9,20,11,11,12,10,9,3,4,D C,1,1,1,1,1,1,20,1,1,1,1,1,1,1,1
19202696,Boschilia,1651,05/03/1996,20,0,0,7,2,172,63,3,1,2,3,1,1,1,3,3,2,1,15,13,15,11,14,16,10,13,5,7,13,12,7,16,13,12,12,13,12,13,12,14,14,11,13,7,12,13,14,14,8,6,20,14,13,10,13,8,13,8,12,8,14,10,15,12,13,13,13,14,7,AM RLC,1,1,1,20,15,15,1,1,1,1,15,14,14,1,1
19202703,Layo,1651,14/03/1995,21,0,0,0,0,180,0,3,1,1,3,2,1,2,1,2,1,3,1,1,4,3,5,3,13,2,1,13,7,3,13,1,9,8,9,7,10,6,12,9,3,13,5,13,6,7,13,13,7,7,9,9,13,20,8,7,9,5,9,9,9,7,12,11,12,8,3,7,1,D C,1,1,1,1,1,1,20,1,1,1,1,1,1,1,1
19202705,Guilherme Schettine,1651,10/10/1995,20,0,0,0,0,178,78,3,1,3,2,3,3,1,1,2,3,2,6,6,13,13,13,7,13,6,5,3,6,9,4,12,10,10,6,13,3,8,9,10,12,11,13,5,7,8,13,13,8,5,10,12,13,20,9,6,10,10,10,7,10,14,15,10,10,10,2,18,2,S ,1,1,20,1,1,1,1,1,1,1,1,1,1,1,1
19202729,João Vítor,1651,04/07/1996,19,0,0,0,0,185,0,2,3,2,2,3,2,3,2,1,2,2,4,8,8,5,12,7,7,8,6,6,12,4,12,8,6,9,6,7,7,7,9,1,9,3,7,10,8,9,14,14,8,14,9,14,13,20,14,7,8,9,7,9,9,9,12,13,11,9,5,9,8,D/WB/DM R,1,1,1,1,1,1,1,1,18,20,10,1,1,1,19
19202731,Matheus Alves,1651,19/05/1993,23,0,0,0,0,187,92,2,3,3,2,1,1,1,1,2,1,2,5,7,11,12,11,6,13,8,5,3,9,13,5,12,9,12,13,11,10,8,11,13,9,5,12,6,12,15,8,10,16,13,8,14,11,20,13,16,12,5,6,9,10,13,9,10,13,15,2,9,4,S ,1,1,20,1,1,1,1,1,1,1,1,1,1,1,1
19202733,Kassiano,1651,24/04/1995,21,0,0,0,0,186,74,1,1,2,1,2,3,3,3,3,2,1,5,3,6,3,8,3,13,6,6,13,8,6,13,6,5,9,10,8,6,2,13,11,7,13,5,9,6,8,13,11,8,11,10,11,13,20,8,10,9,9,7,9,9,15,11,9,9,12,7,8,4,D RC,1,1,1,1,1,1,20,1,19,1,1,1,1,1,1
19202741,Matteus,1651,11/10/1989,26,0,0,0,0,178,72,2,3,2,2,3,2,1,1,3,3,3,10,10,12,11,11,11,12,11,10,13,11,11,13,12,12,11,12,11,11,11,11,10,10,11,12,11,12,12,12,11,12,12,11,11,12,20,11,12,12,11,12,11,11,7,12,11,12,9,7,5,5,DM C,1,1,1,1,1,1,15,1,1,20,1,1,1,1,1
19202746,Marlon Freitas,1651,27/03/1995,21,0,0,0,0,182,0,3,2,1,1,1,1,1,3,1,3,3,10,8,10,10,10,12,8,14,5,10,12,10,11,12,7,11,9,12,10,11,9,7,9,11,12,11,12,12,12,10,10,12,10,14,11,20,13,11,10,10,10,5,10,8,11,10,9,11,10,13,1,DM/M C,1,1,1,1,1,1,1,1,1,20,20,1,1,1,1
19202753,Caio Monteiro,1651,10/02/1997,19,0,0,0,0,177,67,3,1,3,3,2,2,2,1,1,1,3,7,9,13,12,12,9,12,11,4,7,10,10,7,13,10,12,12,12,11,11,12,12,13,10,13,8,13,13,14,13,10,9,12,14,14,20,13,10,12,10,10,11,12,15,13,12,12,11,6,10,9,AM/S RL,1,1,20,1,16,15,1,1,1,1,1,1,1,1,1
19202762,Wellington Bueno,1651,20/04/1996,20,0,0,0,0,166,0,3,1,3,2,3,2,3,2,2,3,2,9,9,12,14,10,9,6,15,7,8,11,9,6,12,10,13,10,8,7,12,13,18,9,5,11,5,10,7,12,11,7,4,10,12,11,20,11,6,10,10,8,7,10,11,10,11,10,11,5,18,3,AM C,1,1,1,20,1,1,1,1,1,1,10,1,1,1,1
19202767,Ruhan,1651,13/11/1995,20,0,0,0,0,175,70,1,2,3,3,3,1,2,3,1,1,1,6,9,7,4,13,7,6,6,4,7,8,2,13,9,9,7,9,9,5,8,9,3,9,11,8,6,8,9,14,13,4,8,15,6,14,20,6,6,9,7,6,5,14,12,14,11,13,11,10,8,4,D/WB RLC,1,1,1,1,1,1,1,18,20,12,15,1,1,11,19
19202780,Bruno Cosendey,1651,25/01/1997,19,0,0,0,0,185,72,3,1,3,2,3,2,3,3,3,4,3,6,7,12,11,10,8,10,12,6,11,12,8,12,13,10,11,13,12,12,13,10,12,13,8,11,12,11,12,12,12,11,10,11,13,12,20,12,11,11,10,9,7,14,19,14,13,8,11,3,15,1,DM/M C,1,1,1,10,1,1,1,1,1,20,18,1,1,1,1
19202789,Foguinho,1651,15/06/1992,24,0,0,0,0,180,75,1,2,2,1,1,2,1,3,2,2,3,7,9,11,9,7,3,6,9,1,10,11,5,10,11,4,12,13,7,9,12,13,6,5,9,8,9,8,13,12,11,8,8,10,12,11,20,12,9,10,10,9,5,10,18,12,10,12,11,4,5,4,DM C,1,1,1,1,1,13,1,1,1,20,15,1,13,1,1
19202856,Jonathan Balotelli,1651,20/04/1989,27,0,0,0,0,185,78,1,3,1,2,2,3,2,1,1,1,4,4,5,12,11,12,5,11,12,8,8,12,5,4,12,5,10,14,10,7,8,14,4,10,8,13,8,13,13,15,12,9,8,1,12,13,20,14,15,11,12,11,9,10,14,14,10,13,12,1,10,4,S ,1,1,20,1,1,1,1,1,1,1,1,1,1,1,1
19203525,Aurélio,1651,28/03/1989,27,0,0,0,0,173,70,2,2,1,3,1,1,3,1,2,2,2,6,5,9,7,12,7,6,9,1,8,10,4,9,8,10,10,6,8,8,13,13,8,10,13,12,9,8,12,13,13,8,4,10,12,13,20,13,5,10,8,10,4,10,10,11,12,12,11,1,6,3,M/AM C,1,1,1,20,1,1,1,1,1,1,18,1,1,1,1
19203527,Alex Murici,1651,28/05/1989,27,0,0,0,0,173,69,1,3,2,2,2,1,3,3,1,1,1,5,10,9,6,9,8,8,9,4,9,11,3,11,11,5,9,9,8,12,6,10,10,3,9,8,9,9,10,14,14,9,5,10,13,14,20,12,9,10,8,7,7,10,9,10,10,9,11,1,8,5,D/WB RC,1,1,1,1,1,1,1,1,20,1,15,1,15,1,18
19203537,Victor Juffo,1651,24/02/1993,23,0,0,0,0,177,74,3,3,2,3,2,1,1,2,2,2,2,5,6,12,8,13,7,7,11,3,6,13,3,8,12,7,11,2,6,8,13,13,4,12,11,11,8,8,11,13,12,8,4,11,5,13,20,9,5,10,5,8,10,10,20,11,10,12,8,6,16,3,AM C,1,1,1,20,1,1,1,1,1,1,10,1,1,1,1
19205128,Adalgiso Pitbull,1651,30/10/1989,26,0,0,0,0,175,72,2,3,3,2,2,2,1,2,2,3,2,6,7,13,13,11,7,12,5,6,7,6,5,5,7,6,11,9,12,8,7,13,2,10,9,13,7,7,8,13,13,6,5,9,16,13,20,13,9,10,10,3,9,10,9,14,12,9,11,13,6,4,S ,1,1,20,1,1,1,1,1,1,1,1,1,1,1,1
19206019,Glaybson,1651,19/12/1987,28,0,0,0,0,185,82,2,2,2,1,3,1,1,4,3,1,3,2,4,8,2,10,5,6,12,6,8,10,1,12,12,9,7,9,8,8,11,12,8,6,8,7,12,7,8,12,12,7,10,20,10,12,10,12,7,10,7,10,10,10,18,10,9,12,11,5,5,1,D/WB/DM LC,1,1,1,13,13,1,1,20,1,18,15,1,1,19,1
19207114,Cris,1651,16/11/1987,28,0,0,0,0,186,82,2,3,2,1,3,1,1,2,3,3,3,6,7,12,9,12,6,10,7,1,6,9,5,1,9,9,8,6,9,5,5,8,9,9,11,12,4,6,7,13,13,7,7,20,4,13,11,12,10,9,6,6,9,9,9,13,11,11,12,1,9,6,S ,1,1,20,1,1,1,1,1,1,1,1,1,1,1,1
19207151,Derlan,1651,06/03/1989,27,0,0,0,0,173,0,1,2,1,3,2,3,2,3,3,2,1,5,11,7,3,8,2,8,6,4,9,9,1,10,9,6,10,9,7,8,8,10,7,7,13,7,9,8,8,14,14,8,6,20,7,14,9,8,8,9,9,7,5,9,7,10,12,11,10,8,13,5,D/WB L,1,1,10,1,10,1,1,20,1,1,1,10,1,18,1
19207171,Baggio,1651,09/08/1994,21,0,0,0,0,184,78,3,1,1,3,3,1,2,2,3,2,3,3,2,7,2,13,5,4,9,5,6,13,1,7,12,5,3,1,3,2,8,13,4,12,2,3,2,7,11,13,12,6,9,8,9,11,20,8,6,8,8,8,8,8,17,13,11,11,11,9,2,1,AM C,1,1,1,20,1,1,1,1,1,1,15,1,1,1,1
19207200,Trinca,1651,13/10/1992,23,0,0,0,0,179,76,1,1,1,3,4,3,2,4,1,2,3,11,12,8,5,9,11,8,9,11,10,10,11,10,9,8,9,9,12,10,9,10,9,8,7,11,12,11,11,11,10,10,9,9,10,10,20,11,10,11,6,11,3,14,11,8,14,12,12,6,4,7,D/M LC,1,1,1,1,1,1,10,20,1,10,20,15,1,15,1
19207202,Alex,1651,06/10/1993,22,0,0,0,0,185,84,1,1,2,2,1,1,3,3,1,2,1,5,7,2,2,8,7,14,7,3,9,8,3,10,4,9,14,9,7,6,6,14,8,9,7,7,10,6,9,10,13,8,12,9,12,14,20,4,12,9,9,6,9,9,8,14,11,12,13,8,9,1,D/DM C,1,1,1,1,1,1,20,1,1,18,1,1,1,1,1
19207203,Caique,1651,23/05/1992,24,0,0,0,0,160,61,1,3,3,3,1,2,3,2,3,2,1,6,10,2,4,9,2,7,4,6,10,6,1,12,7,9,10,9,7,11,5,7,8,9,1,5,10,7,8,13,13,7,1,9,8,13,20,12,10,9,9,9,9,9,14,12,11,11,10,13,11,2,D R,1,1,1,1,1,1,1,1,20,1,1,1,1,1,1
19207208,Zé Júnior,1651,14/03/1989,27,0,0,0,0,185,0,1,3,2,2,1,3,4,3,3,2,1,4,6,6,2,9,2,7,2,6,7,8,5,11,5,8,7,7,7,6,8,12,2,8,9,3,5,8,8,14,14,8,12,20,9,14,9,7,10,8,8,2,6,8,15,12,13,10,12,4,19,3,D/WB L,1,1,1,1,1,1,1,20,1,1,1,1,1,19,1
19207211,Puxinha,1651,13/01/1989,27,0,0,0,0,185,0,3,3,1,2,2,1,3,2,1,3,2,3,1,11,12,12,4,12,4,4,1,4,5,1,12,8,5,1,6,5,3,8,3,13,5,11,5,4,6,12,12,5,12,9,4,12,20,11,8,6,4,8,8,8,12,10,10,8,11,6,14,4,S ,1,1,20,1,1,1,1,1,1,1,1,1,1,1,1
19207212,Romário,1651,16/06/1990,26,0,0,0,0,175,0,3,2,1,2,1,3,3,1,4,3,1,4,6,8,13,13,4,13,10,1,4,6,10,1,11,8,8,3,11,6,1,11,2,11,4,8,6,5,6,13,13,6,5,9,14,13,20,7,4,8,6,8,8,8,16,10,11,10,11,1,8,3,S ,1,1,20,1,1,1,1,1,1,1,1,1,1,1,1
19207223,Felipe Costa,1651,17/09/1992,23,0,0,0,0,169,63,2,1,3,2,3,1,4,3,1,2,2,4,6,8,6,13,6,6,12,6,6,8,1,6,13,6,8,6,6,6,13,10,8,13,9,11,7,7,11,13,13,7,5,9,13,13,20,6,5,9,9,9,6,9,9,12,9,13,12,8,4,8,AM C,1,1,1,20,1,1,1,1,1,1,15,1,1,1,1
19207224,Luís Fernando,1651,31/07/1990,25,0,0,0,0,190,82,2,1,1,1,4,1,1,2,2,2,3,7,7,5,4,9,2,8,5,4,14,6,7,14,4,10,11,10,9,12,4,14,6,1,8,7,14,8,9,13,9,9,13,9,17,13,20,14,10,10,9,7,5,10,14,11,9,14,12,9,1,3,D C,1,1,1,1,1,1,20,1,1,1,1,1,1,1,1
19207225,Luiz Henrique,1651,12/04/1992,24,0,0,0,0,175,0,1,1,2,1,2,3,1,4,2,2,2,3,4,11,9,13,5,13,9,5,5,6,4,1,9,5,10,1,6,6,3,10,8,9,2,11,4,5,7,12,13,6,4,9,7,13,20,12,5,4,8,1,8,8,14,12,12,13,11,3,10,6,S ,1,1,20,1,1,1,1,1,1,1,1,1,1,1,1
19207239,Valdo Bacabal,1651,23/08/1992,23,0,0,0,0,174,72,3,1,2,2,2,1,2,1,4,1,2,7,6,9,9,14,7,7,14,1,6,12,1,7,14,9,7,4,5,6,7,8,2,13,9,9,7,8,10,14,11,8,6,9,7,12,20,11,5,11,11,9,9,9,12,8,11,12,5,6,9,14,AM C,1,1,1,20,1,1,1,1,1,1,15,1,1,1,1
19207278,Linderman,1651,17/03/1995,21,0,0,0,0,182,0,2,2,2,3,2,2,1,2,2,2,4,7,7,2,3,11,2,16,8,10,11,10,6,11,11,8,9,11,9,14,10,16,4,4,8,10,10,11,11,12,12,10,12,6,13,12,20,13,10,10,10,10,10,10,19,11,13,13,12,3,16,6,D RC,1,1,1,1,1,1,15,1,20,1,1,1,1,1,1
19210290,Lucas Silva,1651,20/04/1992,24,0,0,0,0,189,82,2,3,4,1,1,2,3,3,1,4,1,1,1,2,7,7,4,11,6,1,11,8,5,14,7,9,13,9,8,10,3,12,8,1,4,6,14,5,9,10,10,8,15,10,12,12,20,6,14,9,9,9,7,9,18,12,11,11,10,6,14,4,D C,1,1,1,1,1,1,20,1,1,13,1,1,1,1,1
19210292,Luan Viana,1651,14/01/1996,20,0,0,0,0,184,79,2,2,3,4,1,1,1,1,1,1,2,7,8,11,12,11,7,12,11,1,6,8,7,3,14,9,11,6,12,6,8,12,9,13,3,13,6,7,8,13,11,8,12,10,12,12,20,7,12,9,8,9,6,8,11,11,13,11,10,4,14,4,S ,1,1,20,1,1,1,1,1,1,1,1,1,1,1,1
19210309,Iago,1651,06/12/1995,20,0,0,0,0,185,0,11,14,10,1,10,11,11,13,12,10,11,7,3,1,3,1,9,1,2,3,1,1,3,3,2,8,9,13,11,11,7,12,14,3,12,3,9,8,5,9,11,8,9,9,13,9,20,1,8,10,5,10,10,9,12,13,12,10,14,12,11,13,GK ,20,1,1,1,1,1,1,1,1,1,1,1,1,1,1
19210310,Gabriel Leite,1651,06/03/1995,21,0,0,0,0,170,64,2,3,3,3,4,1,3,3,3,1,2,10,10,12,9,12,8,6,7,4,6,10,10,5,11,10,11,11,11,10,10,9,13,13,6,12,7,6,12,13,14,14,5,20,13,13,13,12,4,10,10,10,10,10,13,11,12,13,12,13,15,3,AM C,1,1,1,20,13,13,1,1,1,1,1,1,1,1,1
19210311,Igor Pimentel,1651,14/11/1991,24,0,0,0,0,185,82,4,4,1,3,1,3,1,3,1,1,2,10,7,9,4,9,10,11,7,9,13,10,7,11,8,10,10,13,9,12,10,12,12,7,12,10,11,13,13,12,12,14,14,9,14,12,20,14,14,13,13,5,10,10,12,9,11,10,14,11,8,7,DM/M C,1,1,1,1,1,1,1,1,1,20,17,1,1,1,1
19210312,João Henrique,1651,13/01/1987,29,0,0,0,0,179,73,2,1,2,3,1,3,3,3,2,2,3,8,9,14,9,10,9,8,9,8,5,9,8,5,11,4,11,7,9,7,9,8,3,14,6,11,7,6,7,14,14,5,9,10,12,14,20,12,5,8,8,11,10,10,7,11,12,14,9,5,10,2,AM RL,1,1,13,1,20,17,1,1,1,1,1,1,1,1,1
19210361,Rodrigo Biro,1651,18/11/1986,29,0,0,0,0,182,71,3,2,3,4,3,3,1,2,1,2,2,9,10,12,8,11,8,12,7,9,10,12,8,10,11,10,12,11,12,12,11,12,13,12,6,12,10,10,12,14,13,10,11,20,12,14,11,13,7,12,6,10,8,11,8,6,8,10,9,10,2,12,D/WB L,1,1,1,1,1,1,1,20,12,1,1,1,1,16,12
19210609,Georgemy,1651,15/08/1995,20,0,0,0,0,198,90,12,10,11,5,13,11,9,12,11,10,10,8,2,1,2,7,10,2,1,2,1,8,3,2,7,7,12,12,11,13,10,10,8,2,9,2,12,11,10,9,11,12,15,8,13,10,20,12,11,10,10,4,5,9,10,11,11,10,11,11,6,8,GK ,20,1,1,1,1,1,1,1,1,1,1,1,1,1,1
19210694,Alisson Gaúcho,1651,30/04/1992,24,0,0,0,0,191,83,1,1,1,2,3,3,4,2,1,1,2,6,3,5,1,8,2,11,2,2,11,8,1,13,5,9,10,9,6,7,5,8,8,4,12,6,13,7,7,13,11,4,15,20,13,12,10,6,10,9,9,9,5,9,13,10,12,12,10,5,5,1,D LC,1,1,1,1,1,1,20,19,1,1,1,1,1,13,1
19210710,Nininho,1651,07/02/1992,24,0,0,0,0,175,68,2,3,2,1,3,3,2,1,2,3,3,6,5,9,7,11,3,8,8,8,11,11,6,15,11,9,13,11,10,13,8,13,10,10,13,9,11,10,10,15,13,10,8,11,17,13,20,8,10,10,10,6,10,10,20,11,10,11,14,7,11,3,D R,1,1,1,1,1,1,1,12,20,1,1,1,1,1,14
19211881,Francis Obidikwa,1651,27/04/1995,21,0,0,0,0,192,0,3,1,2,2,2,1,2,3,3,3,3,5,2,1,4,8,1,13,3,1,14,8,3,13,7,9,14,9,8,10,1,7,18,3,8,7,14,7,5,14,13,8,12,1,11,14,20,10,13,9,9,1,8,9,7,12,12,12,13,1,12,3,D C,1,1,1,1,1,1,20,1,1,1,1,1,1,1,1
19211890,Lorran,1651,28/01/1996,20,0,0,0,0,171,65,1,3,2,3,2,1,3,2,3,2,2,6,12,13,10,12,7,9,6,8,9,10,8,9,13,13,12,11,10,12,13,11,13,14,6,12,10,12,12,14,12,8,8,20,13,14,5,13,8,11,7,10,9,12,15,12,9,11,11,7,11,12,D/WB/AM LC,1,1,1,16,17,1,1,20,1,1,1,15,1,19,1
19211892,Thalles,1651,18/05/1995,21,0,0,0,0,185,77,3,3,2,3,1,3,1,1,1,4,3,7,8,12,12,10,9,13,13,5,6,11,11,6,12,14,13,13,12,13,11,12,12,13,10,12,8,12,12,13,14,14,13,11,13,13,20,13,14,12,6,12,8,11,13,12,13,12,7,7,11,6,S RL,1,1,20,1,15,15,1,1,1,1,1,1,1,1,1
19211964,Romulo,1651,11/01/1995,21,0,0,0,0,189,0,2,2,3,2,1,3,1,3,3,1,3,1,1,1,1,5,1,12,3,1,12,5,1,10,3,8,6,7,5,9,1,11,8,1,1,4,12,4,5,12,12,5,7,8,14,12,20,7,8,8,5,8,8,8,20,12,12,11,10,9,9,8,D C,1,1,1,1,1,1,20,1,1,1,1,1,1,1,1
19211967,Lucas,1651,14/08/1994,21,0,0,0,0,173,63,3,1,3,3,2,2,1,1,4,1,2,3,7,6,1,12,5,5,3,1,8,7,1,13,8,7,4,3,5,4,5,14,5,6,1,5,4,6,7,12,7,6,6,10,11,8,20,6,5,7,4,7,5,7,18,12,9,9,11,2,17,8,D/WB R,1,1,1,5,1,1,1,1,20,15,8,1,1,1,18
19211989,Lucas Bahia,1651,19/12/1987,28,0,0,0,0,189,84,2,1,4,3,4,3,2,2,3,3,3,6,7,1,6,7,5,12,8,8,13,8,5,8,9,10,8,10,9,11,8,15,1,3,5,9,12,9,10,15,11,10,14,9,12,14,20,7,13,10,7,10,10,10,13,11,12,11,9,9,10,3,D C,1,1,1,1,1,1,20,1,1,1,1,1,1,1,1
19211990,Edimar,1651,30/08/1988,27,0,0,0,0,185,82,2,4,3,2,2,4,2,4,2,3,1,7,4,1,4,9,2,12,4,8,14,8,4,14,8,9,14,10,9,9,4,14,10,1,5,7,14,8,9,14,14,9,13,11,10,14,20,9,14,10,5,7,10,10,10,11,12,11,12,3,11,4,D C,1,1,1,1,1,1,20,1,1,1,1,1,1,1,1
19211992,Toni,1651,06/10/1992,23,0,0,0,0,178,84,2,3,1,1,1,1,1,1,1,2,1,11,13,12,13,12,8,9,8,7,7,9,8,8,10,5,11,5,11,8,9,12,8,10,2,10,8,8,9,12,8,9,8,10,10,9,20,9,13,10,11,10,10,9,15,10,11,9,10,8,4,6,AM/S RL,1,1,20,13,15,18,1,1,1,1,7,1,1,1,1
19211993,Mineiro,1651,16/09/1989,26,0,0,0,0,182,79,1,1,2,1,3,1,2,1,3,4,2,6,1,7,6,13,6,8,10,3,10,11,3,13,12,13,11,12,8,5,10,13,13,9,6,7,13,7,12,13,10,9,10,10,13,11,20,12,9,9,14,9,9,7,14,14,13,10,10,1,8,8,DM C,1,1,1,1,1,1,1,1,1,20,15,1,1,1,1
19212060,Luizinho Mello,1651,13/03/1993,23,0,0,0,0,182,75,4,3,2,2,3,1,1,2,1,3,3,7,8,8,8,13,7,6,9,1,11,11,5,14,14,9,9,8,9,6,11,13,9,8,8,9,9,8,10,14,11,8,11,20,12,14,8,10,7,9,9,7,9,9,14,13,11,13,11,8,12,1,M C,1,1,1,13,12,1,1,1,1,15,20,12,1,1,1
19212061,Igor Klipper,1651,29/01/1995,21,0,0,0,0,173,0,2,2,1,2,2,1,2,3,2,1,4,3,1,7,12,12,4,12,3,1,1,4,4,2,10,8,5,6,10,4,5,12,8,11,3,12,5,4,5,12,12,5,4,8,5,12,20,5,8,8,8,8,8,8,18,11,9,12,12,5,9,1,S ,1,1,20,1,1,1,1,1,1,1,1,1,1,1,1
19212063,Mateus Arence,1651,03/05/1995,21,0,0,0,0,177,71,1,1,1,1,3,3,3,1,1,1,2,5,5,6,7,12,2,2,11,5,6,11,1,5,12,8,5,4,5,5,10,13,8,12,6,7,7,7,11,13,13,6,7,9,11,13,20,6,5,8,6,8,8,8,11,12,10,12,12,5,11,1,AM C,1,1,1,20,1,1,1,1,1,1,15,1,1,1,1
19212064,Diego,1651,04/02/1993,23,0,0,0,0,183,72,1,2,2,3,2,1,2,2,2,2,1,5,6,9,5,10,2,8,5,8,10,9,5,15,10,6,10,9,8,10,7,9,7,6,13,8,10,9,9,15,11,9,11,20,16,14,12,8,8,9,6,4,8,9,8,11,10,9,11,8,12,3,D/WB L,1,1,1,1,1,1,1,18,1,1,1,1,1,20,1
19212066,Douglas Moreira,1651,17/04/1996,20,0,0,0,0,166,60,2,2,1,1,2,1,2,1,1,2,3,9,9,11,9,12,10,9,11,6,11,12,10,12,13,14,11,11,12,11,11,11,6,12,8,11,12,12,13,13,14,18,3,11,12,14,20,13,8,12,14,7,9,12,8,10,11,11,11,8,6,5,DM/M C,1,1,1,15,12,11,1,1,1,16,20,8,9,1,1
19212265,Venício,1651,16/04/1993,23,0,0,0,0,191,77,2,3,3,1,1,2,2,3,3,3,3,2,1,11,11,10,2,11,3,1,1,3,3,1,10,7,4,4,11,3,3,5,7,12,7,9,3,2,4,11,7,1,12,20,9,9,7,8,9,7,7,7,7,7,15,13,13,11,12,1,5,3,S ,1,1,20,1,1,1,1,1,1,1,1,1,1,1,1
19212269,Pit,1651,28/11/1992,23,0,0,0,0,186,0,1,3,2,1,2,3,3,1,3,1,1,2,1,1,3,7,6,13,3,1,13,7,2,13,6,9,9,9,7,7,6,13,1,6,8,6,13,6,7,9,10,7,11,10,12,11,20,4,10,9,9,9,9,9,13,11,13,14,8,1,10,6,D C,1,1,1,1,1,1,20,1,1,1,1,1,1,1,1
19212298,Jonathan,1651,17/08/1994,21,0,0,0,0,194,0,1,2,3,1,2,2,1,3,1,2,3,1,2,3,1,4,1,13,5,5,13,5,1,11,3,8,9,7,3,5,4,12,6,1,12,4,9,5,6,10,10,6,13,5,14,8,20,5,12,8,8,8,8,8,17,10,12,11,11,1,9,1,D C,1,1,1,1,1,1,20,1,1,1,1,1,1,1,1
19212299,Daniel,1651,21/01/1996,20,0,0,0,0,188,0,3,2,1,1,1,3,3,1,4,3,3,6,5,8,13,13,7,14,5,4,7,3,9,3,13,9,13,8,11,8,8,11,9,12,8,14,3,7,9,14,12,7,13,2,10,9,20,12,9,9,5,4,9,9,10,11,9,10,10,7,1,7,S ,1,1,20,1,1,1,1,1,1,1,1,1,1,1,1
19212300,Willian Rocha,1651,07/07/1993,22,0,0,0,0,185,80,1,3,3,2,2,4,3,1,3,2,1,2,5,11,12,12,4,12,2,2,2,5,4,2,12,6,11,6,9,5,5,8,4,13,10,12,4,4,5,12,11,5,11,8,13,12,20,10,8,8,8,5,5,8,12,13,11,10,9,1,19,7,S ,1,1,20,1,1,1,1,1,1,1,1,1,1,1,1
19212302,Rennan Oliveira,1651,01/08/1991,24,0,0,0,0,178,74,1,2,1,2,3,3,2,3,2,3,4,14,13,12,8,12,13,8,12,2,6,12,6,7,12,5,12,9,9,9,12,12,3,12,6,10,7,9,11,14,12,9,9,5,12,14,20,8,8,8,10,10,10,10,18,9,10,10,12,8,14,5,AM LC,1,1,5,20,15,10,1,1,1,1,15,10,5,1,1
19212524,Gustavo Sauer,1651,30/04/1993,23,0,0,0,0,179,72,3,1,2,1,3,3,1,3,2,3,2,9,13,15,7,15,11,7,11,8,9,9,5,11,15,10,12,9,8,11,10,14,2,13,8,11,9,9,10,8,12,10,10,20,12,12,11,15,9,10,10,6,10,10,16,11,12,13,10,2,3,8,M/AM LC,1,1,1,15,18,1,1,7,1,1,8,20,1,13,1
19212525,Willian Popp,1651,13/04/1994,22,0,0,0,0,188,73,1,2,1,1,3,3,2,4,3,1,2,7,10,14,11,14,9,14,8,6,9,11,7,10,14,7,7,10,13,8,9,13,4,13,4,14,10,9,10,14,13,10,14,11,7,14,20,10,10,12,9,11,9,11,14,12,9,10,11,7,9,6,S ,1,1,20,1,1,1,1,1,1,1,1,1,1,1,1
19212526,Caíque,1651,10/03/1994,22,0,0,0,0,187,82,3,1,3,1,2,1,1,1,4,3,2,5,4,5,1,12,5,5,5,2,6,11,3,11,8,8,10,6,6,6,3,13,3,7,5,5,11,7,9,13,12,5,13,8,11,13,20,5,12,8,8,5,8,8,18,11,10,10,10,2,5,5,DM ,1,1,1,1,1,1,12,1,1,20,10,1,1,1,1
19212657,Élson,1651,21/11/1994,21,0,0,0,0,175,0,2,2,2,1,3,3,2,3,3,4,1,2,5,11,13,13,5,13,4,5,5,6,8,2,9,4,6,3,12,5,5,11,8,9,9,10,5,5,6,13,10,6,3,10,10,12,20,8,5,8,6,8,8,8,20,10,11,11,12,10,8,5,S ,1,1,20,1,1,1,1,1,1,1,1,1,1,1,1
19212658,Nathan,1651,13/05/1995,21,0,0,0,0,188,76,1,1,1,2,3,3,1,1,2,2,4,6,7,8,7,10,8,12,6,8,12,11,8,12,10,12,12,13,12,12,8,12,20,9,9,9,12,12,12,13,9,8,14,8,12,13,20,13,12,12,14,8,12,8,15,14,14,11,12,9,3,2,D C,1,1,1,1,1,1,20,1,11,1,1,1,1,1,1
19212659,João Pedro,1651,15/11/1996,19,0,0,0,0,179,71,3,3,1,3,1,3,1,1,1,1,1,10,12,12,10,12,9,6,9,9,12,12,8,11,12,10,12,11,12,11,12,11,8,12,5,12,11,12,12,15,13,12,9,9,14,15,20,14,7,12,11,10,9,10,10,11,10,12,15,8,8,7,D/WB R,1,1,1,1,1,1,1,8,20,1,1,1,1,4,18
19212661,Vinícius Del'Amore,1651,05/01/1997,19,0,0,0,0,195,84,3,1,2,4,1,3,2,3,1,1,2,1,1,1,1,7,1,13,4,4,13,7,3,13,5,8,7,9,7,5,4,6,12,1,7,6,13,6,7,13,10,7,15,9,16,12,20,9,13,9,6,1,9,9,14,12,10,11,10,1,10,3,D C,1,1,1,1,1,1,20,1,1,1,1,1,1,1,1
19212662,Lucas Macedo,1651,30/03/1997,19,0,0,0,0,180,0,2,2,2,4,1,2,3,2,2,1,1,4,2,8,8,12,4,12,4,1,3,2,4,1,8,8,8,5,12,3,5,10,1,9,11,11,3,4,5,12,12,5,7,9,13,12,20,7,5,8,8,1,8,8,11,11,13,12,12,8,1,7,S ,1,1,20,1,1,1,1,1,1,1,1,1,1,1,1
19212665,Chistopher,1651,22/01/1995,21,0,0,0,0,171,63,1,1,2,4,1,4,2,2,2,2,4,8,13,11,12,13,7,5,9,6,6,12,4,6,12,9,5,4,9,3,5,8,2,12,9,11,7,8,10,13,12,10,7,20,6,13,15,10,6,9,9,9,8,9,7,12,10,10,13,8,11,7,M/AM RLC,1,1,10,16,17,20,1,1,1,1,10,10,16,1,1
19212666,Daniel,1651,13/05/1996,20,0,0,0,0,171,0,3,1,1,2,3,4,3,3,2,1,2,4,6,7,7,13,6,6,13,3,9,13,6,13,13,9,11,8,4,8,10,13,9,9,13,4,5,7,11,13,11,7,4,8,16,10,20,7,5,9,5,6,9,9,18,11,10,12,12,7,7,3,DM ,1,1,1,10,1,1,1,1,1,20,13,1,1,1,1
19212668,Gabriel Dias,1651,10/05/1994,22,0,0,0,0,183,79,3,3,1,2,1,2,3,2,2,3,1,8,6,7,10,12,9,11,9,8,12,15,4,15,8,3,8,10,11,12,9,15,6,6,13,10,11,10,9,8,12,10,12,11,11,10,20,8,9,10,7,10,6,13,10,11,11,10,11,8,14,1,D/DM/M C,1,1,1,5,1,1,19,1,11,20,17,1,5,1,7
19212791,Valber,1651,17/08/1995,20,0,0,0,0,176,71,2,3,3,1,2,3,2,3,2,1,1,4,5,11,12,10,4,12,2,1,2,6,4,1,7,8,7,7,6,4,6,7,3,8,7,10,4,4,6,12,12,11,5,10,10,12,20,5,4,7,8,1,4,7,12,13,8,15,11,4,9,4,S ,1,1,20,13,1,1,1,1,1,1,6,1,1,1,1
19212792,Robson Quintanilha,1651,06/07/1992,23,0,0,0,0,173,72,1,3,2,3,1,3,3,2,1,2,2,6,6,8,8,12,6,6,9,1,7,13,4,8,13,13,9,6,8,7,9,11,5,13,12,11,7,7,11,13,12,12,5,6,14,10,20,13,8,9,12,9,8,9,8,13,12,11,10,1,10,1,AM C,1,1,1,20,1,1,1,1,1,1,15,1,1,1,1
19212859,Mateus Lima,1651,18/01/1993,23,0,0,0,0,187,0,3,3,1,1,2,2,1,3,1,2,3,10,8,13,12,11,10,11,11,3,10,11,8,7,15,10,11,8,11,11,11,11,10,12,6,12,11,8,11,11,12,11,14,8,11,11,20,10,10,10,8,4,10,10,14,9,11,12,11,9,8,6,S ,1,1,20,1,1,1,1,1,1,1,1,1,1,1,1
19212871,Matheus Gutz,1651,01/02/1996,20,0,0,0,0,188,0,9,7,7,3,12,9,8,12,3,7,6,3,2,3,1,1,6,1,2,1,2,1,1,3,4,8,8,11,5,7,4,12,4,1,11,1,12,5,4,9,11,3,7,12,13,9,20,1,8,8,7,8,8,8,17,10,13,11,9,10,10,4,GK ,20,1,1,1,1,1,1,1,1,1,1,1,1,1,1
19213268,Bruno Souto,1651,15/10/1996,19,0,0,0,0,170,67,2,1,2,1,3,1,1,2,2,3,2,6,8,14,14,13,8,10,7,3,5,14,8,8,10,7,9,9,12,6,14,14,12,10,12,14,9,9,10,14,14,5,3,9,16,14,20,6,7,5,7,10,9,9,19,9,11,13,12,2,7,4,AM C,1,1,15,20,1,1,1,1,1,1,15,1,1,1,1
19213297,Renato Kayser,1651,17/02/1996,20,0,0,0,0,178,68,1,2,3,3,1,3,2,4,3,2,3,6,7,11,12,9,5,9,9,2,3,11,9,4,12,10,11,12,10,9,12,10,13,14,7,10,7,9,11,12,9,10,9,17,13,12,20,11,10,10,7,10,6,10,18,13,12,10,14,8,9,8,AM/S LC,1,1,20,15,16,14,1,1,1,1,1,1,1,1,1
19213408,Igor Carioca,1651,21/08/1996,19,0,0,0,0,173,66,3,3,3,2,1,1,2,1,1,1,1,10,10,11,8,11,9,8,10,9,10,9,8,9,12,11,12,11,12,10,8,9,13,11,7,8,10,11,14,13,14,7,7,8,14,13,20,13,6,10,6,10,10,14,16,13,12,14,13,13,14,6,D/WB/M R,1,1,1,1,1,10,1,1,19,1,1,1,16,1,20
19213908,Alef,1651,29/04/1997,19,0,0,0,0,181,0,1,1,3,3,2,3,2,3,2,2,1,7,6,7,6,14,7,7,14,4,11,14,4,14,10,8,10,8,8,5,10,12,9,9,13,7,14,8,8,12,13,8,10,3,11,14,20,7,8,9,9,7,9,9,14,12,9,13,12,4,7,2,DM ,1,1,1,1,1,1,1,1,1,20,10,1,1,1,1
19214281,Cácio,1651,09/12/1991,24,0,0,0,0,180,0,2,3,2,1,3,2,4,1,1,3,1,4,1,1,1,8,1,13,7,4,10,8,1,14,4,9,10,9,7,12,4,14,3,7,9,7,10,7,8,14,14,8,6,8,15,14,20,8,8,9,8,2,9,9,13,10,10,11,11,8,9,8,D C,1,1,1,1,1,1,20,1,1,1,1,1,1,1,1
19214639,Iago,1651,21/05/1995,21,0,0,0,0,172,68,3,4,3,1,3,1,2,2,2,2,3,11,12,13,8,12,11,9,10,13,11,12,11,10,13,10,12,11,10,11,12,12,13,15,13,13,11,12,13,14,13,9,10,20,18,14,11,13,7,12,9,6,6,15,12,11,9,11,12,5,17,8,D L,1,1,1,10,10,1,1,20,1,1,10,13,1,15,1
19214764,Índio Oliveira,1651,01/02/1994,22,0,0,0,0,183,0,1,1,1,3,2,1,3,2,2,1,1,7,8,12,13,12,6,14,8,1,7,5,2,3,10,9,11,5,7,7,6,10,9,9,10,14,6,7,8,14,13,4,11,9,13,13,20,7,7,6,7,9,8,9,11,9,11,10,2,3,11,3,S ,1,1,20,1,1,1,1,1,1,1,1,1,1,1,1
19214768,Rafael Assis,1651,02/04/1993,23,0,0,0,0,177,62,3,2,3,1,1,2,3,1,2,3,2,8,11,13,7,12,8,6,8,5,6,12,7,4,14,8,9,8,9,9,10,9,4,14,6,12,8,9,7,13,13,7,5,8,14,12,20,8,8,7,9,7,7,12,9,12,11,11,11,6,5,4,AM RLC,1,1,1,17,17,20,1,1,1,1,10,1,1,1,1
19215315,Bruno,1651,11/11/1988,27,0,0,0,0,186,0,1,1,2,4,3,3,1,2,3,1,3,4,6,7,7,12,6,6,13,4,7,13,1,8,13,6,7,7,8,8,11,7,3,9,4,7,13,7,9,13,11,7,7,10,13,11,20,7,10,9,9,9,4,9,13,10,12,13,11,11,16,5,DM C,1,1,1,1,1,1,1,1,1,20,15,1,1,1,1
19215330,Juninho Potiguar,1651,22/02/1990,26,0,0,0,0,177,75,3,2,1,2,2,2,2,3,3,3,3,8,6,13,14,13,8,13,6,5,7,9,10,2,13,11,13,7,12,7,9,8,20,13,10,11,9,8,8,13,13,9,8,10,12,13,20,13,10,11,7,11,11,11,16,13,14,13,12,7,12,5,S ,1,1,20,1,1,1,1,1,1,1,1,1,1,1,1
19215331,Bocão,1651,03/11/1992,23,0,0,0,0,179,64,2,1,2,2,1,2,1,2,2,3,3,7,12,13,7,5,7,5,4,13,8,12,5,8,13,8,11,11,11,12,12,11,11,12,8,13,11,13,13,14,13,12,7,11,13,14,20,15,8,11,9,10,6,11,11,10,10,11,11,12,10,9,D/WB R,1,1,1,1,1,1,1,1,20,1,1,1,13,1,18
19215469,Tassio,1651,01/03/1993,23,0,0,0,0,179,67,3,3,3,1,3,3,2,2,3,1,4,7,11,11,7,15,5,8,3,7,10,6,2,13,11,6,9,8,8,13,11,12,4,13,4,7,10,9,10,15,13,5,7,20,11,13,10,6,6,9,9,6,9,9,14,10,12,12,10,11,7,3,D L,1,1,1,1,13,1,1,20,1,1,1,13,1,13,1
19215470,Rafael Vicentini,1651,24/02/1995,21,0,0,0,0,176,66,3,1,2,1,1,3,2,2,1,2,2,6,6,8,8,11,6,6,11,1,6,13,4,6,13,5,8,3,4,8,9,13,3,13,8,9,8,8,10,13,8,8,5,9,8,11,20,7,4,9,3,9,9,9,9,13,10,11,13,3,8,1,M/AM C,1,1,1,20,1,1,1,1,1,1,17,1,1,1,1
19215471,Matheus,1651,22/03/1996,20,0,0,0,0,175,0,1,2,3,1,2,2,3,1,2,2,3,7,7,13,13,13,7,13,6,1,6,11,6,8,13,6,11,9,10,8,10,13,10,13,12,8,8,8,9,11,13,6,6,8,9,13,20,13,8,10,4,10,8,10,11,10,10,11,12,9,17,2,AM/S C,1,1,17,20,1,1,1,1,1,1,1,1,1,1,1
19215472,Eduardo,1651,01/05/1996,20,0,0,0,0,187,0,4,3,2,3,3,2,2,2,3,3,3,7,6,9,9,14,7,7,13,5,5,14,4,7,13,4,5,7,6,4,7,14,8,12,1,5,5,6,11,14,8,9,9,8,9,12,20,7,8,9,5,7,7,9,15,12,9,9,12,1,15,1,M/AM C,1,1,1,20,1,1,1,1,1,1,17,1,1,1,1
19215474,Dejair,1651,30/11/1994,21,0,0,0,0,186,0,2,4,2,1,3,2,2,3,2,1,1,6,8,4,10,14,5,8,8,5,13,14,6,14,11,9,12,9,10,6,9,13,9,10,13,10,10,10,13,14,12,10,14,2,9,13,20,10,11,10,3,8,10,10,11,12,11,12,10,3,12,4,DM/M C,1,1,1,1,1,1,1,1,1,17,20,1,1,1,1
19215475,Cassius,1651,15/06/1995,21,0,0,0,0,184,0,3,2,3,1,1,2,1,2,2,4,2,1,4,6,7,8,1,14,7,5,14,8,1,13,6,9,9,7,8,7,4,14,3,5,13,7,13,7,8,10,10,8,6,12,12,13,20,5,10,9,9,9,6,9,18,10,11,12,10,5,8,1,D C,1,1,1,1,1,1,20,1,1,1,1,1,1,1,1
19215476,Luan Peres,1651,19/07/1994,21,0,0,0,0,180,0,3,1,2,3,1,3,1,2,2,2,1,6,7,5,8,12,6,13,8,11,13,11,7,14,11,14,13,13,11,12,10,13,11,10,14,12,10,14,13,12,12,12,13,20,13,12,1,13,13,13,14,10,10,13,13,11,12,11,9,4,11,1,D/WB LC,1,1,1,1,1,1,20,19,1,1,1,1,1,17,1
19215477,Andrezinho,1651,21/04/1997,19,0,0,0,0,179,72,1,3,1,1,3,4,1,3,2,1,1,8,5,14,10,14,8,14,9,3,6,9,4,1,14,10,14,7,9,4,8,13,4,13,11,14,8,8,9,14,14,8,5,20,10,14,10,8,8,10,8,10,10,10,7,13,10,13,12,4,14,3,S ,1,1,20,1,1,1,1,1,1,1,1,1,1,1,1
19215493,César,1651,28/12/1992,23,0,0,0,0,190,83,2,4,1,1,2,1,2,1,3,1,2,5,7,9,9,10,7,14,10,10,13,10,10,13,9,14,14,14,13,10,11,11,11,11,10,11,12,12,12,12,12,14,13,12,15,13,20,16,12,11,13,11,8,6,12,12,10,12,12,10,16,2,D C,1,1,1,1,1,1,20,1,5,1,1,1,1,1,1
19215494,Rafinha,1651,21/06/1992,24,0,0,0,0,175,73,1,1,2,1,2,4,3,3,2,2,3,9,11,15,12,12,9,11,11,1,9,11,12,9,13,10,11,8,11,7,12,14,5,15,8,13,10,11,11,13,14,10,7,11,7,13,20,14,7,12,5,11,11,11,9,11,13,12,11,5,6,4,AM/S LC,1,1,17,20,17,1,1,1,1,1,1,1,1,1,1
19215512,Graxa,1651,08/10/1993,22,0,0,0,0,177,69,1,2,1,3,3,1,3,2,1,3,3,7,7,9,9,13,7,7,14,5,8,14,2,7,14,9,9,4,7,9,11,14,9,13,3,14,9,9,8,14,8,9,4,9,13,13,20,10,6,9,9,9,7,9,11,11,12,11,12,12,8,2,M/AM C,1,1,1,20,1,1,1,1,1,1,17,1,1,1,1
19215513,Vinicius,1651,04/05/1993,23,0,0,0,0,194,0,12,5,7,1,12,11,5,12,8,8,8,3,3,1,3,1,6,1,1,1,2,1,2,3,2,8,8,12,5,10,4,12,4,3,1,2,9,5,3,10,8,1,13,11,13,12,20,1,8,8,8,8,4,8,13,12,11,11,9,8,3,5,GK ,20,1,1,1,1,1,1,1,1,1,1,1,1,1,1
19215517,Romário,1651,25/12/1988,27,0,0,0,0,176,0,3,3,3,2,1,2,1,2,3,2,1,8,9,12,12,13,8,10,7,8,8,10,9,5,10,9,10,7,14,6,9,12,3,12,12,12,6,11,13,14,14,7,6,2,11,14,20,12,4,10,10,10,10,10,8,12,11,11,11,1,13,3,AM/S L,1,1,17,13,20,13,1,1,1,1,1,1,1,1,1
19215518,João Paulo,1651,23/04/1990,26,0,0,0,0,185,78,3,4,2,3,1,1,3,3,1,2,3,8,5,7,5,12,8,8,13,4,9,14,1,14,9,7,12,9,6,8,7,12,10,8,9,7,11,7,11,13,13,9,8,14,10,13,20,7,6,10,6,5,5,10,14,10,12,11,12,4,15,5,DM/M C,1,1,1,1,1,1,1,4,7,20,19,1,6,1,1
19215530,Wesley Matos,1651,08/04/1986,30,0,0,0,0,183,80,4,1,1,2,3,3,2,2,1,2,2,2,2,9,7,10,2,14,7,9,13,10,5,14,9,8,2,12,10,13,12,13,12,6,13,7,14,13,15,13,11,14,15,20,13,13,11,14,13,12,9,12,11,11,10,10,12,12,12,12,4,12,D C,1,1,1,1,1,1,20,1,1,1,1,1,1,1,1
19215556,Rodrigo Viana,1651,14/11/1989,26,0,0,0,0,183,79,14,12,11,1,14,11,12,13,8,10,9,4,3,2,2,5,7,1,2,3,1,1,3,1,4,4,9,11,7,9,8,14,4,3,13,2,11,9,8,13,10,9,12,20,17,11,11,3,9,10,7,10,10,10,7,9,10,9,11,3,8,2,GK ,20,1,1,1,1,1,1,1,1,1,1,1,1,1,1
19215559,Felipe Hereda,1651,10/09/1992,23,0,0,0,0,177,72,3,3,3,1,1,3,2,1,1,2,3,7,5,8,8,12,7,7,12,3,9,13,6,14,14,5,13,8,8,8,9,14,9,1,7,8,11,8,12,11,13,8,5,9,11,14,20,8,7,9,9,9,4,9,17,12,15,10,10,1,19,8,DM C,1,1,1,1,1,1,1,1,1,20,15,1,1,1,1
19215560,Gustavinho,1651,31/08/1993,22,0,0,0,0,174,71,2,3,2,1,3,3,3,3,2,1,2,7,5,14,12,14,7,14,8,3,7,4,4,1,12,9,13,8,7,8,3,8,4,11,4,10,7,7,8,14,13,8,7,15,7,14,20,8,7,9,9,5,9,9,14,11,13,10,14,8,11,3,S ,1,1,20,1,1,1,1,1,1,1,1,1,1,1,1
19215562,Allan,1651,17/04/1994,22,0,0,0,0,191,0,1,1,1,4,2,3,2,3,3,2,4,7,7,6,8,13,7,7,9,4,7,14,4,13,9,9,10,8,8,7,14,14,9,9,11,8,6,8,12,14,10,3,16,9,13,12,20,8,10,9,9,9,5,9,8,9,9,10,9,1,18,4,DM C,1,1,1,1,1,1,1,1,1,20,15,1,1,1,1
19215563,Polidoro,1651,12/09/1996,19,0,0,0,0,194,90,2,2,1,3,2,2,1,3,1,1,3,3,2,2,1,7,5,10,5,1,8,6,1,12,5,9,4,6,4,6,6,12,7,6,8,3,12,5,7,12,8,2,15,9,14,7,20,6,15,9,9,9,5,9,10,10,12,12,9,2,7,5,D C,1,1,1,1,1,1,20,1,1,15,5,1,1,1,1
19215564,Bismark,1651,12/07/1993,22,0,0,0,0,169,69,4,3,3,4,1,1,1,2,1,3,1,8,7,14,14,14,8,10,8,4,8,14,8,5,14,10,10,6,6,8,13,14,2,13,11,8,10,9,10,14,14,9,5,10,15,14,20,6,7,10,10,1,7,10,10,11,11,13,11,3,12,1,AM/S C,1,1,18,20,1,1,1,1,1,1,13,1,1,1,1
19215565,Bruno Pereira,1651,22/06/1996,20,0,0,0,0,179,0,2,1,3,3,2,3,1,3,1,4,1,8,9,14,15,9,8,15,9,5,8,10,5,3,11,9,9,6,9,7,8,12,8,9,13,7,9,8,6,11,13,9,8,8,12,12,20,8,9,9,6,4,4,9,18,12,10,9,12,6,1,2,S C,1,1,20,15,1,1,1,1,1,1,1,1,1,1,1
19215566,Danilo,1651,23/06/1995,21,0,0,0,0,180,0,3,2,2,3,1,3,1,2,3,1,3,4,3,12,14,14,7,13,9,2,6,9,8,7,9,8,10,5,11,8,7,6,6,9,9,14,7,7,9,14,14,8,7,1,11,14,20,7,6,9,3,9,9,9,20,12,9,11,10,11,14,6,S C,1,1,20,15,1,1,1,1,1,1,1,1,1,1,1
19215567,Joanderson,1651,16/02/1996,20,0,0,0,0,180,74,2,3,3,3,2,2,1,2,2,2,1,9,11,13,12,15,9,11,12,5,8,12,9,7,12,10,12,9,12,9,13,10,10,13,8,11,10,10,11,14,12,11,8,20,13,13,10,12,9,10,4,10,10,10,8,9,14,14,9,9,3,7,AM/S L,1,1,20,14,16,1,1,1,1,1,1,11,1,1,1
19215568,Leonardo Prado,1651,14/05/1996,20,0,0,0,0,185,0,3,2,2,2,1,1,1,2,1,2,1,8,7,12,11,12,8,9,12,5,7,13,5,7,13,9,8,8,7,7,14,12,2,13,7,8,9,9,7,11,12,12,14,20,9,11,10,8,11,10,9,4,9,9,18,12,8,11,11,8,16,8,AM C,1,1,1,20,1,1,1,1,1,1,15,1,1,1,1
19215569,Vencato,1651,20/01/1996,20,0,0,0,0,189,0,4,1,3,2,2,1,3,1,2,2,2,5,2,3,1,5,3,14,5,4,14,7,1,14,7,9,13,9,4,9,4,14,7,7,8,5,13,6,8,8,11,8,14,8,16,8,20,4,12,9,5,5,9,9,9,11,12,9,11,9,10,4,D C,1,1,1,1,1,1,20,1,1,1,1,1,1,1,1
19215570,Valença,1651,20/12/1996,19,0,0,0,0,190,0,3,2,1,3,4,3,2,2,2,1,3,5,3,1,2,8,3,13,3,1,13,7,1,13,6,8,10,10,6,9,7,13,3,1,5,7,13,7,8,13,11,8,12,3,11,12,20,7,10,10,8,1,10,9,20,11,11,13,12,9,13,1,D C,1,1,1,1,1,1,20,1,1,1,1,1,1,1,1
19215571,Lucas Kal,1651,16/03/1996,20,0,0,0,0,185,78,3,2,3,3,1,2,1,1,2,3,3,3,6,1,5,8,1,7,5,5,13,7,2,13,7,10,13,10,8,7,1,13,15,1,10,5,13,7,8,9,9,8,13,10,15,10,20,8,8,10,9,9,10,10,17,10,9,10,12,7,9,5,D C,1,1,1,1,1,1,20,1,1,1,1,1,1,1,1
19215572,Luiz Araújo,1651,02/06/1996,20,0,0,0,0,175,67,3,3,3,1,2,2,2,3,2,2,2,10,13,14,11,12,8,8,11,8,8,12,10,10,12,12,12,11,11,8,13,11,9,14,10,12,10,11,12,13,15,11,7,20,12,14,11,11,8,13,5,10,7,11,7,10,11,11,10,5,15,2,AM RL,1,1,12,14,17,20,1,1,1,1,1,1,1,1,1
19215573,Bernardinetti,1651,26/03/1996,20,0,0,0,0,176,0,2,3,3,1,2,3,4,1,3,1,2,6,7,9,9,14,7,7,10,2,7,12,4,7,14,4,6,8,5,7,12,13,9,13,11,5,9,8,13,14,9,8,7,1,10,12,20,10,5,9,9,7,9,9,11,9,12,11,7,2,5,8,AM C,1,1,1,20,1,1,1,1,1,1,15,1,1,1,1
19215574,Robertinho,1651,22/02/1996,20,0,0,0,0,178,67,2,1,3,2,3,3,3,2,4,3,3,8,8,11,9,11,9,8,9,6,10,11,9,9,12,10,9,10,9,9,10,9,9,12,5,10,10,11,12,13,13,12,9,7,13,13,20,12,7,12,8,9,5,12,17,11,13,12,11,8,9,4,DM/M C,1,1,1,13,1,1,1,1,1,18,20,1,1,1,1
19215575,Silas,1651,27/07/1995,20,0,0,0,0,182,0,2,1,3,3,2,2,2,2,3,1,3,3,6,5,5,9,1,14,2,1,14,9,5,14,5,10,12,10,9,8,7,14,1,2,11,8,14,8,9,14,12,9,6,8,7,12,20,7,10,4,5,3,7,9,16,11,13,12,9,4,12,7,D C,1,1,1,1,1,1,20,1,1,1,1,1,1,1,1
19215576,Tormena,1651,04/01/1996,20,0,0,0,0,191,75,3,3,4,2,2,1,2,1,3,3,3,3,2,7,7,8,1,12,2,3,12,11,7,13,7,4,14,9,3,8,1,14,4,8,1,7,14,7,8,9,9,8,13,9,11,12,20,5,9,9,9,7,8,9,17,12,9,11,11,10,12,1,D C,1,1,1,1,1,1,20,1,1,1,1,1,1,1,1
19215610,Niltinho,1651,11/09/1993,22,0,0,0,0,175,70,1,1,3,1,1,2,2,3,2,2,1,11,12,12,11,11,11,6,11,6,8,12,10,9,12,13,11,11,12,11,12,11,3,13,7,11,10,9,13,13,14,14,7,20,15,13,9,11,7,12,14,9,11,13,10,11,12,11,11,10,5,5,WB/M/AM L,1,1,14,11,20,1,1,15,1,1,1,18,1,17,1
19215802,Rômulo,1651,19/04/1990,26,0,0,0,0,184,74,2,2,2,1,1,4,1,2,2,3,2,3,9,12,13,13,5,12,13,4,6,11,12,6,13,10,11,8,9,7,12,9,9,14,4,13,7,11,8,13,12,12,12,20,10,12,10,13,12,12,5,11,6,5,6,9,12,5,13,10,12,7,S ,1,1,20,1,14,10,1,1,1,1,1,1,1,1,1
19215958,Lucas Fernandes,1651,24/04/1994,22,0,0,0,0,174,70,1,1,1,1,1,1,1,2,3,2,1,11,12,13,11,15,5,15,10,4,9,12,6,8,12,10,12,7,10,10,10,8,6,10,2,12,9,10,11,13,14,12,7,10,11,13,20,13,9,10,10,10,10,10,13,10,12,14,14,1,10,6,AM/S R,1,1,20,1,1,18,1,1,1,1,1,1,13,1,1
19215961,Cassiano,1651,20/07/1993,22,0,0,0,0,185,0,4,2,4,3,2,1,3,2,3,2,1,7,7,9,9,14,7,5,11,4,7,7,5,7,14,9,8,8,5,8,7,11,4,13,3,10,9,8,11,14,9,7,13,3,12,13,20,8,8,9,9,9,5,9,17,9,13,9,10,12,10,7,AM C,1,1,1,20,1,1,1,1,1,1,15,1,1,1,1
19215962,Acácio,1651,02/09/1993,22,0,0,0,0,177,76,1,3,3,3,1,3,3,1,2,1,3,4,4,8,7,14,2,7,6,8,10,8,8,11,9,10,9,10,10,8,5,14,2,9,11,7,8,10,9,14,14,10,9,20,11,14,10,11,7,10,8,10,10,10,16,11,12,11,12,6,9,5,D/WB L,1,1,1,1,1,1,1,20,1,1,1,1,1,17,1
19216415,Christian,1651,14/06/1989,27,0,0,0,0,182,80,1,1,1,3,2,2,2,3,2,1,3,16,16,12,9,14,15,9,14,6,8,14,14,10,15,8,8,7,13,11,13,13,8,11,8,10,8,12,7,11,12,13,10,20,11,11,10,10,13,12,3,7,8,10,10,12,8,11,11,12,7,6,DM/M C,1,1,1,10,1,1,1,13,1,20,20,1,1,10,1
19216424,Cristovam,1651,25/07/1990,25,0,0,0,0,176,0,3,3,3,1,1,4,1,1,3,2,2,5,6,8,7,11,2,9,5,4,8,9,6,10,10,9,8,9,10,9,10,8,7,9,11,8,9,10,10,15,15,10,7,10,9,15,20,12,6,9,8,9,9,9,9,12,11,9,12,1,7,5,D/WB R,1,1,1,1,1,1,1,1,20,1,1,1,1,1,17
19216507,Alexandre Caxambu,1651,31/08/1993,22,0,0,0,0,171,64,4,2,3,3,1,2,2,3,1,1,1,7,7,8,4,9,2,8,5,6,10,8,4,13,10,8,6,10,9,9,8,15,6,4,13,7,6,9,9,14,11,9,5,7,16,10,20,11,7,9,9,9,6,9,20,10,9,12,10,6,10,8,D/WB R,1,1,1,1,1,1,1,1,20,1,1,1,1,1,18
19216532,Juliano,1651,13/10/1986,29,0,0,0,0,182,83,3,2,2,2,1,3,1,1,2,1,3,5,1,2,5,8,3,14,2,6,13,9,4,13,7,10,12,10,9,9,5,14,4,7,14,7,14,7,9,14,13,9,12,1,10,14,20,9,14,10,10,3,10,10,10,11,12,12,11,4,12,6,D C,1,1,1,1,1,1,20,1,1,1,1,1,1,1,1
19216644,Allan Vieira,1651,14/07/1990,25,0,0,0,0,184,79,2,1,4,2,2,2,3,3,2,1,3,10,10,8,6,12,6,14,10,12,14,11,5,14,10,11,12,12,11,11,10,10,10,11,10,11,12,12,12,12,13,11,13,20,13,12,11,12,13,10,12,10,3,12,11,9,10,10,13,4,9,2,D/WB L,1,1,1,1,1,1,10,20,1,1,1,1,1,18,1
19216808,Igor,1651,01/04/1989,27,0,0,0,0,191,76,13,10,7,1,13,13,12,9,8,3,10,5,3,1,1,1,8,1,3,1,1,1,2,3,4,6,7,10,6,9,6,13,9,3,12,3,8,7,6,12,8,7,14,9,4,13,20,4,11,9,9,9,7,9,16,11,11,10,11,3,16,2,GK ,20,1,1,1,1,1,1,1,1,1,1,1,1,1,1
19216809,Rodrigo Jesus,1651,02/10/1990,25,0,0,0,0,178,79,3,3,3,2,3,2,2,1,1,2,3,6,7,13,13,13,6,11,8,1,4,7,11,2,9,7,10,7,13,7,6,11,4,9,8,10,7,6,8,13,13,7,8,8,13,13,20,13,7,9,7,6,9,9,12,11,10,8,10,5,3,5,S ,1,1,20,13,1,1,1,1,1,1,1,1,1,1,1
19216898,Giovani,1651,01/12/1994,21,0,0,0,0,189,90,3,1,3,1,3,1,3,2,2,1,1,4,1,11,12,12,4,11,1,1,2,1,9,1,12,8,9,3,3,5,4,5,8,13,13,12,4,4,5,11,8,3,12,14,8,11,20,5,12,8,8,8,8,8,14,11,9,11,10,5,11,7,S ,1,1,20,1,1,1,1,1,1,1,1,1,1,1,1
19216899,Willian,1651,13/11/1996,19,0,0,0,0,183,0,3,2,2,3,3,1,2,3,2,2,1,1,3,1,1,5,4,11,3,2,12,6,1,12,3,6,3,7,3,6,1,10,5,2,11,4,12,4,6,11,10,5,10,7,3,12,20,5,8,8,7,8,7,8,8,11,10,12,9,2,8,7,D C,1,1,1,1,1,1,20,1,1,15,5,1,1,1,1
19216900,Barreto,1651,10/12/1995,20,0,0,0,0,181,78,1,1,1,2,2,3,1,3,2,2,4,8,10,10,7,11,10,11,9,6,12,11,9,11,11,13,11,11,12,12,10,11,5,10,7,9,12,15,12,12,12,10,11,9,8,13,20,13,12,11,14,11,6,13,7,11,11,9,12,5,10,6,DM ,1,1,1,6,1,1,7,1,1,20,12,1,1,1,1
19216901,Pacheco,1651,05/06/1991,25,0,0,0,0,172,0,1,3,2,2,3,2,1,4,2,2,1,9,9,8,8,11,6,10,6,9,11,10,6,14,8,10,11,10,10,8,8,12,8,2,9,9,10,10,11,14,14,11,5,11,16,13,20,14,7,10,10,10,6,10,20,9,9,11,11,1,2,2,D/WB R,1,1,1,1,1,1,1,1,20,1,1,1,1,1,17
19216902,Cleber,1651,23/02/1996,20,0,0,0,0,170,65,4,2,1,2,2,3,1,1,3,1,2,1,2,11,12,12,3,11,4,1,1,4,8,1,12,7,9,5,10,1,3,6,3,13,2,12,4,3,4,12,12,4,3,9,13,10,20,3,6,7,7,7,7,6,20,11,13,12,9,11,11,4,S ,1,1,20,1,1,1,1,1,1,1,1,1,1,1,1
19216903,Maidana,1651,06/02/1996,20,0,0,0,0,194,85,1,1,3,1,3,3,3,1,3,2,1,3,5,2,3,10,1,12,9,3,14,9,4,15,6,7,13,11,10,8,6,15,3,1,8,9,14,9,10,11,14,10,12,10,10,12,20,11,11,10,6,8,3,10,12,12,12,11,9,10,3,4,D C,1,1,1,1,1,1,20,1,1,1,1,1,1,1,1
19217115,Marcinho,1651,24/03/1991,25,0,0,0,0,170,76,2,3,3,1,3,3,2,1,4,2,2,6,10,11,8,12,6,1,8,2,7,10,7,5,13,9,9,5,10,7,8,11,9,13,13,10,8,10,12,10,10,7,3,10,13,11,20,13,7,5,9,9,4,9,12,12,12,11,9,5,11,6,AM C,1,1,1,20,13,13,1,1,1,1,15,10,10,1,1
19217154,Alisson,1651,28/05/1994,22,0,0,0,0,188,0,3,3,3,1,2,2,2,2,2,1,3,5,1,1,1,6,1,8,1,5,13,6,1,13,5,8,8,8,5,5,4,12,5,1,9,4,13,5,6,13,11,6,11,8,8,12,20,3,10,8,8,7,7,8,10,11,10,11,10,1,15,3,D C,1,1,1,1,1,1,20,1,1,1,1,1,1,1,1
19217156,Francis,1651,16/04/1990,26,0,0,0,0,180,78,1,2,3,3,2,2,2,2,1,3,3,8,12,13,9,11,8,9,7,6,8,11,12,9,12,11,12,12,12,10,11,11,12,13,8,13,9,9,14,14,13,13,10,5,12,13,20,12,11,12,7,3,4,10,8,11,11,10,13,12,12,8,AM/S RL,1,1,20,13,17,17,1,1,13,1,1,1,14,1,10
19217382,Luquinhas,1651,24/01/1991,25,0,0,0,0,170,62,3,2,3,1,2,1,2,3,1,3,2,7,5,13,13,11,7,12,8,4,5,8,3,1,10,10,11,8,10,8,7,10,2,10,9,12,5,4,8,13,13,15,5,10,8,13,20,13,9,10,9,10,5,10,11,11,9,12,11,2,17,2,S ,1,1,20,1,1,1,1,1,1,1,1,1,1,1,1
19217413,Gérson,1651,20/05/1997,19,0,0,8,0,180,69,1,3,3,1,1,1,1,1,2,3,3,12,13,15,11,16,10,9,12,9,8,14,10,7,18,8,12,9,12,10,15,12,10,16,8,13,7,12,11,12,15,9,10,20,13,13,12,11,10,9,6,12,8,12,18,15,12,10,12,7,10,6,M/AM RLC,1,1,1,18,16,18,1,1,1,12,20,10,10,1,1
19217416,Lucas Michel,1651,10/04/1994,22,0,0,0,0,170,60,1,2,3,4,3,1,1,2,2,3,1,9,9,11,10,15,9,13,7,8,9,7,4,6,14,6,15,6,9,5,10,11,10,12,14,15,10,9,10,11,13,10,4,20,11,13,10,11,9,10,5,10,6,10,17,11,11,10,13,5,3,7,S ,1,1,20,1,1,1,1,1,1,1,1,1,1,1,1
19217452,Marcos Vinícius,1651,15/07/1996,19,0,0,0,0,178,73,1,2,4,1,3,2,2,2,3,3,1,5,7,7,5,14,7,7,11,5,7,11,2,12,14,9,7,8,6,8,11,14,9,3,9,7,8,8,12,14,14,7,5,10,12,14,20,7,7,9,5,9,9,8,19,10,9,13,11,8,12,3,DM ,1,1,1,1,1,1,1,1,1,20,10,1,1,1,1
19217966,Reinaldo,1651,05/05/1987,29,0,0,0,0,184,0,2,3,4,3,3,2,3,3,2,3,3,5,3,1,5,7,2,14,4,8,10,9,4,14,8,5,11,10,9,9,3,14,1,2,9,5,14,8,9,14,14,9,6,8,11,14,20,11,12,10,10,4,8,10,20,12,12,13,13,7,9,7,D C,1,1,1,1,1,1,20,1,1,1,1,1,1,1,1
19217968,Héder,1651,03/03/1985,31,0,0,0,0,182,0,1,3,1,1,2,1,2,2,3,3,3,5,8,13,14,10,7,14,6,2,5,8,6,2,13,6,8,5,10,8,6,11,9,12,9,14,8,7,8,14,12,8,6,3,12,13,20,6,7,9,9,7,9,9,12,13,11,11,12,2,17,1,S ,1,1,20,1,1,1,1,1,1,1,1,1,1,1,1
19218034,Wanderson,1651,31/05/1992,24,0,0,0,0,182,80,1,3,3,3,1,3,2,2,2,4,2,10,11,12,11,12,7,7,7,6,7,11,13,5,12,9,11,6,12,11,11,11,10,9,7,12,13,8,8,15,13,12,10,10,13,14,20,12,9,12,10,1,10,13,18,11,12,11,12,4,9,5,S ,1,1,20,1,1,1,1,1,1,1,1,1,1,1,1
19218220,Patrick,1651,16/03/1988,28,0,0,0,0,174,72,2,3,4,3,1,2,1,2,2,3,1,7,5,9,7,13,7,7,10,4,8,13,4,7,13,9,10,8,14,8,10,12,3,12,5,9,9,8,7,14,14,8,4,9,11,14,20,12,6,9,9,9,8,9,11,12,11,11,11,5,7,4,M C,1,1,1,15,1,1,1,1,1,1,20,1,1,1,1
19218221,Jéferson Maranhense,1651,20/04/1989,27,0,0,0,0,174,73,3,2,3,3,3,3,2,3,1,2,3,8,13,12,11,10,6,5,2,5,6,3,8,9,11,8,10,12,11,11,11,9,11,7,5,13,11,13,13,13,14,13,8,20,11,14,9,13,8,10,7,9,8,12,14,12,10,9,10,1,6,3,AM L,1,1,15,1,20,1,1,1,1,1,1,13,1,1,1
19218386,Emanuel,1651,30/05/1995,21,0,0,0,0,187,0,2,3,2,4,2,3,2,3,1,3,1,5,8,8,8,15,8,9,10,7,9,10,5,14,13,10,11,10,10,7,8,15,2,10,10,9,11,10,9,12,11,10,10,12,11,9,20,8,10,10,9,4,10,10,9,12,13,11,13,13,4,2,DM ,1,1,1,1,1,1,1,1,1,20,10,1,1,1,1
19218542,Maicon Silva,1651,22/05/1988,28,0,0,0,0,184,77,1,3,1,2,4,1,1,3,3,3,3,10,12,11,11,13,10,12,11,10,12,12,8,11,12,10,11,10,11,8,10,10,9,11,6,12,12,12,12,14,12,11,11,5,12,14,20,14,14,12,11,9,6,10,9,12,12,11,12,6,8,4,D/WB R,1,1,1,1,1,1,1,1,20,1,1,1,1,1,19
19218554,Herminho,1651,01/02/1991,25,0,0,0,0,183,0,1,2,3,1,2,2,3,3,3,3,1,6,4,9,13,12,6,13,7,4,5,7,7,1,11,9,8,6,6,5,7,12,3,11,2,13,5,6,7,13,9,7,10,9,10,13,20,12,7,9,9,9,7,9,17,12,11,11,11,11,6,2,S ,1,1,20,1,1,1,1,1,1,1,1,1,1,1,1
19218697,Pery,1651,02/02/1986,30,0,0,0,0,176,72,3,2,3,3,2,1,2,2,3,1,4,11,13,12,6,6,7,5,7,14,11,12,6,11,12,12,12,12,13,12,12,12,11,10,11,14,10,13,13,13,12,9,9,20,12,12,12,13,9,10,6,12,6,10,11,12,12,13,9,6,10,8,D/WB L,1,1,1,1,1,1,1,20,1,1,1,15,1,19,1
19218703,Érico Júnior,1651,22/07/1993,22,0,0,0,0,175,71,2,1,2,2,4,1,1,3,3,1,1,7,8,13,13,13,7,13,8,4,6,5,4,1,13,6,12,7,12,5,6,11,2,13,4,13,7,7,9,13,13,8,7,10,10,13,20,6,7,10,7,6,10,10,12,10,11,9,11,6,4,4,AM/S R,1,1,20,1,1,18,1,1,1,1,1,1,1,1,1
19218705,Ikaro,1651,05/01/1996,20,0,0,0,0,175,75,2,3,4,4,1,2,2,3,3,1,1,7,9,10,10,10,8,10,15,5,11,10,7,10,11,10,11,10,10,10,12,9,12,13,7,8,10,10,11,11,11,10,5,10,11,12,20,11,10,10,12,3,10,14,20,12,7,12,12,9,1,13,DM/M C,1,1,1,1,1,1,1,1,1,19,20,1,1,1,1
19218707,Fernando Dinis,1651,10/04/1997,19,0,0,0,0,182,0,2,3,2,2,4,3,2,2,3,3,1,5,3,7,6,10,3,15,9,9,9,10,4,15,7,7,8,10,6,10,6,13,10,3,13,7,14,9,10,15,14,10,11,2,7,11,20,8,11,10,10,10,9,10,15,10,13,11,11,9,11,3,D C,1,1,1,1,1,1,20,1,1,1,1,1,1,1,1
19218814,Maikon Aquino,1651,14/05/1993,23,0,0,0,0,185,83,1,3,2,1,2,1,2,3,3,3,2,9,13,13,13,13,7,8,7,6,4,6,6,7,11,9,7,2,6,5,6,12,1,11,11,9,6,7,8,13,12,3,13,10,8,13,20,8,9,9,8,7,6,9,19,9,11,10,13,11,13,8,AM/S RL,1,1,17,1,20,17,1,1,1,1,1,1,1,1,1
19218918,Lídio,1651,11/03/1987,29,0,0,0,0,186,78,2,2,2,1,3,1,1,2,2,1,3,4,4,5,6,13,6,3,10,3,10,10,4,13,9,9,10,8,8,6,9,9,9,1,13,8,9,8,12,13,10,6,12,9,12,12,20,9,10,9,7,9,5,9,11,10,11,12,12,2,5,5,DM/M C,1,1,1,1,1,1,1,1,1,17,20,1,1,1,1
19218935,Everton Felipe,1651,28/07/1997,18,0,0,0,0,171,71,3,1,2,1,2,1,2,2,2,2,1,10,15,14,12,13,11,9,10,3,4,13,5,8,12,11,7,10,10,9,12,13,11,14,7,15,8,12,12,14,13,9,5,14,15,13,20,12,7,13,7,12,11,12,17,9,13,8,11,7,15,3,AM R,1,1,13,12,1,20,1,1,1,1,9,1,10,1,1
19219065,Renan Zanelli,1651,18/05/1992,24,0,0,0,0,180,80,2,1,1,1,2,2,3,2,3,3,1,8,6,9,14,14,8,12,8,4,6,10,8,5,13,10,8,9,8,8,9,14,5,12,9,14,7,8,10,14,14,9,7,8,6,14,20,12,7,10,8,10,3,10,11,14,12,10,13,5,13,7,AM/S C,1,1,20,18,1,1,1,1,1,1,10,1,1,1,1
19219068,Araruna,1651,12/03/1996,20,0,0,0,0,176,70,2,2,4,3,3,2,3,2,2,3,3,9,9,7,10,15,9,9,15,5,12,11,5,11,15,10,7,10,11,10,10,15,6,6,14,9,9,10,13,12,13,10,6,8,10,10,20,9,10,10,7,8,10,10,19,13,14,12,14,7,9,7,DM/M C,1,1,1,1,1,1,1,1,1,20,18,1,1,1,1
19219070,Juninho,1651,29/07/1987,28,0,0,0,0,170,67,1,1,3,1,3,4,1,1,1,4,3,8,8,10,9,14,6,5,14,2,9,14,4,8,14,10,9,8,14,9,10,14,10,13,9,12,8,10,13,14,14,10,2,1,17,14,20,10,11,10,8,9,5,10,17,12,9,11,10,6,2,2,M/AM C,1,1,1,20,1,1,1,1,1,1,17,1,1,1,1
19219086,Caio Dantas,1651,19/02/1993,23,0,0,0,0,177,72,3,3,3,1,2,2,1,1,3,3,1,8,6,14,14,14,8,14,9,8,5,9,6,1,9,4,9,6,14,9,8,13,1,8,9,14,8,8,9,13,10,12,8,3,9,11,20,10,7,10,10,7,10,10,17,11,11,11,9,9,19,1,S ,1,1,20,1,1,1,1,1,1,1,1,1,1,1,1
19219087,João Pedro,1651,25/04/1996,20,0,0,0,0,179,71,3,1,3,3,1,3,3,1,3,2,3,7,9,7,12,12,7,1,8,5,7,12,5,7,14,9,12,4,6,8,13,7,9,13,8,8,7,8,13,14,14,8,6,10,11,14,20,9,6,9,9,5,7,9,10,10,13,12,12,10,12,1,M/AM LC,1,1,1,20,17,1,1,1,1,1,17,17,1,1,1
19219088,Gabriel Barcos,1651,11/02/1988,28,0,0,0,0,179,0,3,2,2,2,2,3,1,3,4,2,2,6,5,14,14,11,8,14,9,2,8,9,6,5,14,10,9,5,7,9,7,13,10,13,13,14,9,8,9,14,14,9,6,10,16,14,20,11,10,10,6,5,10,10,18,12,11,10,12,9,12,7,S ,1,1,20,1,1,1,1,1,1,1,1,1,1,1,1
19219105,Carlinhos,1651,22/08/1991,24,0,0,0,0,175,0,2,1,2,2,3,2,1,3,1,2,1,7,6,6,3,11,4,7,6,7,9,9,3,14,6,8,7,9,7,7,9,12,4,5,14,6,9,9,9,13,14,9,9,9,15,14,20,13,7,9,9,9,7,9,18,12,13,12,12,5,17,8,D/WB R,1,1,1,1,1,1,1,1,20,1,1,1,1,1,17
19219106,Conrado,1651,18/07/1991,24,0,0,0,0,178,70,2,3,1,1,3,1,2,1,4,2,1,8,8,13,13,11,8,14,6,2,8,13,9,8,12,5,10,8,10,10,9,8,5,13,11,9,10,8,10,13,13,8,9,10,13,13,20,9,8,8,10,9,7,10,12,12,13,10,10,7,8,8,AM/S C,1,1,17,20,1,1,1,1,1,1,1,1,1,1,1
19219111,Jhuan,1651,10/10/1991,24,0,0,0,0,180,0,2,1,2,3,3,2,3,3,3,3,3,10,13,13,8,13,6,7,8,7,5,9,6,7,11,10,8,9,5,9,8,13,4,11,10,8,8,8,7,13,10,6,8,20,8,13,10,11,11,12,7,9,7,10,11,12,9,14,11,3,3,7,AM L,1,1,1,13,20,13,1,13,1,1,1,13,1,13,1
19219113,Luís Mário,1651,08/08/1987,28,0,0,0,0,182,78,1,1,2,2,3,2,1,3,3,3,1,8,6,9,7,14,8,8,9,5,12,14,4,13,12,10,9,9,9,10,8,14,9,1,1,9,13,10,13,14,14,10,8,7,13,14,20,8,6,9,5,7,6,10,14,11,12,10,10,8,14,3,DM/M C,1,1,1,1,1,1,1,1,1,20,17,1,1,1,1
19219141,Adriano Paulista,1651,08/09/1989,26,0,0,0,0,182,80,3,1,2,1,2,3,2,1,3,3,1,6,5,8,8,10,6,6,10,6,6,13,3,4,12,9,8,7,6,8,13,13,4,12,7,7,8,8,10,13,9,8,5,10,9,11,20,13,6,9,8,9,9,9,3,10,13,10,3,1,4,4,M/AM C,1,1,1,20,1,1,1,1,1,1,17,1,1,1,1
19219150,Henrique Motta,1651,10/01/1991,25,0,0,0,0,188,77,2,1,2,2,1,2,3,2,4,3,1,7,5,5,5,13,4,6,11,3,12,7,5,13,9,10,12,9,9,9,11,13,4,4,4,8,12,9,10,13,13,9,7,9,15,13,20,13,7,10,7,8,9,10,14,11,11,13,13,7,9,7,DM/M C,1,1,1,1,1,1,1,1,1,20,17,1,1,1,1
19219154,Marcelo Henrique,1651,08/07/1990,25,0,0,0,0,188,85,14,8,11,1,14,14,10,14,10,8,9,3,2,2,1,3,7,1,1,1,3,1,3,3,4,10,8,15,7,9,8,14,10,3,12,2,7,9,8,13,11,9,11,12,14,11,20,8,14,10,9,2,10,10,7,11,10,14,11,8,18,8,GK ,20,1,1,1,1,1,1,1,1,1,1,1,1,1,1
19219155,Samuel,1651,15/01/1988,28,0,0,0,0,181,73,1,1,4,2,1,2,1,2,3,2,1,7,7,6,9,12,5,7,10,3,9,14,5,10,10,9,11,8,9,8,8,8,4,3,12,6,10,9,11,14,14,8,6,9,12,14,20,12,8,8,9,1,9,9,8,9,12,8,10,3,17,5,DM/M C,1,1,1,1,1,1,1,1,1,17,20,1,1,1,1
19219156,Osman,1651,29/12/1992,23,0,0,0,0,179,72,3,3,1,1,2,2,4,3,2,1,4,11,10,12,11,12,10,11,9,11,9,11,10,9,12,5,12,11,12,11,11,11,11,11,12,9,7,13,13,13,16,11,9,12,8,13,20,13,8,11,4,7,11,12,12,10,11,12,10,6,9,5,D/M/AM RL,1,1,1,1,15,20,1,1,17,1,1,13,17,1,1
19219159,Sydney,1651,14/08/1995,20,0,0,0,0,180,73,1,2,1,4,3,1,2,3,2,2,2,6,7,4,6,14,7,3,8,1,10,14,2,10,14,9,9,8,9,6,12,14,5,4,5,7,9,9,13,14,11,9,11,1,11,13,20,8,7,7,6,9,8,9,12,12,12,11,10,3,9,5,DM/M C,1,1,1,1,1,1,1,1,1,17,20,1,1,1,1
19219160,Victor,1651,23/01/1996,20,0,0,0,0,169,69,1,1,2,4,2,3,1,2,1,1,2,7,12,7,6,13,5,6,4,3,7,8,2,13,8,8,6,7,8,7,4,9,8,8,4,6,8,7,8,14,10,7,2,10,10,12,20,9,6,8,8,8,8,8,12,9,11,11,11,7,13,8,D/WB R,1,1,1,1,1,12,1,1,20,1,1,1,14,1,16
19219198,Adriano,1651,17/02/1988,28,0,0,0,0,183,72,2,3,1,1,3,3,3,3,3,1,2,9,8,10,9,10,9,8,9,2,9,9,9,9,9,10,13,8,9,7,8,11,7,10,11,11,11,10,9,13,12,11,10,10,13,12,20,11,8,10,9,10,10,12,17,11,9,9,10,2,9,4,M RC,1,1,1,1,7,13,1,1,10,10,20,7,17,1,10
19219201,Bruninho,1651,21/10/1995,20,0,0,0,0,180,0,3,3,1,2,3,1,3,3,4,4,3,6,5,14,14,10,7,14,7,7,5,8,9,5,11,9,9,8,11,8,7,12,9,10,3,9,5,7,8,14,14,8,7,9,14,12,20,7,7,9,5,6,4,9,20,9,13,13,12,5,18,6,S ,1,1,20,1,1,1,1,1,1,1,1,1,1,1,1
19219203,Danilo,1651,18/01/1994,22,0,0,0,0,177,73,1,1,1,1,4,2,4,3,2,1,2,7,5,14,11,14,7,13,8,2,7,8,5,4,9,6,11,6,11,8,6,14,6,8,3,13,8,7,8,14,12,8,8,8,8,9,20,13,5,9,7,9,6,9,8,11,11,9,12,5,16,2,S ,1,1,20,1,1,1,1,1,1,1,1,1,1,1,1
19219207,Fabiano,1651,17/02/1990,26,0,0,0,0,183,73,2,1,2,3,3,3,3,2,4,3,4,4,6,7,4,8,1,9,2,7,10,9,4,9,4,10,7,10,8,10,6,13,10,8,3,7,9,13,9,13,12,9,10,20,13,13,10,13,13,10,10,7,6,10,12,9,11,11,11,7,8,5,D/WB L,1,1,1,1,1,1,1,20,1,1,1,1,1,17,1
19219209,Jhonatan,1651,05/03/1994,22,0,0,0,0,183,73,1,1,1,1,1,1,3,1,2,1,3,6,5,8,8,13,3,6,13,3,6,12,1,5,13,9,4,8,6,8,13,13,9,13,9,11,8,8,12,13,8,8,8,2,12,12,20,7,7,9,4,9,9,9,13,12,13,11,8,12,8,7,M/AM C,1,1,1,20,1,1,1,1,1,1,17,1,1,1,1
19219211,Maycon,1651,07/03/1995,21,0,0,0,0,162,57,1,2,1,1,2,2,3,3,3,2,3,5,3,8,13,12,6,13,7,5,5,7,9,1,8,7,11,8,13,7,7,10,5,9,1,12,7,6,7,10,12,16,1,14,7,13,20,5,7,9,7,1,9,9,13,12,11,10,10,10,13,6,S ,1,1,20,1,1,1,1,1,1,1,1,1,1,1,1
19219215,Romário,1651,02/12/1989,26,0,0,0,0,188,86,1,1,3,3,1,1,1,3,1,3,3,3,6,1,4,6,1,14,1,2,13,4,1,14,6,9,12,9,2,9,1,14,8,1,4,7,12,5,7,13,11,8,8,9,5,13,20,4,9,4,9,9,7,9,14,12,12,11,11,7,11,8,D C,1,1,1,1,1,1,20,1,1,1,1,1,1,1,1
19219253,Tiago Marques,1651,03/03/1988,28,0,0,0,0,192,74,2,1,1,1,1,1,1,2,3,2,2,6,3,12,11,12,5,11,7,2,6,7,2,3,10,8,12,8,8,7,6,11,7,11,10,12,6,6,7,12,9,7,9,16,7,10,20,12,9,9,10,8,10,10,12,9,11,12,10,10,10,1,S ,1,1,20,1,1,1,1,1,1,1,1,1,1,1,1
19219255,Willian Lira,1651,09/12/1993,22,0,0,0,0,185,84,4,3,3,2,1,1,2,3,1,2,4,4,5,13,13,13,6,9,6,5,5,7,4,1,13,9,8,7,7,6,7,8,9,13,13,13,6,6,7,13,11,7,10,9,9,11,20,9,9,9,9,9,6,9,9,13,12,11,10,4,11,1,S ,1,1,20,1,1,1,1,1,1,1,1,1,1,1,1
19219284,Heliardo,1651,14/12/1991,24,0,0,0,0,190,75,2,4,1,2,2,1,3,3,3,2,1,7,9,10,12,11,7,12,8,4,6,10,13,6,11,12,12,13,12,9,10,11,5,11,7,11,8,12,11,12,9,6,15,20,12,11,9,12,12,10,12,10,10,8,20,13,12,11,10,9,17,7,S ,1,1,20,1,10,7,1,1,1,1,1,1,1,1,1
19219285,Neto,1651,30/08/1993,22,0,0,0,0,180,77,2,4,3,2,3,3,3,1,3,1,3,8,8,10,9,14,8,8,10,11,13,11,2,14,14,12,6,9,6,7,11,14,20,10,3,9,11,10,13,13,9,12,13,11,14,13,20,14,13,10,12,6,8,10,12,11,9,8,10,2,5,6,DM/M C,1,1,1,1,1,1,1,1,1,17,20,1,1,1,1
19219287,Juninho,1651,06/05/1994,22,0,0,0,0,185,0,1,3,2,2,3,2,3,2,2,2,1,4,4,5,7,13,6,3,9,1,10,13,1,6,13,8,9,8,4,7,9,12,7,4,6,8,4,7,11,12,10,2,8,8,11,12,20,7,9,9,9,9,9,9,15,12,12,11,11,3,9,1,M C,1,1,1,1,1,1,1,1,1,1,20,1,1,1,1
19219300,Paulo Azzi,1651,15/07/1994,21,0,0,0,0,188,78,3,3,3,1,2,3,2,3,3,1,2,5,8,11,9,10,5,9,9,5,5,11,10,7,12,8,8,8,10,7,12,7,14,5,8,12,5,10,8,14,12,12,13,7,10,13,20,12,12,11,10,8,8,5,15,13,12,15,15,14,11,5,S ,1,1,20,1,1,13,1,1,1,1,1,1,1,1,1
19219302,Malcon,1651,05/07/1995,20,0,0,0,0,183,84,2,3,3,3,1,1,2,1,3,2,1,6,3,5,3,9,6,12,3,10,11,10,5,10,4,12,11,14,6,10,8,11,4,4,12,9,7,12,12,12,10,12,13,3,14,11,20,10,14,9,10,9,9,9,13,14,11,12,12,9,8,8,D C,1,1,1,1,1,1,20,1,1,1,1,1,1,1,1
19219310,Rodolfo,1651,04/10/1993,22,0,0,0,0,182,75,2,1,2,3,4,1,1,1,1,2,1,8,9,10,10,9,8,10,9,4,8,7,10,6,14,4,9,8,5,8,10,10,10,13,9,14,8,8,10,12,11,11,10,14,13,13,20,13,9,13,6,4,10,10,12,13,11,12,12,10,4,8,AM/S RL,1,1,17,13,17,20,1,1,1,10,11,1,1,1,1
19219315,Fellipe Mateus,1651,12/02/1991,25,0,0,0,0,178,71,1,3,1,2,3,1,1,1,3,1,1,5,7,9,9,13,7,5,11,7,7,13,2,6,13,10,9,6,8,8,12,13,5,13,9,8,8,5,10,13,13,9,3,10,13,13,20,12,6,10,8,10,10,10,13,12,10,12,12,2,10,4,M/AM C,1,1,1,20,1,1,1,1,1,1,17,1,1,1,1
19219316,Cesinha,1651,20/05/1985,31,0,0,0,0,178,68,3,3,3,2,1,2,1,2,1,1,1,4,4,3,3,13,6,5,7,2,8,7,3,11,13,9,6,8,8,8,10,12,3,13,8,8,10,7,10,13,13,7,8,9,15,13,20,6,7,9,3,9,7,9,17,12,8,14,8,4,11,6,DM/M/AM C,1,1,1,19,1,1,1,1,1,18,20,1,1,1,1
19219355,Renan Paulino,1651,15/02/1995,21,0,0,0,0,180,71,2,1,3,2,1,3,3,4,1,3,2,5,6,4,6,14,8,8,13,5,11,14,4,14,14,7,11,7,6,9,11,12,10,3,2,6,8,9,6,10,11,11,10,10,7,12,20,10,9,10,6,7,8,10,9,11,12,11,10,2,19,8,M C,1,1,1,1,1,1,1,1,1,1,20,1,1,1,1
19219384,Iago,1651,25/07/1995,20,0,0,0,0,170,0,3,3,3,1,3,2,2,3,2,1,1,11,11,10,9,10,11,7,9,7,8,10,9,9,9,7,10,9,9,10,9,10,7,8,8,9,9,10,11,12,12,10,6,6,14,12,20,12,9,9,9,9,3,12,12,12,9,10,10,1,7,1,D/WB R,1,1,1,1,1,1,1,1,20,1,1,1,1,1,19
19219388,Lucas Borges,1651,01/02/1995,21,0,0,0,0,186,0,2,2,3,3,1,1,3,2,3,2,1,8,6,6,9,7,7,9,6,8,11,7,5,11,3,9,9,6,8,13,5,9,5,9,10,9,10,9,10,9,8,11,10,8,12,9,20,8,10,9,9,5,7,9,8,11,9,12,13,8,3,4,D C,1,1,1,1,1,1,20,1,1,1,1,1,1,1,1
19219389,Messias,1651,03/11/1994,21,0,0,0,0,192,87,2,1,2,1,3,2,4,1,3,3,2,2,7,7,8,10,6,13,6,5,12,9,8,12,11,10,12,11,11,10,9,10,9,1,11,7,11,12,13,11,11,12,17,4,13,12,20,11,11,10,10,10,7,12,14,9,9,12,13,9,17,4,D C,1,1,1,1,1,1,20,1,1,1,1,1,1,1,1
19219390,Emerson Carioca,1651,07/12/1995,20,0,0,0,0,174,0,2,2,4,2,1,3,2,1,1,1,4,6,9,10,12,10,6,10,7,4,5,10,12,9,12,8,12,10,11,9,9,10,10,10,5,12,9,10,10,14,12,8,8,5,12,14,20,12,7,10,8,10,5,10,17,12,10,11,9,10,10,7,S ,1,1,20,1,1,1,1,1,1,1,1,1,1,1,1
19219391,Marcos,1651,31/05/1994,22,0,0,0,0,168,66,2,2,2,4,1,2,2,1,1,1,1,5,10,8,4,15,3,9,5,7,9,10,2,10,10,9,11,10,10,10,8,10,10,1,12,8,9,10,12,12,11,7,6,4,7,12,20,13,7,9,9,1,9,9,12,11,14,10,12,11,13,7,D/WB R,1,1,1,1,1,1,1,1,20,1,1,1,1,1,19
19219608,Renan,1651,06/05/1990,26,0,0,0,0,184,75,1,4,2,2,2,2,2,3,3,2,3,5,1,1,5,4,1,12,2,4,7,6,5,11,1,9,6,8,6,7,3,12,3,1,11,3,12,5,6,12,12,5,11,9,7,12,20,8,12,9,9,9,9,9,12,13,9,12,12,5,15,3,D C,1,1,1,1,1,1,20,1,1,1,1,1,1,1,1
19219614,Nalberth,1651,10/07/1994,21,0,0,0,0,189,80,3,1,2,3,3,1,1,1,3,2,3,1,1,1,1,5,1,12,1,1,10,1,1,12,3,8,7,7,2,6,2,12,8,5,5,1,10,4,4,12,7,5,10,9,8,11,20,6,8,8,6,8,6,8,16,14,12,9,12,12,11,4,D C,1,1,1,1,1,1,20,1,1,1,1,1,1,1,1
19219713,Vítor Costa,1651,01/07/1994,22,0,0,0,0,182,73,4,1,3,1,3,3,4,3,2,1,2,11,11,12,12,13,11,7,12,11,10,12,10,8,12,12,11,11,13,8,11,11,12,14,3,12,8,12,12,14,14,7,11,20,12,14,8,13,7,12,9,12,4,7,11,14,6,12,9,4,15,7,D/WB L,1,1,1,1,1,1,1,20,1,1,1,13,1,18,1
19219714,Evandro,1651,25/09/1994,21,0,0,0,0,194,0,3,2,2,3,1,1,1,1,3,3,1,4,6,7,7,9,6,12,6,2,12,8,5,11,8,12,10,12,9,9,4,10,5,3,5,9,11,12,12,11,11,12,16,8,12,11,20,12,12,12,8,5,4,3,15,8,14,10,11,6,1,1,D C,1,1,1,1,1,1,20,1,1,1,1,1,1,1,1
19219717,Leonardo,1651,29/04/1994,22,0,0,0,0,176,0,1,1,3,2,2,1,3,2,1,2,1,3,5,11,12,12,5,12,11,3,4,11,13,3,12,10,10,5,11,9,11,11,3,14,3,13,8,12,12,13,12,12,9,8,12,13,20,12,12,10,6,10,5,4,9,12,13,9,11,7,1,5,S ,1,1,20,1,1,1,1,1,1,1,1,1,1,1,1
19219718,Jéferson Silva,1651,22/04/1994,22,0,0,0,0,179,68,1,2,1,3,1,1,1,3,3,1,1,10,9,10,10,12,10,10,11,5,13,12,5,12,12,13,10,12,10,9,11,10,10,8,6,11,12,13,13,13,12,11,9,8,12,13,20,12,11,12,11,2,4,10,19,10,10,11,11,1,13,7,DM/M C,1,1,1,1,1,1,1,1,1,20,18,1,1,1,1
19219727,Lucas Ybom,1651,26/01/1995,21,0,0,0,0,173,64,1,2,2,1,1,2,4,1,3,1,1,3,3,3,6,13,3,8,5,1,6,8,3,12,9,6,8,9,8,11,8,10,6,4,10,7,7,8,8,13,14,8,5,20,14,14,10,10,5,9,3,9,5,9,13,13,12,13,12,3,19,3,D L,1,1,1,1,1,1,1,20,1,1,1,1,1,1,1
19219728,Serginho,1651,15/03/1995,21,0,0,0,0,180,82,1,2,4,3,3,3,1,2,3,3,3,10,9,13,12,12,8,8,14,5,9,13,11,8,14,12,11,12,12,10,13,12,14,14,5,13,6,11,11,13,14,12,9,20,12,13,10,13,12,12,6,15,4,15,12,11,12,12,13,11,10,7,M/AM LC,1,1,1,20,15,12,1,1,1,1,18,1,1,1,1
19219729,Philipe Sampaio,1651,11/11/1994,21,0,0,0,0,191,82,2,1,1,1,2,2,2,1,3,1,1,4,5,8,9,10,4,12,5,8,12,10,6,13,11,14,13,15,11,9,6,11,16,11,13,11,12,13,12,11,11,13,13,10,12,12,20,11,13,10,15,13,6,10,12,10,11,11,12,9,8,2,D C,1,1,1,1,1,1,20,1,1,1,1,1,1,1,1
19219730,Matheus Augusto,1651,10/03/1996,20,0,0,0,0,169,59,3,3,2,3,1,3,2,1,2,2,2,7,10,14,14,14,8,10,10,3,7,10,6,7,13,10,9,6,7,6,11,11,9,13,12,10,9,9,10,13,10,9,4,20,12,13,11,9,7,8,10,10,6,10,18,12,10,11,8,7,7,15,AM/S C,1,1,18,20,14,1,1,1,1,1,1,1,1,1,1
19219731,Fernando Medeiros,1651,10/02/1996,20,0,0,0,0,180,77,3,3,1,2,2,3,3,2,1,3,3,8,8,12,12,12,9,12,11,6,13,14,8,13,13,12,12,11,13,12,13,13,15,9,10,13,13,10,13,13,12,12,7,20,13,13,10,11,12,11,10,13,11,13,13,10,11,10,13,3,2,1,DM ,1,1,1,1,1,1,1,1,1,20,14,1,1,1,1
19219732,Thiago Maia,1651,22/03/1997,19,0,0,0,0,179,73,1,2,3,4,3,1,3,3,2,2,3,8,9,12,11,12,8,13,10,13,15,14,8,15,14,13,14,15,11,13,12,14,16,8,12,12,14,14,13,12,12,13,10,20,14,12,10,15,14,12,11,13,10,8,9,15,14,16,12,10,12,9,DM ,1,1,1,1,1,1,1,1,1,20,12,1,1,1,1
19219733,Gilmar,1651,08/02/1995,21,0,0,0,0,168,60,2,3,3,1,2,1,2,1,3,3,1,6,4,8,13,13,6,13,7,3,6,7,10,2,9,7,7,8,12,7,9,7,7,9,11,10,7,6,6,13,13,6,3,10,9,13,20,7,4,9,9,3,7,9,12,14,13,10,11,4,15,4,S ,1,1,20,14,1,1,1,1,1,1,1,1,1,1,1
19219734,Gugu,1651,15/01/1995,21,0,0,0,0,170,68,2,3,2,4,3,3,2,2,1,2,3,4,5,7,6,12,7,5,12,1,10,12,2,14,14,9,10,8,6,11,11,13,8,3,4,7,7,8,11,14,13,5,2,10,11,14,20,7,5,9,7,9,7,9,7,12,13,10,11,8,14,5,DM ,1,1,1,1,1,1,1,1,1,20,1,1,1,1,1
19219735,Matheus Rosário,1651,20/02/1995,21,0,0,0,0,172,59,3,1,3,3,2,3,3,1,2,1,1,9,11,14,10,11,7,6,10,9,6,11,8,7,11,10,9,9,9,9,9,9,5,10,9,9,9,9,9,11,11,10,6,20,10,11,8,14,8,10,10,10,10,13,13,10,11,11,11,3,8,3,AM C,1,1,1,20,1,1,1,1,1,1,15,1,1,1,1
19219762,Euller,1651,04/01/1995,21,0,0,0,0,173,65,1,3,2,2,3,1,3,2,1,2,1,11,11,14,10,14,5,5,9,9,9,12,8,9,13,8,13,11,12,9,12,11,13,15,4,14,9,9,12,15,16,11,5,20,13,15,4,13,6,12,6,12,6,14,12,10,12,14,14,13,13,5,D/WB/M L,1,1,1,14,15,1,1,19,1,1,13,17,1,20,1
19219763,Marlon,1651,27/05/1996,20,0,0,0,0,189,0,2,2,1,3,2,2,2,2,2,3,4,8,11,9,9,11,8,12,8,11,12,11,5,12,11,11,11,11,10,11,10,11,13,10,4,10,12,12,12,13,12,10,13,6,13,13,20,13,13,13,8,10,4,5,11,9,13,12,11,8,3,6,D/WB R,1,1,1,1,1,1,12,1,20,11,1,1,1,1,18
19219764,Ramon,1651,20/01/1994,22,0,0,0,0,187,0,2,3,3,2,1,1,3,2,2,2,1,7,11,12,5,12,5,9,7,8,7,10,6,12,10,9,9,10,7,14,8,12,9,9,3,8,9,9,6,13,13,6,12,20,11,14,5,11,6,9,9,9,4,9,19,11,12,13,11,9,4,2,D/WB L,1,1,1,1,1,1,1,20,1,1,1,1,1,18,1
19219766,Douglas,1651,30/03/1996,20,0,0,0,0,188,0,3,2,3,4,1,3,3,2,2,2,3,5,8,11,12,12,7,12,11,4,6,10,13,5,12,10,11,10,10,8,11,9,18,13,4,13,7,12,12,13,12,12,14,8,12,12,20,12,12,12,10,9,4,9,17,11,13,9,10,12,11,3,S ,1,1,20,1,1,1,1,1,1,1,1,1,1,1,1
19219767,João Matos,1651,08/02/1996,20,0,0,0,0,184,0,4,1,1,3,1,4,2,3,1,2,1,6,5,13,13,13,6,13,5,6,4,7,3,3,9,6,10,8,5,4,7,7,5,9,12,13,4,6,8,13,13,7,9,1,13,13,20,12,9,9,7,9,7,9,8,12,11,8,10,3,14,1,S ,1,1,20,1,1,1,1,1,1,1,1,1,1,1,1
19219768,Sillas,1651,07/02/1995,21,0,0,0,0,175,74,2,4,2,1,2,3,1,1,3,2,3,8,10,12,12,14,8,10,10,7,6,10,7,9,14,10,8,2,8,7,10,14,12,13,10,6,8,9,10,13,13,8,6,7,12,13,20,12,8,6,9,10,9,10,19,15,7,10,8,6,19,8,AM/S RC,1,1,16,20,1,15,1,1,1,1,1,1,1,1,1
19219769,Alex Sandro,1651,20/08/1995,20,0,0,0,0,175,74,2,3,1,1,2,2,1,1,3,3,3,12,14,14,13,14,7,6,8,7,6,8,5,4,14,9,5,8,5,7,9,6,9,13,8,11,7,8,9,14,11,3,6,10,15,14,20,6,8,9,9,9,7,9,20,10,11,12,12,4,6,8,AM/S RL,1,1,20,1,18,18,1,1,1,1,1,1,1,1,1
19219770,Matheus Pranke,1651,15/04/1995,21,0,0,0,0,175,0,1,1,3,2,1,2,2,2,1,1,1,11,12,11,10,12,10,7,11,7,10,12,8,9,12,12,11,13,9,8,12,10,12,14,3,12,10,12,13,13,13,9,6,20,13,13,3,12,8,12,10,8,4,15,7,9,8,11,12,11,17,2,D/WB/AM LC,1,1,10,18,20,1,1,16,1,12,14,15,1,17,1
19219771,Matheus,1651,13/06/1995,21,0,0,0,0,176,0,3,3,3,1,1,3,3,3,2,1,1,6,8,13,5,8,3,3,8,1,6,8,1,6,11,8,8,7,11,5,7,7,8,10,1,8,6,8,12,12,10,7,6,8,11,12,20,8,7,8,7,8,7,8,14,12,11,11,11,3,9,3,AM RC,1,1,10,20,1,16,1,1,1,1,15,1,13,1,1
19219772,Léo Ceará,1651,03/02/1995,21,0,0,0,0,178,78,2,3,1,1,3,1,3,1,3,2,2,7,10,12,13,12,10,8,11,3,4,12,13,4,13,10,13,9,12,9,11,12,14,15,3,13,7,11,12,14,13,10,8,7,13,13,20,12,8,12,7,10,4,12,8,11,13,11,13,9,11,6,AM/S L,1,1,20,12,18,13,1,1,1,1,6,8,7,1,1
19219791,Filipe André,1651,13/03/1993,23,0,0,0,0,186,0,2,3,3,3,3,1,3,3,3,3,3,8,5,10,10,14,8,8,11,3,8,14,3,10,12,9,12,7,10,7,10,10,5,11,11,13,10,9,13,14,11,9,11,9,9,13,20,14,10,10,8,3,8,10,9,12,10,11,12,3,3,7,M/AM C,1,1,1,18,1,1,1,1,1,1,20,1,1,1,1
19219799,Willian,1651,16/05/1993,23,0,0,0,0,184,71,1,1,1,1,2,3,3,1,1,2,1,5,5,5,9,12,5,12,10,11,13,12,8,13,10,11,11,12,11,10,12,10,7,10,10,11,11,12,13,10,10,11,12,20,12,11,15,12,12,10,11,10,7,10,7,10,12,12,11,2,14,2,DM/M C,1,1,1,1,1,1,1,1,1,20,18,1,1,1,1
19219840,Léo Pereira,1651,31/01/1996,20,0,0,0,0,186,76,3,3,3,1,2,2,3,4,1,1,1,5,5,9,9,10,9,12,8,12,13,9,10,11,10,12,12,13,10,12,9,10,14,12,11,9,12,11,12,12,10,12,12,20,12,11,10,11,12,12,13,10,11,12,16,13,12,13,11,12,12,12,D C,1,1,1,1,1,1,20,12,1,1,1,1,1,1,1
19219843,Léo,1651,20/03/1995,21,0,0,0,0,188,74,14,10,9,10,14,10,9,14,6,8,13,8,3,3,2,2,10,1,3,1,3,1,4,2,6,4,6,15,9,10,8,14,9,3,5,3,11,9,7,11,7,9,14,8,12,10,20,3,8,10,6,4,10,10,9,14,7,8,13,1,11,4,GK ,20,1,1,1,1,1,1,1,1,1,1,1,1,1,1
19219855,Keno,1651,09/10/1989,26,0,0,0,0,178,66,2,1,1,1,3,1,2,1,1,1,1,10,11,14,14,12,12,7,8,8,12,11,10,11,13,10,10,10,11,12,13,11,15,12,11,13,11,12,14,15,15,12,9,10,12,15,20,16,7,15,12,11,10,11,12,13,15,14,15,12,11,8,AM/S R,1,1,20,1,13,18,1,1,1,1,1,1,1,1,1
19219992,Rodrigo Mucuri,1651,03/04/1995,21,0,0,0,0,174,65,2,2,4,3,2,2,2,1,1,1,1,9,9,8,10,10,9,11,11,4,9,9,3,10,10,9,7,9,9,9,10,9,3,10,8,9,9,12,11,12,13,15,7,6,14,13,20,7,5,9,9,4,9,9,14,10,11,11,10,7,7,3,AM/S C,1,1,16,20,14,14,1,1,1,1,1,1,1,1,1
19220141,Matheus,1651,30/12/1996,19,0,0,0,0,176,0,3,3,3,3,3,3,3,2,1,1,3,12,14,11,11,13,10,12,9,4,7,9,7,6,14,10,8,4,11,9,9,13,10,13,5,9,8,8,10,15,16,5,6,11,10,14,20,7,7,10,4,10,6,10,10,11,13,10,8,4,8,1,S L,1,1,20,1,15,1,1,1,1,1,1,1,1,1,1
19220188,Welinton Júnior,1651,08/06/1993,23,0,0,0,0,175,67,2,1,1,2,1,2,3,4,2,1,1,6,11,12,10,9,5,4,7,6,7,9,5,7,12,9,11,11,10,12,10,11,13,11,8,12,7,11,11,14,13,12,7,11,12,13,20,13,8,10,8,9,7,12,11,12,12,12,11,12,10,7,AM L,1,1,15,1,20,10,1,1,1,1,1,1,1,1,1
19220191,Moisés,1651,09/08/1990,25,0,0,0,0,181,76,4,1,3,1,2,2,1,3,1,1,2,5,8,9,6,12,8,8,7,8,10,10,1,14,10,9,11,9,9,10,6,14,2,5,11,8,11,9,9,14,14,9,6,11,14,14,20,9,6,10,10,7,9,10,18,9,11,11,12,6,1,2,D/WB/DM R,1,1,1,1,1,1,1,1,20,17,1,1,1,1,18
19220237,Alexandre,1651,04/09/1988,27,0,0,0,0,185,0,1,1,3,1,1,3,1,2,2,2,1,8,6,4,7,14,8,3,11,8,14,14,2,14,14,6,8,7,13,9,6,10,7,8,6,7,10,9,11,14,14,8,10,1,11,14,20,14,9,10,10,10,10,10,17,11,11,9,10,8,8,6,M C,1,1,1,1,1,1,1,1,1,1,20,1,1,1,1
19220238,Marcílio Miguel,1651,10/08/1995,20,0,0,0,0,174,67,1,2,3,3,3,4,2,2,1,3,1,6,6,9,7,12,5,10,9,9,9,11,8,15,7,10,9,11,10,10,8,12,8,5,1,8,7,11,11,15,13,11,5,20,7,14,5,15,7,10,7,10,8,10,19,8,12,11,11,1,6,2,D/WB L,1,1,1,1,1,1,1,20,1,1,1,1,1,19,1
19220266,Gabriel Jesus,1651,03/04/1997,19,6,5,10,2,178,73,3,1,3,3,2,1,1,1,4,3,2,11,12,14,15,14,10,10,10,6,8,12,12,10,15,12,13,11,13,12,13,13,13,15,7,14,7,12,13,16,16,14,8,13,14,15,20,13,10,13,14,11,6,12,15,13,12,12,10,8,9,10,AM/S RL,1,1,20,12,15,20,1,1,1,1,1,1,1,1,1
19220268,Laerte,1651,15/04/1997,19,0,0,0,0,177,0,1,1,2,1,4,2,3,2,2,3,2,5,3,11,12,12,5,12,6,1,1,4,2,3,12,7,11,4,8,5,6,11,1,13,5,12,5,5,6,11,12,5,3,16,12,12,20,10,6,5,9,5,9,9,11,10,11,10,14,3,17,1,S ,1,1,20,1,1,1,1,1,1,1,1,1,1,1,1
19220269,Rodrigo Rodrigues,1651,18/06/1996,20,0,0,0,0,189,83,2,2,4,2,4,2,4,2,3,1,2,5,8,10,12,11,7,13,11,8,8,11,12,7,11,11,9,11,9,9,10,9,14,9,7,12,7,12,12,13,12,10,14,20,12,13,8,13,13,10,4,4,5,8,8,9,12,11,12,6,16,5,S ,1,1,20,1,1,1,1,1,1,1,1,1,1,1,1
19220270,Daniel Fuzato,1651,04/07/1997,18,0,0,0,0,189,0,6,9,6,1,12,13,10,13,9,4,8,4,2,2,1,4,8,1,3,1,3,1,3,1,5,7,7,11,7,9,6,13,2,3,9,1,11,6,6,13,14,5,13,9,8,12,20,6,8,9,5,9,9,8,8,11,9,10,13,8,6,2,GK ,20,1,1,1,1,1,1,1,1,1,1,1,1,1,1
19220271,Josimar,1651,19/01/1994,22,0,0,0,0,186,0,3,3,2,2,1,2,2,3,1,4,4,8,6,4,5,12,8,8,10,6,12,8,4,13,10,9,7,7,9,7,10,15,9,2,7,8,10,9,12,10,11,9,13,1,10,10,20,8,12,9,8,9,5,9,17,13,10,9,12,3,16,1,DM ,1,1,1,1,1,1,12,1,1,20,10,1,1,1,1
19220272,Serginho,1651,05/08/1995,20,0,0,0,0,187,0,2,1,3,1,1,1,2,3,3,3,4,4,3,7,7,11,5,5,7,1,3,11,3,7,13,8,5,5,3,4,7,12,6,13,11,7,5,7,11,13,11,6,8,17,10,11,20,6,8,8,6,7,8,8,14,12,14,12,11,1,13,6,AM C,1,1,1,20,1,1,1,1,1,1,15,1,1,1,1
19220378,Charles,1651,10/03/1996,20,0,0,0,0,189,0,1,3,1,3,1,3,3,2,1,1,2,3,4,11,8,10,3,12,4,1,1,4,1,1,7,3,7,5,7,2,1,8,5,8,8,7,3,3,4,12,8,4,6,7,5,10,20,9,10,7,5,7,7,7,8,11,11,12,11,4,8,8,S ,1,1,20,1,1,1,1,1,1,1,1,1,1,1,1
19220427,Giorgio,1651,10/02/1995,21,0,0,0,0,172,0,3,3,4,4,3,4,2,2,3,2,2,7,3,7,8,11,6,6,14,1,12,10,5,14,14,6,7,8,8,7,7,14,1,9,1,7,12,8,9,14,12,7,2,9,10,13,20,5,6,9,5,1,6,9,7,11,9,11,12,3,12,2,DM ,1,1,1,1,1,1,1,1,1,20,10,1,1,1,1
19220435,Daniel Vançan,1651,25/10/1996,19,0,0,0,0,179,76,1,1,2,2,3,2,3,2,1,2,2,9,12,11,10,9,8,8,9,4,10,11,8,11,13,10,11,10,9,10,10,9,2,8,7,12,9,11,10,10,11,9,9,20,5,11,9,11,8,8,8,9,8,9,13,12,13,9,12,8,2,1,D/WB L,1,1,1,1,1,1,1,20,1,1,1,1,1,18,1
19220436,Robson,1651,13/02/1997,19,0,0,0,0,191,0,1,2,4,3,1,1,3,1,2,3,2,6,2,1,1,7,2,8,3,6,13,3,1,13,6,7,13,9,5,6,5,13,5,1,12,4,6,6,7,8,10,7,14,9,12,11,20,4,11,9,9,9,8,9,14,12,13,9,13,9,9,7,D C,1,1,1,1,1,1,20,1,1,1,1,1,1,1,1
19220438,Matheus Batista,1651,04/10/1994,21,0,0,0,0,182,0,4,3,2,1,1,3,1,2,1,1,1,5,8,8,9,11,8,10,12,1,10,14,6,11,13,6,12,9,9,11,10,10,9,4,8,8,10,12,11,11,10,11,10,8,12,11,20,12,11,9,9,9,9,9,10,10,12,9,12,4,17,8,DM ,1,1,1,1,1,1,1,1,1,20,10,1,1,1,1
19220442,Júnior Lemos,1651,30/07/1993,22,0,0,0,0,165,68,3,2,2,2,2,2,3,3,2,1,4,7,7,3,8,13,7,7,12,1,10,11,5,13,13,10,11,9,6,11,10,13,10,4,10,7,13,8,11,13,13,8,1,8,12,13,20,7,7,10,10,4,10,10,19,11,9,9,8,8,17,8,DM ,1,1,1,1,1,1,1,1,1,20,10,1,1,1,1
19220444,Chiquinho Alagoano,1651,24/12/1989,26,0,0,0,0,175,76,3,1,2,1,2,3,2,4,2,2,1,7,9,9,9,15,4,10,8,9,10,9,7,15,11,9,11,10,10,10,10,11,10,7,11,9,10,10,10,15,13,10,8,10,12,15,20,8,12,10,6,10,8,10,17,13,12,12,11,11,8,2,D/WB R,1,1,1,1,1,1,1,1,20,1,1,1,1,1,18
19220446,Jimmy,1651,23/09/1993,22,0,0,0,0,189,0,1,2,1,2,2,3,1,1,2,1,3,7,4,14,14,14,7,8,8,5,7,8,9,4,12,9,9,8,10,7,8,12,4,11,10,7,7,7,8,13,8,6,12,9,15,10,20,9,9,9,8,9,9,9,11,11,9,12,11,5,9,4,S ,1,1,20,1,1,1,1,1,1,1,1,1,1,1,1
19220447,Mazinho,1651,11/11/1989,26,0,0,0,0,181,77,1,3,2,1,1,3,1,3,1,3,3,8,8,4,7,11,7,8,11,6,10,12,6,14,14,10,13,8,9,10,14,12,3,3,9,9,10,9,11,14,14,9,10,5,12,14,20,11,9,10,9,10,7,10,7,13,12,10,11,10,7,5,DM C,1,1,1,1,1,1,1,1,1,20,15,1,1,1,1
19220448,Thiago,1651,01/03/1993,23,0,0,0,0,180,70,3,3,4,2,1,2,3,2,2,3,2,4,1,6,2,6,1,14,4,5,13,8,3,14,6,6,12,9,7,11,4,14,3,2,13,7,14,7,8,14,12,8,6,9,16,13,20,10,6,9,5,8,6,9,14,11,13,13,11,4,5,6,D C,1,1,1,1,1,1,20,1,1,1,1,1,1,1,1
19220451,Léo Coca,1651,07/03/1996,20,0,0,0,0,186,82,2,4,1,2,2,3,4,3,1,2,3,5,7,11,13,9,7,9,9,2,7,10,3,9,12,9,10,8,7,9,12,7,6,11,13,12,8,6,9,14,14,8,9,5,12,14,20,8,10,9,9,8,9,8,16,10,8,9,11,9,14,7,AM/S C,1,1,17,20,1,1,1,1,1,15,10,1,1,1,1
19220453,Bruninho,1651,25/02/1990,26,0,0,0,0,165,70,3,3,1,1,1,3,4,1,3,3,2,10,12,13,11,12,10,11,9,3,7,11,5,7,11,7,11,8,11,11,9,11,5,11,5,12,5,11,13,12,10,10,8,7,13,12,20,14,10,12,5,10,10,10,16,11,12,13,8,6,16,2,AM/S RC,1,1,16,20,1,18,1,1,1,1,1,1,1,1,1
19220691,Matheus,1651,18/02/1996,20,0,0,0,0,188,0,3,2,1,1,2,2,3,1,3,1,2,6,3,4,3,10,3,12,6,1,12,11,6,12,6,9,12,8,10,7,1,12,2,4,12,2,12,8,12,12,12,12,14,9,10,11,20,7,16,10,12,12,10,10,13,11,9,12,9,3,13,6,D C,1,1,1,1,1,1,20,1,1,1,1,1,1,1,1
19220692,Marcos,1651,17/05/1996,20,0,0,0,0,181,0,3,2,3,3,4,3,1,4,1,1,3,8,8,7,12,12,5,12,7,5,9,12,8,12,12,9,12,9,9,8,7,12,7,4,6,4,10,6,8,12,12,12,7,9,15,12,20,7,5,10,6,13,9,12,20,8,12,13,10,3,14,1,DM ,1,1,1,1,1,1,1,1,1,20,10,1,1,1,1
19220693,Caio Vinícius,1651,05/03/1996,20,0,0,0,0,184,0,1,3,1,2,1,2,3,2,2,2,2,2,4,5,7,13,1,5,3,4,7,9,1,13,8,5,6,9,8,8,6,14,3,7,11,7,7,9,9,14,12,9,7,20,10,13,3,7,9,9,7,7,9,9,17,10,11,11,12,12,9,8,D/WB L,1,1,1,1,1,1,1,20,1,1,1,1,1,19,1
19220695,Murilo,1651,21/02/1996,20,0,0,0,0,175,65,2,1,3,2,1,1,3,4,1,3,1,8,4,14,8,14,8,8,11,5,8,11,5,13,14,5,7,9,10,7,12,14,5,15,6,10,12,9,12,14,14,7,6,8,12,14,20,8,7,10,10,3,10,10,7,10,13,12,11,7,19,5,DM/M C,1,1,1,1,1,1,1,1,1,18,20,1,1,1,1
19220698,Carlos Eduardo,1651,10/10/1996,19,0,0,0,0,173,68,2,4,4,1,2,3,1,3,2,3,4,5,8,13,12,12,8,12,9,2,2,10,8,5,11,11,9,9,12,10,7,11,12,12,3,11,6,9,9,14,13,11,6,11,16,16,20,10,6,9,10,10,10,15,15,10,15,8,10,7,10,10,AM/S RL,1,1,20,13,17,16,1,1,1,1,10,1,1,1,1
19220700,Betinho,1651,31/12/1987,28,0,0,0,0,181,0,1,2,2,3,2,1,3,3,3,4,1,8,7,4,9,12,7,8,14,7,10,12,3,10,14,8,14,9,8,10,9,11,10,10,12,7,10,9,13,14,14,9,9,9,12,14,20,10,7,10,5,6,10,10,16,10,12,10,10,7,5,2,DM ,1,1,1,1,1,1,1,1,1,20,10,1,1,1,1
19220721,William,1651,15/02/1993,23,0,0,0,0,163,0,3,3,2,3,1,1,3,3,2,2,3,6,6,7,8,11,6,2,8,2,5,8,3,5,7,7,10,7,10,7,11,13,8,8,1,9,7,8,12,14,9,5,3,8,12,13,20,9,4,7,8,6,8,8,7,13,12,14,11,4,4,2,AM C,1,1,1,20,1,1,1,1,1,1,10,1,1,1,1
19220843,Victor,1651,10/03/1994,22,0,0,0,0,173,71,2,2,1,3,2,1,1,3,3,3,1,13,11,12,10,9,7,8,12,10,9,10,8,10,12,11,10,8,12,9,11,9,13,14,4,12,9,9,10,14,13,8,7,20,17,13,7,14,7,10,10,6,10,10,20,10,10,10,10,5,7,7,D/WB/M/AM L,1,1,1,10,20,1,1,20,1,1,10,17,1,17,1
19220845,Jorge Eduardo,1651,08/09/1994,21,0,0,0,0,179,66,2,1,2,4,1,3,2,3,1,1,3,5,8,11,11,9,7,9,9,5,5,9,7,5,11,7,11,8,8,5,8,9,2,7,5,10,8,12,12,14,14,11,9,10,13,14,20,11,9,9,8,7,8,13,11,12,10,11,13,8,12,4,S ,1,1,20,1,1,14,1,1,1,1,1,1,1,1,1
19220847,Giovanni,1651,23/06/1989,27,0,0,0,0,182,73,3,3,2,1,1,1,1,2,2,2,2,13,12,12,10,14,11,12,10,11,11,13,4,15,12,12,11,13,11,11,13,11,13,13,10,13,10,13,12,13,13,12,14,20,11,13,12,12,14,10,7,10,14,12,10,12,13,10,9,9,12,9,D L,1,1,1,1,1,1,1,20,1,1,1,1,1,13,1
19220896,Leandro Pereira,1651,13/07/1991,24,0,0,0,0,190,75,2,1,3,2,2,4,3,3,1,4,1,6,10,11,12,11,9,14,10,6,7,10,13,7,11,12,13,12,13,13,11,13,13,12,11,13,8,12,12,13,13,8,16,9,14,13,20,13,13,12,10,11,9,9,6,12,10,11,10,9,10,8,S ,1,1,20,1,8,1,1,1,1,1,1,1,1,1,1
19220948,Carlinhos,1651,08/08/1994,21,0,0,0,0,174,71,1,4,1,1,3,2,3,3,2,3,3,11,15,11,6,13,10,7,8,10,9,11,7,10,8,8,8,7,8,10,10,6,14,6,5,10,5,11,9,12,14,11,6,11,9,14,20,15,9,10,3,10,10,10,10,12,11,11,10,8,11,3,AM/S R,1,1,20,1,1,19,1,1,1,1,1,1,1,1,1
19220951,Wendell,1651,08/09/1992,23,0,0,0,0,192,94,13,11,9,4,13,10,8,13,5,8,11,5,3,2,3,1,8,1,1,2,3,1,5,2,5,10,10,10,8,8,7,13,7,3,9,3,12,8,7,13,15,8,10,9,11,13,20,2,9,10,7,9,10,10,20,8,10,12,13,1,5,3,GK ,20,1,1,1,1,1,1,1,1,1,1,1,1,1,1
19221036,Edy,1651,17/03/1993,23,0,0,0,0,180,0,3,1,2,2,3,1,2,1,1,2,2,8,7,6,5,14,5,9,4,8,9,8,4,13,10,10,9,10,8,13,8,10,2,9,11,8,7,10,9,14,14,10,6,10,8,14,20,9,8,10,10,10,9,10,17,11,9,11,10,6,16,2,D/WB R,1,1,1,1,1,1,1,1,20,1,1,1,1,1,19
19221037,André,1651,12/06/1993,23,0,0,0,0,184,0,2,2,3,3,2,1,2,1,3,2,3,5,3,4,1,6,4,13,5,4,10,5,1,11,1,8,10,8,6,7,5,13,1,1,3,5,13,5,6,6,9,6,10,9,8,10,20,9,8,6,8,2,6,8,20,11,11,11,11,8,11,4,D C,1,1,1,1,1,1,20,1,1,1,1,1,1,1,1
19221039,Hyago,1651,22/04/1995,21,0,0,0,0,187,0,2,2,3,1,3,2,3,2,3,3,3,7,7,6,8,14,5,7,9,6,7,13,2,12,9,8,13,8,6,11,11,14,14,9,8,7,12,8,10,13,13,5,14,14,15,13,20,6,8,9,8,8,9,9,11,11,12,11,10,7,4,3,DM ,1,1,1,1,1,1,11,1,1,20,10,1,1,1,1
19221044,Ronaldo,1651,27/06/1994,22,0,0,0,0,180,73,1,3,1,3,1,1,2,3,2,4,1,10,6,10,9,11,6,9,11,4,12,11,4,10,12,9,10,11,11,11,14,11,13,7,14,10,12,11,13,13,11,11,9,11,13,12,20,12,11,12,9,12,6,11,9,12,12,12,9,8,10,6,DM/M C,1,1,1,1,1,1,1,1,13,18,20,1,1,1,13
19221048,Everton,1651,03/07/1993,22,0,0,0,0,186,78,3,4,3,2,2,1,1,2,3,2,2,7,9,14,14,10,6,14,7,3,8,9,10,3,14,8,10,7,10,9,7,14,2,13,9,13,9,8,9,14,14,9,11,1,15,14,20,11,9,10,7,10,10,10,10,11,10,8,9,7,10,8,S ,1,1,20,1,1,1,1,1,1,1,1,1,1,1,1
19221051,Evandrizio,1651,18/02/1994,22,0,0,0,0,190,0,13,8,6,1,13,8,7,13,9,9,11,6,1,2,3,2,9,1,1,1,1,1,3,2,1,9,8,12,7,8,5,13,3,2,5,1,8,7,6,12,10,7,10,20,9,11,10,2,10,9,6,9,8,9,17,8,12,10,11,3,2,4,GK ,20,1,1,1,1,1,1,1,1,1,1,1,1,1,1
19221054,Bruno,1651,02/01/1993,23,0,0,0,0,180,0,2,3,2,1,3,2,1,1,3,1,1,6,2,12,10,13,6,13,7,5,5,4,5,1,9,7,12,4,6,6,4,10,7,9,9,11,6,6,7,13,13,7,10,9,10,13,20,9,8,9,9,4,5,9,10,9,11,11,11,6,8,7,S ,1,1,20,1,1,1,1,1,1,1,1,1,1,1,1
19221060,Fabrício Baiano,1651,13/06/1992,24,0,0,0,0,184,0,2,4,2,2,1,1,2,1,3,4,3,5,7,9,10,11,8,10,8,4,12,10,6,12,10,13,13,12,11,12,10,12,4,11,8,11,11,13,13,13,11,13,12,5,13,13,20,14,13,11,10,10,10,12,17,9,10,11,12,4,13,5,DM C,1,1,1,1,1,1,1,1,1,20,15,1,1,1,1
19221061,Leonardo,1651,15/11/1993,22,0,0,0,0,193,0,3,3,2,2,3,1,2,1,1,3,2,5,5,3,4,8,3,13,6,1,11,9,6,10,8,10,12,10,9,7,3,14,4,2,14,6,11,7,9,14,10,7,11,8,10,13,20,6,10,4,10,7,10,10,20,10,13,12,11,4,12,2,D C,1,1,1,1,1,1,20,1,1,1,1,1,1,1,1
19221253,Rodrigo Celeste,1651,30/06/1990,26,0,0,0,0,170,0,3,2,1,3,4,1,3,2,4,2,2,7,7,6,5,9,7,7,10,2,10,12,7,13,13,5,7,9,8,8,12,13,10,10,13,7,12,9,12,13,13,9,2,10,12,13,20,12,6,10,7,10,4,10,8,13,11,12,9,8,8,2,DM/M C,1,1,1,1,1,1,1,1,1,20,17,1,1,1,1
19221254,Birungueta,1651,17/08/1993,22,0,0,0,0,175,63,1,1,2,3,1,2,1,3,3,1,3,8,7,10,5,11,8,8,11,8,7,13,3,12,14,10,11,7,11,9,12,11,10,13,7,13,11,9,13,12,12,7,9,11,10,12,20,10,6,10,10,10,10,10,20,10,14,11,10,6,7,6,AM C,1,1,1,20,1,1,1,1,1,1,14,1,1,1,1
19221255,Moisés,1651,17/07/1986,29,0,0,0,0,169,65,4,1,3,3,2,3,2,4,3,2,1,8,6,13,14,14,6,14,9,7,8,9,10,5,12,8,14,6,14,8,8,13,7,11,3,14,6,8,9,14,14,7,7,3,13,14,20,11,10,10,6,10,10,9,15,10,12,10,12,9,7,3,S ,1,1,20,1,1,1,1,1,1,1,1,1,1,1,1
19221257,Tony,1651,25/09/1992,23,0,0,0,0,194,80,13,9,11,4,12,13,5,13,10,10,10,6,2,3,1,3,10,1,3,2,2,1,2,2,2,6,9,12,8,8,7,13,4,3,12,1,13,8,7,12,15,8,16,10,16,8,20,6,12,10,9,6,10,10,19,14,9,12,13,3,15,6,GK ,20,1,1,1,1,1,1,1,1,1,1,1,1,1,1
19221258,Arthur,1651,02/10/1993,22,0,0,0,0,180,0,1,1,3,3,2,3,3,3,2,3,1,6,8,9,4,8,8,8,7,2,13,11,5,15,10,3,13,9,9,11,12,13,6,1,15,8,15,9,7,9,15,8,9,2,9,13,20,9,8,9,9,9,9,9,18,14,12,12,11,6,7,5,DM R,1,1,1,1,1,1,1,1,15,20,10,1,1,1,1
19221259,Rafael Vila,1651,04/02/1988,28,0,0,0,0,170,64,2,2,3,1,3,1,3,2,3,2,3,7,7,8,6,12,7,7,7,3,9,11,3,13,14,8,10,8,9,9,11,12,9,13,6,9,8,8,13,14,13,8,3,2,16,13,20,14,7,9,9,9,9,14,12,13,15,10,11,1,7,2,DM/M C,1,1,1,15,1,1,1,9,11,18,20,1,1,7,9
19221260,Robson,1651,08/07/1993,22,0,0,0,0,180,0,1,3,2,2,1,1,2,2,3,1,3,7,5,5,4,13,7,4,9,3,12,11,4,8,13,9,10,2,7,8,13,13,3,10,14,9,9,8,5,13,13,7,6,13,8,13,20,6,8,10,7,3,6,10,16,10,11,10,10,9,9,8,M C,1,1,1,1,1,1,1,1,1,1,20,1,1,1,1
19221261,Róbson,1651,30/05/1991,25,0,0,0,0,176,75,3,1,3,1,1,1,1,2,2,3,1,11,15,12,13,12,10,12,12,10,9,12,12,9,13,7,10,9,14,6,8,15,12,10,4,14,9,11,12,14,14,11,6,12,14,13,20,13,9,13,10,11,8,11,9,12,11,11,11,6,12,6,AM/S RC,1,1,19,15,13,20,1,1,1,1,13,1,1,1,1
19221278,Ivan Pereira,1651,12/10/1992,23,0,0,0,0,171,70,1,1,2,2,1,2,3,3,2,3,3,6,6,4,6,12,6,1,10,3,10,13,5,11,9,6,7,6,8,6,7,8,5,4,14,9,7,7,12,13,13,7,2,8,13,13,20,11,6,9,8,6,5,9,11,10,12,10,11,4,5,5,M C,1,1,1,1,1,1,1,1,1,1,20,1,1,1,1
19221327,Eduardo,1651,13/02/1996,20,0,0,0,0,184,0,1,2,1,3,1,2,3,3,2,3,3,7,2,4,2,7,7,14,3,2,14,9,5,14,8,10,14,10,9,12,1,14,9,9,7,7,10,8,9,14,12,9,11,10,13,13,20,6,10,9,10,10,6,10,16,11,13,11,13,3,13,7,D C,1,1,1,1,1,1,20,1,1,1,1,1,1,1,1
19221328,Gabriel,1651,10/06/1997,19,0,0,0,0,185,0,6,11,8,1,14,14,9,14,6,7,9,5,1,2,3,2,7,1,1,2,2,3,2,2,5,9,6,13,5,13,7,14,4,1,11,3,12,8,7,12,12,8,14,3,12,13,20,2,10,9,5,9,9,8,12,12,10,12,11,11,13,6,GK ,20,1,1,1,1,1,1,1,1,1,1,1,1,1,1
19221329,Léo Mendes,1651,15/02/1996,20,0,0,0,0,183,0,2,1,3,3,1,1,3,4,1,3,3,5,7,8,6,9,8,15,7,1,11,9,1,15,4,9,15,10,9,8,7,15,4,1,5,7,8,8,9,10,10,5,7,8,15,11,20,6,9,9,9,9,9,9,9,11,12,14,11,11,10,8,D C,1,1,1,1,1,1,20,1,1,1,1,1,1,1,1
19221352,Rodrigo Figueiredo,1651,27/03/1996,20,0,0,0,0,178,0,3,4,3,1,1,1,1,3,1,2,2,4,2,12,9,13,7,6,12,4,7,13,2,8,12,8,10,4,9,6,13,9,13,13,7,9,6,10,11,12,13,8,8,12,12,11,20,11,7,10,10,7,8,10,20,11,13,12,11,6,5,2,AM C,1,1,1,20,1,1,1,1,1,1,10,1,1,1,1
19221382,Yuri Branco,1651,16/07/1994,21,0,0,0,0,193,0,1,1,1,2,1,4,1,2,1,2,2,6,3,6,6,9,4,14,5,6,14,9,2,12,6,10,11,10,7,8,6,10,10,4,10,8,14,8,9,11,11,9,14,9,12,13,20,6,13,10,9,10,7,10,20,10,14,10,10,8,1,1,D C,1,1,1,1,1,1,20,1,1,1,1,1,1,1,1
19221407,Edinho,1651,08/08/1994,21,0,0,0,0,158,60,2,3,4,2,2,3,1,2,3,3,1,6,5,13,14,14,1,8,13,5,7,14,5,4,14,7,12,9,6,9,14,10,3,14,10,12,8,7,11,15,15,4,4,11,16,14,20,8,3,10,4,10,8,10,11,12,9,10,12,4,3,4,AM C,1,1,1,20,1,1,1,1,1,1,10,1,1,1,1
19221408,Jussimar,1651,07/10/1988,27,0,0,0,0,167,61,1,1,3,2,2,3,3,1,1,3,2,9,11,10,8,14,6,11,11,9,7,9,5,6,12,11,14,10,11,7,11,8,9,10,12,11,9,8,8,9,12,7,2,7,12,14,20,12,8,10,9,10,3,9,15,9,10,12,13,10,8,4,AM/S RC,1,1,19,20,12,20,1,1,1,1,1,1,1,1,1
19221410,Luiz Felipe,1651,09/09/1993,22,0,0,0,0,186,79,3,1,3,2,3,1,2,3,3,2,3,7,6,9,9,12,9,14,8,8,14,13,8,15,13,13,14,13,13,13,8,13,13,8,10,8,13,13,13,12,12,10,13,12,14,13,20,12,11,13,12,12,10,5,15,12,12,12,11,11,10,6,D C,1,1,1,1,1,1,20,1,1,1,1,1,1,1,1
19221488,Inácio,1651,29/01/1996,20,0,0,0,0,179,71,3,1,2,1,2,1,3,3,1,4,2,7,12,12,13,11,13,11,13,8,8,12,7,8,12,9,11,9,7,7,12,12,12,13,10,10,6,12,10,12,12,11,6,20,14,13,10,13,12,10,10,10,7,10,7,12,9,13,11,6,7,1,D/WB/AM L,1,1,1,11,16,14,1,20,1,1,1,15,1,18,1
19221567,Maycon,1651,15/07/1997,18,0,0,0,0,171,66,2,3,3,3,3,2,2,2,2,1,1,8,8,10,11,16,5,9,13,4,13,14,8,11,13,12,11,12,11,15,13,11,13,11,8,13,13,12,15,12,14,14,6,20,12,13,12,14,8,12,8,16,15,11,16,10,11,10,12,7,1,4,M C,1,1,1,1,1,1,1,11,1,13,20,1,1,11,1
19221582,Everton,1651,20/03/1995,21,0,0,0,0,169,0,2,2,3,1,1,2,1,1,4,4,2,7,4,7,4,14,7,7,7,4,8,10,2,12,13,9,9,8,9,9,14,12,4,2,10,7,11,8,12,14,11,8,4,9,13,12,20,8,7,9,9,9,9,9,8,10,11,13,9,6,6,1,DM C,1,1,1,1,1,1,1,1,1,20,15,1,1,1,1
19221583,Ueslei,1651,20/03/1995,21,0,0,0,0,169,0,3,1,2,2,1,3,3,2,2,2,3,4,4,7,3,13,1,8,7,6,8,5,2,13,9,9,11,9,8,11,6,11,5,6,13,7,10,8,9,14,10,8,4,5,15,13,20,7,7,9,9,2,5,9,20,10,11,9,9,6,19,7,D R,1,1,1,1,1,1,1,1,20,13,7,1,1,1,15
19221584,Vagner,1651,27/10/1996,19,0,0,0,0,190,65,1,1,4,1,1,1,2,2,3,2,3,2,1,1,2,6,1,13,4,2,12,7,4,10,4,8,7,8,7,5,1,14,8,6,1,4,14,6,7,9,8,7,15,6,9,8,20,9,8,8,8,8,8,8,12,10,10,9,10,5,12,4,D C,1,1,1,1,1,1,20,1,1,1,1,1,1,1,1
19221728,Lico,1651,19/04/1997,19,0,0,0,0,170,0,2,4,3,1,3,2,1,2,4,2,1,10,13,4,5,9,7,4,5,3,5,6,2,6,5,6,6,6,2,3,3,9,6,7,12,5,4,5,6,13,7,2,1,16,12,8,20,7,3,6,7,7,7,7,14,12,12,11,12,1,15,4,WB/AM R,1,1,1,13,1,17,1,1,15,1,9,1,15,1,20
19221812,Diego Tavares,1651,06/07/1991,24,0,0,0,0,181,78,3,2,2,2,4,3,3,2,2,3,1,8,11,11,8,13,3,11,8,10,11,12,7,13,12,6,14,12,6,10,10,15,6,7,7,10,10,12,12,15,11,12,11,11,14,11,20,14,12,12,11,6,6,11,10,10,11,11,12,7,3,2,D/WB R,1,1,1,1,1,1,1,1,20,1,1,1,1,1,19
19221908,Juninho,1651,26/12/1995,20,0,0,0,0,176,0,1,4,1,1,1,1,2,3,2,2,1,6,8,3,3,10,4,8,4,3,10,9,2,14,9,9,10,8,10,9,7,9,6,5,11,9,8,9,10,15,15,9,10,3,8,15,20,11,6,9,9,9,4,13,15,13,9,10,11,3,11,1,D/WB L,1,1,1,8,11,2,1,18,12,1,1,13,6,20,10
19221976,Renan Dutra,1651,20/01/1992,24,0,0,0,0,189,87,2,3,1,1,1,1,1,1,2,2,1,4,1,5,2,6,1,13,2,4,13,7,5,13,1,9,12,9,7,6,1,7,1,1,11,3,13,6,8,13,12,7,13,9,8,13,20,12,10,9,9,9,9,9,19,12,12,9,11,3,15,7,D C,1,1,1,1,1,1,20,1,1,1,1,1,1,1,1
19222018,Cristiano Lopes,1651,24/06/1988,28,0,0,0,0,189,0,1,3,3,3,3,3,2,1,2,2,1,7,7,10,14,14,8,14,9,4,8,9,6,8,12,10,14,4,9,9,6,14,7,11,8,8,7,4,9,14,14,9,9,8,10,14,20,8,11,10,7,9,10,10,10,11,10,11,12,7,8,3,S ,1,1,20,1,1,1,1,1,1,1,1,1,1,1,1
19222054,Julinho,1651,05/06/1995,21,0,0,0,0,175,0,2,3,3,2,1,3,3,2,4,2,2,1,1,6,5,10,1,2,10,1,4,10,1,6,11,8,6,2,2,1,12,12,7,12,1,6,6,6,9,12,12,5,5,7,9,12,20,5,4,8,8,8,8,8,11,11,12,12,12,7,10,5,AM C,1,1,1,20,1,1,1,1,1,1,15,1,1,1,1
19222076,Fabrício Paraíba,1651,30/06/1993,23,0,0,0,0,188,0,3,1,1,1,3,3,3,1,3,1,1,4,1,1,3,7,1,13,3,3,13,7,3,13,4,9,13,9,7,9,4,13,3,9,4,5,13,3,7,6,9,7,13,20,12,10,5,4,10,9,9,9,9,9,14,12,11,11,13,3,7,8,D C,1,1,1,1,1,1,20,1,1,1,1,1,1,1,1
19222080,Gelvane,1651,31/01/1988,28,0,0,0,0,179,0,3,3,1,1,1,2,2,3,1,3,2,4,4,7,1,11,4,8,6,4,9,8,3,14,9,5,8,9,9,11,6,11,4,8,6,7,10,9,9,14,13,6,7,20,16,11,9,7,7,8,9,7,9,9,13,12,13,11,10,6,10,2,D/WB L,1,1,1,1,1,1,1,20,1,1,1,1,1,17,1
19222085,Alexandre,1651,18/04/1994,22,0,0,0,0,190,71,3,1,1,1,3,3,1,2,2,2,1,3,7,9,6,10,7,11,7,5,11,9,5,12,8,12,11,14,10,11,10,9,10,6,10,8,12,12,12,10,9,12,16,20,15,12,5,12,15,13,7,11,7,10,12,14,10,11,12,8,1,4,D C,1,1,1,1,1,1,20,1,1,1,1,1,1,1,1
19222383,Neto,1651,29/01/1991,25,0,0,0,0,182,0,2,1,2,2,2,3,3,3,2,1,1,4,1,1,4,6,1,12,4,3,13,7,3,13,2,9,10,9,7,8,4,6,6,9,11,4,13,6,7,13,13,7,10,8,15,13,20,12,12,9,15,9,4,9,12,12,10,12,12,6,16,3,D C,1,1,1,1,1,1,20,1,1,1,1,1,1,1,1
19222410,Gustavo,1651,11/04/1994,22,0,0,0,0,186,85,13,13,5,9,13,13,11,13,10,10,8,5,1,1,3,1,7,1,3,1,1,1,1,3,2,10,9,13,7,9,3,13,5,1,13,3,12,8,7,10,14,8,11,10,11,12,20,6,8,10,10,7,10,10,13,11,12,15,13,7,2,6,GK ,20,1,1,1,1,1,1,1,1,1,1,1,1,1,1
19222414,Lucas,1651,17/10/1994,21,0,0,0,0,178,0,2,1,2,2,3,2,1,2,2,3,2,7,5,5,5,12,2,7,7,7,9,9,2,13,9,9,5,9,9,11,8,13,9,7,11,5,9,9,9,14,14,9,5,12,11,13,20,8,7,9,9,6,9,9,15,8,14,11,10,5,15,6,D/WB R,1,1,1,1,1,1,1,1,20,1,1,1,1,1,19
19222415,Dener,1651,17/09/1994,21,0,0,0,0,181,0,2,3,1,2,2,2,2,3,1,1,1,7,2,2,4,6,4,14,3,4,14,8,7,14,4,9,11,9,8,6,7,13,5,1,1,7,10,7,7,13,14,8,11,8,11,14,20,10,9,9,9,9,5,9,8,10,10,10,10,8,10,5,D C,1,1,1,1,1,1,20,1,1,1,1,1,1,1,1
19222422,Sanchez,1651,28/09/1995,20,0,0,0,0,178,73,1,2,4,1,1,3,2,4,3,2,2,5,7,8,5,11,3,9,6,4,10,8,8,14,7,10,10,10,10,7,10,11,5,9,7,8,9,10,10,14,14,7,6,20,15,13,10,13,7,10,7,9,6,10,13,10,10,9,10,8,18,8,D/WB L,1,1,1,1,1,1,1,20,1,1,1,1,1,19,1
19222425,Kalil,1651,08/07/1994,21,0,0,0,0,183,0,3,1,1,3,3,1,2,2,1,1,3,8,4,5,6,10,8,12,7,2,12,8,3,14,6,10,11,6,10,7,9,13,2,9,1,6,8,8,10,13,14,10,10,12,7,14,20,6,8,8,4,10,10,15,15,10,12,13,12,7,9,8,D C,1,12,1,1,1,1,20,10,10,12,1,1,1,1,1
19222428,Alan Fabrício,1651,29/08/1994,21,0,0,0,0,177,70,4,2,2,3,4,3,3,3,2,1,3,9,5,12,13,14,9,9,12,5,7,12,7,7,14,4,12,3,8,9,11,13,7,12,4,11,8,10,8,13,14,8,8,10,12,13,20,12,7,10,5,2,10,10,12,11,11,11,8,7,10,2,AM C,1,1,1,20,1,1,1,1,1,1,10,1,1,1,1
19222430,Iago,1651,20/11/1996,19,0,0,0,0,182,0,2,3,2,2,3,3,2,3,1,3,1,5,3,3,7,12,5,5,12,1,3,13,7,3,12,8,3,5,13,4,13,10,3,12,12,7,5,7,10,13,8,6,5,7,15,9,20,11,5,8,8,8,7,8,20,12,10,11,11,3,6,1,AM C,1,1,1,20,1,1,1,1,1,1,15,1,1,1,1
19222439,Breno,1651,18/01/1996,20,0,0,0,0,172,0,3,1,3,2,3,1,1,1,4,2,3,5,10,8,7,11,10,9,5,8,9,10,7,14,10,5,10,10,7,10,8,10,10,3,8,7,8,10,10,14,14,10,2,10,8,14,20,9,7,10,10,9,10,10,8,12,7,9,11,7,8,7,D/WB R,1,1,1,1,1,1,1,1,20,1,1,1,1,1,19
19222440,Nogueira,1651,27/03/1995,21,0,0,0,0,187,82,2,2,2,3,2,1,2,2,2,1,3,7,3,1,8,11,7,12,9,10,13,11,7,15,10,11,9,12,9,11,6,15,12,5,11,8,15,10,11,11,9,13,12,11,11,11,20,12,15,11,11,1,8,11,16,12,12,11,9,11,5,5,D C,1,1,1,1,1,1,20,1,1,1,1,1,1,1,1
19222444,Marcelo,1651,07/01/1996,20,0,0,0,0,180,78,1,3,2,1,3,1,1,4,2,1,1,5,2,8,7,6,3,13,10,6,12,11,5,13,11,14,12,13,10,12,8,15,11,2,1,10,12,10,13,15,12,13,14,11,7,13,20,13,13,12,11,10,10,11,16,11,11,10,12,12,4,6,D C,1,1,1,1,1,1,20,1,1,1,1,1,1,1,1
19222445,Magdiel,1651,03/03/1995,21,0,0,0,0,174,63,3,3,2,3,1,2,2,2,3,1,1,7,8,7,8,11,3,8,5,9,11,11,3,15,9,8,12,11,5,7,5,11,2,8,11,8,10,11,10,15,12,11,6,20,10,11,10,10,8,10,10,10,8,10,9,12,10,11,9,3,12,5,D/WB L,1,1,1,1,1,1,1,20,1,1,1,1,1,19,1
19222446,Jefferson Renan,1651,18/03/1993,23,0,0,0,0,172,67,2,3,1,1,3,2,2,1,1,2,2,5,6,12,8,12,6,6,7,4,6,12,1,7,13,9,7,5,7,7,9,9,2,13,9,9,7,7,5,13,13,13,5,20,9,13,10,9,4,9,9,9,9,9,14,13,12,10,8,6,8,6,AM C,1,1,1,20,1,1,1,1,1,1,10,1,1,1,1
19222447,Euller,1651,30/01/1995,21,0,0,0,0,185,80,1,1,2,4,2,2,3,3,2,2,3,6,2,13,13,13,6,13,7,1,6,7,4,1,11,9,8,5,7,6,7,11,3,11,2,7,6,6,7,13,12,7,10,12,13,11,20,7,10,9,5,8,9,9,10,10,13,13,12,10,6,8,S ,1,1,20,1,1,1,1,1,1,1,1,1,1,1,1
19222448,Matheus Pato,1651,08/06/1995,21,0,0,0,0,183,64,2,2,3,2,2,2,2,2,2,2,1,6,4,13,11,13,7,13,8,2,6,8,4,4,13,4,12,5,10,8,8,13,17,13,9,13,7,7,9,13,13,8,7,11,10,13,20,10,11,12,4,10,8,10,15,9,13,10,13,11,10,1,S ,1,1,20,1,1,1,1,1,1,1,1,1,1,1,1
19222449,Gabriel Proença,1651,17/01/1995,21,0,0,0,0,171,65,3,3,3,1,3,3,3,1,2,2,1,2,6,8,2,7,1,5,4,4,8,9,3,14,9,8,7,9,7,9,6,15,6,5,4,8,8,5,9,15,13,13,7,9,10,10,20,11,5,9,9,9,7,9,17,11,12,14,8,4,1,3,D R,1,1,1,1,1,1,1,1,20,1,1,1,1,1,1
19222465,Marcelo Rosa,1651,28/05/1991,25,0,0,0,0,176,75,1,1,2,2,4,4,3,3,1,2,4,2,6,8,9,10,7,7,11,6,13,10,3,13,8,9,13,8,6,9,10,12,2,9,4,8,8,9,9,14,14,9,7,10,14,14,20,13,9,9,9,9,5,9,19,10,12,10,13,2,3,7,DM/M C,1,1,1,1,1,1,1,1,1,20,17,1,1,1,1
19222810,Aílton,1651,16/03/1995,21,0,0,0,0,181,66,4,2,2,1,3,3,3,2,3,2,2,10,12,12,7,12,11,6,12,11,9,12,6,10,12,15,13,12,11,11,10,9,12,10,6,12,11,11,11,13,12,11,10,20,12,13,7,11,10,10,10,9,5,10,10,12,8,11,13,13,15,6,D/WB L,1,1,1,1,1,1,1,20,1,1,1,1,1,19,1
19222844,João Afonso,1651,09/02/1995,21,0,0,0,0,181,81,2,3,2,2,3,2,4,2,3,2,2,6,9,9,7,11,6,11,7,9,12,11,8,12,10,14,12,12,11,12,8,10,15,6,8,6,13,13,12,13,12,9,11,8,10,12,20,14,14,11,15,4,8,7,10,13,10,9,15,9,14,5,DM ,1,1,1,1,1,1,1,1,1,20,10,1,1,1,1
19222848,Rafael Ratão,1651,30/11/1995,20,0,0,0,0,176,71,1,3,3,2,1,3,2,3,2,3,4,10,13,13,12,12,11,8,11,8,9,11,6,8,12,12,10,13,12,12,8,13,11,17,5,10,7,11,11,15,12,7,10,11,15,13,20,9,7,12,5,9,9,11,18,9,11,11,12,8,12,7,AM/S RL,1,1,20,1,17,19,1,1,1,1,1,1,1,1,1
19222979,Juliano,1651,28/02/1995,21,0,0,0,0,167,64,3,1,2,1,2,3,3,1,1,3,1,8,9,9,5,12,6,10,9,8,9,11,5,14,8,7,11,11,6,7,8,15,10,10,5,9,12,11,11,15,15,11,1,11,11,15,20,11,8,10,7,10,10,10,10,12,11,9,8,3,7,4,D/WB R,1,1,1,1,1,1,1,1,20,1,1,1,1,1,19
19222982,Yann Rolim,1651,15/03/1995,21,0,0,0,0,173,68,3,3,2,3,3,3,2,1,1,1,1,13,11,13,9,14,12,5,10,4,5,14,10,6,15,12,11,8,13,10,15,10,12,15,6,10,6,13,12,11,14,10,6,11,12,11,20,10,8,11,7,11,7,8,8,14,10,11,10,7,13,9,M/AM C,1,1,8,20,1,1,1,1,1,12,17,1,1,1,1
19222984,Deivison,1651,12/04/1991,25,0,0,0,0,187,81,3,2,1,1,2,2,1,3,3,2,3,6,3,11,13,12,5,13,5,1,6,7,8,1,13,8,8,5,13,4,3,8,9,13,13,13,7,6,7,13,12,7,12,9,11,13,20,7,10,9,9,9,9,8,19,12,10,9,11,4,16,1,S ,1,1,20,1,1,1,1,1,1,1,1,1,1,1,1
19222985,Gustavo Ermel,1651,29/03/1995,21,0,0,0,0,165,64,1,2,2,1,3,1,3,3,2,3,2,9,9,12,12,11,9,5,12,3,10,9,10,10,11,8,10,10,11,11,11,11,19,14,6,12,6,11,13,15,15,17,3,20,12,15,7,11,5,10,9,2,7,11,17,10,12,12,9,10,10,4,M/AM R,1,1,11,12,14,20,1,1,1,1,8,10,16,1,1
19222989,Nathan,1651,13/03/1996,20,0,0,14,3,178,71,1,3,1,2,1,3,1,2,3,1,1,11,11,15,12,14,12,7,13,4,5,13,12,6,15,10,12,10,11,11,11,11,14,15,7,13,5,12,8,13,14,10,8,13,15,12,20,10,9,9,7,8,3,13,15,14,10,12,11,6,12,6,AM LC,1,1,12,20,18,1,1,1,1,1,12,14,1,1,1
19223058,Gabriel Almeida,1651,03/09/1996,19,0,0,0,0,174,60,2,2,2,3,3,2,2,1,2,3,2,8,8,13,8,13,14,6,8,2,7,12,6,5,12,9,4,7,9,7,12,12,11,14,4,8,1,7,8,13,13,7,6,20,15,13,10,6,4,9,9,5,5,9,9,12,12,12,11,12,17,5,M/AM RLC,1,1,12,20,15,15,1,1,1,1,18,1,1,1,1
19223062,Henrique,1651,10/03/1996,20,0,0,0,0,185,0,2,1,1,2,2,3,3,2,3,3,3,5,4,2,5,6,1,13,1,1,12,7,1,13,6,9,11,9,6,7,1,10,9,1,8,2,12,6,7,13,10,7,9,16,10,11,20,9,9,9,6,9,9,9,9,9,10,14,12,1,7,6,D C,1,1,1,1,1,1,20,1,1,1,1,1,1,1,1
19223066,Lucas,1651,23/09/1988,27,0,0,0,0,181,77,2,2,3,2,3,1,1,1,1,1,2,10,12,11,10,11,10,13,13,8,13,11,12,13,12,13,12,13,12,10,12,12,3,11,9,11,12,13,13,12,11,12,12,20,13,12,8,13,12,11,11,10,9,13,20,12,12,13,12,8,12,6,DM/M C,1,1,1,1,1,1,1,1,1,19,20,1,1,1,1
19223076,Kallyl,1651,24/03/1995,21,0,0,0,0,180,78,2,1,1,3,2,4,1,2,2,1,2,6,2,13,13,13,4,13,7,1,6,7,3,3,13,9,8,6,8,7,4,5,7,13,3,13,5,6,7,13,13,5,9,8,9,13,20,6,9,9,9,4,9,9,20,14,8,11,8,7,7,2,S ,1,1,20,1,1,1,1,1,1,1,1,1,1,1,1
19223084,Abner,1651,06/06/1995,21,0,0,0,0,172,69,1,2,2,2,3,3,2,1,2,3,2,4,4,6,9,14,7,7,10,1,7,14,2,3,14,6,9,5,10,8,13,14,3,13,9,5,8,8,11,9,12,3,6,20,10,10,10,8,5,9,5,9,9,9,18,12,12,11,12,8,2,5,AM C,1,1,1,20,1,1,1,1,1,1,10,1,1,1,1
19223087,Ayrton,1651,06/05/1994,22,0,0,0,0,182,77,1,3,3,2,1,1,1,3,1,3,1,8,6,7,7,10,8,8,13,4,13,14,3,14,12,6,8,9,10,10,11,12,13,6,1,9,11,10,13,14,11,8,6,20,14,14,10,8,9,10,9,5,5,10,16,13,9,11,12,2,14,2,DM/M C,1,1,1,1,1,1,1,1,1,20,19,10,1,1,1
19223089,Lucas Balardin,1651,03/03/1995,21,0,0,0,0,182,79,3,2,2,2,4,4,1,2,3,3,4,4,4,5,6,8,2,12,9,6,15,9,3,15,6,10,15,10,10,10,5,15,5,3,3,7,12,9,5,9,13,9,7,15,5,13,20,9,8,10,9,10,10,10,10,11,12,11,12,7,12,1,D C,1,1,1,1,1,1,20,1,1,1,1,1,1,1,1
19223090,Felipe Zang,1651,21/05/1994,22,0,0,0,0,190,82,3,3,3,3,2,1,2,2,1,2,1,1,2,1,7,7,1,12,4,1,9,8,7,9,6,9,12,9,4,7,4,14,9,3,6,6,8,7,8,14,14,8,15,10,9,14,20,8,12,9,3,9,9,9,7,11,11,14,10,3,12,7,D C,1,1,1,1,1,1,20,1,1,1,1,1,1,1,1
19223092,Douglas Abner,1651,30/01/1996,20,0,0,0,0,175,62,3,2,2,3,1,2,1,2,3,3,2,6,9,13,8,11,6,9,8,4,5,10,7,5,14,10,12,12,8,11,8,8,10,13,6,14,5,8,13,14,14,13,6,11,12,13,20,11,10,9,6,8,10,8,7,14,9,8,15,12,10,11,AM/S C,1,1,20,17,1,12,1,1,1,1,1,1,1,1,1
19223093,Gabriel Espeto,1651,18/04/1997,19,0,0,0,0,171,66,1,3,1,1,1,3,2,1,3,3,2,9,9,11,9,10,9,9,11,2,8,12,5,9,12,10,13,9,8,6,15,15,10,12,2,11,10,11,11,12,9,7,5,10,13,13,20,8,7,9,10,10,8,10,15,12,11,12,12,5,6,2,AM C,1,1,1,20,1,1,1,1,13,1,13,1,1,1,13
19223094,Lauder,1651,07/08/1996,19,0,0,0,0,173,73,3,1,3,3,2,1,3,3,1,2,1,7,7,14,11,14,7,14,9,3,5,13,1,4,12,8,10,7,6,5,11,12,19,12,4,11,8,8,4,13,12,8,5,10,13,13,20,8,5,9,9,9,9,9,10,11,13,12,8,2,12,7,AM/S C,1,1,18,20,1,1,1,1,1,1,10,1,1,1,1
19223098,Lucão,1651,27/04/1994,22,0,0,0,0,172,68,3,1,3,2,1,3,2,2,1,3,1,4,11,5,5,11,3,8,8,8,10,10,4,14,8,8,12,10,9,10,8,13,2,10,12,8,9,9,10,14,14,13,6,10,13,13,20,7,8,10,10,9,10,10,18,11,10,11,12,11,7,3,D/WB R,1,1,1,1,1,1,10,1,20,1,1,1,1,1,19
19223131,Márcio Ferrari,1651,12/01/1996,20,0,0,0,0,178,75,1,1,2,3,1,3,3,1,1,2,1,7,5,4,4,13,7,7,12,4,8,14,1,14,8,9,9,8,9,5,10,9,5,9,8,7,9,8,12,13,10,8,9,11,9,11,20,8,7,7,6,9,9,8,20,9,14,11,11,7,8,6,DM C,1,1,1,5,1,1,1,1,1,20,15,1,1,1,1
19223132,Kaique Vergilio,1651,19/01/1996,20,0,0,0,0,183,0,2,1,1,1,2,1,3,1,3,3,3,6,7,13,13,10,6,13,7,1,3,7,4,1,13,7,7,8,6,5,2,8,1,13,7,13,6,6,7,13,13,7,5,8,10,13,20,6,9,9,6,7,8,8,14,10,12,12,10,1,1,5,S ,1,1,20,1,1,1,1,1,1,1,1,1,1,1,1
19223133,Zé Paulo,1651,26/03/1994,22,0,0,0,0,189,78,2,3,1,2,3,3,1,3,2,1,2,9,9,12,11,15,10,12,13,3,8,11,7,11,13,8,12,8,8,10,15,11,12,13,1,9,11,10,14,12,12,10,14,11,16,12,20,10,8,10,8,10,8,10,16,13,12,14,14,1,4,8,AM C,1,1,10,20,1,1,1,1,1,1,13,1,1,1,1
19223134,Matheus Cassini,1651,15/02/1996,20,0,0,0,0,174,68,1,3,1,2,3,2,4,3,1,1,4,10,10,11,9,11,9,7,9,7,4,10,11,4,12,12,10,9,9,9,9,10,13,15,8,9,3,10,9,12,10,5,4,20,14,12,16,9,5,9,6,10,7,15,16,14,12,13,12,6,10,6,AM RLC,1,1,15,15,20,18,1,1,1,1,1,14,12,1,1
19223136,Ewerton,1651,27/09/1995,20,0,0,0,0,187,0,1,1,2,3,1,1,1,3,2,1,4,5,4,11,14,9,8,14,6,3,6,8,8,5,14,3,9,7,10,7,7,6,6,13,6,14,7,8,9,14,14,6,14,7,14,14,20,10,11,10,10,1,9,9,17,10,11,13,10,4,13,6,S ,1,1,20,1,1,1,1,1,1,1,1,1,1,1,1
19223137,Niel,1651,26/02/1997,19,0,0,0,0,182,78,2,2,1,4,2,2,3,2,3,2,1,7,9,10,10,15,9,9,13,4,8,12,5,14,13,10,11,9,9,8,15,14,3,5,7,10,11,11,12,14,11,11,12,2,12,13,20,15,10,10,10,7,5,10,7,10,12,10,11,6,15,8,DM/M C,1,1,1,1,1,1,1,1,1,20,19,1,1,1,1
19223427,Felipe Macedo,1651,27/03/1994,22,0,0,0,0,187,76,3,2,1,2,2,2,2,2,3,3,1,10,5,6,5,13,5,14,8,8,13,11,10,13,10,16,13,14,10,13,3,13,13,3,10,10,10,9,15,11,11,11,15,11,13,11,20,13,16,12,13,14,11,10,15,10,12,13,12,9,10,9,D C,1,1,1,1,1,1,20,1,1,1,1,1,1,1,1
19223545,Lucão,1651,05/06/1995,21,0,0,0,0,193,0,14,8,11,7,13,11,13,13,10,10,11,3,3,3,1,6,6,1,2,2,1,3,2,2,4,6,11,12,4,7,8,14,4,3,1,1,9,9,7,13,12,9,12,3,12,14,20,3,11,10,8,5,7,10,18,14,12,13,12,3,5,2,GK ,20,1,1,1,1,1,1,1,1,1,1,1,1,1,1
19223546,Breno,1651,06/03/1995,21,0,0,0,0,178,70,1,1,2,2,4,3,3,3,2,2,1,11,12,12,10,12,11,8,11,10,9,12,8,10,12,9,11,8,11,12,12,12,12,13,7,12,8,12,11,15,13,11,7,20,11,14,10,13,12,11,10,11,15,11,10,12,11,12,11,7,12,7,D/WB L,1,1,1,1,1,1,1,20,1,1,1,1,1,19,1
19223552,Crysan,1651,07/07/1996,19,0,0,0,0,182,70,1,1,1,2,3,2,1,3,3,2,3,10,12,13,13,11,11,13,11,12,10,11,12,10,11,11,11,11,12,11,12,10,15,12,10,11,12,11,10,14,12,12,11,11,13,13,20,12,11,11,11,12,11,11,10,15,10,12,10,6,11,2,AM/S LC,1,1,20,17,17,11,1,1,1,1,13,1,1,1,1
19223736,Lucão,1651,23/03/1996,20,0,0,0,0,187,78,3,1,2,1,3,1,2,1,1,3,1,8,11,6,8,8,4,13,5,5,13,12,11,13,12,11,12,10,12,16,9,11,9,4,5,7,12,11,12,13,16,13,14,12,13,14,20,13,13,13,8,10,4,13,20,9,11,9,15,9,2,8,D C,1,1,1,1,1,1,20,13,13,1,1,1,1,1,1
19223923,Marcelo Oliveira,1651,24/08/1988,27,0,0,0,0,177,0,2,3,2,3,2,3,3,2,2,2,2,5,3,10,9,14,8,8,12,3,10,14,6,9,11,10,10,9,8,7,13,10,5,10,7,13,10,9,13,14,14,12,8,10,11,14,20,8,8,10,5,10,10,10,14,12,12,13,11,6,7,4,M C,1,1,1,15,1,1,1,1,1,1,20,1,1,1,1
19223932,Ceará,1651,17/08/1987,28,0,0,0,0,169,70,2,2,2,2,1,3,3,4,1,1,1,7,12,9,4,11,8,8,5,8,10,9,4,14,9,10,11,7,9,11,10,10,10,2,11,8,13,9,4,14,14,9,3,10,12,14,20,6,7,10,6,10,6,10,9,11,12,12,11,1,3,4,D/WB R,1,1,1,1,1,1,1,1,20,15,1,1,1,1,19
19224083,Léo Jabá,1651,09/08/1998,17,0,0,0,0,178,75,1,3,3,4,2,3,1,3,3,1,3,10,12,12,13,12,8,11,12,8,8,11,13,5,12,13,12,8,12,9,12,1,10,13,1,14,10,12,13,13,13,13,12,11,13,14,20,12,13,10,8,5,9,10,17,12,11,13,13,7,4,2,AM/S L,1,1,19,1,20,14,1,1,1,1,1,1,1,1,1
19224334,Ian,1651,25/09/1996,19,0,0,0,0,184,0,1,2,1,1,3,3,2,3,2,3,1,6,5,7,5,13,6,6,13,1,5,11,5,8,13,9,9,1,5,7,13,12,7,13,3,9,5,7,12,13,11,7,8,9,10,12,20,11,6,9,6,8,9,9,18,11,11,10,11,2,14,1,AM C,1,1,1,20,1,1,1,1,1,1,13,1,1,1,1
19224426,João Kuspiosz,1651,10/10/1994,21,0,0,0,0,192,88,9,11,7,1,14,14,10,12,9,9,8,7,3,1,3,2,9,1,3,2,1,3,3,2,3,9,9,13,8,11,7,14,4,2,11,3,10,8,7,14,6,4,11,5,12,11,20,4,12,9,5,9,6,9,14,11,12,13,11,10,15,3,GK ,20,1,1,1,1,1,1,1,1,1,1,1,1,1,1
19224459,Saullo,1651,10/03/1997,19,0,0,0,0,187,0,2,2,1,3,4,1,3,1,3,2,3,6,7,7,12,13,4,13,5,1,4,8,8,6,13,9,13,6,9,7,9,9,13,13,9,6,6,6,8,13,12,7,11,20,13,12,9,9,7,9,5,3,8,9,10,11,8,12,12,11,13,5,S ,1,1,20,14,14,12,1,1,1,1,1,1,1,1,1
19224726,Juliano,1651,14/03/1998,18,0,0,0,0,185,75,14,10,9,3,14,12,10,14,9,6,10,3,2,3,1,3,8,1,1,2,3,1,3,3,4,9,12,14,4,8,7,12,6,2,9,1,7,8,7,14,11,8,14,10,14,14,20,5,7,9,6,2,4,9,9,13,9,13,13,6,12,6,GK ,20,1,1,1,1,1,1,1,1,1,1,1,1,1,1
19224729,Evander,1651,09/06/1998,18,0,0,0,0,179,76,3,1,1,4,1,4,1,1,1,2,2,11,11,13,12,12,12,10,13,4,5,12,11,6,13,10,12,11,12,11,13,13,13,15,11,12,6,11,11,14,12,11,9,9,14,14,20,12,11,13,6,12,10,16,19,13,13,11,12,8,11,9,AM RLC,1,1,13,20,15,15,1,1,1,13,15,10,1,1,1
19224806,Isaac,1651,26/01/1995,21,0,0,0,0,186,76,3,4,3,1,3,1,3,1,1,3,1,8,6,14,12,14,8,12,6,1,8,8,12,4,14,8,9,9,12,9,5,14,13,13,6,14,8,8,14,13,11,12,14,20,9,14,11,7,9,10,8,10,10,10,12,11,10,10,10,10,9,3,S ,1,1,20,1,1,1,1,1,1,1,1,1,1,1,1
19225443,Andreazzi,1651,09/05/1994,22,0,0,0,0,188,80,3,1,2,1,3,3,1,3,4,3,3,1,1,9,9,12,1,12,11,10,12,12,9,10,11,8,11,12,11,11,11,10,7,12,12,12,12,12,11,13,12,12,12,10,13,11,20,11,12,12,5,12,5,12,16,11,11,11,10,4,13,7,DM ,1,1,1,1,1,1,1,1,1,20,13,1,1,1,1
19225445,Erick,1651,23/05/1995,21,0,0,0,0,173,66,1,3,2,2,1,1,1,2,2,3,3,5,7,7,2,13,2,7,6,8,10,10,8,11,10,7,8,10,8,10,8,11,9,9,5,8,11,10,10,12,14,10,7,10,15,10,20,7,9,9,8,9,3,9,17,11,11,10,8,4,8,1,D/WB R,1,1,1,1,1,1,1,1,20,1,1,1,1,1,17
19225447,Igor Carioca,1651,02/01/1995,21,0,0,0,0,186,76,1,3,1,2,3,2,2,3,3,3,1,5,6,14,14,12,6,7,7,2,6,7,9,5,8,6,5,1,11,6,7,13,3,8,3,13,5,6,7,13,9,7,8,8,14,11,20,11,8,8,8,1,8,8,18,12,11,12,11,5,10,5,S ,1,1,20,1,1,1,1,1,1,1,1,1,1,1,1
19225448,Moraes,1651,12/06/1995,21,0,0,0,0,173,66,3,1,1,1,1,1,3,2,3,3,1,6,8,9,6,12,6,6,5,1,6,13,4,7,13,8,6,3,6,7,7,9,2,13,1,7,6,6,8,12,12,6,3,20,14,12,10,12,4,9,9,9,9,9,14,8,11,14,10,9,3,6,WB/M/AM LC,1,1,1,20,17,1,1,1,1,1,1,17,1,17,1
19225490,Raphael Silva,1651,20/04/1992,24,0,0,0,0,192,83,1,1,1,1,2,3,3,3,2,1,1,6,6,6,8,10,6,13,6,7,12,11,8,13,10,13,11,13,11,11,10,11,4,9,10,7,12,13,12,11,8,5,16,15,11,10,20,14,14,11,12,5,11,6,15,10,12,12,13,5,12,5,D C,1,1,1,1,1,1,20,1,1,1,1,1,1,1,1
19225494,Windson,1651,01/05/1995,21,0,0,0,0,189,0,4,3,1,3,1,4,2,2,2,2,1,3,1,1,2,5,1,12,3,3,12,2,1,12,4,6,9,7,5,6,4,12,8,1,1,3,12,4,5,7,8,5,7,16,10,12,20,3,8,8,5,8,8,8,14,13,12,11,12,10,14,7,D C,1,1,1,1,1,1,20,1,1,1,1,1,1,1,1
19225496,Ademir,1651,30/01/1995,21,0,0,0,0,179,76,1,2,2,2,1,4,2,3,1,4,1,7,8,15,10,11,8,15,9,3,8,9,3,2,7,9,8,8,10,8,9,15,7,8,1,13,9,8,10,14,13,5,5,11,13,13,20,7,5,11,9,9,7,9,6,11,13,12,10,9,5,1,S ,1,1,20,1,13,13,1,1,1,1,1,1,1,1,1
19225501,Luizinho,1651,07/01/1996,20,0,0,0,0,175,70,1,1,2,3,1,1,3,1,2,2,3,5,7,14,14,8,7,11,8,7,6,9,5,1,9,9,7,6,9,7,7,11,6,8,12,11,9,7,9,14,10,13,7,8,8,11,20,9,7,9,3,9,9,9,13,10,8,11,12,9,12,8,AM/S C,1,1,20,17,1,1,1,1,1,1,1,1,1,1,1
19225502,Maurício,1651,04/02/1994,22,0,0,0,0,184,78,4,3,1,2,3,1,3,1,3,2,2,4,6,5,5,6,6,13,3,1,12,8,1,13,7,8,11,9,7,8,2,13,6,9,10,4,13,6,8,12,13,7,7,1,16,13,20,7,8,9,5,6,4,9,11,11,10,13,12,2,14,5,D C,1,1,1,1,1,1,20,1,1,15,5,1,1,1,1
19225567,Elton,1651,23/08/1996,19,0,0,0,0,184,82,3,2,3,2,2,3,2,3,4,2,3,5,2,10,10,13,5,11,5,3,4,7,2,1,10,8,5,4,11,6,5,10,1,10,12,6,4,5,7,13,8,1,8,20,10,11,9,6,11,8,5,8,8,7,8,11,12,11,11,8,2,5,S ,1,1,20,14,1,1,1,1,1,1,1,1,1,1,1
19225612,Amaral,1651,04/10/1994,21,0,0,0,0,183,0,11,9,6,7,11,10,6,13,9,8,7,7,3,2,2,1,9,1,3,3,2,1,2,2,1,9,7,14,5,8,6,13,5,1,13,2,10,7,4,12,14,7,7,16,15,10,20,1,6,9,9,6,9,9,17,11,14,13,12,14,11,2,GK ,20,1,1,1,1,1,1,1,1,1,1,1,1,1,1
19225613,Carlos Henrique,1651,22/12/1993,22,0,0,0,0,185,83,2,1,4,2,3,2,3,1,1,1,3,4,1,1,4,8,3,14,5,5,12,9,4,14,4,13,14,10,9,9,7,14,10,1,6,8,14,8,9,10,14,9,14,1,16,13,20,6,8,10,13,4,6,10,14,11,9,14,14,7,13,4,D C,1,1,1,1,1,1,20,1,1,1,1,1,1,1,1
19225614,Mancini,1651,14/09/1994,21,0,0,0,0,190,75,1,3,1,2,3,3,1,2,1,3,3,6,3,1,1,8,1,11,7,4,13,8,3,13,7,5,10,10,7,10,4,13,7,10,14,7,13,7,8,13,11,8,15,9,17,12,20,5,10,10,5,3,5,10,11,11,12,9,11,2,10,3,D C,1,1,1,1,1,1,20,1,1,1,1,1,1,1,1
19225615,Lineker,1651,05/01/1995,21,0,0,0,0,178,0,3,2,1,2,3,3,2,1,3,2,3,3,6,5,8,13,2,6,11,1,11,13,5,13,12,9,10,8,7,8,6,13,5,9,13,8,10,8,11,9,8,8,5,16,13,7,20,7,6,9,7,9,9,9,11,11,10,11,9,8,14,5,DM/M C,1,1,1,1,1,1,1,1,1,17,20,1,1,1,1
19225617,Baratella,1651,18/01/1993,23,0,0,0,0,180,80,3,1,3,2,1,2,1,3,1,2,2,6,6,4,4,13,6,6,13,1,9,9,6,13,13,5,8,8,6,6,6,11,4,8,9,6,8,7,11,12,12,9,9,20,14,13,8,6,12,9,5,9,9,9,20,13,8,12,10,5,9,4,DM/M C,1,1,1,1,1,1,1,1,1,20,17,1,1,1,1
19225618,Caíque,1651,30/01/1994,22,0,0,0,0,186,82,1,2,1,3,2,3,3,2,2,2,2,9,9,11,13,11,10,13,10,11,10,11,12,10,11,13,11,11,12,10,11,11,3,11,11,11,10,11,10,10,10,11,11,10,12,10,20,11,10,10,12,12,12,12,13,12,14,10,12,8,6,3,S ,1,1,20,1,1,1,1,1,1,1,1,1,1,1,1
19225620,Alex,1651,07/11/1996,19,0,0,0,0,182,80,1,2,2,3,1,2,2,3,3,2,3,13,11,13,12,12,13,7,13,4,5,13,11,6,14,6,14,10,12,8,14,13,9,14,8,14,6,11,10,10,13,10,11,20,12,11,10,12,10,9,6,10,10,10,11,8,10,10,13,12,12,5,AM RLC,1,1,13,20,17,17,1,1,1,1,15,1,1,1,1
19225640,Buba,1651,23/04/1993,23,0,0,0,0,182,64,3,4,1,1,2,3,3,1,3,1,1,6,7,10,13,10,5,9,12,5,6,12,6,7,12,10,12,13,11,10,13,11,9,11,6,14,9,10,13,11,10,10,7,10,12,12,20,10,14,13,5,11,8,11,20,13,10,11,13,4,12,2,AM/S R,1,1,20,1,1,17,1,1,1,1,1,1,1,1,1
19225760,Cássio,1651,13/10/1993,22,0,0,0,0,169,0,2,3,3,3,3,3,2,1,3,3,1,5,7,8,6,13,6,2,7,3,7,10,1,8,13,9,9,8,8,3,7,11,6,13,11,8,3,7,8,13,10,7,6,10,11,13,20,13,4,9,7,1,4,9,15,14,14,11,10,10,1,4,D/WB/M/AM RC,1,1,1,20,1,1,1,1,19,1,17,1,1,1,19
19225761,Clayson,1651,19/03/1995,21,0,0,0,0,170,63,4,3,3,2,3,2,3,3,2,3,1,8,8,15,12,13,12,7,12,5,8,14,10,5,15,6,13,6,13,8,13,8,10,15,5,13,9,10,10,17,18,8,6,7,14,16,20,9,6,12,13,10,6,11,12,9,9,12,11,9,15,8,AM/S LC,1,1,17,19,20,14,1,1,1,1,1,1,1,1,1
19225762,Diego Neto,1651,16/01/1991,25,0,0,0,0,194,0,13,13,10,4,13,7,8,13,4,10,12,8,3,1,1,5,10,1,2,1,2,1,2,1,3,5,12,12,6,8,7,13,10,1,12,3,12,8,7,11,9,8,15,9,10,11,20,7,10,10,5,10,7,10,20,9,9,10,9,4,14,7,GK ,20,1,1,1,1,1,1,1,1,1,1,1,1,1,1
19225764,Guilherme Castro,1651,17/02/1995,21,0,0,0,0,174,0,2,4,3,2,2,3,1,3,1,2,3,8,8,10,10,14,8,8,9,2,5,12,5,10,13,10,8,8,6,10,13,14,10,12,9,13,9,6,11,14,14,10,4,1,10,14,20,9,7,10,10,6,10,10,19,10,12,11,11,9,1,8,M/AM C,1,1,1,20,1,1,1,1,1,1,17,1,1,1,1
19225765,Fefe,1651,22/03/1997,19,0,0,0,0,179,73,3,2,3,1,2,4,1,3,1,1,3,5,3,6,7,10,9,15,6,5,15,9,8,15,9,10,8,11,9,10,9,15,3,10,13,9,15,9,10,11,15,10,9,1,13,14,20,8,8,10,9,10,10,10,17,13,8,14,12,7,11,1,D C,1,1,1,1,1,1,20,1,1,1,1,1,1,1,1
19225766,Gabriel Braga,1651,18/05/1996,20,0,0,0,0,180,80,3,2,2,1,1,3,3,2,1,1,3,4,7,12,7,10,7,8,10,4,8,8,9,8,13,10,8,8,8,5,9,6,9,9,6,13,8,8,11,11,10,12,12,9,9,11,20,10,9,8,10,10,10,14,20,11,10,9,12,11,15,5,AM/S RLC,1,1,16,20,18,16,1,1,1,1,1,1,1,1,1
19225768,Ricardo Friedrich,1651,18/02/1993,23,0,0,0,0,187,80,11,10,10,12,12,11,12,13,10,12,10,3,3,2,1,7,4,1,3,2,3,2,1,2,5,10,12,15,8,9,8,14,12,3,11,2,8,9,8,13,7,9,13,9,15,11,20,6,10,9,7,6,10,10,12,10,11,10,10,10,12,8,GK ,20,1,1,1,1,1,1,1,1,1,1,1,1,1,1
19225769,Roberto,1651,08/01/1995,21,0,0,0,0,173,0,2,3,2,2,3,2,1,2,2,3,2,4,4,6,6,12,4,2,7,3,6,12,2,6,10,8,8,3,4,6,12,12,4,11,10,8,5,6,10,12,12,6,1,8,13,12,20,5,3,8,8,1,5,8,12,10,11,12,10,2,12,6,M/AM C,1,1,1,17,1,1,1,1,1,1,20,1,1,1,1
19225782,André Luiz,1651,17/06/1995,21,0,0,0,0,195,0,8,7,11,1,11,9,6,13,5,6,10,3,2,2,3,1,5,1,1,1,1,2,1,1,2,9,8,15,7,9,6,12,9,1,1,3,8,7,6,13,9,7,15,9,15,9,20,2,12,9,4,7,8,9,9,11,10,13,10,2,2,7,GK ,20,1,1,1,1,1,1,1,1,1,1,1,1,1,1
19225805,Juninho,1651,04/05/1994,22,0,0,0,0,181,74,3,2,3,1,1,1,1,1,1,1,2,5,3,14,9,13,7,10,5,4,7,8,4,1,12,4,10,6,6,8,7,14,6,11,7,14,8,7,8,14,14,8,8,9,9,14,20,6,8,9,9,6,6,9,19,10,9,13,12,4,3,5,S ,1,1,20,1,1,1,1,1,1,1,1,1,1,1,1
19225809,Chico,1651,02/02/1994,22,0,0,0,0,179,0,3,2,1,3,3,3,3,1,4,3,1,5,8,7,6,12,2,8,6,7,9,8,3,14,9,3,7,9,9,11,9,10,9,4,13,7,8,4,9,14,12,9,9,7,13,13,20,13,7,9,8,9,9,9,18,10,13,14,14,4,10,1,D/WB R,1,1,1,1,1,1,1,1,20,1,1,1,1,1,17
19225813,Michael,1651,02/08/1994,21,0,0,0,0,186,0,2,3,2,2,1,2,3,2,4,2,4,7,7,5,9,14,7,7,9,7,9,12,6,13,14,5,9,8,9,8,7,14,3,4,4,8,11,9,10,13,9,9,7,8,11,12,20,12,8,9,6,9,9,9,10,13,11,11,13,8,14,2,DM/M C,1,1,1,1,1,1,1,1,1,20,17,1,1,1,1
19225861,Fabricio Bruno,1651,12/02/1996,20,0,0,0,0,190,90,3,1,1,2,1,3,2,3,3,2,3,5,7,7,9,10,4,14,8,9,12,11,8,13,11,12,12,12,11,12,6,12,11,6,12,5,12,12,13,11,12,7,15,8,12,12,20,12,15,10,8,11,5,11,8,10,10,10,11,10,11,8,D C,1,1,1,1,1,1,20,1,1,1,1,1,1,1,1
19225862,Kaique,1651,14/01/1994,22,0,0,0,0,178,0,1,1,2,1,2,2,4,2,3,2,3,7,10,11,10,13,7,8,8,7,9,10,5,8,10,7,10,8,9,9,11,9,9,11,3,10,9,8,11,11,9,10,8,20,10,10,4,8,9,9,7,6,8,9,17,13,12,8,11,8,8,6,WB/M/AM LC,1,1,15,20,18,1,1,15,1,1,19,17,1,16,1
19225865,Kelvin,1651,15/08/1995,20,0,0,0,0,183,0,3,3,4,3,3,1,1,2,4,3,3,9,9,10,10,9,9,9,8,4,9,10,8,6,10,9,10,8,8,8,11,9,2,9,10,10,11,9,11,10,11,9,13,9,7,10,20,7,8,9,9,8,5,9,15,10,13,9,11,5,8,5,M/AM C,1,1,1,20,1,1,1,1,1,1,19,1,1,1,1
19225866,Gabriel Nunes,1651,11/07/1994,21,0,0,0,0,182,78,2,1,1,1,1,2,1,1,2,2,3,10,8,11,11,10,12,9,13,6,5,11,12,6,10,10,9,6,11,10,11,11,1,10,6,14,8,8,11,12,11,13,10,10,13,11,20,13,11,10,7,2,5,10,7,11,13,10,12,12,9,1,M/AM C,1,1,1,20,1,1,1,1,1,1,19,1,1,1,1
19225867,Lucas Kevin,1651,15/05/1994,22,0,0,0,0,169,65,1,1,1,2,3,3,1,3,2,1,3,7,6,9,8,9,7,5,8,1,4,9,6,5,9,9,9,8,8,9,8,9,9,11,14,9,9,7,10,10,10,8,2,16,16,10,20,10,8,9,7,9,4,9,13,9,14,9,11,4,12,3,M/AM C,1,1,1,20,1,1,1,1,1,1,19,1,1,1,1
19225868,João Gabriel,1651,12/02/1996,20,0,0,0,0,193,74,3,2,1,2,3,2,2,1,1,2,3,7,6,9,12,10,9,13,10,6,6,9,7,8,10,10,9,11,10,8,6,9,10,10,6,12,5,9,10,10,10,10,16,6,12,10,20,12,12,9,9,8,7,8,9,10,13,12,13,3,18,6,S ,1,1,20,1,1,1,1,1,1,1,1,1,1,1,1
19225869,Alan,1651,22/06/1994,22,0,0,0,0,201,97,13,11,9,10,9,10,9,12,9,12,10,3,2,1,2,11,6,3,1,2,2,7,5,3,11,13,10,11,10,12,7,11,13,1,12,1,13,11,11,11,12,5,20,5,10,10,20,11,20,12,10,12,6,10,8,10,9,13,13,14,11,11,GK ,20,1,1,1,1,1,1,1,1,1,1,1,1,1,1
19225942,Daniel,1651,06/05/1994,22,0,0,0,0,188,0,7,10,6,3,13,14,12,14,6,4,12,3,3,1,3,4,4,1,2,2,1,2,2,3,1,8,6,10,9,11,8,13,10,1,11,2,11,9,7,14,17,9,13,9,16,12,20,5,9,10,8,9,10,10,11,7,10,13,11,9,3,6,GK ,20,1,1,1,1,1,1,1,1,1,1,1,1,1,1
19225943,Kaike,1651,18/03/1995,21,0,0,0,0,173,63,2,2,2,3,3,3,3,1,3,4,3,6,9,9,5,14,3,10,5,9,11,11,5,15,9,5,9,10,10,11,9,11,10,6,8,9,11,10,10,15,15,10,4,20,7,15,10,8,7,10,7,10,10,10,8,10,11,11,13,2,14,1,D/WB L,1,1,1,1,1,1,1,20,1,1,1,1,1,16,1
19225944,Eriks,1651,23/02/1996,20,0,0,0,0,185,0,2,1,3,3,1,1,4,1,3,3,1,4,6,2,4,8,1,14,6,1,10,7,7,14,7,9,9,9,7,6,7,9,9,1,7,7,12,7,8,14,14,8,14,20,10,14,10,7,7,9,9,9,9,9,7,13,10,11,11,3,10,7,D C,1,1,1,1,1,1,20,1,1,1,1,1,1,1,1
19225945,Rafael Magalhães,1651,13/08/1995,20,0,0,0,0,170,0,3,2,1,3,1,3,2,2,3,2,2,7,9,14,14,14,7,14,9,3,5,9,7,8,13,5,9,2,7,8,12,14,2,12,1,10,8,8,9,13,10,8,6,20,9,12,9,7,7,9,9,9,9,9,8,10,12,12,11,11,17,6,AM/S RC,1,1,20,16,1,15,1,1,1,1,1,1,1,1,1
19225946,William,1651,03/04/1995,21,0,0,0,0,176,71,1,2,1,1,3,3,1,3,1,2,1,13,12,11,11,13,10,10,12,7,9,13,12,13,13,10,11,11,11,12,13,13,13,13,11,13,12,13,13,14,12,12,9,12,12,14,20,12,12,11,10,10,7,13,7,12,12,14,11,6,12,9,D/WB/AM R,1,1,1,1,1,16,1,1,20,1,1,1,13,1,19
19225947,Aylon,1651,07/04/1992,24,0,0,0,0,180,70,1,3,2,1,3,3,1,2,1,4,3,9,11,14,12,14,9,13,9,1,9,11,8,10,13,10,10,9,12,10,10,14,13,10,12,14,7,13,12,14,13,10,10,12,16,13,20,12,10,10,10,3,5,11,19,12,12,12,12,6,7,6,AM/S R,1,1,20,1,1,16,1,1,1,1,1,1,1,1,1
19225957,Rômulo,1651,27/10/1995,20,0,0,0,0,169,73,1,2,3,2,4,2,3,3,2,3,2,11,11,12,12,14,7,8,12,4,11,13,13,9,14,7,13,8,11,9,12,11,11,13,6,14,10,12,9,12,13,11,5,20,12,11,11,12,10,12,8,11,5,11,19,10,12,13,8,5,3,2,DM/M C,1,1,1,15,12,8,1,1,1,18,20,13,10,1,1
19225958,Éder,1651,05/04/1995,21,0,0,0,0,184,70,2,3,1,1,2,1,2,3,3,1,3,6,9,10,8,11,10,13,9,9,14,11,2,13,12,13,10,13,11,9,9,10,11,11,6,9,13,13,13,13,12,7,11,9,12,13,20,14,14,13,12,11,4,11,20,11,9,11,11,9,4,7,D C,1,1,1,10,1,8,20,1,12,15,13,1,8,1,11
19225960,Jeam,1651,19/10/1994,21,0,0,0,0,174,74,2,1,2,2,1,2,3,3,2,2,1,7,9,11,12,13,8,10,10,5,6,11,13,6,12,9,12,11,11,8,11,11,12,14,5,13,8,11,12,13,14,9,8,20,13,13,10,13,9,12,7,4,4,10,19,10,13,9,12,7,14,2,AM/S L,1,1,20,1,16,12,1,1,1,1,1,1,1,1,1
19225961,Gabriel Ramos,1651,20/03/1996,20,0,0,0,0,175,0,3,2,2,2,3,2,1,1,3,1,2,8,6,13,10,12,8,8,12,5,9,13,7,10,13,10,7,7,9,8,14,9,4,10,12,10,8,9,8,14,14,6,7,11,12,13,20,11,5,10,10,9,9,10,20,10,10,13,11,1,10,7,M/AM C,1,1,1,20,1,1,1,1,1,1,18,1,1,1,1
19226196,Thiago Henrique,1651,06/05/1995,21,0,0,0,0,186,0,13,13,10,1,12,10,12,13,1,9,9,6,1,3,1,1,8,1,3,2,2,1,3,1,1,5,7,15,5,8,6,13,6,2,7,3,9,7,6,10,12,7,7,1,16,11,20,2,7,9,9,9,9,9,8,11,9,10,12,9,2,4,GK ,20,1,1,1,1,1,1,1,1,1,1,1,1,1,1
19226197,Lucas Perri,1651,10/12/1997,18,0,0,0,0,185,0,13,10,10,3,13,13,11,13,9,9,11,5,1,2,1,5,7,1,1,3,2,1,2,3,3,9,5,13,5,11,6,13,4,3,4,2,12,7,6,9,13,5,9,9,13,11,20,1,6,9,9,2,8,7,14,11,11,11,12,1,12,4,GK ,20,1,1,1,1,1,1,1,1,1,1,1,1,1,1
19226199,Wellington Lucas,1651,01/02/1996,20,0,0,0,0,189,0,3,1,2,1,2,1,1,3,3,3,3,3,4,3,5,8,1,14,3,5,13,9,4,14,8,10,13,10,7,11,7,13,6,4,5,6,14,8,9,14,14,9,8,3,7,14,20,8,11,10,6,8,10,10,18,12,10,9,10,3,5,5,D C,1,1,1,1,1,1,20,1,1,1,1,1,1,1,1
19226200,Lucas Fernandes,1651,20/09/1997,18,0,0,0,0,176,71,3,1,2,3,2,3,3,3,1,1,2,12,13,13,11,11,11,8,11,7,7,13,12,7,14,11,12,8,12,10,14,11,12,13,10,13,7,12,12,14,13,9,12,12,8,13,20,12,8,10,7,13,14,13,20,1,8,12,12,6,12,7,AM C,1,1,1,20,1,1,1,1,1,1,15,1,1,1,1
19226201,João Paulo,1651,28/11/1996,19,0,0,0,0,178,78,3,2,3,2,3,1,2,1,2,2,1,13,15,12,13,11,13,11,12,10,10,11,11,7,13,11,13,11,11,10,12,16,13,13,10,12,12,11,13,13,11,13,8,20,13,12,8,12,14,12,11,2,9,10,10,11,9,11,12,7,11,5,S R,1,1,20,1,13,15,1,1,1,1,1,1,1,1,1
19226202,Pedro Bortoluzo,1651,17/07/1996,19,0,0,0,0,186,78,2,2,1,3,1,2,3,1,1,3,1,10,10,11,13,12,8,14,11,7,9,11,8,6,12,12,13,8,13,9,11,12,13,11,5,14,9,10,12,13,11,13,14,11,16,13,20,12,13,11,7,11,4,10,18,9,12,12,11,1,13,1,S ,1,1,20,11,1,1,1,1,1,1,1,1,1,1,1
19226331,Róbson Bambu,1651,12/11/1997,18,0,0,0,0,187,0,1,3,4,1,1,4,4,2,2,3,3,8,6,4,3,10,6,14,1,1,8,10,6,14,8,10,10,10,7,9,4,14,2,1,11,8,10,8,9,10,9,6,15,11,15,9,20,9,9,10,9,7,3,10,19,10,11,11,11,7,8,6,D C,1,1,1,1,1,1,20,1,12,1,1,1,1,1,12
19226430,Bruno Mota,1651,22/05/1995,21,0,0,0,0,187,74,2,3,3,2,1,1,1,4,4,3,3,10,12,13,10,13,10,12,11,10,11,12,11,11,13,10,11,13,11,11,11,12,14,14,9,11,10,11,12,11,12,11,12,20,11,12,13,11,11,10,10,12,11,13,17,13,13,13,12,8,12,6,M/AM C,1,1,1,20,1,1,1,1,1,1,18,1,1,1,1
19226431,Gerson Galdino,1651,10/04/1996,20,0,0,0,0,180,0,3,4,1,3,1,2,2,1,1,1,2,2,1,2,3,8,3,14,4,6,14,8,2,12,5,8,10,9,8,7,2,14,9,8,6,5,12,7,8,12,14,8,11,10,8,14,20,5,8,9,5,9,7,9,15,9,13,10,12,3,2,4,D C,1,1,1,1,1,1,20,1,1,1,1,1,1,1,1
19226432,Hugo Gumiero,1651,01/01/1993,23,0,0,0,0,180,0,11,14,7,10,11,14,10,14,9,10,12,3,3,1,3,5,2,1,2,3,3,2,1,2,2,10,11,15,9,10,8,14,18,2,5,1,11,9,8,14,13,9,6,11,12,13,20,5,8,10,10,3,10,10,18,11,10,9,12,3,7,1,GK ,20,1,1,1,1,1,1,1,1,1,1,1,1,1,1
19226434,Jonathan,1651,02/06/1995,21,0,0,0,0,177,0,1,3,2,1,1,3,2,1,1,2,2,4,7,7,3,11,2,6,2,6,8,8,3,8,8,4,6,7,8,7,4,12,8,8,2,7,9,7,8,14,9,7,8,20,14,13,9,5,8,8,6,8,8,8,18,10,9,14,11,5,10,2,D/WB L,1,1,1,1,11,1,1,20,1,1,1,13,1,17,1
19226435,Lucas Macanhan,1651,25/06/1994,22,0,0,0,0,188,80,14,14,10,1,14,13,10,14,6,6,13,4,2,2,2,4,9,1,1,1,3,2,2,2,5,9,8,13,8,11,8,14,18,3,13,3,11,9,8,12,8,6,13,20,12,8,11,8,11,10,10,10,10,10,17,12,11,9,12,5,9,2,GK ,20,1,1,1,1,1,1,1,1,1,1,1,1,1,1
19226436,Matheus Rossetto,1651,03/06/1996,20,0,0,0,0,180,75,3,2,3,2,3,3,2,3,2,1,1,10,10,11,10,12,10,9,11,10,11,10,8,12,11,11,12,11,10,11,13,12,10,12,11,11,13,10,10,11,12,13,10,11,14,11,20,12,9,12,14,13,12,12,16,11,12,12,12,9,9,5,M/AM C,1,1,1,16,1,1,1,1,1,1,20,1,1,1,1
19226437,Otávio,1651,04/05/1994,22,0,0,0,0,176,73,1,3,2,3,2,2,3,1,3,1,3,10,11,12,12,11,11,12,13,12,14,15,11,14,13,13,13,13,13,13,12,11,13,11,11,12,14,13,14,13,13,12,11,20,11,12,12,14,13,13,12,11,11,12,10,13,12,12,9,6,9,9,DM/M C,1,1,1,1,1,1,1,1,1,20,17,9,10,1,1
19226439,Sidcley,1651,13/05/1993,23,0,0,0,0,176,74,2,4,3,1,2,2,2,2,2,1,2,9,10,8,10,11,6,11,8,10,12,12,10,14,12,7,13,12,11,8,12,15,11,2,12,10,11,12,12,15,15,12,7,20,8,15,12,11,8,11,5,3,4,11,11,12,12,11,9,7,2,3,D/WB L,1,1,1,1,1,1,1,20,1,1,1,12,1,16,1
19226544,Abraão,1651,12/06/1993,23,0,0,0,0,173,71,2,3,2,1,1,2,1,2,2,3,1,7,3,4,7,14,7,6,11,1,11,14,1,11,10,5,9,5,9,3,13,12,3,7,5,8,6,8,10,12,9,8,7,8,10,8,20,8,7,7,9,9,9,9,19,10,12,12,15,6,11,8,M C,1,1,10,10,1,1,1,1,1,1,20,1,1,1,1
19226545,Adenilson,1651,11/06/1994,22,0,0,0,0,177,70,2,1,3,1,2,1,2,3,1,1,2,7,7,4,5,9,7,7,8,6,12,7,3,14,6,9,6,5,8,9,10,14,9,9,14,7,14,8,12,14,14,8,8,9,11,14,20,8,6,9,6,5,9,9,10,11,12,13,13,10,1,8,DM ,1,1,1,1,1,1,7,1,1,20,7,1,1,1,1
19226546,Alan Schons,1651,24/05/1993,23,0,0,0,0,180,74,2,1,1,2,3,1,3,2,2,2,2,8,7,9,5,11,8,7,9,8,10,13,8,11,13,12,11,10,13,10,12,13,1,8,7,11,12,13,11,11,12,13,10,12,11,11,20,12,11,11,5,10,6,8,14,12,10,9,10,1,20,2,DM ,1,1,1,1,1,1,1,1,1,20,13,1,1,1,1
19226547,Alan,1651,18/03/1996,20,0,0,0,0,175,73,3,2,2,1,1,3,2,3,4,3,1,4,9,6,6,8,1,9,6,8,10,8,4,15,9,8,7,10,9,8,9,11,5,7,12,8,8,9,9,12,15,9,10,20,12,15,9,7,8,9,9,7,9,9,17,12,9,8,12,7,2,1,D L,1,1,1,1,1,1,1,20,1,1,1,9,1,13,1
19226548,Cadu Padilha,1651,02/09/1996,19,0,0,0,0,181,72,1,1,2,2,3,3,3,2,3,1,3,9,13,11,8,10,7,4,7,7,7,11,6,8,14,6,5,8,8,8,7,11,5,5,6,3,7,8,13,14,14,11,10,20,14,14,1,9,9,9,7,1,9,9,9,12,11,10,12,5,13,2,M L,1,1,1,1,10,1,1,1,1,1,1,20,1,7,1
19226549,Carlos Henrique,1651,27/02/1995,21,0,0,0,0,181,0,1,2,4,1,3,3,3,2,2,4,2,5,6,10,11,13,6,13,4,2,5,6,4,4,10,9,9,2,12,7,3,12,9,10,1,13,5,6,7,11,12,8,9,8,13,12,20,6,12,9,9,6,9,9,7,13,10,12,10,5,7,7,S ,1,1,20,7,1,1,1,1,1,1,1,1,1,1,1
19226550,Chandler,1651,02/09/1994,21,0,0,0,0,184,0,3,3,1,2,4,3,3,2,1,2,1,6,5,13,13,9,5,13,7,3,6,7,7,1,7,7,9,7,12,7,6,5,4,9,3,10,6,6,5,12,13,7,10,8,9,13,20,5,8,9,6,7,9,9,18,10,12,9,10,8,13,4,S ,1,1,20,1,1,1,1,1,1,1,1,1,1,1,1
19226551,Vidal,1651,23/08/1996,19,0,0,0,0,174,70,2,2,2,2,3,1,3,1,2,3,3,5,4,5,1,9,3,8,4,6,9,9,2,13,4,9,7,9,7,8,8,14,3,6,2,7,6,9,9,14,14,13,7,10,10,14,20,7,8,9,9,7,9,9,20,11,10,12,12,10,16,6,D/WB R,1,1,1,1,1,1,1,1,20,1,1,1,7,1,17
19226554,Dionas Bruno,1651,05/01/1996,20,0,0,0,0,180,73,1,1,3,1,1,3,2,4,4,2,1,10,13,12,13,10,7,7,7,2,6,7,8,6,13,6,7,1,8,7,7,11,1,13,12,8,3,2,3,12,13,10,9,8,8,13,20,6,7,5,8,7,9,9,10,8,11,11,11,6,18,7,AM R,1,1,13,7,13,20,1,1,1,1,1,1,1,1,1
19226555,Fábio,1651,10/01/1996,20,0,0,0,0,186,70,2,2,3,1,1,1,1,2,3,1,4,6,7,8,6,12,1,9,5,8,8,10,1,13,10,9,8,7,9,9,9,13,9,9,7,7,9,9,9,14,10,6,13,20,10,12,1,12,11,9,9,7,8,9,9,13,10,11,12,1,10,4,D L,1,1,1,1,1,1,1,20,1,1,1,1,1,15,1
19226556,Matheus Ribeiro,1651,23/02/1993,23,0,0,0,0,178,72,1,1,2,2,3,3,3,2,3,3,3,5,10,10,6,12,3,11,9,10,11,12,9,14,12,7,12,12,10,9,11,11,11,11,10,9,12,12,12,15,13,12,10,18,13,11,20,11,8,11,3,9,10,11,12,12,9,10,11,9,14,3,D/WB R,1,1,1,1,1,1,1,1,20,1,1,1,1,1,19
19226558,Roiter,1651,04/04/1993,23,0,0,0,0,175,73,2,3,3,2,1,2,1,2,2,2,1,1,3,2,7,13,2,3,12,3,10,13,2,11,13,7,8,1,6,7,13,12,1,3,4,8,7,7,7,13,13,7,6,9,16,13,20,7,6,9,8,2,7,9,10,11,9,11,11,2,2,4,M C,1,1,1,1,1,1,1,1,1,1,20,1,1,1,1
19226560,Mossoró,1651,05/06/1996,20,0,0,0,0,192,0,1,4,1,1,1,2,3,2,1,1,3,7,12,14,8,14,7,7,9,7,5,10,1,9,14,5,10,3,6,8,12,11,4,13,9,9,7,8,11,10,9,7,12,8,13,11,20,8,13,9,7,9,4,9,19,11,14,10,13,1,10,4,M/AM RC,1,1,1,1,1,17,1,1,1,1,17,1,20,1,1
19226616,Marcelo Maciel,1651,20/01/1981,35,0,0,0,0,179,78,2,3,3,1,3,1,3,1,1,2,3,6,11,10,6,15,6,7,8,9,10,10,4,12,11,10,8,10,11,5,11,13,6,9,10,10,11,10,11,10,11,10,8,20,13,10,10,9,7,10,7,1,7,10,10,10,13,11,12,10,9,6,D/WB LC,1,1,1,15,1,1,1,20,1,1,15,13,1,19,1
19226634,Nicolas Careca,1651,18/05/1997,19,0,0,0,0,187,0,3,1,1,2,1,1,1,4,2,2,3,2,5,9,11,10,4,11,8,2,2,7,9,2,9,8,8,6,10,7,8,13,16,9,5,10,9,9,10,15,11,11,12,15,12,11,20,11,11,9,10,10,6,10,17,16,10,11,13,3,16,4,S ,1,1,20,1,1,1,1,1,1,1,1,1,1,1,1
19226635,Nikolas,1651,07/11/1997,18,0,0,0,0,187,0,3,2,1,4,1,3,3,2,1,2,3,8,8,4,11,15,8,8,12,1,9,11,4,12,11,9,8,9,7,10,11,12,6,2,10,8,15,1,6,12,14,9,15,9,6,12,20,8,9,9,4,9,9,9,7,12,9,13,10,3,10,8,DM ,1,1,1,1,1,1,1,1,1,20,14,1,1,1,1
19226636,Luan,1651,27/03/1993,23,0,0,0,0,180,71,2,3,1,2,3,2,1,3,2,3,3,7,12,15,13,15,14,10,10,3,7,14,15,8,15,8,13,12,13,12,15,13,16,16,6,16,8,13,13,14,14,12,9,12,13,14,20,14,11,12,8,13,6,15,9,13,13,13,15,7,12,7,AM/S RLC,1,1,20,19,19,18,1,1,1,1,1,1,1,1,1
19226638,Guilherme Amorim,1651,30/04/1993,23,0,0,0,0,174,74,1,3,1,3,3,1,2,3,2,1,3,8,8,7,9,14,8,8,10,4,10,13,4,14,10,10,13,9,10,7,13,14,10,5,11,8,12,9,12,14,14,9,4,2,16,14,20,8,7,9,8,10,10,10,7,9,9,10,12,6,20,5,DM ,1,1,1,1,1,1,1,1,1,20,12,1,1,1,1
19226731,Daniel,1651,19/04/1995,21,0,0,0,0,190,86,14,10,10,10,12,12,11,11,9,9,11,3,1,3,2,9,7,5,2,1,2,7,3,1,10,10,9,12,10,11,9,10,12,1,11,2,12,11,10,10,12,12,12,6,11,9,20,11,12,10,10,10,4,10,11,14,13,13,15,12,13,3,GK ,20,1,1,1,1,1,1,1,1,1,1,1,1,1,1
19226732,Darlan,1651,27/02/1994,22,0,0,0,0,178,0,3,2,2,3,1,3,1,4,3,1,2,4,4,14,14,14,6,14,7,4,5,9,4,1,14,8,13,8,11,9,6,8,6,13,13,14,9,8,9,14,13,9,4,20,14,13,7,7,8,10,7,10,7,10,9,9,10,11,10,8,10,8,S ,1,1,20,1,1,1,1,1,1,1,1,1,1,1,1
19226735,Felipe Vizeu,1651,12/03/1997,19,0,0,0,0,184,82,2,3,3,3,2,1,1,1,3,3,1,10,11,13,13,12,10,12,11,10,9,11,13,6,12,12,14,10,13,12,11,10,14,12,11,13,6,12,12,12,13,13,14,20,13,14,13,12,15,12,13,10,7,8,8,13,12,13,12,7,12,5,S ,1,1,20,1,1,1,1,1,1,1,1,1,1,1,1
19226738,Jorge,1651,28/03/1996,20,0,0,0,0,184,71,1,2,1,1,1,1,3,2,2,1,4,11,14,15,13,13,8,9,13,7,12,14,11,11,15,10,14,8,12,13,14,13,14,14,7,13,11,13,14,14,15,11,8,20,12,14,9,14,10,12,5,13,10,14,11,14,8,15,13,10,14,8,D/WB/M L,1,1,1,8,14,1,1,20,1,1,1,16,1,18,1
19226739,Zé Lucas,1651,10/10/1996,19,0,0,0,0,182,75,3,3,2,3,3,2,1,1,2,3,1,2,1,13,13,8,5,13,2,5,3,6,6,1,10,8,9,6,5,5,2,9,3,10,2,13,4,5,6,13,10,6,7,6,12,10,20,8,7,8,3,8,7,7,15,8,10,13,12,9,6,2,S ,1,1,20,1,1,1,1,1,1,1,1,1,1,1,1
19226740,Léo Henrique,1651,31/05/1994,22,0,0,0,0,180,82,1,4,2,2,1,2,1,1,3,2,3,5,7,8,7,8,6,8,9,3,12,9,8,12,8,12,11,10,10,11,9,11,11,5,7,9,13,14,14,10,9,13,8,6,13,10,20,13,13,12,8,10,8,12,14,11,9,9,10,10,14,6,DM/M C,1,1,1,1,1,8,1,1,14,20,16,1,10,1,12
19226741,Lucas Paquetá,1651,27/08/1997,18,0,0,0,0,180,72,2,2,2,2,1,3,1,2,2,2,3,11,12,11,11,12,8,7,10,4,5,12,10,8,12,10,10,8,12,12,14,8,17,14,4,11,7,12,12,14,14,10,8,20,12,12,6,14,8,13,10,8,9,10,16,12,11,10,11,2,12,4,M/AM LC,1,1,1,20,16,1,1,1,1,1,16,14,1,1,1
19226742,Luis Felipe,1651,19/02/1997,19,0,0,0,0,183,0,11,7,7,1,12,12,7,12,8,8,7,3,2,2,1,1,8,1,1,3,1,1,1,1,3,7,5,11,5,7,4,12,4,2,8,1,5,5,4,10,14,5,4,3,13,8,20,1,5,8,5,8,3,8,14,13,11,10,9,9,14,7,GK ,20,1,1,1,1,1,1,1,1,1,1,1,1,1,1
19226743,Matheus Cruz,1651,23/09/1996,19,0,0,0,0,174,66,1,3,1,1,1,4,4,3,1,3,2,6,6,6,8,12,5,6,10,1,7,10,4,8,12,8,5,7,8,4,12,12,6,11,13,9,4,8,11,13,9,7,9,6,14,9,20,7,7,8,6,8,8,8,11,11,13,10,14,8,12,2,M/AM C,1,1,1,20,1,1,1,1,1,1,16,1,1,1,1
19226744,Matheus Jesus,1651,10/04/1997,19,0,0,0,0,186,81,3,2,3,3,2,1,2,1,2,2,3,10,11,14,11,12,11,14,16,7,11,10,8,11,14,8,12,7,13,8,13,12,13,12,5,11,12,15,11,13,12,12,12,20,16,13,14,12,14,10,10,11,11,11,7,12,13,12,13,10,11,8,DM/M C,1,1,1,1,1,1,1,1,1,16,20,1,1,1,1
19226745,Trindade,1651,05/03/1996,20,0,0,0,0,181,77,3,2,2,3,1,3,3,3,2,3,1,8,10,10,10,14,8,8,7,7,9,12,2,14,14,10,7,9,7,9,11,14,3,7,7,8,6,10,11,14,14,10,10,6,11,14,20,8,7,10,5,4,10,10,19,12,11,12,10,8,4,6,DM/M RC,1,1,1,1,1,14,1,1,1,18,20,1,16,1,1
19226746,Michel,1651,12/05/1997,19,0,0,0,0,186,0,3,2,2,1,3,3,3,3,3,1,2,6,8,11,7,14,5,4,8,6,7,10,3,8,12,8,9,7,8,7,14,11,7,9,13,6,7,7,11,10,8,8,12,6,10,10,20,7,8,8,3,8,8,8,15,12,9,12,10,7,3,7,M/AM RC,1,1,1,20,14,16,1,1,1,1,18,1,1,1,1
19226747,Pedro Paulo,1651,18/08/1995,20,0,0,0,0,190,78,3,2,3,2,1,3,3,2,2,3,1,7,4,11,13,14,7,11,5,1,5,8,6,4,12,7,8,4,10,8,6,12,9,11,13,13,5,7,8,5,9,3,16,6,11,9,20,8,13,8,9,9,4,8,9,11,13,11,11,1,7,4,S ,1,1,20,1,1,1,1,1,1,1,1,1,1,1,1
19226749,Roberth,1651,06/07/1995,20,0,0,0,0,178,80,1,4,3,2,3,2,1,4,3,1,1,3,4,5,3,10,1,3,2,6,8,8,1,11,8,7,8,8,7,8,7,12,8,3,6,3,6,7,7,14,14,6,5,6,11,14,20,8,7,8,8,8,8,8,19,11,11,12,11,11,9,7,D R,1,1,1,1,1,1,1,1,20,1,1,1,1,1,14
19226750,Romário,1651,03/07/1994,21,0,0,0,0,175,66,2,2,1,2,2,4,3,1,1,3,1,10,12,10,10,8,12,6,12,10,9,10,14,9,8,10,9,8,8,8,9,10,11,7,5,8,9,12,11,11,10,8,7,6,14,11,20,13,8,12,5,8,5,16,18,10,9,10,11,10,15,5,WB/M/AM RC,1,1,1,20,1,18,1,1,15,1,16,1,17,1,16
19226751,Ronaldo,1651,23/10/1996,19,0,0,0,0,178,64,1,3,3,2,1,1,2,3,3,1,3,7,8,8,4,13,7,7,7,7,10,10,3,10,12,10,11,8,9,9,8,13,16,12,4,8,10,8,9,13,11,8,3,6,13,11,20,12,7,10,10,4,9,16,16,12,9,9,11,7,10,4,D/WB/DM/M/AM RC,1,1,1,16,1,14,1,1,18,20,18,1,16,1,18
19226752,Thiago Santos,1651,12/04/1995,21,0,0,0,0,174,62,3,2,4,2,2,2,2,2,1,3,4,6,12,14,8,9,6,7,8,2,9,9,14,6,10,8,9,11,10,9,9,9,12,14,4,11,6,13,13,15,12,8,7,6,14,15,20,15,9,12,5,10,8,6,18,12,10,10,12,10,15,8,S ,1,1,20,1,1,1,1,1,1,1,1,1,1,1,1
19227008,Bertotto,1651,15/06/1993,23,0,0,0,0,189,79,2,3,3,1,1,2,1,2,2,3,1,8,9,9,10,10,10,14,9,6,12,11,10,11,10,12,11,13,11,11,10,11,7,9,11,10,11,13,13,12,11,9,15,12,13,12,20,12,11,11,14,6,10,11,13,12,12,13,11,1,11,2,DM/M C,1,1,1,1,1,1,5,1,1,20,16,1,1,1,1
19227020,Alex Silva,1651,15/05/1994,22,0,0,0,0,183,74,2,2,2,2,1,1,1,3,2,2,2,8,11,11,10,11,7,10,9,8,11,12,8,11,12,14,12,12,10,11,11,12,13,12,4,12,8,13,14,13,12,11,11,10,14,13,20,14,11,11,9,11,7,13,10,12,13,12,11,5,10,11,D/WB RL,1,1,1,1,1,1,1,17,20,1,1,1,1,17,19
19227023,Danielzinho,1651,04/11/1994,21,0,0,0,0,166,62,3,4,3,1,3,2,2,1,3,2,3,8,6,14,13,14,8,3,9,5,7,14,2,7,14,7,10,7,6,7,12,14,9,13,10,10,7,9,13,14,10,9,1,11,12,11,20,9,6,10,9,6,9,10,17,10,12,9,12,10,13,2,AM C,1,1,1,20,1,1,1,1,1,1,10,1,1,1,1
19227200,Ronan,1651,22/04/1995,21,0,0,0,0,195,88,1,1,1,1,2,2,1,3,3,1,3,5,9,11,12,12,5,12,10,5,5,10,5,5,12,13,10,12,11,12,11,11,10,11,7,13,6,14,11,11,11,15,16,11,14,12,20,12,14,10,6,7,5,10,20,10,10,11,12,5,17,6,S ,1,1,20,1,1,1,1,1,1,1,1,1,1,1,1
19227248,Jardiel,1651,10/05/1996,20,0,0,0,0,177,70,2,1,2,2,3,1,1,1,1,4,3,12,12,11,6,10,11,7,6,4,9,11,8,11,13,8,10,9,8,12,7,10,8,10,5,9,10,11,10,14,11,10,7,20,12,13,9,10,9,11,6,13,6,8,9,9,10,11,8,10,12,7,D/WB L,1,1,1,1,1,1,1,20,1,1,1,1,1,19,1
19227295,Thales,1651,13/01/1997,19,0,0,0,0,180,0,2,1,2,2,3,1,3,3,2,1,1,5,5,13,13,13,6,13,6,4,2,5,5,2,11,8,10,3,13,7,7,10,8,11,12,13,6,6,7,13,13,7,8,9,10,13,20,6,7,9,9,1,6,8,7,11,13,11,12,8,12,6,S ,1,1,20,1,1,1,1,1,1,1,1,1,1,1,1
19227474,Túlio,1651,24/07/1995,20,0,0,0,0,182,0,1,2,2,4,2,2,3,2,1,1,4,7,5,14,14,14,7,9,8,6,5,8,7,1,14,9,6,8,14,8,8,11,6,13,3,14,6,7,8,14,11,8,10,3,11,14,20,7,9,8,9,9,7,9,14,11,11,11,12,9,10,1,S ,1,1,20,1,1,1,1,1,1,1,1,1,1,1,1
19227511,Gustavo Mosquito,1651,07/09/1997,18,0,0,0,0,169,63,1,3,2,2,3,2,1,1,1,2,2,7,8,14,14,10,7,14,7,6,7,8,7,3,10,9,9,8,14,6,5,9,9,9,9,13,4,7,8,14,11,8,2,8,15,12,20,10,9,9,9,9,9,9,10,9,9,13,11,7,3,1,S ,1,1,20,10,1,1,1,1,1,1,1,1,1,1,1
19227702,Ítalo,1651,25/01/1995,21,0,0,0,0,180,0,2,1,1,1,3,3,1,2,2,2,2,8,13,14,10,14,4,8,5,3,8,10,3,5,14,7,9,3,10,6,10,11,8,15,6,9,8,9,8,14,14,9,7,20,13,14,10,6,7,10,5,10,10,10,7,13,11,9,10,6,7,1,AM L,1,1,1,13,20,14,1,1,1,1,10,13,1,1,1
19227765,Gabriel Félix,1651,04/04/1995,21,0,0,0,0,191,0,15,11,11,1,11,15,13,12,10,5,8,5,3,2,1,5,8,1,2,1,3,3,3,3,5,10,10,15,9,9,9,15,14,2,13,3,9,10,9,12,13,10,14,7,14,13,20,12,10,12,9,10,5,10,9,8,11,11,11,8,18,7,GK ,20,1,1,1,1,1,1,1,1,1,1,1,1,1,1
19227767,Thiago Seiji,1651,18/07/1995,20,0,0,0,0,175,0,1,1,1,3,2,2,1,1,3,2,3,6,7,9,13,12,6,13,8,6,5,8,6,1,13,9,5,3,8,6,11,13,9,13,13,7,8,6,8,13,13,7,7,6,12,13,20,6,5,9,9,9,9,9,18,9,11,11,11,5,13,7,AM/S C,1,1,20,17,1,1,1,1,1,1,1,1,1,1,1
19227774,Patrick,1651,04/01/1994,22,0,0,0,0,178,0,3,4,2,3,1,3,3,3,2,2,1,6,2,13,13,13,6,9,7,4,6,7,5,1,14,6,8,5,13,7,6,10,14,15,10,12,7,6,7,13,13,5,5,8,13,12,20,6,5,9,9,8,8,9,12,12,11,11,12,6,12,5,S ,1,1,20,1,1,1,1,1,1,1,1,1,1,1,1
19227778,Marco Damasceno,1651,11/04/1996,20,0,0,0,0,178,74,2,3,2,1,2,3,1,1,4,3,3,10,10,13,11,12,12,11,12,11,10,12,11,11,14,12,11,12,11,10,12,11,5,12,12,11,12,11,12,13,14,12,12,11,12,12,20,12,12,12,12,12,11,11,18,5,12,11,5,6,9,16,AM/S C,1,1,20,19,1,1,1,1,1,1,10,1,1,1,1
19227779,Tiago Andrei,1651,02/03/1994,22,0,0,0,0,196,0,1,2,1,2,2,2,3,3,2,1,3,4,5,2,6,8,5,5,8,1,8,11,1,13,13,8,8,7,6,7,13,13,8,4,1,6,6,7,10,12,7,2,13,9,9,9,20,5,12,8,7,5,4,8,9,9,9,7,11,3,1,1,DM C,1,1,1,1,1,1,1,1,1,20,15,1,1,1,1
19227789,Bruno Baio,1651,03/10/1995,20,0,0,0,0,196,89,1,3,2,2,1,1,3,3,3,1,2,5,7,8,12,10,7,13,8,7,5,9,14,4,10,13,10,12,11,10,9,10,10,9,7,12,10,11,10,11,8,3,18,9,13,10,20,13,16,11,13,1,9,9,17,9,12,12,12,1,5,1,S ,1,1,20,1,1,1,3,1,1,1,1,1,1,1,1
19227796,Leonardo,1651,15/02/1996,20,0,0,0,0,184,0,3,1,3,3,4,2,3,1,1,3,2,6,4,10,8,13,6,13,5,4,6,4,1,1,13,7,9,8,8,7,6,9,9,13,9,12,4,6,7,13,10,7,8,9,14,13,20,6,7,9,3,9,8,9,19,12,12,10,10,10,10,7,S ,1,1,20,1,1,1,1,1,1,1,1,1,1,1,1
19228026,Henrique Trevisan,1651,20/01/1997,19,0,0,0,0,180,78,2,4,3,1,2,1,1,1,2,2,2,5,6,7,5,8,6,10,6,6,10,8,6,11,8,9,11,10,8,10,8,16,7,1,12,6,10,9,10,11,11,11,10,7,16,11,20,11,10,9,9,9,9,6,14,11,10,10,12,1,1,1,D C,1,1,1,1,1,1,20,1,1,1,1,1,1,1,1
19228027,Jatobá,1651,15/09/1995,20,0,0,0,0,183,78,3,1,4,3,2,3,3,1,2,2,1,4,6,9,7,10,5,12,6,5,11,12,6,14,11,12,11,11,10,12,7,10,11,5,5,8,13,12,14,13,8,9,13,9,12,12,20,14,11,9,11,5,7,9,13,12,8,10,10,12,11,7,DM/M C,1,1,1,1,1,1,13,1,1,20,20,1,1,1,1
19228028,Bruno Santos,1651,13/06/1995,21,0,0,0,0,172,66,1,2,4,4,4,3,3,2,2,1,3,7,8,9,7,8,7,7,7,8,8,8,3,8,8,9,8,10,9,10,9,13,3,4,12,8,9,9,12,12,12,14,5,9,11,12,20,10,6,9,12,6,9,9,16,12,12,13,11,2,8,1,D/WB R,1,1,1,1,1,1,1,1,20,1,1,1,1,1,18
19228029,Cunha,1651,02/05/1996,20,0,0,0,0,177,0,3,2,1,1,3,2,2,4,2,3,3,6,5,7,8,11,6,4,10,1,4,7,3,5,10,8,5,7,8,7,12,10,4,9,1,6,8,8,10,14,9,7,5,7,14,10,20,6,7,7,5,8,8,8,19,11,10,13,12,5,7,6,AM C,1,1,1,20,1,1,1,1,1,1,15,1,1,1,1
19228030,Dener,1651,05/10/1997,18,0,0,0,0,183,76,3,2,3,2,1,1,3,1,2,1,1,2,1,2,7,8,2,14,3,4,14,8,1,14,5,9,8,9,4,7,5,8,8,1,1,2,14,7,8,10,11,8,9,5,9,8,20,9,10,9,9,9,9,8,16,11,15,13,10,3,4,5,D C,1,1,1,1,1,1,20,1,1,1,1,1,1,1,1
19228152,Suéliton,1651,26/06/1991,25,0,0,0,0,184,82,3,4,3,1,3,2,4,3,1,3,2,5,5,1,1,10,3,13,7,6,14,7,3,14,9,11,14,11,10,10,4,14,11,8,9,9,14,9,9,14,11,10,12,8,10,13,20,7,13,11,4,6,11,11,19,12,14,11,11,11,8,7,D C,1,1,1,1,1,1,20,1,1,1,1,1,1,1,1
19228227,Rafinha,1651,04/02/1995,21,0,0,0,0,170,65,1,2,2,3,2,1,3,3,2,1,3,5,6,13,13,13,5,10,7,1,5,4,7,1,11,8,5,5,8,5,5,10,1,11,2,9,6,5,8,11,8,5,4,5,12,10,20,12,5,8,8,1,8,8,13,11,11,9,12,2,14,4,S C,1,1,20,15,1,1,1,1,1,1,10,1,1,1,1
19228281,Bruno Kairon,1651,23/09/1996,19,0,0,0,0,165,0,2,1,1,1,4,2,2,3,3,1,1,5,3,7,6,13,5,1,9,4,4,12,1,7,8,8,3,7,5,5,13,10,2,8,11,8,3,7,8,13,9,6,1,16,11,12,20,5,3,8,8,1,8,8,7,9,10,13,14,6,12,3,AM C,1,1,1,20,1,1,1,1,1,1,15,1,1,1,1
19228283,Roberto,1651,31/03/1997,19,0,0,0,0,191,0,3,4,2,3,3,3,2,1,3,2,2,1,1,1,1,5,4,11,1,1,12,3,1,11,4,8,8,7,5,6,1,12,5,4,1,2,12,4,5,11,8,5,9,7,13,10,20,2,7,8,8,6,8,8,12,13,12,12,13,7,10,2,D C,1,1,1,1,1,1,20,1,1,1,1,1,1,1,1
19228284,Alisson,1651,11/05/1995,21,0,0,0,0,189,0,3,1,4,3,1,4,1,2,1,1,1,3,2,12,12,12,2,12,4,1,2,4,4,1,7,7,6,5,7,4,4,9,4,8,4,9,2,3,4,12,10,1,11,7,6,11,20,9,9,7,7,7,7,7,18,10,10,11,11,1,19,7,S ,1,1,20,1,1,1,1,1,1,1,1,1,1,1,1
19228289,Joãozinho,1651,28/02/1996,20,0,0,0,0,163,64,1,3,1,3,3,2,3,3,3,1,2,3,6,6,4,11,5,5,3,3,5,8,1,11,7,8,3,7,6,6,6,13,2,8,12,5,8,7,9,13,13,16,1,8,8,11,20,5,2,8,8,8,8,8,13,11,12,9,11,1,13,7,DM R,1,1,1,1,1,1,1,1,15,20,7,1,1,1,13
19228541,Yan,1651,05/08/1994,21,0,0,0,0,181,0,3,2,1,1,2,3,3,1,1,2,1,6,6,3,7,13,6,6,10,1,11,10,2,13,13,7,9,7,8,8,6,13,5,7,5,7,6,7,11,9,11,7,9,16,10,11,20,7,8,9,7,8,9,9,10,10,10,10,12,2,20,8,DM C,1,1,1,1,1,1,1,1,1,20,15,1,1,1,1
19228542,Yuri,1651,05/08/1994,21,0,0,0,0,182,78,3,1,2,1,3,1,2,1,1,2,2,8,8,12,11,13,10,13,13,10,15,14,9,14,13,9,12,11,13,12,13,12,12,8,12,10,12,12,14,13,13,10,10,11,12,13,20,14,14,12,12,13,7,12,14,11,10,12,11,1,12,2,DM ,1,1,1,1,1,1,14,1,1,20,10,1,1,1,1
19228543,Caio César,1651,26/12/1995,20,0,0,0,0,178,70,2,3,1,1,2,3,1,1,2,3,3,8,10,11,10,14,6,9,8,3,7,11,6,9,12,10,6,9,6,8,7,11,3,11,7,6,9,9,10,14,14,12,9,20,12,14,10,10,8,10,10,10,9,10,20,9,11,8,13,1,5,3,AM RLC,1,1,14,20,15,16,1,1,1,1,1,1,1,1,1
19228544,Mateus Muller,1651,18/11/1995,20,0,0,0,0,178,73,3,1,3,1,3,1,2,1,3,3,2,8,12,12,5,15,12,11,13,10,12,11,5,16,11,10,8,11,11,9,9,12,12,11,12,8,13,11,11,13,12,11,7,20,15,11,11,8,10,10,10,10,10,10,8,11,10,11,10,4,6,5,D/WB L,1,1,1,1,1,1,1,20,1,1,1,1,1,18,1
19228545,Augusto,1651,16/04/1997,19,0,0,0,0,186,0,2,3,1,3,3,1,2,1,3,1,2,2,1,3,1,7,1,10,2,1,13,6,8,13,5,8,11,9,3,9,4,13,7,1,9,3,10,6,6,11,10,7,12,9,10,13,20,9,9,9,9,6,6,9,19,13,10,12,11,1,1,5,D C,1,1,1,1,1,1,20,1,1,1,1,1,1,1,1
19228547,Julen,1651,09/06/1994,22,0,0,0,0,181,0,1,2,3,2,2,2,2,1,2,2,1,6,8,13,8,13,6,6,8,1,6,13,6,8,10,5,10,8,13,7,11,11,1,10,14,8,6,7,6,13,8,5,7,10,13,12,20,8,7,9,4,4,6,11,17,9,12,11,10,7,7,7,AM RC,1,1,10,20,1,17,1,1,1,1,12,1,13,1,1
19228548,João Vitor,1651,20/03/1997,19,0,0,0,0,170,66,1,3,3,3,2,3,1,3,3,2,1,5,4,5,5,10,5,6,9,1,7,13,3,12,5,8,7,7,5,3,12,14,3,8,8,8,10,8,10,9,9,15,5,8,8,9,20,7,4,8,8,8,8,8,14,12,10,10,11,2,13,1,DM/M C,1,1,1,1,1,1,1,1,1,17,20,1,1,1,1
19228549,Alan,1651,05/08/1996,19,0,0,0,0,188,0,12,7,7,1,12,12,4,12,3,1,5,4,1,2,2,1,7,1,3,1,2,1,2,3,1,7,2,10,4,7,4,12,7,3,9,2,3,5,4,9,15,5,7,12,13,9,20,1,6,8,8,8,4,7,13,10,12,11,9,8,13,8,GK ,20,1,1,1,1,1,1,1,1,1,1,1,1,1,1
19228550,Fábio Henrique,1651,07/05/1997,19,0,0,0,0,178,70,1,1,2,3,1,1,2,1,1,3,2,5,4,13,13,13,1,12,5,1,4,5,5,3,13,8,9,7,9,6,6,11,8,13,4,7,2,5,7,13,13,4,8,5,9,13,20,5,5,8,8,8,8,8,19,9,10,12,9,3,16,3,S C,1,1,20,15,1,1,1,1,1,1,8,1,1,1,1
19228809,Philipe Maia,1651,11/07/1995,20,0,0,0,0,185,79,2,2,4,2,1,1,3,2,2,2,2,4,1,4,1,8,2,11,5,4,11,7,1,14,4,10,10,10,8,10,4,14,10,7,12,6,11,8,9,14,11,9,13,9,14,12,20,6,11,10,8,6,10,10,16,11,8,9,13,1,7,7,D C,1,1,1,1,1,1,20,1,1,1,1,1,1,1,1
19228810,Egon,1651,08/01/1989,27,0,0,0,0,190,81,3,3,3,2,2,1,3,4,3,3,1,1,1,5,1,5,2,13,1,4,13,7,3,13,7,10,12,10,6,9,6,13,8,5,10,4,13,7,8,13,11,4,14,20,6,12,10,8,12,10,7,10,5,10,11,11,12,12,9,3,3,3,D C,1,1,1,1,1,1,20,1,1,1,1,1,1,1,1
19228811,Anderson Zangão,1651,03/04/1994,22,0,0,0,0,166,65,3,2,1,2,3,1,2,2,3,3,3,6,8,9,10,14,8,8,12,3,9,14,3,10,12,8,12,9,11,9,12,14,9,11,2,6,10,9,12,14,10,4,4,20,14,14,10,7,6,10,5,5,4,10,10,11,12,12,10,1,14,4,AM C,1,1,1,20,1,1,1,1,1,1,15,1,1,1,1
19228812,Lukinhas,1651,23/06/1995,21,0,0,0,0,168,67,3,1,3,4,2,3,2,2,1,1,1,6,8,9,7,13,4,6,6,6,4,10,1,5,13,9,8,6,5,7,9,10,4,13,9,8,7,7,11,13,13,7,3,20,15,13,8,9,4,9,5,9,9,9,17,9,8,11,11,7,8,4,AM LC,1,1,1,20,17,1,1,1,1,1,14,14,1,1,1
19228814,Felipe Félix,1651,20/10/1994,21,0,0,0,0,178,70,2,1,3,2,4,3,3,3,2,1,2,5,4,6,10,8,2,5,2,3,8,7,6,14,11,8,7,8,8,4,5,11,8,6,2,6,8,8,8,13,7,8,9,8,9,12,20,14,11,8,8,8,8,8,17,10,12,12,12,6,10,5,D/WB R,1,1,1,1,1,1,1,12,20,1,1,1,1,8,16
19228991,Guilherme,1651,02/01/1995,21,0,0,0,0,188,0,2,3,3,3,1,1,2,1,3,3,3,3,5,6,4,14,2,9,5,8,8,10,4,13,10,7,8,10,5,6,9,11,9,9,8,2,7,10,10,11,14,10,13,10,7,12,20,15,10,9,9,7,7,9,16,8,11,10,10,1,11,3,D/WB R,1,1,1,1,1,1,7,1,20,1,1,1,1,1,17
19229109,Wanderlan,1651,14/10/1993,22,0,0,0,0,185,73,3,3,1,2,3,2,3,2,1,1,1,4,4,9,12,12,4,12,5,1,3,5,5,1,12,7,8,2,11,1,1,10,8,13,2,12,5,4,5,12,7,5,11,8,12,10,20,10,7,8,6,3,8,8,19,10,10,11,12,7,14,2,S ,1,1,20,1,1,1,1,1,1,1,1,1,1,1,1
19229111,Yan,1651,18/12/1993,22,0,0,0,0,168,0,3,4,2,2,3,2,1,1,3,1,2,1,2,4,1,9,1,4,4,4,6,6,1,11,6,7,7,7,6,5,5,11,6,7,14,4,4,6,6,13,11,5,4,6,7,12,20,7,3,7,7,7,5,7,17,11,14,11,10,1,12,3,D/WB R,1,1,8,1,1,1,1,1,20,1,1,1,1,1,17
19229259,Raphael,1651,03/04/1996,20,0,0,0,0,168,0,1,2,4,1,4,1,2,2,3,1,2,6,5,14,8,14,6,6,7,6,5,14,3,6,14,8,8,5,6,3,9,7,3,13,10,8,6,8,11,12,9,7,2,20,11,9,1,11,5,7,8,8,8,8,13,12,13,11,12,4,8,3,AM LC,1,1,1,18,20,1,1,1,1,1,12,15,1,1,1
19229260,Ruan,1651,15/04/1995,21,0,0,0,0,179,75,4,3,1,1,4,2,4,3,1,2,3,6,6,10,6,11,6,10,6,5,12,11,6,11,10,13,12,11,8,9,8,9,8,9,11,7,11,12,11,12,12,12,9,7,9,13,20,12,11,11,12,9,9,7,14,9,10,7,5,2,5,13,DM ,1,1,1,1,1,1,1,1,1,20,10,1,1,1,1
19229264,Edy Bueno,1651,15/06/1995,21,0,0,0,0,176,0,3,3,3,1,1,2,1,2,2,3,3,7,7,12,14,10,7,14,3,2,4,8,9,1,11,9,13,8,11,8,7,7,9,10,3,14,3,7,8,14,9,8,8,1,10,12,20,10,6,9,5,7,9,9,14,11,9,8,11,1,9,5,S ,1,1,20,1,1,1,1,1,1,1,1,1,1,1,1
19229435,Malcom,1651,26/02/1997,19,0,0,11,1,171,65,2,2,2,2,2,3,3,3,1,1,3,14,13,13,11,14,15,8,12,6,4,13,12,4,15,8,12,10,12,8,13,13,14,15,8,14,6,13,12,15,16,10,7,20,13,15,10,12,7,11,6,11,8,11,12,13,11,12,12,6,12,5,AM RL,1,1,14,13,20,17,1,1,1,1,1,12,10,1,1
19229588,Guidio,1651,24/02/1990,26,0,0,0,0,175,0,1,3,3,1,1,3,3,2,3,2,2,6,6,3,7,13,6,6,12,6,8,13,1,13,12,9,8,8,8,8,11,13,9,9,12,7,11,7,12,13,10,7,5,10,4,12,20,7,6,9,8,9,9,9,15,11,13,11,12,3,8,6,DM C,1,1,1,1,1,1,1,1,1,20,15,1,1,1,1
19229606,Gabriel,1651,18/01/1997,19,0,0,0,0,171,65,2,2,3,3,4,2,1,1,1,3,3,7,11,13,12,13,6,7,12,4,7,12,12,7,14,10,12,11,11,8,12,10,12,14,3,13,6,9,11,13,15,10,5,5,12,14,20,11,6,12,5,13,5,10,12,10,12,13,10,1,10,5,AM/S RL,1,1,17,14,20,18,1,1,1,1,1,1,1,1,1
19229918,Rafael Oller,1651,24/02/1995,21,0,0,0,0,175,0,1,3,2,2,2,2,2,2,2,3,4,10,11,13,12,12,9,5,11,9,10,16,5,11,13,9,13,7,9,10,10,11,3,15,7,8,10,11,13,14,14,6,6,20,16,12,11,10,7,10,3,9,8,10,16,11,11,11,11,6,9,6,AM C,1,1,1,20,13,1,1,1,1,1,10,9,1,1,1
19229998,João Pedro,1651,20/01/1997,19,0,0,0,0,185,0,1,3,1,3,1,2,3,4,1,3,1,7,4,13,14,14,6,7,8,4,4,13,6,7,14,9,8,8,6,8,7,14,9,13,12,8,6,8,13,13,10,4,11,12,14,10,20,8,7,9,9,9,9,9,18,8,12,13,10,10,12,5,AM C,1,1,1,20,1,1,1,1,1,1,10,1,1,1,1
19230045,Jesiel,1651,15/03/1994,22,0,0,0,0,186,79,3,2,1,1,1,3,1,3,3,4,2,2,5,7,8,9,6,13,6,5,13,9,6,12,9,13,12,12,12,12,6,12,9,5,10,7,12,12,12,12,12,11,13,5,12,11,20,13,15,10,10,9,6,4,18,10,10,12,14,1,4,2,D C,1,1,1,1,1,1,20,1,1,1,1,1,1,1,1
19230408,Rodolfo,1651,12/04/1995,21,0,0,0,0,188,75,10,11,11,2,13,14,12,15,11,5,15,5,3,3,3,11,7,7,2,3,3,10,2,3,8,13,11,12,13,10,12,11,16,11,7,9,11,13,12,10,12,11,10,10,13,8,20,7,11,14,9,12,7,11,13,15,11,11,14,12,13,9,GK ,20,1,1,1,1,1,1,1,1,1,1,1,1,1,1
19230414,Gustavo,1651,29/03/1994,22,0,0,0,0,189,76,3,3,1,3,4,1,1,3,3,1,2,10,7,10,13,9,8,14,11,4,9,9,11,8,10,7,13,12,12,11,8,15,7,10,7,15,11,10,11,11,11,14,15,12,12,12,20,12,14,14,11,11,11,11,20,12,12,9,11,7,15,6,S ,1,1,20,1,1,1,1,1,1,1,1,1,1,1,1
19230472,Matheus Vargas,1651,18/06/1996,20,0,0,0,0,181,78,2,3,2,2,1,2,1,1,1,3,2,11,15,12,11,12,10,8,12,1,9,12,7,5,13,10,10,6,11,12,9,11,3,14,2,12,7,13,11,12,13,10,11,11,12,11,20,12,7,11,7,2,10,10,15,10,10,10,10,7,6,7,AM RLC,1,1,1,20,17,17,1,1,1,1,10,1,1,1,1
19230473,Marcinho,1651,08/06/1995,21,0,0,0,0,173,0,2,1,2,2,1,1,1,3,2,2,1,7,8,12,9,14,7,4,9,2,7,11,9,7,12,9,9,7,14,8,6,14,3,12,3,9,7,8,9,13,7,8,2,10,4,13,20,8,6,9,9,4,6,9,17,8,14,12,11,7,13,4,AM RLC,1,1,13,18,18,20,1,1,1,1,1,1,1,1,1
19230574,Thiago,1651,18/12/1992,23,0,0,0,0,179,73,2,2,2,1,3,1,2,4,3,3,2,6,6,13,7,13,5,6,12,1,6,11,4,6,13,9,9,8,11,7,9,11,9,13,8,9,7,7,11,13,13,7,7,9,13,13,20,7,6,9,9,5,9,9,19,11,12,9,12,5,1,5,AM C,1,1,1,20,1,1,1,1,1,1,10,1,1,1,1
19230575,Lucas Batatinha,1651,03/07/1990,25,0,0,0,0,185,78,3,3,1,3,2,2,2,1,3,2,1,6,4,13,13,13,6,13,2,1,6,7,9,4,13,8,13,8,9,2,6,9,9,13,10,13,7,6,6,13,13,7,9,4,11,13,20,10,8,9,8,4,9,9,15,10,10,13,11,5,15,3,S ,1,1,20,1,1,1,1,1,1,1,1,1,1,1,1
19230576,Andrezinho,1651,05/05/1986,30,0,0,0,0,184,0,1,2,1,1,2,1,3,3,2,1,1,6,3,10,13,13,6,12,7,2,5,4,6,5,13,8,8,8,10,4,7,12,2,13,12,12,6,6,8,13,13,7,9,10,10,13,20,12,7,9,9,9,8,9,8,12,12,12,12,3,2,3,S ,1,1,20,1,1,1,1,1,1,1,1,1,1,1,1
19231005,Jeferson Romário,1651,16/10/1994,21,0,0,0,0,197,0,13,10,9,2,13,13,10,12,4,6,11,5,2,2,3,6,10,1,3,3,2,1,4,2,5,9,5,14,7,8,7,13,6,1,9,3,10,8,7,13,13,6,12,10,15,11,20,7,11,10,10,5,5,10,11,11,12,11,12,2,14,6,GK ,20,1,1,1,1,1,1,1,1,1,1,1,1,1,1
19231006,Josemar,1651,21/02/1994,22,0,0,0,0,183,0,2,3,3,1,2,3,1,2,2,1,4,4,4,5,2,11,1,7,7,6,7,8,1,13,7,9,8,8,9,8,6,11,9,3,4,7,7,5,9,14,7,6,6,20,13,13,9,14,8,9,7,3,9,9,8,9,10,12,11,13,9,6,D/WB L,1,1,1,1,1,1,1,20,1,1,1,1,1,17,1
19231041,João Paulo,1651,29/06/1995,21,0,0,0,0,187,86,8,8,10,1,14,14,9,14,6,9,12,2,2,1,1,5,6,1,3,3,2,3,2,1,6,6,5,14,6,12,7,10,6,2,12,2,7,8,7,13,7,8,14,4,16,11,20,7,10,9,8,1,9,9,15,10,12,11,10,1,2,7,GK ,20,1,1,1,1,1,1,1,1,1,1,1,1,1,1
19231042,Diogo Vítor,1651,11/02/1997,19,0,0,0,0,170,63,3,1,1,2,4,2,3,2,2,1,1,8,12,14,10,14,8,8,10,5,5,10,5,6,14,10,10,7,7,9,12,14,5,14,12,10,8,9,12,12,13,9,5,20,16,13,12,8,6,10,6,10,5,10,7,12,10,6,4,4,6,15,AM LC,1,1,1,18,20,1,1,1,1,1,1,12,1,1,1
19231043,Diego Santos,1651,10/04/1995,21,0,0,0,0,184,78,1,1,3,2,2,1,3,3,3,1,1,5,6,7,6,11,2,6,12,2,11,11,5,13,11,9,9,3,7,9,6,13,9,7,4,6,7,7,10,13,11,7,8,10,8,13,20,6,6,9,9,9,6,9,19,12,12,12,12,3,6,8,DM ,1,1,1,1,1,1,1,1,1,20,1,1,1,1,1
19231080,Lucas,1651,18/06/1997,19,0,0,0,0,190,79,3,1,2,3,1,3,1,1,2,1,3,5,11,10,10,11,4,12,11,12,12,11,6,12,11,12,11,11,10,10,10,9,10,10,4,9,12,12,12,13,12,11,14,4,9,12,20,12,11,13,8,4,4,13,8,8,12,9,11,6,11,5,D RC,1,1,1,1,1,1,20,1,17,1,1,1,1,1,12
19231081,Fernandes,1651,16/05/1995,21,0,0,0,0,180,0,3,1,2,3,3,1,1,4,2,2,3,5,8,9,8,11,8,12,9,5,13,11,8,12,11,11,11,12,11,10,8,10,4,9,5,9,12,13,12,12,11,12,12,20,12,12,5,13,13,12,11,10,5,10,20,13,10,12,9,8,19,3,D C,1,1,1,1,1,1,20,1,1,15,1,1,1,1,1
19231089,Vinícius,1651,26/01/1995,21,0,0,0,0,186,82,1,1,1,4,1,2,2,3,2,1,2,3,5,8,7,11,5,13,8,5,14,10,8,13,10,12,11,12,11,9,5,12,13,10,5,12,12,13,13,13,12,9,14,8,14,12,20,14,13,13,11,13,3,5,11,6,12,11,16,10,8,5,D C,1,1,1,1,1,1,20,1,1,1,1,1,1,1,1
19231090,Rafaelson,1651,30/03/1997,19,0,0,0,0,184,79,3,3,2,3,1,1,2,2,3,3,1,3,9,11,13,12,7,12,12,3,6,10,12,6,11,11,12,12,9,8,10,9,14,14,3,13,6,11,13,13,12,12,11,20,13,13,10,13,13,12,11,5,3,13,9,11,12,9,11,5,18,6,AM/S R,1,1,20,1,13,18,1,5,1,1,1,10,9,7,1
19231091,Linik,1651,10/07/1996,19,0,0,0,0,185,78,1,2,3,3,1,3,1,2,3,1,4,8,10,13,10,14,8,8,9,4,8,12,4,7,11,10,6,5,6,8,9,14,10,10,13,10,9,9,13,13,14,4,10,10,10,13,20,10,9,10,7,7,10,10,12,9,11,12,9,7,4,8,AM RLC,1,1,1,20,15,18,1,1,1,1,15,11,13,1,1
19231093,Jardel,1651,15/03/1995,21,0,0,0,0,176,0,2,1,3,1,1,3,2,2,1,2,2,8,10,10,10,15,8,5,7,7,8,8,6,10,15,9,7,1,5,5,11,11,3,13,4,10,10,9,11,11,11,5,5,9,11,11,20,9,7,9,4,7,9,9,20,11,11,10,10,6,11,6,M/AM C,1,1,1,17,12,13,1,1,1,13,20,13,14,1,1
19231101,Matheus Phillipe,1651,10/02/1995,21,0,0,0,0,189,71,13,13,11,4,13,13,8,13,6,9,12,5,1,2,1,3,7,1,3,2,1,1,4,1,7,7,7,13,8,9,7,13,5,2,12,1,8,8,6,10,15,8,8,8,10,6,20,2,10,10,10,1,8,10,9,13,11,12,9,5,16,4,GK ,20,1,1,1,1,1,1,1,1,1,1,1,1,1,1
19231106,João Cleriston,1651,24/03/1994,22,0,0,0,0,173,70,2,3,3,3,2,2,2,3,3,1,3,4,2,3,8,13,7,7,8,5,7,14,7,12,8,7,13,8,8,9,12,14,6,5,3,7,12,8,12,14,12,8,5,13,10,11,20,8,8,9,8,9,9,9,14,11,10,10,9,6,7,7,DM ,1,1,1,1,1,1,1,1,1,20,10,1,1,1,1
19231107,Luiz Fernando,1651,08/05/1994,22,0,0,0,0,178,74,2,1,3,2,1,2,2,3,2,3,1,10,8,6,10,15,10,10,9,6,12,11,5,15,15,8,14,10,12,12,14,15,12,7,1,10,12,11,13,15,11,11,7,13,7,11,20,13,7,11,6,5,5,11,14,11,12,11,12,12,9,6,DM C,1,1,1,1,1,1,1,1,1,20,15,1,1,1,1
19231109,Matheus Silva,1651,07/11/1995,20,0,0,0,0,178,80,3,3,2,3,2,1,1,3,3,2,1,1,1,5,6,8,5,5,13,1,7,13,1,13,12,8,12,3,6,3,11,12,6,8,13,5,7,7,11,10,6,6,8,7,15,6,20,8,4,8,6,8,8,8,20,12,10,11,9,2,8,7,DM ,1,1,1,1,1,1,1,1,1,20,10,1,1,1,1
19231111,Luquinha,1651,28/01/1994,22,0,0,0,0,170,58,2,3,3,2,2,2,2,1,2,1,3,8,7,10,10,13,8,4,10,7,7,14,2,9,14,8,10,8,7,9,14,11,10,13,11,10,10,9,10,14,12,9,5,10,10,10,20,8,6,10,10,1,4,10,9,10,10,9,11,2,20,6,AM C,1,1,1,20,1,1,1,1,1,1,12,1,1,1,1
19231112,Matheus Leiria,1651,22/01/1995,21,0,0,0,0,179,65,3,3,3,4,1,3,2,3,2,2,3,2,4,8,8,14,3,7,8,2,7,12,3,7,14,5,9,8,8,8,13,10,3,13,13,8,9,7,11,14,13,6,9,11,13,12,20,10,7,9,5,9,9,9,16,13,11,12,11,7,7,8,AM C,1,1,1,20,1,11,1,1,7,1,13,1,10,1,7
19231113,Rafael,1651,24/04/1995,21,0,0,0,0,177,76,3,4,2,1,2,3,3,1,3,2,1,8,8,10,10,14,8,8,14,1,7,14,5,10,14,8,12,3,8,8,11,14,12,13,9,12,8,9,12,14,14,6,6,9,5,14,20,8,7,10,9,3,10,10,12,11,13,11,12,11,8,8,M/AM C,1,1,1,20,1,1,1,1,1,1,18,1,1,1,1
19231114,Roger,1651,04/04/1995,21,0,0,0,0,170,66,4,2,1,1,2,2,1,3,1,3,1,8,6,10,10,15,8,7,11,5,9,13,3,10,15,7,6,8,6,8,11,12,5,13,4,6,8,9,14,10,12,9,8,1,11,14,20,13,6,9,9,9,7,9,8,13,11,12,10,2,2,1,AM C,1,1,1,20,1,1,1,1,1,1,15,1,1,1,1
19231117,Bruno Tanque,1651,24/01/1995,21,0,0,0,0,187,86,1,3,3,1,2,3,3,2,3,1,1,7,5,9,14,14,7,12,8,1,7,8,8,3,11,6,10,5,13,8,4,5,9,10,2,9,8,7,8,14,9,8,12,1,9,13,20,12,9,9,6,5,7,9,16,12,10,9,10,8,5,6,S ,1,1,20,1,1,1,1,1,1,1,1,1,1,1,1
19231123,Léo,1651,06/03/1996,20,0,0,0,0,183,71,3,3,3,3,3,2,1,2,1,2,3,4,13,14,9,12,5,11,13,15,12,12,11,13,13,10,12,12,12,13,11,11,12,12,5,14,11,13,12,15,13,12,11,20,13,15,7,16,13,13,7,11,11,11,11,13,12,10,12,7,9,3,D/WB L,1,1,1,1,1,1,1,20,1,1,1,13,1,19,1
19231357,Alisson Farias,1651,07/04/1996,20,0,0,0,0,171,67,2,2,3,2,4,2,1,1,1,1,1,7,12,14,11,13,11,8,10,4,4,11,7,4,13,8,11,9,11,12,11,12,13,14,8,12,6,12,11,13,13,13,9,8,17,14,20,10,9,12,6,9,11,13,10,12,12,12,12,8,14,6,AM/S RL,1,1,18,1,20,16,1,1,1,1,1,13,1,1,1
19231627,Eron,1651,16/07/1998,17,0,0,0,0,178,73,1,2,1,1,3,4,1,2,1,4,3,8,9,12,13,13,7,11,11,5,5,11,12,5,13,9,13,9,12,9,11,10,17,14,3,13,6,11,12,13,14,11,10,5,13,13,20,12,11,13,5,4,4,9,8,11,9,9,11,12,6,6,AM/S L,1,1,20,1,18,12,1,1,1,1,1,1,1,1,1
19232507,Carlos Eduardo,1651,27/03/1995,21,0,0,0,0,190,0,3,1,2,3,1,3,2,3,2,2,1,8,7,4,7,13,5,9,7,8,7,8,1,13,9,7,10,9,5,7,4,15,9,7,14,6,11,9,9,15,10,9,15,20,9,13,6,9,11,9,9,9,7,9,18,12,10,10,8,10,17,5,D L,1,1,1,1,1,1,1,20,1,1,1,1,1,1,1
19232508,Guilherme Arana,1651,14/04/1997,19,0,0,0,0,176,68,1,1,1,2,3,1,1,4,1,1,1,11,13,12,11,12,7,8,13,10,10,12,11,12,13,13,12,12,12,12,11,11,13,12,11,8,11,12,13,14,14,11,8,20,14,14,12,13,10,12,8,11,10,11,7,12,12,10,12,10,15,7,D/WB L,1,1,1,1,1,1,1,20,1,1,1,1,1,19,1
19232509,Henrique,1651,02/05/1994,22,0,0,0,0,185,75,10,14,11,7,14,13,9,14,10,8,10,2,2,1,2,2,6,1,1,2,3,1,1,2,5,6,8,13,7,13,8,14,5,2,10,2,11,9,7,14,6,5,9,9,14,14,20,3,8,10,9,3,10,10,7,9,13,14,10,1,6,7,GK ,20,1,1,1,1,1,1,1,1,1,1,1,1,1,1
19232512,Marcel,1651,01/03/1996,20,0,0,0,0,185,0,2,3,3,1,3,4,2,3,1,1,1,1,2,1,6,3,1,12,5,2,12,6,4,12,5,7,8,9,4,5,5,13,1,1,9,4,13,6,6,13,13,7,9,9,15,13,20,7,8,9,1,5,9,9,11,12,13,11,9,6,5,7,D C,1,1,1,1,1,1,20,1,1,1,1,1,1,1,1
19232514,Batista,1651,16/06/1995,21,0,0,0,0,178,72,1,1,3,2,1,2,4,3,2,1,2,6,9,10,11,11,6,10,9,5,5,8,10,5,11,6,12,12,12,11,9,12,14,12,8,12,8,13,13,13,14,12,9,10,13,14,20,14,7,12,6,8,5,10,11,10,10,13,13,8,13,5,S ,1,1,20,1,1,1,1,1,1,1,1,1,1,1,1
19232515,Matheus,1651,12/10/1995,20,0,0,0,0,188,0,13,6,9,1,9,11,10,13,9,6,6,4,2,3,3,3,6,1,2,1,2,1,3,3,1,9,7,12,7,11,6,13,6,3,1,2,9,7,6,11,6,7,8,10,9,13,20,1,7,8,8,3,7,9,14,13,11,9,13,5,2,3,GK ,20,1,1,1,1,1,1,1,1,1,1,1,1,1,1
19232517,Pedro Henrique,1651,02/10/1995,20,0,0,0,0,188,82,2,2,2,4,1,1,2,2,2,2,1,5,5,10,9,11,9,14,7,10,14,12,7,14,11,10,13,12,12,12,10,10,14,10,12,12,14,12,13,13,12,13,16,12,16,12,20,12,13,12,12,11,11,9,12,12,12,13,12,10,10,6,D C,1,1,1,1,1,1,20,1,13,1,1,1,1,1,1
19232614,Daniel,1651,23/09/1995,20,0,0,0,0,191,0,11,7,9,1,13,12,9,9,7,10,11,3,3,1,2,6,6,1,1,1,2,2,3,1,3,1,9,11,8,11,6,13,3,2,9,3,8,8,6,11,16,8,10,6,14,12,20,1,9,10,8,10,8,10,12,13,12,9,9,1,5,8,GK ,20,1,1,1,1,1,1,1,1,1,1,1,1,1,1
19232616,José Ivaldo,1651,21/02/1997,19,0,0,0,0,184,76,4,1,3,1,2,2,2,1,2,1,2,6,2,6,5,7,3,14,6,4,14,9,3,14,8,6,11,10,8,9,6,14,18,6,13,8,14,7,4,14,14,9,8,8,15,14,20,8,10,10,10,6,7,10,18,11,12,12,10,10,9,4,D C,1,1,1,1,1,1,20,1,1,1,1,1,1,1,1
19232643,Jaildo,1651,25/04/1991,25,0,0,0,0,182,0,3,2,2,1,3,3,1,3,1,3,1,5,3,8,7,8,7,7,9,7,10,13,2,13,9,10,8,9,6,8,6,13,5,3,11,7,11,8,12,13,13,8,5,10,4,13,20,13,7,10,10,10,8,10,16,10,11,11,10,1,13,1,DM R,1,1,1,1,1,1,1,1,15,20,13,1,1,1,1
19232644,Miller,1651,23/11/1990,25,0,0,0,0,174,71,3,2,3,3,1,2,1,3,2,1,1,4,3,7,7,12,5,5,11,2,6,12,5,7,8,8,7,5,8,6,11,7,7,8,9,9,7,7,11,13,13,12,6,8,8,13,20,9,7,8,8,2,8,8,17,11,13,13,12,4,7,1,AM C,1,1,1,20,1,1,1,1,1,1,15,1,1,1,1
19232876,Rubão,1651,12/01/1994,22,0,0,0,0,194,79,1,2,4,3,2,2,1,2,1,4,2,4,8,9,12,8,5,12,10,4,8,12,10,8,10,12,10,12,12,12,10,12,10,12,8,12,6,12,12,12,10,12,13,11,10,11,20,12,14,10,5,10,10,4,16,11,9,12,9,8,14,2,S ,1,1,20,1,1,1,1,1,1,1,1,1,1,1,1
19232877,Leonan,1651,28/10/1995,20,0,0,0,0,183,77,1,2,4,2,2,2,2,1,2,2,1,12,13,10,3,14,11,11,10,6,9,11,7,9,10,10,12,11,9,11,11,14,14,13,6,12,9,12,12,11,12,12,13,20,13,12,5,12,9,8,7,4,12,10,19,10,11,10,12,5,4,1,D/WB L,1,1,1,1,1,1,1,20,1,1,1,1,1,19,1
19233140,Cleylton,1651,19/03/1993,23,0,0,0,0,190,83,2,2,3,1,2,2,1,3,3,1,3,4,1,1,1,7,1,13,5,4,12,7,1,13,5,9,10,9,7,8,5,13,3,1,8,6,10,6,7,13,11,7,14,10,15,10,20,4,11,9,9,9,4,9,18,10,12,11,9,7,14,4,D C,1,1,1,1,1,1,20,1,1,1,1,1,1,1,1
19233141,Moisés Gaúcho,1651,24/09/1994,21,0,0,0,0,181,73,2,3,1,2,2,3,3,3,3,3,2,9,10,10,9,10,10,10,8,4,13,12,8,12,11,11,12,12,11,12,10,12,10,8,10,10,12,12,13,11,13,13,12,11,13,12,20,12,12,12,12,5,8,8,20,11,10,11,10,7,16,7,DM/M C,1,1,1,1,1,1,1,1,1,19,20,1,1,1,1
19233144,Leandro Canhoto,1651,23/11/1994,21,0,0,0,0,181,72,3,3,3,3,2,3,1,1,4,3,1,12,11,12,10,12,12,6,11,4,3,12,13,3,12,10,8,6,9,11,10,12,3,9,6,9,10,11,13,12,11,10,10,20,11,12,10,11,10,10,5,10,10,10,12,11,11,12,8,7,11,5,M/AM LC,1,1,1,20,15,1,1,1,1,1,18,15,1,1,1
19233145,Jéferson Negueba,1651,02/01/1994,22,0,0,0,0,176,76,2,1,2,3,2,4,2,2,3,1,2,9,12,12,8,14,8,8,9,5,8,13,7,8,14,8,9,9,10,7,13,12,8,12,9,10,9,9,7,13,12,9,4,10,15,12,20,12,7,10,6,2,10,10,8,12,8,11,10,6,5,7,AM RLC,1,1,1,20,18,18,1,1,1,1,14,1,1,1,1
19233146,Everton,1651,22/03/1996,20,0,0,0,0,174,72,3,2,3,1,3,2,3,2,2,1,2,5,12,16,12,13,5,8,12,2,7,11,10,5,16,5,13,13,12,12,11,12,16,16,4,16,5,13,13,15,15,10,8,9,12,15,20,14,9,12,6,7,5,12,11,15,13,9,15,7,12,3,AM/S RLC,1,1,17,15,20,18,1,1,1,1,1,1,1,1,1
19233153,Rafael Silva,1651,02/11/1991,24,0,0,0,0,180,0,3,3,2,1,3,1,4,2,3,2,2,9,11,11,14,14,8,14,9,6,8,9,5,3,10,7,11,3,9,9,8,8,8,10,14,14,7,8,10,13,12,11,9,3,12,13,20,12,7,10,4,10,10,9,16,13,11,8,9,1,4,8,S RL,1,1,20,1,15,15,1,1,1,1,1,1,1,1,1
19233479,Samuel,1651,29/03/1994,22,0,0,0,0,188,80,14,10,10,1,13,14,11,12,10,10,14,1,1,3,1,5,6,1,3,3,3,3,1,3,6,10,11,13,9,10,8,14,12,3,4,2,12,9,7,12,13,9,14,8,12,13,20,3,11,10,10,10,10,10,11,11,14,11,12,7,9,8,GK ,20,1,1,1,1,1,1,1,1,1,1,1,1,1,1
19233480,Anderson,1651,19/09/1995,20,0,0,0,0,178,0,4,2,3,3,2,2,2,2,1,3,2,7,9,5,3,6,5,5,5,7,8,9,2,13,9,8,5,9,4,8,7,13,9,9,1,6,6,9,9,14,10,9,6,17,13,14,20,8,7,9,8,9,6,9,20,11,11,11,12,9,1,2,D/WB R,1,1,1,1,1,1,1,1,20,1,1,1,1,1,17
19233481,Fábio,1651,29/05/1995,21,0,0,0,0,178,0,2,1,2,3,2,3,3,1,3,2,1,6,4,7,6,10,2,8,7,7,6,6,3,12,9,9,9,9,4,6,7,12,1,3,1,7,8,9,9,14,14,9,7,20,12,14,2,14,6,9,7,9,9,9,20,10,12,11,12,2,9,2,D/WB L,1,1,1,1,1,1,1,20,1,1,1,1,1,17,1
19233482,Henrique Gelain,1651,05/01/1995,21,0,0,0,0,180,81,3,1,1,1,3,1,3,1,1,2,4,6,10,9,3,12,3,8,9,9,11,11,7,15,11,10,13,11,9,14,11,12,10,6,11,8,12,11,11,13,11,11,10,20,12,14,11,8,9,10,10,10,6,10,15,11,9,11,11,5,14,5,D/WB L,1,1,1,1,1,1,1,20,1,1,1,1,1,19,1
19233484,Geovane,1651,17/10/1996,19,0,0,0,0,191,0,1,3,3,2,1,2,1,1,1,1,3,5,3,1,2,6,1,9,3,1,12,4,1,9,4,5,10,8,6,10,3,12,8,6,11,5,10,5,6,8,12,6,13,18,11,11,20,11,7,8,9,4,8,9,10,10,10,11,12,4,9,7,D C,1,1,1,1,1,1,20,1,1,1,1,1,1,1,1
19233485,Juninho,1651,01/02/1995,21,0,0,0,0,187,80,2,1,2,2,2,2,3,4,1,2,3,9,5,7,9,9,7,15,7,8,15,10,5,15,10,11,13,11,9,10,7,14,10,1,13,10,13,10,11,15,15,9,12,20,18,15,12,10,11,13,9,5,11,11,17,12,12,9,13,4,6,1,D C,1,1,1,1,1,1,20,1,1,1,1,1,1,1,1
19233488,Thiago Lopes,1651,27/10/1996,19,0,0,0,0,178,71,3,1,2,2,3,2,2,3,3,1,2,11,11,11,10,12,9,9,13,7,8,11,12,8,13,10,11,9,11,13,12,11,13,12,9,12,7,11,10,13,13,9,8,12,13,13,20,11,9,11,9,10,6,12,12,12,12,12,10,9,12,9,M/AM C,1,1,1,20,7,1,1,1,1,1,18,13,10,1,1
19233489,Vitor,1651,27/05/1997,19,0,0,0,0,181,0,4,3,3,2,2,2,2,2,2,1,3,8,3,4,5,15,8,8,11,4,8,15,4,13,15,9,9,6,8,5,13,15,3,9,7,8,8,9,11,11,12,4,8,1,12,15,20,8,8,9,9,1,9,9,20,12,10,12,11,8,12,5,DM ,1,1,1,1,1,1,1,1,1,20,13,1,1,1,1
19233491,Raphael Veiga,1651,19/06/1995,21,0,0,0,0,176,73,1,4,1,2,3,2,3,4,4,2,1,10,11,13,11,13,11,9,11,5,9,13,10,9,13,8,10,10,11,11,12,11,11,13,8,12,8,11,11,14,14,13,7,10,12,14,20,13,9,14,11,5,11,11,17,14,11,11,11,4,12,2,M/AM C,1,1,1,20,1,10,1,1,1,1,17,1,7,1,1
19233492,Guilherme Parede,1651,19/09/1995,20,0,0,0,0,186,0,4,1,3,2,2,2,2,1,3,1,2,8,9,14,14,14,8,14,7,5,6,5,9,3,13,6,12,8,13,5,8,12,10,12,7,13,10,8,10,7,9,10,13,16,14,7,20,14,10,10,9,4,4,10,20,10,10,10,9,6,4,8,AM/S C,1,1,20,17,1,1,1,1,1,1,1,1,1,1,1
19233493,Ítalo,1651,26/04/1995,21,0,0,0,0,182,70,3,3,3,3,3,4,4,3,3,3,2,3,6,12,12,12,5,12,5,1,3,1,8,4,12,9,12,7,11,4,3,9,9,13,13,12,5,5,6,12,12,6,9,9,15,12,20,7,6,9,9,9,9,9,13,11,10,11,13,4,7,2,S ,1,1,20,7,1,1,1,1,1,1,1,1,1,1,1
19233495,Odair,1651,28/10/1994,21,0,0,0,0,171,0,1,3,4,3,1,3,1,2,2,1,2,7,6,14,13,14,7,8,8,5,6,8,5,1,14,9,7,8,14,6,6,11,3,13,11,14,6,7,8,14,14,8,6,1,10,12,20,6,8,9,9,9,9,9,20,13,12,10,14,5,9,4,S ,1,1,20,10,1,1,1,1,1,1,1,1,1,1,1
19233502,Rodrigo Antunes,1651,12/11/1997,18,0,0,0,0,196,90,10,7,6,7,14,13,8,14,7,6,12,6,2,3,1,2,10,1,1,1,3,1,2,2,1,10,8,12,4,10,8,14,5,2,8,2,13,9,8,13,14,5,13,10,13,9,20,7,12,10,7,1,10,8,16,12,11,12,11,4,11,3,GK ,20,1,1,1,1,1,1,1,1,1,1,1,1,1,1
19234316,Danilo Quipapá,1651,21/02/1994,22,0,0,0,0,194,0,2,2,1,1,3,1,1,3,3,2,2,3,5,5,4,9,3,7,3,3,14,8,1,14,8,10,14,10,4,9,4,14,10,3,3,6,13,4,8,14,11,9,12,9,10,13,20,7,11,10,7,3,7,10,11,7,12,10,11,5,2,3,D C,1,1,1,1,1,1,20,1,1,1,1,1,1,1,1
19234320,Gustavo Henrique,1651,01/06/1992,24,0,0,0,0,185,70,1,3,1,1,1,3,2,3,3,2,1,8,5,8,9,9,8,8,12,4,11,11,4,14,14,7,14,8,9,7,11,13,3,8,13,8,11,9,11,14,12,9,13,11,13,11,20,12,9,10,10,4,10,10,16,13,12,9,10,8,14,2,DM ,1,1,1,1,1,1,1,1,1,20,10,1,1,1,1
19234325,Danilo Cirqueira,1651,02/02/1992,24,0,0,0,0,187,0,1,1,1,3,4,1,2,2,1,2,2,2,1,2,6,6,4,13,6,3,13,6,1,12,3,9,9,9,5,9,5,13,9,3,5,6,13,6,7,13,12,7,13,9,16,12,20,7,10,9,9,8,3,9,13,11,10,12,11,3,13,4,D C,1,1,1,1,1,1,20,1,1,1,1,1,1,1,1
19234326,Iranílson,1651,23/06/1993,23,0,0,0,0,186,0,3,3,1,3,2,4,2,3,4,3,2,5,6,8,5,11,4,9,7,6,10,9,4,15,10,9,10,10,10,8,7,13,4,4,10,7,8,10,10,13,10,10,10,10,13,10,20,15,11,9,9,6,8,9,11,13,10,8,11,5,10,1,D/WB R,1,1,1,1,1,1,1,1,20,1,1,1,1,1,19
19234327,Patrick,1651,30/09/1993,22,0,0,0,0,179,66,1,2,3,3,2,2,3,2,1,1,3,12,14,9,5,7,10,7,7,7,8,9,4,9,7,9,9,8,9,8,9,11,7,7,5,8,8,8,9,12,14,8,9,20,14,14,10,7,8,9,9,5,9,11,12,10,12,12,12,5,2,3,D/WB/M L,1,1,1,10,15,1,1,20,1,1,5,16,1,19,1
19234349,Diego Alemão,1651,13/03/1990,26,0,0,0,0,192,86,2,1,2,2,3,2,1,1,3,1,2,2,5,3,4,7,1,12,4,3,11,5,3,13,6,9,11,9,7,7,4,13,9,8,14,6,7,6,8,13,12,7,15,10,10,12,20,12,13,9,9,2,9,9,12,11,11,13,11,6,18,3,D C,1,1,1,1,1,1,20,1,1,1,1,1,1,1,1
19234350,Rodrigo Mann,1651,24/06/1993,23,0,0,0,0,181,70,1,1,3,2,1,1,3,3,1,1,2,7,6,9,6,15,3,6,7,8,11,11,4,11,11,9,11,10,10,12,10,12,2,7,11,9,8,11,11,15,15,11,10,10,13,15,20,7,9,10,10,10,9,10,20,10,13,12,12,6,8,2,D/WB R,1,1,1,1,1,1,1,1,20,1,1,1,1,1,19
19234351,Breno Lopes,1651,28/09/1990,25,0,0,0,0,181,70,2,3,1,3,2,1,3,2,1,1,2,11,12,12,10,12,9,10,9,11,8,13,6,8,13,11,11,12,12,12,12,12,12,13,10,13,7,12,8,14,11,11,12,20,15,13,12,12,14,12,1,11,6,11,13,12,11,11,11,7,7,7,D/WB L,1,1,1,1,1,1,1,20,1,1,1,1,1,19,1
19234352,Jhonatan,1651,21/10/1993,22,0,0,0,0,186,0,1,1,3,1,3,4,2,3,2,1,1,6,7,6,7,14,8,8,8,3,7,9,2,13,14,10,9,9,5,13,10,14,8,3,2,8,9,9,12,14,9,9,13,9,12,9,20,7,9,10,10,10,10,10,12,11,12,12,12,1,5,2,DM ,1,1,1,1,1,1,1,1,1,20,10,1,1,1,1
19234354,Arthur,1651,21/02/1994,22,0,0,0,0,180,78,2,1,2,3,2,2,3,3,2,2,2,7,6,7,13,12,4,13,4,5,6,6,4,4,8,10,13,9,12,5,4,9,1,10,9,12,7,7,8,12,13,7,9,9,11,12,20,12,8,10,6,10,10,10,14,14,12,12,14,7,9,7,S ,1,1,20,1,1,1,1,1,1,1,1,1,1,1,1
19234356,Valson,1651,29/07/1993,22,0,0,0,0,175,0,2,2,1,2,3,3,3,2,2,2,3,6,2,13,13,13,6,13,7,5,6,6,8,6,12,3,11,5,9,2,7,12,9,12,5,13,7,6,7,13,11,3,5,9,10,11,20,12,6,9,9,9,9,9,12,15,12,12,12,6,3,6,S ,1,1,20,1,1,1,1,1,1,1,1,1,1,1,1
19234574,Mário Sérgio,1651,19/01/1992,24,0,0,0,0,174,67,3,3,3,2,1,1,1,1,3,1,1,12,12,11,10,11,10,8,10,10,12,11,10,11,11,11,10,12,11,12,11,11,12,11,8,11,10,13,12,14,15,9,7,11,14,15,20,13,8,11,11,10,10,9,12,11,12,12,12,6,7,7,D/WB R,1,1,1,1,1,1,1,1,20,1,1,1,1,1,19
19234578,Pará,1651,23/08/1995,20,0,0,0,0,167,70,3,3,1,1,3,2,3,2,1,1,1,10,11,12,10,12,6,6,10,12,12,12,11,11,12,14,11,13,11,11,11,12,13,13,7,12,12,13,13,15,14,15,5,20,14,15,6,14,8,11,12,13,4,11,13,11,12,13,13,11,10,6,D/WB L,1,1,1,1,13,1,1,20,1,1,1,12,1,19,1
19234581,Rhuan,1651,18/12/1991,24,0,0,0,0,179,75,1,3,3,2,3,2,2,1,3,1,1,6,5,9,7,9,3,8,6,5,10,10,3,14,10,10,11,10,8,8,8,11,9,9,11,8,11,10,10,14,14,8,10,10,11,14,20,14,7,10,10,8,10,10,16,13,13,11,11,5,9,7,D/WB R,1,1,1,1,1,1,1,1,20,1,1,1,1,1,19
19234582,Paulo Victor,1651,11/05/1994,22,0,0,0,0,181,77,3,3,3,1,3,3,3,2,2,2,3,6,4,11,10,13,6,13,2,3,6,7,5,4,11,9,10,8,7,6,4,8,9,11,1,13,7,6,8,13,10,7,6,20,9,11,10,12,11,9,9,6,8,9,18,13,13,12,9,3,4,4,S ,1,1,20,1,1,1,1,1,1,1,1,1,1,1,1
19235109,Túlio,1651,04/03/1993,23,0,0,0,0,184,76,3,3,1,2,1,2,4,3,2,3,3,8,7,4,9,14,4,11,14,5,12,14,8,12,14,13,13,4,10,10,11,14,20,9,4,10,11,8,13,13,11,11,10,11,10,12,20,11,12,12,13,14,10,10,17,10,12,12,11,8,9,8,D/DM C,1,1,1,1,1,1,18,1,1,20,10,1,1,1,1
19235111,Rodrigo,1651,11/02/1994,22,0,0,0,0,176,70,3,1,2,3,1,3,3,1,2,3,2,10,10,9,10,12,6,12,14,4,12,14,10,11,12,6,14,10,11,9,10,14,11,9,9,10,14,11,15,10,12,14,11,11,14,14,20,14,10,10,8,14,12,10,12,11,11,10,13,6,9,6,DM ,1,1,1,1,1,1,1,1,1,20,10,1,1,1,1
19235113,Victor Oliveira,1651,28/05/1994,22,0,0,0,0,190,78,3,3,3,1,1,3,2,1,3,1,3,6,10,9,10,11,9,12,9,9,12,10,8,12,10,5,13,12,12,12,10,12,12,8,8,10,12,13,12,13,11,10,15,20,11,12,6,12,12,11,6,10,9,11,15,9,10,9,12,10,10,13,D C,1,1,1,1,1,1,20,13,1,1,1,1,1,1,1
19235114,Erivelton,1651,06/11/1991,24,0,0,0,0,193,0,2,1,3,3,1,3,3,3,2,2,1,8,6,14,14,14,8,8,11,1,8,14,5,7,11,6,9,2,9,7,10,14,7,10,12,13,8,9,13,14,13,9,11,5,13,12,20,10,10,10,7,3,10,10,15,13,10,10,11,5,14,6,AM C,1,1,1,20,1,1,1,1,1,1,10,1,1,1,1
19235115,Gustavo Ramos,1651,02/07/1996,19,0,0,0,0,175,74,4,3,1,3,3,3,2,3,3,2,1,5,8,12,11,14,8,14,5,5,7,11,4,3,12,10,13,8,9,6,12,9,4,12,7,14,9,8,5,12,14,9,8,10,3,13,20,9,10,10,6,10,5,10,14,10,10,11,10,2,3,3,S ,1,1,20,1,1,1,1,1,1,1,1,1,1,1,1
19235116,Victor,1651,15/01/1993,23,0,0,0,0,185,80,2,3,2,3,1,2,2,4,2,1,2,8,6,6,5,9,3,14,3,3,11,9,3,12,6,10,11,10,9,8,8,12,3,4,3,7,14,8,9,14,12,9,12,9,17,12,20,8,9,10,10,4,10,10,12,12,13,11,11,1,8,3,D C,1,1,1,1,1,1,20,1,1,1,1,1,1,1,1
19235126,Hugo,1651,02/03/1993,23,0,0,0,0,170,64,4,2,4,3,3,1,3,1,4,1,2,7,5,12,5,14,7,7,10,2,7,11,5,5,14,4,8,8,7,7,14,14,9,13,9,9,8,8,13,14,10,8,2,20,13,12,9,9,5,9,9,6,9,9,20,11,11,11,10,2,17,1,AM C,1,1,1,20,1,1,1,1,1,1,10,1,1,1,1
19235130,Diego,1651,16/10/1991,24,0,0,0,0,174,65,1,1,3,1,3,3,1,3,3,3,2,7,4,8,10,11,4,5,7,4,6,10,6,8,13,9,9,8,10,6,11,13,9,12,2,12,8,8,13,14,14,6,6,9,11,14,20,12,9,9,9,5,9,9,13,9,11,11,9,9,6,5,AM C,1,1,1,20,1,1,1,1,1,1,10,1,1,1,1
19235306,Sidney,1651,04/06/1993,23,0,0,0,0,167,63,3,3,3,2,2,3,2,2,2,2,3,5,4,8,6,13,3,9,4,7,10,10,4,12,10,10,10,10,7,14,9,12,10,4,8,7,11,9,10,13,14,10,3,10,12,14,20,9,7,10,10,10,3,10,15,11,12,11,10,6,9,2,D/WB R,1,1,1,1,1,1,1,1,20,1,1,1,1,1,19
19235309,Max Oliveira,1651,15/12/1993,22,0,0,0,0,186,81,3,3,2,2,2,1,1,3,2,1,3,4,6,10,2,7,7,12,7,9,12,9,4,14,10,13,12,13,10,11,6,11,3,8,8,7,11,10,10,12,12,14,12,20,13,11,10,11,12,12,15,11,13,9,9,11,9,11,12,7,15,8,D C,1,1,1,1,1,1,20,1,1,1,1,1,1,1,1
19235310,Walfrido,1651,22/08/1994,21,0,0,0,0,187,77,3,1,2,3,2,3,1,1,1,2,1,3,8,5,9,14,8,8,14,1,8,14,6,14,14,10,7,9,5,9,13,14,10,5,9,9,7,9,12,14,10,6,14,11,14,12,20,7,9,10,10,10,10,10,7,13,10,9,11,7,17,8,DM/M C,1,1,1,1,1,1,1,1,1,20,18,1,1,1,1
19235325,Cloves,1651,15/06/1988,28,0,0,0,0,191,82,1,3,2,3,2,3,3,1,3,1,1,7,5,13,12,10,4,7,8,3,7,14,7,8,11,9,9,8,9,8,10,10,4,10,7,11,8,8,11,14,11,6,16,10,13,13,20,8,9,9,9,9,4,9,20,9,8,10,13,11,9,2,AM C,1,1,1,20,1,1,1,1,1,1,10,1,1,1,1
19235326,Gabriel,1651,14/03/1995,21,0,0,0,0,181,76,3,1,1,3,1,3,3,3,1,1,3,8,7,6,9,12,4,13,10,9,13,13,8,12,12,11,12,12,12,10,6,16,11,6,3,10,11,12,12,13,12,10,13,10,13,13,20,13,11,11,6,11,5,11,7,12,12,11,12,5,14,8,D C,1,1,1,1,1,1,20,1,9,1,1,1,1,1,1
19235330,Romarinho,1651,14/11/1989,26,0,0,0,0,177,75,3,2,3,1,1,2,2,3,2,1,3,6,10,13,12,15,9,11,11,8,8,12,9,9,15,9,11,6,15,10,10,9,10,13,8,13,9,10,11,13,14,12,8,20,10,13,4,13,8,10,9,10,5,10,13,12,14,12,12,2,3,4,AM L,1,1,14,11,20,1,1,1,1,1,8,1,1,1,1
19235398,Érik,1651,21/02/1994,22,0,0,0,0,182,77,1,1,1,3,4,3,2,1,1,2,3,8,6,14,9,10,8,13,8,1,8,8,7,6,11,10,11,7,11,8,6,13,10,12,4,13,8,7,9,13,12,8,11,10,9,12,20,14,5,10,9,9,9,10,19,11,9,12,11,9,12,1,S ,1,1,20,1,1,1,1,1,1,1,1,1,1,1,1
19235426,Andrew,1651,15/09/1996,19,0,0,0,0,172,65,1,3,1,1,1,3,3,1,2,2,1,6,9,14,14,14,8,13,9,8,8,9,8,6,9,9,10,4,11,8,6,9,10,9,3,14,9,7,9,14,13,15,6,10,15,13,20,7,6,10,10,10,10,10,10,12,9,12,9,4,13,1,S ,1,1,20,10,1,1,1,1,1,1,1,1,1,1,1
19235427,Caio Fontes,1651,01/01/1996,20,0,0,0,0,178,0,1,3,2,2,3,2,2,2,1,1,1,5,5,8,10,13,5,6,7,2,3,10,4,6,11,8,9,1,7,6,13,8,8,11,10,7,7,6,7,13,7,5,3,8,9,8,20,6,7,8,8,8,6,8,13,12,12,14,12,3,16,5,AM C,1,1,13,20,1,1,1,1,1,1,13,1,1,1,1
19235600,Yuri,1651,06/09/1995,20,0,0,0,0,183,71,1,2,4,1,2,3,2,3,2,3,3,5,7,10,11,10,6,11,10,3,5,9,11,5,10,10,11,6,11,6,10,11,8,10,6,11,6,10,11,13,12,9,12,9,7,13,20,13,9,10,10,10,8,6,8,9,12,11,12,2,12,6,S ,1,1,20,1,1,1,1,1,1,1,1,1,1,1,1
19235634,João Pedro,1651,28/03/1996,20,0,0,0,0,179,74,1,1,1,3,2,2,3,3,2,3,1,7,7,11,11,14,7,5,9,1,6,14,4,7,14,6,9,8,8,8,14,11,9,13,11,11,9,8,9,13,9,3,9,8,11,10,20,9,7,9,9,6,9,9,8,13,9,11,12,5,5,8,AM C,1,1,1,20,1,1,1,1,1,1,15,1,1,1,1
19235782,Valkennedy,1651,13/06/1993,23,0,0,0,0,180,76,2,1,1,2,2,1,2,1,2,3,3,7,6,8,9,13,3,7,7,1,8,9,2,13,13,10,10,9,9,9,12,13,4,13,8,8,13,8,11,13,12,8,7,10,16,12,20,7,8,10,10,10,8,10,7,13,10,12,10,12,8,5,DM C,1,1,1,15,1,1,1,1,1,20,15,1,1,1,1
19235794,Paulo Eduardo,1651,24/02/1994,22,0,0,0,0,183,0,12,9,8,1,12,9,9,12,4,9,11,6,3,2,2,1,9,1,1,2,1,1,2,3,4,3,6,10,6,10,5,12,5,1,4,1,11,6,5,10,11,3,9,16,11,11,20,1,5,9,9,2,6,9,7,10,12,11,10,9,11,4,GK ,20,1,1,1,1,1,1,1,1,1,1,1,1,1,1
19235795,Marquinhos,1651,07/05/1992,24,0,0,0,0,182,71,2,2,2,1,2,1,2,2,1,2,1,3,1,5,4,5,1,13,4,1,12,4,4,13,1,9,12,9,7,10,6,13,8,1,1,6,11,6,7,11,13,7,10,11,7,13,20,5,10,9,9,2,9,9,12,12,11,8,10,10,11,2,D C,1,1,1,1,1,1,20,1,1,1,1,1,1,1,1
19235796,Caio,1651,02/10/1996,19,0,0,0,0,175,67,2,2,2,2,3,3,4,3,3,2,3,6,7,8,4,11,3,8,6,8,10,10,4,10,9,9,9,9,8,12,10,15,5,7,6,5,10,9,10,15,15,5,9,20,10,11,1,6,7,9,9,1,9,9,11,11,10,13,12,8,8,3,D/WB L,1,1,1,1,1,1,1,20,1,1,1,1,1,19,1
19235798,Leandro Carvalho,1651,10/05/1995,21,0,0,0,0,172,65,3,1,1,4,1,3,1,2,2,3,4,6,7,13,13,13,5,12,6,3,3,7,9,1,11,9,11,8,9,7,6,10,7,11,5,9,7,6,7,10,13,7,6,9,7,13,20,12,8,9,9,9,7,9,7,13,11,11,11,1,18,3,S ,1,1,20,1,1,1,1,1,1,1,1,1,1,1,1
19235900,Bruno Pacheco,1651,08/12/1991,24,0,0,0,0,174,69,2,1,2,1,2,1,1,1,1,1,3,9,7,12,2,14,4,10,9,9,11,11,4,11,13,8,13,11,9,8,12,11,3,8,14,9,11,11,10,15,13,13,7,20,14,14,11,14,8,11,9,8,11,11,7,9,10,8,9,6,16,7,D/WB L,1,1,1,1,1,1,1,20,1,1,1,1,1,19,1
19235919,Henrique,1651,27/09/1993,22,0,0,0,0,167,59,1,1,3,3,2,1,3,1,3,2,2,9,13,11,13,11,7,12,9,6,7,8,5,5,11,5,6,9,9,6,6,13,5,10,11,10,7,8,9,13,13,6,4,20,5,13,10,11,5,10,7,10,5,10,14,11,12,10,10,5,11,7,AM/S R,1,1,19,1,1,20,1,1,1,1,1,1,1,1,1
19235922,Jadson,1651,20/11/1992,23,0,0,0,0,186,78,3,3,1,1,3,1,3,1,4,1,3,4,6,6,1,6,1,8,4,4,9,8,1,13,7,9,7,9,7,9,4,13,3,1,9,6,10,7,7,13,12,7,13,20,9,13,10,10,12,9,7,9,5,9,15,11,12,11,11,4,1,8,D/WB LC,1,1,1,1,1,1,20,19,1,1,1,1,1,18,1
19236273,Lyanco,1651,01/02/1997,19,0,0,0,0,188,83,3,3,2,1,3,3,3,2,2,1,4,5,7,8,5,8,6,13,10,4,13,10,11,12,8,14,13,14,14,11,9,15,15,8,8,6,14,14,13,12,13,11,15,10,16,12,20,15,14,13,11,9,2,6,17,14,10,12,12,10,12,16,D C,1,1,1,1,1,1,20,1,1,1,1,1,1,1,1
19236278,Orlan,1651,15/07/1995,20,0,0,0,0,185,0,2,2,2,1,2,3,2,3,1,3,2,7,5,6,3,11,14,7,5,6,8,8,6,11,8,5,8,9,8,7,3,13,1,8,4,5,8,8,8,9,10,8,11,9,12,13,20,12,6,9,9,9,6,9,17,10,9,10,13,6,17,1,D/WB R,1,1,1,1,1,1,1,1,20,1,1,1,1,1,19
19237293,Matheus Sávio,1651,15/04/1997,19,0,0,0,0,171,62,2,1,2,3,1,1,1,3,3,1,3,7,12,13,11,11,13,7,15,8,8,12,4,9,14,7,12,9,12,11,13,11,13,13,2,12,5,10,13,13,14,7,7,10,12,13,20,9,10,10,10,6,7,10,7,12,12,12,10,7,12,9,AM C,1,1,1,20,1,1,1,1,1,1,10,1,1,1,1
19237385,Reginaldo,1651,22/02/1993,23,0,0,0,0,174,69,2,2,3,2,3,3,2,2,1,1,3,9,10,10,10,14,7,9,7,10,10,11,6,10,12,12,12,11,11,8,11,13,3,11,3,12,14,12,13,14,14,14,7,9,14,13,20,14,5,12,10,6,10,10,7,9,10,9,13,7,7,7,D/WB R,1,1,1,1,1,1,1,1,20,1,1,1,1,1,19
19237855,Luan,1651,03/03/1998,18,0,0,0,0,170,0,1,2,1,1,3,1,1,3,2,1,2,7,7,14,9,14,7,7,14,1,5,8,6,8,14,9,5,8,9,8,11,14,6,13,8,8,8,8,13,14,14,7,2,8,12,14,20,9,5,9,9,9,7,9,18,8,6,11,10,2,1,7,AM C,1,1,1,20,1,1,1,1,1,1,10,1,1,1,1
19237947,Matheus Pereira,1651,25/02/1998,18,0,0,0,0,182,71,2,3,1,2,3,1,3,2,3,1,2,10,12,13,10,12,10,11,11,9,5,14,7,5,15,11,12,6,13,11,14,12,10,14,7,11,6,9,11,12,11,12,8,20,12,12,11,9,11,11,7,10,10,10,8,12,13,11,10,7,4,4,AM RLC,1,1,1,20,18,15,1,1,1,1,12,1,1,1,1
19239246,Bruno Ferreira,1651,14/09/1994,21,0,0,0,0,180,70,2,4,1,2,2,3,3,3,2,2,2,7,8,13,9,11,8,10,9,10,11,11,9,12,12,12,12,12,11,12,11,10,12,11,9,12,9,13,12,14,12,10,9,12,12,14,20,14,10,10,8,10,10,13,11,11,9,12,10,6,6,10,D/WB R,1,1,1,1,1,1,1,1,20,15,10,1,1,1,17
19239248,Farley,1651,21/07/1994,21,0,0,0,0,188,0,14,8,10,1,14,8,7,14,8,8,8,7,3,1,3,2,9,1,1,2,1,2,3,1,4,4,5,14,3,8,7,14,9,3,4,3,9,8,7,11,14,8,12,9,16,10,20,5,11,9,7,6,8,9,15,14,13,11,11,5,18,7,GK ,20,1,1,1,1,1,1,1,1,1,1,1,1,1,1
19239249,Gustavo Cascardo,1651,24/03/1997,19,0,0,0,0,184,0,3,1,3,1,1,3,3,3,3,2,2,4,8,8,4,14,2,8,9,8,8,13,3,12,10,6,9,9,7,7,12,14,10,10,2,7,8,9,10,14,14,6,10,9,16,13,20,9,7,10,5,5,8,10,7,11,10,10,10,1,11,5,D/WB R,1,1,1,13,1,10,1,1,20,1,13,1,10,1,17
19239250,Gustavo Tabalipa,1651,28/01/1993,23,0,0,0,0,185,71,3,1,3,2,2,1,2,3,3,2,2,6,3,6,7,9,4,14,5,7,14,7,5,11,6,10,10,10,9,12,6,10,1,1,9,6,14,8,9,14,12,9,9,9,12,12,20,11,7,10,3,4,7,10,18,10,11,11,9,4,1,5,D C,1,1,1,1,1,1,20,1,1,1,1,1,1,1,1
19239251,Junior Alves,1651,20/03/1994,22,0,0,0,0,176,0,4,2,2,3,3,2,3,3,3,2,1,7,3,9,9,10,7,6,13,2,8,12,7,8,12,7,5,4,11,9,14,5,4,9,13,9,9,9,12,14,11,13,7,20,10,13,10,10,8,8,9,9,9,9,12,10,12,11,13,8,8,8,M/AM C,1,1,1,20,1,1,1,1,1,1,17,1,1,1,1
19239253,Leonardo Wellington,1651,08/01/1997,19,0,0,0,0,175,0,3,2,2,1,3,1,1,1,1,1,1,5,3,5,7,13,5,5,9,1,4,13,2,7,11,8,5,5,4,7,12,13,2,11,11,11,7,7,6,13,9,7,4,10,10,11,20,10,4,8,8,4,8,8,10,12,10,10,10,1,2,7,M/AM C,1,1,1,17,1,1,1,1,1,1,20,1,1,1,1
19239255,Michel,1651,17/04/1995,21,0,0,0,0,197,0,6,7,10,4,13,13,8,13,8,8,8,4,2,3,1,3,7,1,1,3,1,1,2,3,1,4,8,8,6,9,5,12,8,3,8,1,11,6,5,11,16,6,13,2,8,11,20,2,11,8,8,5,8,8,12,10,12,13,11,3,9,6,GK ,20,1,1,1,1,1,1,1,1,1,1,1,1,1,1
19239256,Ricardo Caliman,1651,22/09/1994,21,0,0,0,0,188,0,3,2,3,1,4,3,1,2,2,3,3,5,4,1,6,7,3,11,4,3,8,5,4,13,5,9,10,5,7,10,6,13,9,1,8,4,12,6,7,12,10,7,10,12,16,11,20,10,9,9,9,9,9,9,19,11,12,12,13,5,14,8,D C,1,1,1,1,1,1,20,1,1,1,1,1,1,1,1
19239257,Roberto,1651,21/03/1995,21,0,0,0,0,172,65,2,2,1,1,1,2,4,1,2,1,3,7,7,13,13,14,7,10,9,5,7,8,9,4,14,9,8,8,9,7,9,14,7,13,5,11,8,8,9,13,10,9,2,20,14,13,6,9,6,9,9,3,9,9,9,9,12,10,12,7,8,2,AM/S C,1,1,17,20,1,1,1,1,1,1,1,1,1,1,1
19239258,Ronaldo,1651,27/01/1995,21,0,0,0,0,175,70,3,3,3,4,3,2,3,1,1,2,3,9,9,6,10,13,9,9,9,7,8,15,6,14,10,10,8,9,6,11,8,15,4,4,14,10,13,11,13,11,10,11,8,9,15,11,20,8,8,7,5,5,8,10,8,12,9,15,8,5,9,3,DM/M C,1,1,1,1,1,1,1,1,1,20,17,1,1,1,1
19239259,Walter,1651,01/01/1994,22,0,0,0,0,185,80,1,3,2,3,1,3,2,2,2,3,3,3,4,1,1,7,1,10,1,1,13,7,1,13,5,9,10,9,7,7,5,13,3,9,11,5,12,6,7,13,10,7,9,8,9,9,20,8,9,9,9,8,7,9,14,10,12,12,11,8,3,6,D C,1,1,1,1,1,1,20,1,1,1,1,1,1,1,1
19239319,Erik Mamadeira,1651,20/04/1991,25,0,0,0,0,183,60,1,2,1,3,2,1,3,2,1,3,2,10,11,13,8,8,11,9,9,10,7,11,8,4,13,8,10,9,10,11,13,11,11,14,10,12,7,11,7,14,14,3,10,20,12,13,10,11,4,10,4,10,10,12,12,11,12,12,11,12,2,4,AM/S RLC,1,1,17,17,20,17,1,10,1,1,1,10,1,10,1
19239320,Felipe Rodrigues,1651,31/10/1995,20,0,0,0,0,183,82,3,2,2,3,4,3,3,1,1,1,2,7,8,9,8,9,10,12,9,11,13,10,5,12,10,12,11,12,12,11,8,11,4,8,4,10,12,11,13,12,12,12,11,7,15,12,20,14,15,12,10,10,8,13,18,13,13,10,9,11,2,6,D/WB/DM R,1,1,1,1,1,1,13,1,20,17,13,1,13,1,17
19239321,Pará,1651,03/05/1996,20,0,0,0,0,158,0,3,4,1,2,3,1,2,2,4,3,1,3,9,12,8,11,1,7,3,3,6,7,4,6,10,6,9,15,12,11,6,10,15,12,12,14,4,8,16,14,14,4,3,20,7,14,7,14,4,9,8,9,7,14,13,14,15,13,14,11,18,13,D/WB L,1,1,1,1,13,1,1,20,1,1,1,13,1,17,1
19239324,Felipe Santos,1651,03/01/1997,19,0,0,0,0,183,0,3,2,2,3,1,3,3,2,3,3,3,4,6,11,13,13,6,13,5,3,2,6,8,1,11,9,12,8,13,7,7,11,9,12,12,13,5,6,4,13,13,2,8,2,8,11,20,8,8,3,9,9,9,8,19,11,13,12,12,1,1,2,S ,1,1,20,10,10,10,1,1,1,1,1,1,1,1,1
19239524,Dudu,1651,20/02/1994,22,0,0,0,0,176,0,2,1,3,3,3,1,1,1,1,2,2,8,8,9,10,9,9,9,13,6,13,9,4,13,9,7,14,14,7,10,11,11,10,10,5,5,15,13,13,12,10,10,5,11,11,11,20,9,11,10,10,9,10,10,20,11,12,12,11,1,6,3,DM C,1,1,1,1,1,1,1,1,1,20,15,1,1,1,1
19239526,Ericson Henrique,1651,09/04/1996,20,0,0,0,0,173,0,3,3,3,1,1,2,2,2,2,3,3,6,10,10,3,15,2,8,6,8,9,10,3,12,12,9,6,9,7,9,5,10,5,8,2,8,9,9,10,15,11,9,6,20,12,13,8,11,6,9,9,9,6,9,17,12,9,12,11,13,6,8,D/WB L,1,1,1,1,12,1,10,16,1,1,1,14,1,20,1
19239527,Paulo,1651,03/01/1995,21,0,0,0,0,178,71,3,1,3,2,3,2,2,3,3,2,2,2,6,6,5,11,1,9,3,7,7,6,2,13,8,8,11,10,9,7,8,13,10,10,1,6,10,9,9,14,14,9,7,20,9,14,8,14,7,10,10,10,8,10,15,13,9,10,13,5,12,4,D L,1,1,1,1,1,1,1,20,1,1,1,1,1,15,1
19239528,Gustavo,1651,02/08/1995,20,0,0,0,0,193,92,3,2,3,2,2,2,3,1,2,3,3,8,5,12,14,14,8,14,8,4,7,10,8,4,13,5,13,5,9,6,9,12,7,12,7,10,9,8,10,13,10,4,13,8,9,8,20,8,10,10,5,10,9,10,13,11,13,8,11,3,11,8,S ,1,1,20,12,1,1,1,1,1,1,1,1,1,1,1
19239529,João Pedro,1651,20/02/1995,21,0,0,0,0,185,80,1,2,3,3,4,2,1,2,3,2,2,4,2,4,6,8,1,14,7,2,14,8,3,14,3,9,14,9,8,8,7,14,6,2,1,5,13,7,8,14,8,7,8,9,13,11,20,6,9,9,9,9,3,9,8,10,15,9,10,5,1,4,D C,1,1,1,1,1,1,20,1,1,1,1,1,1,1,1
19239531,Henrique,1651,04/05/1995,21,0,0,0,0,184,81,7,13,11,9,13,11,9,13,4,9,8,6,2,1,1,6,9,1,2,1,3,1,15,3,4,7,9,12,7,7,6,13,9,3,9,3,11,7,6,9,16,7,8,9,10,10,20,3,9,9,9,9,6,9,10,11,12,12,11,11,11,1,GK ,20,1,1,1,1,1,1,1,1,1,1,1,1,1,1
19239534,Ramon,1651,02/11/1995,20,0,0,0,0,175,69,1,2,1,3,2,1,3,2,3,1,1,5,8,4,6,13,5,8,12,6,8,13,3,13,14,10,6,9,9,7,8,14,6,10,8,8,11,9,12,12,14,8,8,17,8,14,20,7,7,10,3,6,10,10,11,8,12,12,12,6,12,3,DM C,1,1,1,1,1,1,1,1,1,20,15,1,1,1,1
19239535,Lucas Albino,1651,25/09/1995,20,0,0,0,0,182,64,2,3,3,2,3,4,2,1,3,1,1,8,10,15,10,15,8,6,8,1,6,15,4,10,13,9,8,6,7,8,12,13,9,11,12,10,6,9,10,15,13,9,7,20,10,14,1,8,7,9,7,3,7,9,15,13,11,12,8,3,12,1,AM LC,1,1,1,20,17,1,1,10,1,1,15,15,1,12,1
19239537,Douglas Bonfim,1651,17/01/1996,20,0,0,0,0,180,60,1,3,1,3,4,2,3,1,3,3,1,5,8,5,7,14,8,8,10,5,10,14,1,12,12,9,8,9,10,4,6,13,6,10,9,9,9,9,13,14,14,9,10,9,11,14,20,9,7,10,9,8,10,10,9,8,14,12,11,2,10,8,WB/DM/M RC,1,1,1,1,1,1,1,1,14,20,16,1,1,1,16
19239538,Carlos Vinícius,1651,06/07/1994,21,0,0,0,0,185,77,3,1,2,3,1,4,2,1,1,2,1,9,7,15,15,15,9,15,10,7,7,8,8,8,15,8,15,8,10,9,10,7,6,13,6,15,9,9,10,8,9,10,14,9,10,8,20,9,10,10,10,8,8,10,7,9,13,10,11,9,8,5,S ,1,1,20,1,1,1,1,1,1,1,1,1,1,1,1
19239539,Lucas Gomes,1651,21/05/1994,22,0,0,0,0,172,62,1,1,3,1,1,2,3,3,1,3,2,8,8,10,10,15,8,8,9,6,7,12,5,10,10,8,6,6,7,9,15,11,9,9,10,10,8,9,12,15,12,9,6,7,7,14,20,8,6,9,7,7,5,9,14,11,12,12,11,2,11,1,AM C,1,1,1,20,1,1,1,1,1,1,15,1,1,1,1
19239540,Pedro Júnior,1651,09/05/1994,22,0,0,0,0,172,64,1,1,2,3,1,4,2,2,2,1,3,6,4,13,11,12,6,12,7,1,6,8,4,5,9,8,9,8,6,3,7,11,9,9,13,5,8,7,8,13,13,7,1,16,5,13,20,6,6,9,9,9,9,9,11,11,8,15,10,4,8,1,S R,1,1,20,1,1,15,1,1,12,1,1,1,12,1,14
19239541,Lucas Pires,1651,09/02/1995,21,0,0,0,0,179,75,2,3,1,4,3,1,3,1,2,1,3,7,5,9,9,14,5,7,9,6,8,9,6,7,9,9,8,7,8,8,9,13,3,8,14,11,9,8,11,14,12,8,5,10,9,11,20,9,5,9,8,9,8,9,10,12,12,9,10,4,13,5,AM C,1,1,1,20,1,1,1,1,1,1,15,1,1,1,1
19239542,Wellington,1651,27/07/1995,20,0,0,0,0,172,70,3,1,1,2,3,2,3,2,1,3,1,7,7,6,9,9,7,1,10,4,5,9,4,8,13,9,8,8,8,6,14,9,9,12,9,11,9,8,13,14,14,5,3,3,15,14,20,8,5,9,9,5,5,9,14,11,10,10,11,7,16,6,AM C,1,1,1,20,1,1,1,1,1,1,15,1,1,1,1
19239544,Richard,1651,04/02/1994,22,0,0,0,0,176,71,3,1,3,2,3,1,1,2,1,1,3,6,5,14,14,14,8,14,7,7,6,9,5,6,14,5,14,8,12,7,6,12,7,13,7,7,9,8,9,14,11,9,7,9,11,14,20,9,6,10,7,3,10,10,8,12,13,12,15,1,13,1,S ,1,1,20,1,1,1,1,1,1,1,1,1,1,1,1
19239545,Lucas Cavalcanti,1651,23/07/1994,21,0,0,0,0,178,68,3,1,1,3,1,1,3,1,3,1,1,7,8,12,14,9,7,13,9,2,4,9,6,1,13,7,9,7,11,6,8,12,3,12,3,12,8,5,9,14,14,8,6,6,13,14,20,7,8,9,1,2,7,9,15,9,11,11,11,7,9,6,S C,1,1,20,15,1,1,1,1,1,1,1,1,1,1,1
19239546,Rafael Guedes,1651,25/04/1995,21,0,0,0,0,180,77,1,4,3,3,3,1,2,2,2,2,3,6,4,13,13,13,4,13,7,6,4,8,9,5,13,4,9,6,13,7,8,12,1,13,4,13,8,7,8,13,13,8,5,8,14,13,20,6,9,10,7,10,4,10,11,11,12,10,12,9,7,3,S ,1,1,20,1,1,1,1,1,1,1,1,1,1,1,1
19239595,Zé Alberto,1651,14/01/1995,21,0,0,0,0,187,0,2,2,1,2,2,3,1,2,3,3,1,8,7,10,10,14,4,14,9,2,8,10,3,10,11,6,8,3,9,10,11,14,9,10,1,12,10,8,10,14,12,10,14,10,6,14,20,9,9,10,3,10,10,12,13,8,13,11,12,1,13,6,AM/S C,1,1,20,17,1,1,1,1,1,1,1,1,1,1,1
19239596,Cleiton,1651,19/08/1997,18,0,0,0,0,190,80,15,10,11,1,11,13,10,10,10,4,13,3,2,2,1,6,8,2,2,3,1,1,2,3,12,7,11,12,10,9,12,14,15,3,6,2,12,10,8,12,9,10,15,10,15,14,20,7,10,10,10,10,10,10,14,14,11,14,14,6,13,3,GK ,20,1,1,1,1,1,1,1,1,1,1,1,1,1,1
19239598,Jordan,1651,17/01/1997,19,0,0,0,0,186,79,2,1,2,1,3,3,3,3,1,1,3,4,3,5,6,9,4,15,11,3,11,10,3,10,8,13,10,12,6,11,1,15,15,1,3,8,11,8,9,10,10,9,9,10,9,10,20,6,12,9,5,9,6,9,7,11,9,9,12,1,9,1,D C,1,1,1,1,1,1,20,1,1,1,1,1,1,1,1
19239599,César,1651,06/05/1997,19,0,0,0,0,178,60,3,3,2,3,2,2,1,3,1,2,2,11,8,11,5,13,8,10,8,7,11,11,13,11,11,7,11,10,12,12,8,11,10,4,8,7,11,11,11,13,13,11,6,20,13,14,10,10,7,10,10,10,8,11,16,7,8,10,10,10,13,3,D/WB L,1,1,1,1,1,1,1,20,1,1,1,1,1,17,1
19239600,Adson,1651,31/07/1997,18,0,0,0,0,171,66,3,3,2,1,2,1,1,1,1,2,3,12,11,11,8,10,7,10,7,5,10,11,5,10,11,10,8,11,8,9,9,16,16,8,2,6,8,8,7,15,13,6,8,12,13,14,20,11,8,4,10,2,12,12,9,13,11,10,11,5,16,6,D/WB R,1,1,1,1,1,1,1,13,20,1,1,1,1,13,16
19239601,Bruno Tabata,1651,30/03/1997,19,0,0,0,0,175,72,3,3,4,2,2,1,4,3,3,2,3,14,10,15,10,13,12,5,11,7,10,14,13,9,14,6,9,7,10,10,13,8,17,12,4,9,10,7,10,10,10,8,8,20,13,12,12,10,9,7,10,9,10,9,11,16,13,11,18,14,15,1,AM RLC,1,1,1,20,18,18,1,1,1,1,13,1,1,1,1
19239602,Cleitinho,1651,12/04/1998,18,0,0,0,0,164,0,3,2,3,2,3,2,4,1,2,2,2,6,9,11,10,11,7,7,10,1,4,11,5,8,11,11,12,8,8,8,10,13,9,12,8,9,6,8,11,12,13,8,4,20,8,14,13,7,5,9,9,9,7,9,8,10,10,10,10,5,8,5,M/AM LC,1,1,1,20,15,1,1,1,1,1,16,15,1,1,1
19239603,Capixaba,1651,09/01/1997,19,0,0,0,0,170,64,2,2,1,3,3,3,1,1,1,3,3,11,12,12,10,11,8,9,9,8,8,12,4,6,13,6,7,7,11,10,11,10,14,13,3,12,10,9,10,14,14,12,2,20,12,13,10,12,9,11,10,3,8,10,8,9,11,13,10,3,4,6,AM RL,1,1,13,1,17,20,1,1,1,1,1,1,1,1,1
19239604,Flávio,1651,20/02/1997,19,0,0,0,0,183,0,2,3,2,1,2,1,1,2,3,2,2,9,5,10,12,11,8,12,9,5,8,8,13,4,12,8,12,10,12,5,8,12,8,12,4,12,8,9,10,12,11,14,11,10,14,11,20,11,12,10,7,10,8,10,8,12,11,12,11,11,3,2,S ,1,1,20,1,1,1,1,1,1,1,1,1,1,1,1
19239893,Jarles,1651,16/06/1996,20,0,0,0,0,180,0,4,1,2,1,1,1,3,3,2,3,2,5,7,7,9,13,6,13,7,2,5,7,4,3,13,6,11,8,11,6,7,11,9,13,11,13,5,6,7,13,11,7,9,10,15,12,20,6,9,9,4,9,4,9,13,12,10,9,11,9,16,3,S ,1,1,20,1,1,1,1,1,1,1,1,1,1,1,1
19240975,Jacó,1651,28/02/1996,20,0,0,0,0,182,77,1,2,2,2,2,2,2,1,2,1,4,5,7,10,12,11,6,12,10,5,5,11,12,5,12,12,11,13,9,8,9,10,15,14,4,11,7,13,12,13,12,11,11,10,7,13,20,13,13,12,7,6,4,10,13,10,12,12,13,12,7,6,S ,1,1,20,1,12,7,1,1,1,1,1,1,1,1,1
19241129,Leandro,1651,13/01/1995,21,0,0,0,0,178,65,3,4,3,1,3,3,2,2,2,2,1,10,12,13,10,12,8,13,10,5,5,10,6,5,12,6,6,10,12,10,10,10,12,14,12,12,4,11,12,15,13,7,4,11,8,14,20,11,7,11,9,11,6,11,11,13,10,12,10,5,5,6,AM/S R,1,1,20,1,1,17,1,1,1,1,1,1,1,1,1
19241666,Andrei Alba,1651,14/01/1995,21,0,0,0,0,186,74,3,3,2,1,3,2,2,3,1,2,2,6,6,2,7,13,10,6,8,2,7,6,5,12,12,6,7,8,8,8,13,13,9,6,9,7,10,7,11,13,13,7,12,10,11,13,20,6,9,9,6,3,9,9,19,9,13,9,11,9,19,4,DM C,1,1,1,1,1,1,1,1,1,20,15,1,1,1,1
19241669,Igor Brondani,1651,21/03/1995,21,0,0,0,0,191,85,3,1,1,1,2,1,1,3,2,3,4,4,3,3,1,7,1,13,6,1,13,7,3,13,6,9,9,9,7,9,1,13,6,1,9,3,13,6,7,12,10,7,14,10,13,12,20,5,12,9,6,4,8,9,8,9,8,12,10,9,13,6,D C,1,1,1,1,1,1,20,1,1,1,1,1,1,1,1
19241670,Lucas Fávero,1651,18/07/1994,21,0,0,0,0,198,0,1,2,2,3,3,2,3,4,4,3,4,2,4,3,6,12,4,3,11,1,3,12,1,6,9,8,4,4,5,5,7,12,8,10,1,6,6,6,10,12,8,5,14,8,10,11,20,8,10,8,7,8,8,8,14,11,9,11,10,7,12,1,AM C,1,1,1,20,1,1,1,1,1,1,15,1,1,1,1
19241671,Lucas Machado,1651,22/02/1994,22,0,0,0,0,176,68,1,2,1,1,3,2,3,2,1,1,2,6,5,6,6,12,6,6,6,5,8,13,1,13,12,9,6,8,8,6,6,13,9,1,6,8,4,7,12,13,11,7,6,8,15,12,20,8,5,9,1,9,9,9,7,10,11,8,11,12,16,5,M C,1,1,11,9,1,1,1,1,1,15,20,1,1,1,1
19241733,Kássio,1651,01/06/1989,27,0,0,0,0,182,0,3,3,1,2,2,2,3,4,2,1,2,3,3,4,7,11,6,6,9,2,10,10,5,13,6,9,9,8,7,8,8,13,7,5,4,6,10,7,9,11,13,7,10,8,14,13,20,13,6,9,9,9,8,9,15,13,10,8,14,2,8,5,DM ,1,1,1,1,1,1,1,1,1,20,10,1,1,1,1
19241794,Arthur,1651,22/01/1996,20,0,0,0,0,173,0,3,3,1,3,4,2,3,2,2,2,2,3,1,5,5,8,3,3,5,1,4,11,1,2,12,7,6,5,3,4,12,12,6,13,11,9,3,5,10,12,12,2,3,10,10,11,20,7,3,7,7,7,7,7,19,10,10,9,11,5,8,1,AM C,1,1,1,20,1,1,1,1,1,1,15,1,1,1,1
19241795,Bruno Renan,1651,26/06/1996,20,0,0,0,0,183,0,3,2,3,3,2,2,3,1,1,1,1,5,6,13,13,9,4,13,7,1,5,7,4,3,13,4,4,7,5,5,6,6,4,13,10,9,4,5,7,13,11,6,9,6,13,12,20,6,7,8,6,8,8,8,16,13,13,12,13,1,11,3,S C,1,1,20,15,1,1,1,1,1,1,10,1,1,1,1
19241850,Ianson,1651,15/07/1995,20,0,0,0,0,187,80,2,3,1,1,1,2,3,3,3,3,4,2,1,6,6,8,1,10,5,6,11,8,2,14,9,9,12,9,8,11,7,14,3,3,6,4,9,7,8,10,11,8,14,7,9,11,20,6,9,9,8,7,9,9,11,12,8,13,13,7,10,5,D C,1,1,1,1,1,1,20,1,1,1,1,1,1,1,1
19241851,Vinicius,1651,24/05/1995,21,0,0,0,0,182,73,1,1,4,3,3,2,1,3,1,2,1,3,5,9,5,12,1,1,5,1,3,9,1,5,7,6,3,1,2,3,8,11,7,8,11,5,4,5,9,12,12,4,9,20,11,12,7,4,4,7,7,4,7,7,8,9,11,12,11,1,3,1,AM LC,1,1,1,20,15,1,1,1,1,1,12,13,1,1,1
19241853,Ronaldo,1651,26/01/1996,20,0,0,0,0,190,78,7,13,9,1,14,9,7,14,9,8,14,1,1,1,3,2,5,1,1,2,1,1,2,2,5,8,8,15,6,14,7,9,9,1,3,2,6,8,4,9,9,6,15,15,15,9,20,5,12,8,9,9,9,9,11,11,10,10,13,8,17,2,GK ,20,1,1,1,1,1,1,1,1,1,1,1,1,1,1
19242045,Luidy,1651,21/07/1996,19,0,0,0,0,167,65,2,1,4,2,2,1,3,3,3,2,1,2,12,14,11,11,5,3,8,4,7,11,4,7,13,10,11,11,10,10,11,11,14,12,10,13,11,12,12,13,14,12,7,10,13,13,20,14,8,11,7,11,8,13,11,13,11,9,13,12,10,9,AM RL,1,1,14,1,20,18,1,1,1,1,1,12,12,1,1
19242090,Rômulo,1651,28/04/1995,21,0,0,0,0,175,75,2,3,2,2,2,3,3,2,1,3,2,8,9,11,13,12,10,10,11,6,7,10,11,9,11,13,12,11,12,11,11,11,11,13,8,12,7,10,13,13,13,13,7,12,12,13,20,12,11,11,12,13,9,9,17,11,11,13,12,10,3,1,S ,1,1,20,10,1,1,1,1,1,1,1,1,1,1,1
19242091,Baiano,1651,16/10/1997,18,0,0,0,0,184,0,1,4,2,2,1,1,1,3,3,4,1,2,3,13,13,13,5,13,6,4,2,6,8,1,8,8,6,5,10,5,2,7,2,8,9,12,5,5,5,13,12,6,9,3,7,12,20,5,8,8,8,5,8,6,7,12,12,10,10,2,1,5,S ,1,1,20,1,1,1,1,1,1,1,1,1,1,1,1
19242092,Thiago,1651,28/03/1995,21,0,0,0,0,181,0,1,1,1,4,3,3,3,1,2,1,2,5,5,7,7,13,5,5,7,2,5,9,4,4,10,8,8,5,5,4,12,9,7,10,11,3,3,7,11,13,13,6,7,7,10,13,20,7,8,8,8,6,8,8,16,13,13,12,11,5,9,7,AM C,1,1,1,20,1,1,1,1,1,1,15,1,1,1,1
19242093,Jean Silva,1651,07/03/1989,27,0,0,0,0,173,63,2,2,2,3,1,2,1,2,1,2,3,7,5,14,14,14,8,13,8,7,7,6,4,1,14,6,14,6,10,9,6,11,5,13,14,14,9,8,9,14,14,9,6,1,5,14,20,7,11,10,10,8,9,10,12,11,12,11,12,4,1,8,S ,1,1,20,1,1,1,1,1,1,1,1,1,1,1,1
19242094,Gabriel,1651,19/12/1997,18,0,0,0,0,190,78,1,2,2,3,1,2,1,3,3,3,1,5,5,8,6,9,5,11,6,7,12,9,7,11,9,14,10,12,9,11,9,10,14,4,8,9,11,13,12,13,11,8,15,20,13,12,10,14,13,13,14,10,10,7,15,13,11,11,14,1,9,1,D C,1,1,1,1,1,1,20,1,1,1,1,1,1,1,1
19242095,Lucas Lovat,1651,15/01/1997,19,0,0,0,0,193,86,2,1,2,1,3,4,3,3,3,3,1,7,9,10,9,14,2,11,7,10,10,12,6,15,12,11,11,12,10,13,7,11,16,11,9,8,8,8,11,15,12,11,12,20,11,14,11,11,11,11,6,8,11,11,20,13,11,12,11,9,8,7,D L,1,1,1,1,1,1,1,20,1,1,1,1,1,15,1
19242096,Renanzinho,1651,19/09/1997,18,0,0,0,0,173,69,1,3,1,1,1,2,3,2,4,1,1,6,9,11,10,12,9,11,9,6,13,12,9,12,13,13,11,12,11,11,11,12,13,11,9,11,13,11,11,14,13,12,7,11,11,14,20,13,12,12,11,12,10,10,19,12,5,9,7,8,12,14,DM ,1,1,1,1,1,1,1,1,1,20,10,1,1,1,1
19242097,Athyla,1651,02/05/1997,19,0,0,0,0,182,0,3,2,3,2,2,1,3,3,2,3,2,4,2,1,1,5,1,12,3,1,11,5,1,13,1,5,10,7,5,9,1,11,4,1,11,2,9,4,5,11,7,5,5,7,10,11,20,6,8,7,7,7,7,7,15,10,8,12,8,1,1,8,D C,1,1,1,1,1,1,20,1,1,1,1,1,1,1,1
19242099,Juninho,1651,30/05/1997,19,0,0,0,0,170,0,1,2,4,2,1,1,1,2,1,3,1,5,3,5,5,13,4,5,7,1,4,10,1,7,11,8,3,5,12,6,7,6,3,11,12,6,5,6,5,13,13,6,5,16,14,13,20,8,4,8,8,8,6,8,11,13,11,9,13,2,7,7,AM C,1,1,1,20,1,1,1,1,1,1,15,1,1,1,1
19242102,Foguinho,1651,12/07/1997,18,0,0,0,0,175,70,4,4,1,2,1,2,2,2,3,1,2,6,4,2,2,12,3,7,3,5,8,8,4,11,8,5,8,8,7,4,7,14,5,8,9,2,5,7,7,14,9,5,7,8,10,13,20,8,7,8,8,2,8,8,15,12,11,13,13,6,13,4,D R,1,1,1,1,1,1,1,11,20,1,1,1,1,9,15
19242103,Leonardo,1651,13/01/1998,18,0,0,0,0,195,0,12,8,6,1,13,13,10,13,8,8,8,2,2,1,1,1,4,1,3,2,2,2,3,1,4,5,7,10,6,8,3,12,8,1,1,2,5,6,4,12,8,6,15,3,8,11,20,1,10,8,6,8,7,6,17,12,10,10,11,3,9,7,GK ,20,1,1,1,1,1,1,1,1,1,1,1,1,1,1
19242277,Raphinha,1651,14/12/1996,19,0,0,0,0,176,69,1,1,3,2,3,4,3,3,2,1,2,12,13,16,9,14,11,8,9,4,3,12,9,5,15,8,12,9,12,10,12,11,11,17,6,13,7,11,19,15,14,8,7,20,11,14,11,10,7,9,6,12,3,4,13,12,12,14,13,10,12,8,S RL,1,1,20,1,15,15,1,1,1,1,1,10,7,1,1
19242474,Manu,1651,25/11/1997,18,0,0,0,0,170,0,2,1,2,3,2,3,3,2,3,1,4,6,6,6,7,12,3,8,4,7,9,9,4,11,9,6,9,9,5,10,8,10,8,8,11,6,7,9,9,14,11,9,8,8,14,14,20,6,7,8,8,6,3,8,14,9,10,12,13,1,16,4,D/WB R,1,1,1,1,1,1,1,1,20,1,1,1,1,1,17
19242475,Marcos Coelho,1651,18/09/1997,18,0,0,0,0,181,0,1,2,3,2,1,3,1,2,2,1,1,6,6,4,7,11,6,3,6,1,7,12,3,12,11,6,7,4,5,7,8,10,4,8,2,4,6,8,11,14,10,7,10,7,10,12,20,7,6,8,7,8,8,8,19,9,14,11,10,5,8,1,DM ,1,1,1,1,1,1,1,1,1,20,5,1,1,1,1
19242476,Maranhão,1651,25/03/1995,21,0,0,0,0,192,86,3,1,1,1,2,2,3,3,2,1,1,6,3,13,13,12,6,13,5,2,6,7,4,1,8,9,7,7,10,5,2,7,9,8,9,11,5,6,7,10,10,7,15,6,16,13,20,8,12,9,8,9,6,9,8,10,9,12,10,7,5,5,S ,1,1,20,1,1,1,1,1,1,1,1,1,1,1,1
19242477,Brendon,1651,20/05/1995,21,0,0,0,0,186,88,2,4,2,3,3,3,3,2,3,2,2,4,2,1,5,7,5,13,4,1,13,7,6,13,6,9,8,9,7,8,3,13,6,6,4,6,9,6,7,10,10,7,12,10,15,10,20,9,13,9,4,9,9,9,17,13,11,12,10,2,4,1,D C,1,1,1,1,1,1,20,1,1,1,1,1,1,1,1
19242478,Guilherme,1651,04/12/1995,20,0,0,0,0,169,0,3,3,1,1,1,1,2,2,3,3,3,9,13,11,1,14,12,8,7,7,8,7,6,12,11,9,9,9,7,9,8,14,9,7,1,6,8,8,8,13,12,8,4,20,14,14,9,9,6,9,9,9,9,9,12,10,9,10,12,5,4,6,D/WB L,1,1,1,1,1,1,1,20,1,1,1,1,1,16,1
19242555,Gabriel,1651,15/07/1996,19,0,0,0,0,185,0,1,2,3,2,2,1,1,1,2,3,3,6,5,6,3,5,2,8,3,6,7,4,5,13,7,8,7,5,5,6,5,12,8,1,5,3,10,7,8,10,12,7,14,20,10,13,1,12,9,8,8,1,3,8,14,12,12,12,10,8,15,8,D LC,1,1,1,1,1,1,17,20,1,1,1,1,1,15,1
19242556,Dudu,1651,15/07/1996,19,0,0,0,0,172,65,1,2,1,1,3,3,3,2,3,2,3,9,14,9,6,9,7,7,8,7,8,8,3,9,13,7,6,8,9,4,4,11,9,9,10,5,7,9,9,14,13,14,6,11,14,13,20,13,6,9,5,5,5,15,15,8,9,11,12,11,12,5,WB/M R,1,1,1,11,1,13,1,10,15,1,6,1,20,12,17
19242560,Matheus Oliveira,1651,08/01/1997,19,0,0,0,0,173,60,1,3,2,3,2,3,2,1,2,1,2,4,2,7,7,13,5,4,11,3,6,7,3,6,11,8,7,6,3,5,8,10,8,11,11,7,3,7,10,11,13,6,5,8,9,12,20,6,4,8,7,6,8,8,7,11,11,11,13,2,9,3,AM C,1,1,1,20,1,1,1,1,1,1,15,1,1,1,1
19242562,Rocha,1651,06/05/1996,20,0,0,0,0,166,65,2,2,3,2,3,2,1,3,3,1,2,5,4,7,11,11,5,6,7,1,5,9,1,7,12,8,3,7,6,7,10,11,1,12,6,8,7,6,7,13,10,2,2,10,9,13,20,3,3,8,8,8,8,8,9,8,10,10,10,6,10,1,AM C,1,1,12,20,1,1,1,1,1,1,15,1,1,1,1
19242650,Zé Arthur,1651,02/01/1997,19,0,0,0,0,170,64,2,3,3,1,3,3,3,1,2,2,2,5,1,12,12,10,5,13,6,2,5,4,9,4,8,7,7,1,11,1,2,8,6,8,9,12,4,5,6,13,9,14,4,8,8,10,20,7,4,8,8,8,4,8,16,11,9,9,9,1,7,6,S ,1,1,20,1,10,10,1,1,1,1,1,1,1,1,1
19244393,Luís Felippe,1651,19/09/1996,19,0,0,0,0,192,0,3,1,2,2,1,3,3,1,2,2,1,8,8,14,11,14,7,12,6,1,5,9,8,8,12,8,10,9,13,4,9,9,5,11,12,14,4,8,7,10,10,14,16,10,11,11,20,12,14,10,3,7,10,9,17,12,10,12,5,11,9,7,S ,1,1,20,1,1,1,1,1,1,1,1,1,1,1,1
19244752,João Carlos,1651,12/02/1987,29,0,0,0,0,182,85,4,3,2,3,1,1,3,2,2,2,2,6,5,11,16,11,6,15,7,2,4,11,12,6,11,10,11,5,10,6,9,12,10,10,13,12,8,8,11,12,12,7,9,11,8,12,20,4,9,11,4,5,10,10,9,12,9,11,10,7,20,6,S ,1,1,20,1,1,1,1,1,1,1,1,1,1,1,1
19244756,Marquinho,1651,25/09/1989,26,0,0,0,0,184,75,2,3,1,1,3,2,2,2,2,2,3,15,14,14,12,14,13,6,15,5,8,14,5,4,14,10,10,9,11,9,11,10,10,11,7,11,9,9,11,14,13,8,9,11,14,13,20,10,7,10,7,12,10,12,7,11,9,10,8,9,10,7,AM C,1,1,1,20,1,1,1,1,1,1,10,1,1,1,1
19244758,Daniel Bacan,1651,14/08/1993,22,0,0,0,0,179,73,1,3,3,1,2,3,1,2,3,2,2,5,4,7,7,13,5,5,13,5,6,9,5,7,11,6,8,7,6,2,12,7,8,11,9,6,7,7,5,13,10,7,8,20,15,10,9,8,4,8,8,7,7,8,16,9,11,14,14,9,14,1,M/AM C,1,1,1,20,1,1,1,1,1,1,17,1,1,1,1
19244759,Weverton Gomes,1651,08/03/1993,23,0,0,0,0,178,75,2,3,1,1,3,1,1,2,1,1,3,10,14,14,13,14,6,11,9,1,8,9,8,7,11,6,10,3,12,8,8,11,3,10,2,9,7,9,10,14,14,11,9,11,15,14,20,10,6,12,10,6,8,10,8,12,10,10,12,3,2,3,AM/S RL,1,1,20,1,17,17,1,1,1,1,1,1,1,1,1
19244781,Raphinha,1651,16/11/1996,19,0,0,0,0,196,0,1,3,2,3,3,3,1,1,2,3,3,2,1,2,6,13,4,4,5,1,7,12,1,13,11,8,8,3,7,5,10,10,3,6,11,4,8,7,10,13,9,6,16,8,14,11,20,10,12,8,8,6,8,8,18,13,13,12,9,10,13,5,M C,1,1,1,13,1,1,1,1,1,13,20,1,1,1,1
19244783,Otavio Gut,1651,19/06/1996,20,0,0,0,0,185,0,2,2,3,3,2,4,4,3,4,2,1,5,4,6,6,8,1,11,6,8,11,9,5,10,8,7,10,10,9,10,10,11,4,8,9,5,12,8,11,9,9,10,11,11,13,9,20,14,10,9,7,8,9,9,14,12,11,10,9,6,7,7,D C,1,1,1,1,1,1,20,1,1,1,1,1,1,1,1
19244805,Gabriel,1651,11/11/1996,19,0,0,0,0,195,80,13,13,7,1,13,12,10,11,10,9,10,4,1,2,2,4,9,1,1,3,2,1,3,2,5,5,8,13,6,10,7,13,5,3,11,3,11,8,7,7,15,8,13,9,11,12,20,5,13,5,9,10,10,10,18,13,12,12,12,2,11,3,GK ,20,1,1,1,1,1,1,1,1,1,1,1,1,1,1
19244807,Baiano,1651,28/07/1995,20,0,0,0,0,186,70,3,1,3,2,2,3,3,1,1,2,3,6,9,8,7,10,9,13,5,8,9,9,4,14,6,10,13,10,4,7,7,15,3,10,9,7,14,8,11,14,10,11,9,1,11,14,20,10,10,10,8,5,7,10,19,9,11,10,12,12,1,1,D/DM C,1,1,1,1,1,1,20,1,1,17,1,1,1,1,1
19244808,Pablo,1651,05/04/1995,21,0,0,0,0,170,60,1,1,2,1,3,2,3,1,2,3,2,9,11,14,11,16,9,8,11,6,9,13,4,11,16,9,8,6,12,8,13,10,5,13,9,6,6,10,14,9,13,7,4,20,9,12,1,10,7,9,7,3,9,9,10,13,12,10,9,9,6,3,M/AM LC,1,1,1,20,17,1,1,1,1,1,17,1,1,1,1
19244809,Renan Gorne,1651,22/02/1996,20,0,0,0,0,182,74,3,3,1,3,1,1,2,3,1,3,2,5,8,10,12,11,7,13,10,7,9,10,12,4,11,13,10,11,11,8,10,12,19,11,12,12,12,10,12,11,10,11,13,12,12,12,20,11,13,11,5,4,11,10,15,11,9,12,9,2,6,7,AM/S C,1,1,20,17,1,1,1,1,1,1,1,1,1,1,1
19244810,Saulo,1651,20/04/1995,21,0,0,0,0,190,85,8,10,9,7,14,14,12,14,10,10,12,8,3,3,3,3,10,1,2,2,3,2,2,3,2,10,8,11,9,8,8,12,8,3,2,2,14,9,7,12,16,9,15,8,12,10,20,3,11,10,10,9,10,10,13,11,11,12,9,14,7,7,GK ,20,1,1,1,1,1,1,1,1,1,1,1,1,1,1
19244811,Luís Henrique,1651,17/03/1998,18,0,0,0,0,182,76,3,2,3,1,1,1,1,3,1,3,2,2,10,11,14,13,5,14,10,5,5,12,13,10,13,10,13,11,13,12,11,11,14,11,10,14,12,12,12,13,12,13,12,20,13,11,10,12,14,13,5,11,5,10,18,9,11,12,15,12,11,7,S ,1,1,20,1,1,1,1,1,1,1,1,1,1,1,1
19244812,Matheus,1651,03/08/1998,17,0,0,0,0,170,60,10,8,6,1,14,14,9,14,4,6,11,7,1,2,1,7,9,1,1,1,3,2,3,1,4,9,5,15,7,8,7,14,8,3,3,2,12,8,7,13,8,8,7,9,13,11,20,7,6,3,9,2,5,9,10,10,9,11,12,2,4,6,GK ,20,1,1,1,1,1,1,1,1,1,1,1,1,1,1
19245067,Zé Marcos,1651,01/02/1998,18,0,0,0,0,183,69,3,3,3,3,3,3,1,2,2,2,3,4,4,3,2,8,6,11,6,6,14,7,7,14,3,8,7,9,8,7,1,10,9,3,8,5,14,7,8,13,7,3,9,10,15,12,20,9,10,8,7,8,9,9,7,11,11,8,13,11,10,8,D C,1,1,1,1,1,1,20,1,1,1,1,1,1,1,1
19245477,Bruno,1651,24/09/1997,18,0,0,0,0,177,0,2,1,1,1,1,2,2,3,2,2,3,4,5,12,12,11,4,10,2,1,1,5,1,3,8,7,9,3,7,1,5,12,8,9,3,9,2,4,5,11,10,5,5,7,13,12,20,6,4,8,7,1,8,8,17,11,12,12,12,3,12,6,S ,1,1,20,1,1,1,1,1,1,1,1,1,1,1,1
19245478,Reginaldo,1651,08/07/1992,23,0,0,0,0,193,84,1,3,2,3,3,1,1,1,3,3,3,6,7,11,5,7,6,12,7,14,11,9,4,10,10,13,11,15,12,7,7,7,10,10,6,12,7,9,14,15,10,14,18,10,12,12,20,14,15,7,11,5,5,10,17,11,10,11,10,10,4,5,D RC,1,1,1,1,1,1,20,1,15,1,1,1,1,1,1
19245511,Kadu,1651,08/09/1996,19,0,0,0,0,180,72,1,4,1,1,2,1,2,1,3,1,2,9,10,9,9,12,10,10,10,7,12,9,8,11,9,14,11,12,10,10,9,10,20,1,13,8,16,12,14,12,14,11,10,20,17,13,11,11,10,10,15,3,5,10,10,12,11,11,11,8,18,1,DM ,1,1,1,1,1,1,1,1,1,20,10,1,1,1,1
19245512,Adriano,1651,22/06/1996,20,0,0,0,0,183,73,4,2,2,1,1,2,1,2,1,1,3,8,7,10,10,10,8,15,8,3,8,9,4,4,11,9,8,7,11,6,9,8,9,8,14,11,8,8,9,12,11,10,11,14,11,12,20,8,8,9,5,4,3,9,11,12,10,8,11,1,6,5,S ,1,1,20,1,10,10,1,1,1,1,1,1,1,1,1
19245514,Gabriel,1651,17/03/1997,19,0,0,0,0,173,0,3,3,3,1,2,1,2,1,1,1,3,5,1,2,6,8,3,5,8,3,5,6,3,10,12,8,7,7,7,5,10,13,8,5,2,6,7,7,11,12,10,6,6,8,12,10,20,8,5,8,8,7,8,8,14,13,11,13,9,9,14,6,DM/M C,1,1,1,1,1,1,1,1,9,18,20,1,1,1,1
19245515,Luiz Meneses,1651,15/10/1996,19,0,0,0,0,183,79,2,4,2,3,3,3,1,3,1,1,2,7,3,6,8,11,7,7,11,4,8,11,7,13,9,9,7,3,8,6,7,11,3,9,1,7,13,8,10,14,13,5,12,10,11,14,20,7,10,8,7,5,4,9,10,12,12,9,12,9,10,6,DM ,1,1,1,1,1,1,1,1,1,20,10,1,1,1,1
19245596,Elias,1651,10/12/1997,18,0,0,0,0,172,0,1,2,1,3,1,1,1,3,1,1,3,6,8,2,2,10,4,7,6,5,8,8,2,14,8,7,9,8,7,8,7,11,5,7,7,5,8,8,8,10,7,6,9,20,12,7,8,7,7,7,6,7,7,7,11,11,12,12,11,3,12,6,D/WB L,1,1,1,1,1,1,1,20,8,1,1,1,1,17,7
19245597,Matheusinho,1651,18/10/1997,18,0,0,0,0,165,59,3,3,2,1,3,2,1,2,3,2,3,7,8,12,7,9,8,5,8,2,4,9,8,4,11,6,9,9,10,10,10,10,6,12,12,10,6,11,11,13,13,16,4,20,8,13,7,11,4,11,6,10,7,10,9,11,13,11,10,6,5,8,AM RC,1,1,14,20,13,15,1,1,1,1,1,1,1,1,1
19245598,Léo Taivã,1651,04/12/1996,19,0,0,0,0,176,0,1,2,2,2,2,2,2,1,3,1,2,5,3,1,2,12,5,5,4,3,7,9,1,13,7,8,8,7,6,9,9,13,2,8,8,4,7,7,8,8,11,12,6,16,15,12,20,5,7,8,8,5,8,8,14,10,13,12,12,9,15,2,DM ,1,1,1,1,1,1,1,1,1,20,10,1,1,1,1
19245681,Hiago,1651,04/11/1997,18,0,0,0,0,193,0,2,1,2,3,1,2,3,3,1,2,3,4,2,1,4,6,1,13,2,1,10,6,2,11,5,8,3,8,6,8,3,13,4,6,5,4,13,5,6,12,7,6,15,2,10,8,20,5,11,6,8,8,8,8,18,11,13,12,8,3,7,7,D C,1,1,1,1,1,1,20,1,1,1,1,1,1,1,1
19245682,Matias,1651,28/04/1997,19,0,0,0,0,185,0,2,4,2,3,3,1,2,4,2,1,3,1,3,4,6,12,1,6,1,6,8,8,2,12,8,8,6,8,5,9,6,11,1,8,13,6,7,2,5,14,13,7,13,7,10,13,20,6,7,7,8,4,8,8,17,10,9,10,11,2,4,4,D/WB R,1,1,1,1,1,1,1,7,20,1,1,1,1,5,18
19245683,Shaylon,1651,28/04/1997,19,0,0,0,0,178,70,3,2,1,3,2,2,3,3,4,2,1,7,7,9,9,13,7,7,13,5,5,13,1,9,13,5,7,9,9,6,9,13,20,13,9,12,9,8,9,13,13,8,8,20,16,13,12,7,7,10,10,5,10,10,7,11,12,12,12,5,8,3,AM C,1,1,1,20,1,1,1,1,1,1,15,1,1,1,1
19245920,Murilo,1651,12/07/1993,22,0,0,0,0,187,82,1,1,3,1,2,3,1,3,2,2,1,6,6,5,4,13,6,6,11,1,11,11,1,14,14,8,9,7,7,9,7,14,3,2,11,6,10,8,10,10,8,7,13,2,10,9,20,6,9,8,8,8,6,8,11,9,11,12,10,7,10,3,DM ,1,1,1,1,1,1,1,1,1,20,10,1,1,1,1
19245970,Ewerton,1651,13/06/1993,23,0,0,0,0,173,73,2,2,1,2,3,1,3,3,1,1,2,2,3,4,2,11,2,6,3,4,7,6,1,13,7,8,6,8,7,6,4,9,4,8,5,4,5,7,7,13,13,6,5,20,13,13,7,7,6,8,8,8,7,8,12,10,12,14,10,9,5,4,D/WB L,1,1,1,1,1,1,1,20,1,1,1,1,1,17,1
19245971,Maykon,1651,16/04/1992,24,0,0,0,0,170,70,2,2,3,2,3,1,1,2,1,3,2,7,12,6,4,12,2,4,4,3,4,7,1,5,13,8,8,7,3,7,7,9,2,13,1,7,6,5,7,12,12,5,4,20,11,13,7,10,3,8,8,8,8,12,18,14,13,10,11,3,10,1,AM LC,1,1,1,20,16,1,1,11,1,1,10,15,1,13,1
19245972,Waldenison Eto'o,1651,29/05/1990,26,0,0,0,0,185,0,3,1,4,1,1,2,3,4,2,3,3,1,1,1,3,4,3,11,1,2,12,2,2,12,1,8,8,7,5,10,3,10,3,3,4,1,12,4,5,12,10,5,12,5,11,12,20,6,7,8,5,5,8,8,11,11,11,10,12,8,1,8,D C,1,1,1,1,1,1,20,1,1,1,1,1,1,1,1
19245974,Jonathan,1651,30/09/1994,21,0,0,0,0,189,0,3,2,1,4,3,2,2,2,3,1,3,1,1,11,12,10,3,11,3,1,1,5,2,1,10,5,10,1,5,4,5,9,7,11,4,8,4,3,5,12,10,4,6,7,7,10,20,10,8,7,4,7,7,7,17,11,11,13,9,5,15,8,S ,1,1,20,13,1,1,1,1,1,1,10,1,1,1,1
19245999,Felipe Pires,1651,21/08/1993,22,0,0,0,0,185,0,2,1,1,2,1,2,1,1,2,1,3,5,2,1,4,5,1,8,5,1,10,4,1,11,3,8,10,8,5,6,3,13,7,2,7,5,13,5,6,8,12,6,11,8,8,11,20,7,7,8,8,1,6,8,17,10,12,10,11,2,10,5,D C,1,1,1,1,1,1,20,1,1,1,1,1,1,1,1
19246158,Tauan,1651,22/08/1996,19,0,0,0,0,179,70,2,6,5,1,12,9,8,12,7,7,6,3,1,2,1,1,2,1,1,2,1,1,1,3,1,7,7,13,2,8,3,10,6,3,6,3,9,4,3,9,14,4,8,7,8,12,20,1,6,7,7,7,7,7,14,14,11,14,12,1,12,6,GK ,20,1,1,1,1,1,1,1,1,1,1,1,1,1,1
19246161,Fabiano,1651,26/01/1996,20,0,0,0,0,176,64,1,2,1,1,4,3,1,1,3,3,1,7,4,5,5,7,5,7,7,6,6,9,5,11,8,8,7,8,5,6,8,10,3,1,1,5,9,8,8,15,10,8,7,9,7,13,20,11,5,8,8,8,8,8,14,13,12,12,12,5,10,8,D R,1,1,1,1,1,1,1,1,20,1,1,1,1,1,15
19246262,Maninho,1651,23/11/1988,27,0,0,0,0,166,0,2,3,1,1,3,1,2,4,1,1,3,5,4,7,1,14,5,8,4,7,9,9,1,12,9,6,10,9,9,10,5,12,6,8,4,7,10,7,9,14,14,9,1,20,13,14,10,14,5,9,9,9,9,9,19,12,13,13,11,8,5,5,D/WB L,1,1,1,1,1,1,1,20,1,1,1,1,1,19,1
19246269,Everton,1651,20/12/1990,25,0,0,0,0,183,0,3,1,1,2,1,2,2,1,3,2,3,8,7,10,10,14,8,8,10,4,8,14,5,4,11,1,9,6,8,9,14,13,10,10,12,9,10,9,10,14,13,9,9,9,14,12,20,13,7,10,5,6,7,10,11,12,12,12,10,6,1,6,AM C,1,1,1,20,1,1,1,1,1,1,12,1,1,1,1
19246270,Jefferson,1651,22/11/1989,26,0,0,0,0,186,0,3,2,1,2,2,2,2,1,2,3,1,7,7,11,13,13,7,13,7,1,7,5,9,2,10,7,11,5,10,6,6,11,2,10,1,13,7,7,8,13,12,8,12,16,15,12,20,8,9,4,10,1,6,10,12,11,10,12,11,4,3,6,S ,1,1,20,1,1,1,1,1,1,1,1,1,1,1,1
19246350,Matheus Moresche,1651,24/06/1998,18,0,0,0,0,180,61,1,2,2,2,3,4,1,1,2,1,4,7,6,11,10,13,7,1,13,3,5,13,6,7,13,6,9,6,8,6,13,13,1,13,11,5,7,8,5,13,13,8,7,10,12,13,20,9,5,10,10,5,6,10,11,11,11,9,12,7,11,7,AM C,1,1,1,20,1,1,1,1,1,1,10,1,1,1,1
19246772,Thaciano,1651,12/05/1995,21,0,0,0,0,182,73,1,2,1,3,2,3,3,1,3,1,2,8,6,10,10,14,8,8,8,3,9,14,7,14,11,10,9,9,10,10,13,14,1,10,13,10,8,9,6,14,12,7,11,11,11,10,20,9,7,10,10,10,3,10,7,9,11,12,10,7,12,4,AM C,1,1,1,20,1,1,1,1,1,15,15,1,1,1,1
19246839,Marcos Serrato,1651,08/02/1994,22,0,0,0,0,175,75,2,2,3,3,2,3,1,2,1,2,2,9,12,12,10,11,11,9,11,4,9,11,4,7,13,6,10,10,12,12,12,10,11,14,11,13,10,9,10,14,12,9,9,20,12,13,15,13,9,12,10,11,8,11,17,10,11,10,13,7,10,3,M/AM C,1,1,1,20,13,13,1,1,1,1,17,1,1,1,1
19247227,Balotelli,1651,23/11/1994,21,0,0,0,0,177,0,2,3,1,2,2,2,3,2,2,3,2,7,6,14,14,14,7,14,3,3,7,8,10,4,14,9,11,7,10,8,6,12,5,13,7,12,8,7,8,13,11,8,5,8,13,13,20,10,8,9,5,9,9,9,15,11,13,10,12,6,8,5,S ,1,1,20,1,1,1,1,1,1,1,1,1,1,1,1
19247356,Uilliam,1651,11/10/1994,21,0,0,0,0,182,69,2,1,2,2,1,2,2,3,3,1,1,7,7,9,9,8,6,9,6,3,5,10,8,5,9,9,7,11,8,9,7,8,5,8,5,9,6,12,12,12,12,11,10,10,15,12,20,13,6,12,4,9,8,9,17,13,13,11,11,9,12,8,AM/S R,1,1,20,1,1,17,1,1,1,1,1,1,1,1,1
19247360,Alisson Mosquito,1651,03/01/1997,19,0,0,0,0,164,0,2,2,2,2,1,3,2,1,2,3,2,6,5,11,13,13,3,13,6,1,3,7,7,3,13,3,9,8,8,6,4,10,1,13,4,13,5,6,7,13,13,15,2,9,13,13,20,5,2,8,8,4,9,9,19,10,11,9,14,5,15,2,S ,1,1,20,1,1,1,1,1,1,1,1,1,1,1,1
19247362,João Igor,1651,14/03/1996,20,0,0,0,0,173,0,1,3,1,1,3,3,1,2,3,1,1,7,7,11,6,13,7,6,9,4,5,11,7,8,13,9,9,2,13,6,14,12,3,12,9,10,4,8,10,14,10,8,6,2,15,9,20,8,5,9,9,9,5,9,16,11,11,10,11,1,4,5,AM C,1,1,1,20,1,1,1,1,1,1,10,1,1,1,1
19247382,Léo,1651,18/03/1993,23,0,0,0,0,187,81,3,3,2,1,2,1,1,1,3,3,1,4,6,8,5,14,7,7,6,2,9,10,1,12,9,9,10,8,8,7,8,14,2,7,8,7,11,8,9,14,12,6,14,9,8,14,20,8,10,9,5,9,7,9,7,13,12,12,10,4,13,5,D/WB/DM R,1,1,1,1,1,1,1,1,16,20,10,1,1,1,16
19247387,Walney,1651,21/11/1996,19,0,0,0,0,194,0,3,3,1,1,1,3,2,3,3,2,1,4,7,6,7,12,8,8,11,4,8,14,6,14,12,10,10,9,7,6,11,14,10,6,9,8,7,9,11,14,12,8,16,9,10,9,20,6,13,10,8,10,6,10,9,12,13,12,11,8,14,3,DM ,1,1,1,1,1,1,1,1,1,20,10,1,1,1,1
19247388,Marquinhos Calazans,1651,14/06/1996,20,0,0,0,0,168,64,3,3,1,4,3,2,2,2,1,4,1,8,13,16,16,13,9,12,7,7,9,11,7,9,12,6,8,3,13,8,12,6,7,9,12,16,10,11,12,8,14,6,6,20,12,13,11,9,7,9,9,3,8,10,5,10,9,10,13,6,16,1,AM/S RL,1,1,20,1,18,18,1,1,1,1,1,1,1,1,1
19247495,Bruno Paulista,1651,21/08/1995,20,0,0,0,0,189,83,1,2,3,2,2,2,1,3,1,2,2,11,12,12,8,13,8,11,13,8,11,14,12,13,14,14,13,12,14,11,12,14,14,14,8,12,12,12,13,12,11,14,14,20,13,13,9,13,13,13,12,13,9,14,13,10,12,13,13,11,11,6,DM/M C,1,1,1,14,13,1,1,14,1,18,20,13,1,13,1
19247518,Jackson,1651,16/01/1995,21,0,0,0,0,177,0,2,3,3,1,1,1,3,1,2,1,1,8,6,4,7,11,8,8,14,7,9,9,3,11,8,13,8,12,7,8,10,13,10,7,9,8,6,9,12,14,14,9,5,10,14,14,20,8,7,10,6,10,10,10,9,12,12,12,11,6,8,2,DM ,1,1,1,1,1,1,1,1,1,20,10,1,1,1,1
19247687,Yan Petter,1651,04/04/1996,20,0,0,0,0,177,0,3,3,2,1,3,1,1,2,1,1,1,8,7,13,14,13,8,9,10,8,8,10,5,8,13,10,11,9,9,4,13,14,10,14,5,9,4,9,10,15,12,6,6,20,15,13,11,12,6,11,9,10,9,10,18,10,10,9,12,7,6,8,AM LC,1,1,14,20,18,1,1,1,1,1,10,1,1,1,1
19247694,Ruan Café,1651,12/01/1997,19,0,0,0,0,173,64,3,3,1,1,1,3,1,1,4,3,3,5,10,13,12,13,5,10,11,4,4,11,12,4,13,4,12,10,12,8,11,11,12,13,2,12,8,10,12,13,13,8,7,8,12,13,20,12,8,12,8,10,4,10,12,14,6,12,8,4,14,14,S R,1,1,20,1,13,15,1,1,1,1,1,1,1,1,1
19247695,Gustavo Ferrareis,1651,02/01/1996,20,0,0,0,0,177,69,3,3,3,3,2,3,2,1,3,4,4,11,10,12,12,12,11,9,12,5,9,13,9,8,13,7,10,6,12,12,14,11,3,13,12,14,11,12,12,13,13,11,9,12,16,14,20,14,9,12,10,3,9,11,20,13,11,10,11,7,11,1,AM LC,1,1,1,20,17,12,1,1,1,1,10,1,12,1,1
19247744,Léo Duarte,1651,17/07/1996,19,0,0,0,0,183,76,3,3,2,4,1,3,3,1,1,1,3,6,7,12,8,11,10,12,10,7,14,11,10,14,14,12,13,12,13,13,10,12,13,10,10,11,13,12,13,14,13,13,11,10,12,14,20,13,12,12,6,12,9,12,20,12,13,12,12,12,11,5,D C,1,1,1,1,1,1,20,1,1,15,1,1,1,1,1
19248142,Wellington,1651,15/12/1991,24,0,0,0,0,176,75,3,1,3,2,1,3,3,1,1,1,3,10,13,11,11,15,10,10,15,2,12,12,7,12,11,14,11,11,11,11,11,14,4,4,14,10,11,11,12,11,13,11,7,11,14,12,20,15,8,12,13,5,5,11,20,10,13,14,10,2,14,1,DM ,1,1,1,1,1,1,1,1,1,20,10,1,1,1,1
19248311,Fábio,1651,28/02/1990,26,0,0,0,0,173,68,2,2,3,2,1,4,1,3,2,2,2,7,9,11,9,12,7,5,9,6,7,13,3,5,12,6,10,9,10,11,13,12,1,10,12,11,8,11,10,15,11,6,5,11,12,13,20,11,6,10,10,8,10,10,9,11,8,11,10,7,5,5,AM RC,1,1,1,20,1,18,1,1,1,1,10,1,1,1,1
19248473,Bruno Arrabal,1651,22/02/1992,24,0,0,0,0,180,71,3,4,2,2,3,4,3,2,1,2,2,7,4,6,5,12,4,9,8,2,13,12,2,9,9,10,11,9,9,10,8,13,3,9,9,7,11,8,10,13,13,8,10,5,15,13,20,13,8,10,3,5,9,10,19,9,12,12,11,2,11,4,D/DM C,1,10,1,8,1,1,17,1,1,20,15,1,1,1,1
19248479,Lucas,1651,21/06/1993,23,0,0,0,0,181,77,2,2,1,3,2,3,1,1,3,1,2,6,7,3,3,10,7,9,9,7,12,10,7,14,9,9,11,8,6,13,5,14,9,9,8,7,11,8,11,12,10,9,9,9,9,11,20,7,9,9,3,8,9,9,18,12,11,12,10,11,1,4,D/DM C,1,1,1,1,1,1,17,1,1,20,10,1,1,1,1
19248483,Rafinha,1651,23/02/1992,24,0,0,0,0,169,67,1,2,1,2,3,3,2,3,2,3,3,4,4,14,14,14,8,14,5,3,8,9,7,3,14,10,13,9,7,7,8,11,5,13,8,12,9,8,8,13,14,9,1,8,13,14,20,14,9,10,10,10,10,10,8,13,12,12,11,9,9,3,S ,1,1,20,1,1,1,1,1,1,1,1,1,1,1,1
19248490,Tiago Barreiros,1651,27/08/1990,25,0,0,0,0,176,77,1,2,3,1,1,2,2,1,2,2,3,5,7,13,5,7,6,4,8,2,6,6,3,6,11,9,11,6,8,6,6,13,1,11,14,8,6,8,8,13,13,12,6,20,12,13,10,13,9,9,6,9,9,9,14,10,12,12,14,6,2,2,M/AM LC,1,1,1,15,20,1,1,10,1,1,1,19,1,12,1
19248499,Bernardo,1651,01/09/1992,23,0,0,0,0,189,83,12,9,10,1,12,9,9,12,9,9,9,1,1,1,1,4,4,1,3,3,3,1,3,2,1,5,9,14,6,7,5,12,6,2,8,2,12,6,5,11,15,6,12,10,14,12,20,1,7,9,9,9,9,9,17,11,13,12,11,3,10,1,GK ,20,1,1,1,1,1,1,1,1,1,1,1,1,1,1
19248507,Sampson,1651,11/11/1992,23,0,0,0,0,184,72,2,1,3,1,3,1,2,3,3,3,4,4,4,11,11,14,7,7,12,2,7,12,3,4,9,3,10,1,10,8,8,14,4,9,7,13,8,8,12,14,11,3,10,10,12,13,20,8,8,9,9,3,5,9,13,9,12,9,11,11,18,2,AM C,1,1,1,20,1,1,1,1,1,1,10,1,1,1,1
19248542,Tomas Bastos,1651,30/09/1992,23,0,0,0,0,177,70,2,2,1,3,1,2,1,1,4,3,2,13,12,12,13,12,13,13,12,8,2,12,13,10,12,5,10,5,11,9,13,10,19,12,11,12,10,13,13,14,14,11,11,20,11,13,8,12,12,12,5,11,5,10,13,9,14,11,12,8,15,8,AM LC,1,1,1,20,15,11,1,1,1,1,10,12,1,1,1
19248548,Paulinho,1651,08/08/1987,28,0,0,0,0,160,0,1,4,3,2,2,4,1,4,3,3,2,7,5,13,7,12,4,7,11,1,7,13,2,8,13,5,8,7,6,8,7,13,6,13,10,9,8,8,9,13,13,8,1,9,14,13,20,13,7,10,8,9,10,10,11,13,11,13,13,3,13,3,AM C,1,1,1,20,1,1,1,1,1,1,10,1,1,1,1
19248557,Felipe Macena,1651,25/07/1993,22,0,0,0,0,173,66,2,1,2,3,2,1,3,3,3,1,2,7,8,4,9,12,8,8,8,1,11,11,7,12,8,10,12,9,9,11,11,14,4,6,9,8,13,9,11,13,12,9,4,2,7,14,20,8,9,10,10,10,10,10,12,11,9,10,11,8,1,8,DM ,1,1,1,1,1,1,1,1,1,20,10,1,1,1,1
19248563,Matheuzinho,1651,15/07/1991,24,0,0,0,0,171,0,3,1,1,1,2,3,3,4,1,3,2,6,2,6,8,12,6,6,11,1,5,13,1,6,9,9,10,7,10,4,10,13,3,9,12,11,7,7,10,13,13,7,3,20,11,13,9,13,4,9,8,1,6,9,16,13,11,9,11,1,7,3,AM C,1,1,1,20,1,1,1,1,1,1,10,1,1,1,1
19248568,Michel Benhami,1651,03/05/1988,28,0,0,0,0,176,75,2,2,4,3,3,1,1,1,2,3,1,5,4,8,7,13,2,7,8,7,9,12,4,7,9,9,11,6,8,8,6,11,8,1,3,7,10,8,9,14,14,8,7,20,13,14,10,13,10,9,4,9,9,9,10,10,11,11,9,1,7,6,D/WB/DM L,1,1,1,1,1,1,1,18,1,20,10,1,1,18,1
19248729,Wanderson,1651,23/08/1991,24,0,0,0,0,183,0,7,9,8,1,14,13,9,14,8,5,8,3,3,2,1,1,7,1,3,3,1,1,3,3,5,6,9,11,7,7,6,14,6,1,5,3,13,7,5,12,6,4,9,7,12,11,20,1,9,8,8,8,4,8,18,9,11,9,12,4,9,4,GK ,20,1,1,1,1,1,1,1,1,1,1,1,1,1,1
19248737,David,1651,22/01/1986,30,0,0,0,0,186,0,2,2,2,1,3,1,1,1,3,2,1,5,1,1,1,6,1,11,3,3,12,3,1,12,5,4,8,3,6,7,3,12,2,1,12,4,12,5,6,12,9,6,8,15,12,7,20,9,12,9,9,9,9,9,15,11,14,11,9,10,9,3,D C,1,1,1,1,1,1,20,1,1,1,1,1,1,1,1
19248738,Hycaro,1651,04/03/1993,23,0,0,0,0,186,0,3,1,3,2,3,2,2,1,2,1,3,3,2,4,4,7,2,13,5,1,14,8,1,12,3,9,8,9,3,10,5,13,9,1,2,4,13,7,6,13,10,7,11,4,10,10,20,8,7,6,6,9,3,9,14,11,10,12,12,1,12,6,D C,1,1,1,1,1,1,20,1,1,1,1,1,1,1,1
19248740,Pablo,1651,05/02/1987,29,0,0,0,0,177,0,3,2,1,1,2,2,2,3,1,2,2,7,5,3,8,11,7,7,8,1,9,11,5,14,12,5,8,8,6,10,10,14,5,9,11,7,10,3,8,14,14,8,6,9,16,14,20,6,9,9,9,9,7,9,15,11,10,15,8,11,9,1,DM ,1,1,1,1,1,1,1,1,1,20,10,1,1,1,1
19248744,Kelvin,1651,23/01/1992,24,0,0,0,0,170,67,3,4,2,2,2,1,3,3,1,3,1,7,11,12,10,9,5,4,6,4,5,7,4,5,10,8,10,9,10,12,11,10,2,9,4,11,10,12,11,13,12,10,4,10,13,13,20,14,7,11,8,9,8,11,19,10,12,11,8,10,17,4,D/AM R,1,1,1,1,1,18,1,1,20,1,1,1,15,1,15
19248746,Willyan,1651,27/01/1995,21,0,0,0,0,193,0,1,3,3,3,2,1,2,2,1,4,2,2,3,2,4,7,6,11,1,5,14,7,1,12,7,9,9,9,8,7,5,14,9,1,7,5,11,7,8,14,11,8,11,10,14,12,20,5,12,9,8,5,6,9,10,10,13,12,10,10,14,7,D C,1,1,1,1,1,1,20,1,1,1,1,1,1,1,1
19248747,Tatá,1651,20/06/1990,26,0,0,0,0,184,0,1,2,1,3,4,1,1,2,1,4,3,2,3,4,5,7,2,4,6,6,8,8,3,12,8,7,9,9,7,10,5,10,9,9,9,5,9,8,7,13,13,8,10,20,10,13,8,11,6,9,9,9,9,9,15,12,11,9,11,10,3,1,D/WB L,1,1,1,1,1,1,1,20,1,1,1,1,1,19,1
19248751,Sorriso,1651,10/09/1986,29,0,0,0,0,170,62,2,2,3,3,1,1,3,1,3,1,1,10,10,10,10,8,10,6,11,12,3,6,13,6,9,6,8,12,7,10,11,7,10,10,4,10,6,13,12,14,8,15,5,10,10,12,20,14,4,12,10,13,6,16,20,2,2,19,10,18,15,10,D/WB R,1,1,1,1,1,12,1,1,20,1,1,1,15,1,19
19248755,Leandro Morais,1651,19/01/1993,23,0,0,0,0,184,0,2,1,1,3,2,2,4,2,3,1,1,7,6,5,6,12,7,7,10,4,9,12,7,14,8,7,12,7,8,7,9,12,9,2,12,7,10,8,7,10,13,8,8,2,9,14,20,6,8,9,7,4,9,9,20,9,8,11,10,9,18,7,DM ,1,1,1,1,1,1,1,1,1,20,10,1,1,1,1
19248757,Carlos Vitor,1651,27/02/1993,23,0,0,0,0,170,0,2,3,1,2,2,1,2,2,2,1,3,10,11,15,8,10,9,5,9,8,3,8,8,3,13,10,15,8,15,9,11,5,19,14,11,15,3,3,5,15,15,3,7,8,11,14,20,12,4,6,10,12,6,13,14,12,10,13,11,12,10,4,AM RL,1,1,14,12,20,20,1,1,1,1,1,1,1,1,1
19248759,Diego Soares,1651,12/08/1994,21,0,0,0,0,174,71,3,1,3,1,3,1,4,1,1,2,1,6,8,13,8,13,6,3,8,1,6,8,6,8,13,9,7,6,8,7,6,8,1,13,11,8,5,4,8,13,13,5,6,8,12,13,20,5,7,9,9,8,9,9,16,9,13,9,13,9,10,2,AM C,1,1,10,20,1,14,1,1,10,1,1,1,12,1,11
19248763,Gabriel Buru,1651,01/10/1992,23,0,0,0,0,172,72,3,2,3,3,1,1,4,2,1,1,1,7,8,7,13,13,5,13,5,3,6,7,7,2,12,10,11,6,13,8,8,11,7,12,12,13,6,7,8,13,13,3,5,18,12,13,20,6,5,10,9,10,10,10,11,10,8,13,12,1,15,8,S ,1,1,20,1,1,1,1,1,1,1,1,1,1,1,1
19248772,Ricardo Muniz,1651,03/04/1988,28,0,0,0,0,192,0,4,2,1,3,3,4,1,1,2,2,1,6,6,12,12,12,6,10,4,5,5,7,10,1,11,8,12,8,12,7,6,10,7,12,8,12,7,6,7,11,8,7,14,18,12,6,20,12,10,10,10,4,10,10,15,11,13,13,11,6,7,8,S ,1,1,20,1,1,1,1,1,1,1,1,1,1,1,1
19248781,Max,1651,05/06/1992,24,0,0,0,0,187,80,2,3,1,1,2,1,4,4,4,1,4,4,4,1,6,7,6,12,2,3,12,7,1,13,5,9,10,9,7,7,1,13,7,6,5,6,13,6,7,13,9,7,12,20,8,13,5,10,10,9,9,9,9,9,8,11,11,12,11,6,18,3,D C,1,1,1,1,1,1,20,1,1,1,1,1,1,1,1
19248910,Lucas Pavone,1651,25/03/1990,26,0,0,0,0,183,78,3,2,1,1,1,1,1,1,3,1,3,5,4,9,6,13,1,9,6,6,10,8,8,14,10,8,10,10,10,7,9,11,4,10,5,8,11,9,10,14,14,9,9,20,12,14,10,9,9,10,10,1,4,10,10,13,13,8,11,8,10,8,D L,1,1,1,1,1,1,1,20,1,1,1,13,1,15,1
19249113,Xavier,1651,13/12/1994,21,0,0,0,0,170,69,3,2,2,1,3,1,1,2,2,2,1,9,11,12,10,12,9,9,10,6,10,14,7,11,11,8,11,10,11,10,11,11,11,14,7,12,5,11,10,13,10,7,4,20,11,12,14,10,7,12,9,8,10,18,16,9,13,13,14,6,3,7,D/WB/M/AM LC,1,1,1,20,18,1,1,19,1,1,18,16,1,18,1
19249123,Carlos Renato,1651,09/02/1993,23,0,0,0,0,168,63,1,3,2,3,3,1,3,1,4,3,2,8,12,11,11,14,11,10,10,10,6,9,4,6,11,5,8,12,6,12,8,12,8,11,9,12,12,7,12,14,12,11,3,20,12,12,11,14,11,11,7,5,11,11,18,10,14,12,13,7,18,2,D/WB/M L,1,1,1,1,15,1,1,20,1,1,1,17,1,19,1
19249130,Patrick Allan,1651,24/12/1994,21,0,0,0,0,168,64,3,2,3,2,4,2,1,1,1,2,3,10,10,11,11,11,10,8,10,2,7,10,5,7,12,3,11,2,7,4,11,14,8,12,1,9,6,6,11,12,13,16,4,20,13,12,13,7,5,9,9,9,8,9,14,10,9,12,12,7,12,4,AM RLC,1,1,1,20,16,15,1,1,1,1,10,1,1,1,1
19249131,Hugo,1651,27/02/1995,21,0,0,0,0,186,0,9,14,8,1,14,9,8,14,10,10,10,5,2,2,3,5,8,1,1,1,3,1,4,3,7,6,11,11,7,9,8,13,2,3,12,2,9,9,4,14,6,9,10,4,13,13,20,8,9,10,10,10,10,10,17,12,11,11,12,1,3,4,GK ,20,1,1,1,1,1,1,1,1,1,1,1,1,1,1
19249189,Marcelinho,1651,12/03/1991,25,0,0,0,0,175,67,4,3,1,1,3,2,1,1,1,3,2,11,11,12,11,13,6,10,11,10,9,12,8,9,12,10,12,11,12,12,12,13,13,14,4,13,8,10,12,15,13,8,5,11,13,14,20,12,7,12,9,5,10,10,14,12,12,12,12,7,16,6,D/WB R,1,1,1,1,1,1,1,1,20,1,1,1,1,1,19
19249216,Jeanderson,1651,13/08/1991,24,0,0,0,0,180,72,1,2,1,2,1,1,4,2,1,3,3,7,12,12,8,12,8,8,6,7,10,8,8,11,12,14,9,12,13,12,8,12,10,14,9,12,9,8,14,12,15,12,11,20,13,13,5,12,10,7,12,10,9,7,18,8,10,13,11,6,5,4,D/WB L,1,1,1,1,1,1,1,20,1,1,1,1,1,19,1
19249270,Marcos Paulo,1651,27/09/1994,21,0,0,0,0,183,79,3,1,1,3,3,1,1,1,3,1,3,5,6,11,11,11,7,11,11,4,6,9,7,5,10,9,11,8,12,10,6,11,13,10,5,16,10,10,11,12,11,11,12,10,13,12,20,10,12,10,10,7,10,10,10,9,10,11,10,11,5,1,S ,1,1,20,1,1,1,1,1,1,1,1,1,1,1,1
19249271,Balbino,1651,19/01/1996,20,0,0,0,0,178,62,3,4,2,2,2,2,2,2,1,3,1,3,6,8,6,11,4,10,7,4,12,10,5,12,9,10,14,9,7,10,9,14,3,4,3,6,13,9,11,12,11,13,9,10,11,12,20,12,12,10,6,5,8,10,14,11,10,12,12,7,9,3,DM ,1,1,1,1,1,1,1,1,1,20,10,1,1,1,1
19249316,Anderson Mauro,1651,21/03/1993,23,0,0,0,0,194,82,1,2,1,3,2,3,1,3,1,1,1,1,2,1,4,8,1,14,4,3,14,8,1,10,6,9,9,9,7,8,6,13,6,1,9,6,14,7,8,14,8,8,13,1,11,10,20,7,13,9,8,9,6,9,8,10,13,11,13,8,8,7,D C,1,1,1,1,1,1,20,1,1,1,1,1,1,1,1
19249317,Oliveira,1651,24/03/1991,25,0,0,0,0,176,75,1,2,3,1,1,3,4,2,1,3,1,6,9,6,2,14,4,5,6,7,9,8,1,14,9,9,10,9,9,14,9,9,1,9,13,7,10,7,9,14,13,13,7,10,11,13,20,12,10,9,9,9,9,9,20,12,11,11,12,11,13,2,D/WB R,1,1,1,1,1,1,1,1,20,1,1,1,1,1,17
19249318,João Guima,1651,11/12/1996,19,0,0,0,0,177,71,2,1,2,2,1,1,2,3,4,3,1,8,8,10,10,14,12,8,7,6,9,13,5,7,14,10,9,7,7,4,13,8,10,12,2,14,10,10,13,12,12,11,5,20,12,12,11,14,9,10,9,6,4,10,7,12,10,10,13,6,13,6,M/AM C,1,1,1,20,1,1,1,1,1,1,17,1,1,1,1
19249332,Andrey,1651,16/02/1995,21,0,0,0,0,180,0,1,1,2,1,1,4,4,2,2,3,2,2,1,1,2,1,1,12,4,1,10,5,1,12,1,9,9,4,5,9,3,12,7,1,12,5,12,5,6,12,12,6,7,16,14,12,20,6,7,9,9,4,3,9,9,12,11,11,13,6,1,3,D C,1,1,1,1,1,1,20,1,1,1,1,1,1,1,1
19249333,Bruno Caprioli,1651,21/02/1996,20,0,0,0,0,178,0,2,1,1,3,4,2,2,2,3,3,4,6,6,7,8,12,6,6,11,5,7,7,1,13,7,7,8,8,6,8,13,9,9,1,7,5,10,8,10,13,12,8,6,8,14,12,20,6,6,9,9,9,9,9,10,10,12,12,11,6,9,7,DM/M C,1,1,1,1,1,1,1,1,1,20,17,1,1,1,1
19249334,Chaveirinho,1651,13/09/1991,24,0,0,0,0,189,0,3,3,1,1,2,3,1,3,1,2,3,4,3,12,13,13,6,13,7,1,5,7,8,1,11,9,13,7,13,7,4,9,9,11,5,11,7,6,7,13,10,7,8,8,13,13,20,9,9,9,8,1,7,9,7,12,9,11,12,7,11,3,S ,1,1,20,1,1,1,1,1,1,1,1,1,1,1,1
19249335,Claudinho,1651,02/09/1991,24,0,0,0,0,174,74,1,3,2,1,2,2,2,1,2,2,3,7,10,11,11,10,8,9,10,4,8,10,5,9,11,9,11,13,11,10,10,14,4,10,14,11,8,11,12,12,12,14,7,11,14,12,20,14,8,10,10,10,5,10,17,11,11,13,12,6,12,7,AM/S R,1,1,17,1,1,20,1,1,1,1,1,1,1,1,1
19249336,Dener,1651,13/01/1995,21,0,0,0,0,177,70,3,1,2,2,2,2,3,2,3,2,2,7,7,9,9,14,7,7,12,4,11,9,2,12,12,9,8,8,7,9,9,13,4,7,11,8,11,13,6,10,10,9,9,8,13,11,20,8,6,9,7,7,3,9,10,9,10,10,11,9,16,6,DM/M C,1,1,1,1,1,1,1,1,1,20,17,1,1,1,1
19249338,Léo,1651,03/06/1994,22,0,0,0,0,190,0,2,2,3,2,3,2,3,2,2,1,2,4,4,1,7,8,1,13,5,1,13,8,5,13,5,10,10,10,8,11,6,13,10,8,10,4,13,7,8,13,11,8,14,9,15,9,20,5,11,13,10,10,10,10,18,11,12,11,11,6,12,7,D C,1,1,1,1,1,1,20,1,1,1,1,1,1,1,1
19249339,Luizão,1651,23/06/1990,26,0,0,0,0,186,78,2,2,3,1,2,3,2,2,2,2,1,4,3,5,4,9,6,14,6,9,13,11,10,14,10,16,11,13,9,12,7,13,14,3,10,6,12,12,14,12,7,10,14,12,12,11,20,13,16,10,15,13,9,7,14,13,12,15,12,11,18,15,D C,1,1,1,1,1,1,20,1,1,1,1,1,1,1,1
19249340,Julio Lopes,1651,09/08/1991,24,0,0,0,0,177,73,3,1,3,2,3,2,3,2,2,4,1,6,9,7,6,14,3,8,12,7,9,8,1,13,9,9,8,9,9,11,6,10,7,9,12,7,9,9,9,14,14,9,7,10,12,14,20,8,8,9,9,3,6,9,8,8,10,11,11,10,13,8,D/WB R,1,1,1,1,1,1,1,1,20,1,1,1,1,1,17
19249341,Lucas,1651,21/05/1996,20,0,0,0,0,175,0,3,1,2,1,1,2,2,3,1,3,2,7,5,14,14,13,8,13,7,1,5,9,11,2,14,10,10,7,14,7,8,13,10,13,1,13,8,8,9,14,11,8,3,8,12,10,20,14,6,10,5,10,4,9,17,11,11,11,10,2,9,3,S ,1,1,20,1,1,1,1,1,1,1,1,1,1,1,1
19249342,Lucas Dalara,1651,01/07/1994,22,0,0,0,0,187,81,7,10,7,8,13,7,6,13,8,7,8,1,3,1,1,2,6,1,2,3,2,1,2,2,4,6,9,13,6,13,5,13,5,3,1,3,9,6,5,10,8,6,8,8,14,11,20,2,8,8,8,8,8,8,20,13,12,10,13,11,10,3,GK ,20,1,1,1,1,1,1,1,1,1,1,1,1,1,1
19249345,Marlon,1651,13/02/1994,22,0,0,0,0,176,69,3,1,1,3,2,1,2,3,3,4,2,7,9,5,6,9,4,8,7,1,7,9,1,12,10,9,6,9,10,10,8,14,1,6,1,8,5,9,10,15,13,9,9,20,12,14,10,8,7,9,6,9,9,9,8,12,12,9,12,1,2,4,D/WB L,1,1,1,1,13,1,1,20,1,1,1,13,1,17,1
19249346,Rodrigo Bassani,1651,17/10/1997,18,0,0,0,0,185,0,2,3,4,2,1,1,3,3,3,3,4,6,6,8,8,14,6,6,4,1,6,14,3,8,11,8,10,7,9,5,10,7,7,10,11,9,7,8,12,14,10,4,11,8,14,13,20,8,7,8,8,1,8,8,9,9,11,11,13,8,9,5,M/AM C,1,1,1,20,1,1,1,1,1,1,17,1,1,1,1
19249347,Severino,1651,30/09/1994,21,0,0,0,0,189,0,1,1,2,3,1,1,1,3,1,3,3,4,1,1,2,5,1,13,4,2,13,5,1,13,3,8,11,9,7,7,6,13,1,2,9,5,13,6,7,13,9,2,12,4,11,12,20,8,11,9,9,9,4,9,10,9,12,11,12,1,6,7,D C,1,1,1,1,1,1,20,1,1,1,1,1,1,1,1
19249349,Vitinho,1651,16/05/1996,20,0,0,0,0,163,0,3,3,3,3,3,1,3,3,2,3,2,6,4,3,5,13,6,6,12,4,7,11,1,13,11,9,10,8,8,8,11,13,9,3,12,6,9,12,11,12,9,7,1,8,13,9,20,7,6,9,8,8,4,9,16,11,11,10,10,7,9,1,M C,1,1,1,1,1,1,1,1,1,14,20,1,1,1,1
19249350,Wesley,1651,18/03/1996,20,0,0,0,0,177,71,1,1,1,2,4,3,1,4,3,1,1,7,11,11,10,13,6,8,7,6,5,7,1,7,12,8,5,4,6,2,8,13,4,13,7,7,4,7,8,13,8,7,7,9,9,12,20,12,6,9,9,9,9,8,11,10,13,11,12,7,15,3,AM RL,1,1,15,7,20,17,1,1,1,1,1,1,1,1,1
19249368,Neto,1651,04/02/1992,24,0,0,0,0,179,0,1,1,1,2,1,2,3,2,2,3,3,8,8,11,9,10,9,9,7,3,8,8,7,4,11,7,10,12,11,11,7,10,10,12,8,11,8,10,12,14,12,9,6,11,13,13,20,12,8,10,6,10,12,9,17,12,11,9,10,6,13,7,AM/S RL,1,1,20,1,17,17,1,1,1,1,1,1,1,1,1
19249395,Augusto,1651,02/07/1994,22,0,0,0,0,187,0,1,3,3,2,1,2,1,1,2,2,2,7,7,13,9,13,8,14,11,8,8,12,5,8,11,6,10,6,9,9,12,11,8,10,4,13,12,9,10,14,12,10,14,9,14,10,20,14,9,12,7,10,4,10,20,10,10,11,12,11,6,7,AM/S C,1,1,17,20,1,1,1,1,1,1,1,1,1,1,1
19249396,Bruno Teixeira,1651,11/08/1996,19,0,0,0,0,179,0,2,2,1,2,3,3,2,1,1,3,3,5,5,4,4,13,5,5,13,1,5,12,4,10,12,8,4,7,7,7,7,13,4,5,11,5,9,7,10,13,8,7,6,5,14,12,20,6,6,8,8,7,8,8,7,10,12,11,12,4,11,8,DM/M C,1,1,1,1,1,1,1,1,1,17,20,1,1,1,1
19249398,Felipe Mendes,1651,08/11/1995,20,0,0,0,0,175,69,3,3,3,1,1,2,2,1,1,2,4,7,8,8,7,10,2,8,8,5,9,8,4,11,10,6,7,10,8,7,7,13,1,3,3,8,11,10,10,14,9,10,7,20,13,10,15,9,7,9,9,9,9,9,17,10,10,10,10,6,19,5,D/WB L,1,1,1,1,1,1,1,20,1,1,1,1,1,17,1
19249400,Gabriel Silva,1651,02/02/1997,19,0,0,0,0,186,0,2,3,2,2,2,2,3,3,1,1,3,5,4,1,2,2,3,12,5,1,13,4,1,11,3,9,4,9,4,7,6,13,9,6,1,5,12,6,7,13,10,7,12,12,11,10,20,7,8,9,9,9,7,9,8,12,11,12,8,7,17,3,D C,1,1,1,1,1,1,20,1,1,1,1,1,1,1,1
19249401,Gabriel Cajano,1651,16/04/1993,23,0,0,0,0,183,0,2,2,3,2,1,3,3,2,2,2,1,7,4,8,11,10,7,1,10,4,7,14,7,7,10,6,11,7,9,11,9,12,5,9,1,10,8,9,13,13,12,9,12,20,13,12,10,13,9,9,9,5,9,9,7,10,12,13,10,2,13,6,M/AM C,1,1,1,20,1,1,1,1,1,1,17,1,1,1,1
19249402,Israel,1651,23/04/1995,21,0,0,0,0,172,0,2,4,2,2,3,1,4,2,4,3,3,7,4,7,2,12,3,8,5,7,9,9,5,12,9,6,10,9,7,9,8,13,9,7,1,6,9,9,9,14,14,9,4,8,15,13,20,7,7,9,5,8,7,9,11,9,13,10,11,12,11,2,D/WB R,1,1,1,1,1,1,1,1,20,1,1,1,1,1,17
19249403,Johny,1651,08/02/1995,21,0,0,0,0,185,0,2,3,2,1,1,1,2,3,3,3,2,3,9,10,12,12,6,13,11,3,5,11,13,5,12,12,10,12,10,8,10,9,7,12,5,13,6,12,12,13,12,11,12,9,13,12,20,13,13,12,10,2,5,10,16,13,10,12,10,8,6,4,S ,1,1,20,1,1,1,1,1,1,1,1,1,1,1,1
19249405,Kewin,1651,25/01/1995,21,0,0,0,0,194,0,10,8,11,1,10,13,9,13,9,5,6,2,2,1,1,4,4,1,2,1,1,1,1,2,2,9,10,10,6,9,4,13,7,2,1,3,8,7,6,13,13,3,13,8,11,12,20,2,10,9,9,8,7,9,18,10,13,12,12,7,14,7,GK ,20,1,1,1,1,1,1,1,1,1,1,1,1,1,1
19249407,Mateus Lima,1651,05/08/1994,21,0,0,0,0,182,0,2,3,2,2,1,3,1,4,3,4,3,8,5,1,6,8,6,14,5,2,14,8,6,14,4,9,9,10,5,8,6,15,4,3,9,6,11,8,9,7,9,9,11,9,16,10,20,8,10,9,9,2,9,9,14,11,11,9,10,7,9,2,D C,1,1,1,1,1,1,20,1,1,1,1,1,1,1,1
19249408,Luan,1651,31/05/1996,20,0,0,0,0,180,74,3,2,1,2,4,2,2,3,3,2,2,8,6,4,3,9,6,13,4,3,14,9,2,14,5,8,9,10,7,11,6,14,1,4,9,5,14,8,9,14,11,9,8,10,14,13,20,6,10,10,6,4,10,10,18,10,9,12,10,1,18,6,D C,1,1,1,1,1,1,20,1,1,10,1,1,1,1,1
19249409,Lucas Chinaqui,1651,29/03/1994,22,0,0,0,0,186,80,1,1,2,3,2,2,2,1,2,2,1,7,2,5,8,13,7,7,13,2,10,12,6,14,14,6,11,8,9,4,10,14,9,5,10,8,12,9,9,9,11,9,9,20,9,14,10,6,8,9,9,2,9,9,18,9,10,12,11,5,8,2,DM/M C,1,1,1,1,1,1,1,1,1,20,17,1,1,1,1
19249410,Pará,1651,02/02/1997,19,0,0,0,0,187,0,3,1,4,2,3,1,3,4,1,3,1,6,6,8,8,13,6,6,6,5,3,13,5,8,12,5,7,8,9,8,13,11,9,12,12,11,8,8,11,13,12,8,8,8,9,12,20,7,8,9,9,9,9,9,11,11,13,13,9,4,6,8,M/AM C,1,1,1,17,1,1,1,1,1,1,20,1,1,1,1
19249412,Mayk,1651,11/10/1995,20,0,0,0,0,172,0,3,3,2,2,2,2,2,2,1,3,3,9,13,14,7,11,7,8,6,5,6,9,3,8,12,2,10,3,7,8,10,12,9,15,9,12,8,7,9,14,14,4,7,2,14,14,20,10,4,9,9,1,9,9,8,10,11,12,12,9,13,3,AM RLC,1,1,13,17,17,20,1,1,1,1,7,10,10,1,1
19249413,Luís,1651,02/08/1997,18,0,0,0,0,173,0,1,3,3,1,2,2,3,2,2,2,2,6,12,12,6,14,2,9,8,6,10,10,2,15,10,6,10,10,5,6,5,8,9,9,5,5,6,10,10,13,13,10,6,9,10,12,20,8,8,7,9,9,9,9,16,10,10,12,8,8,9,8,D/WB R,1,1,1,1,1,1,1,1,20,1,1,1,1,1,17
19249415,Matheus Manoel,1651,03/04/1997,19,0,0,0,0,189,0,3,1,1,1,2,3,1,2,1,1,2,5,5,11,12,12,5,12,5,1,2,5,8,4,12,3,11,7,9,5,5,8,2,13,7,5,4,5,2,12,12,6,7,20,13,12,10,6,7,9,9,9,5,9,13,12,11,10,11,12,9,5,S ,1,1,20,1,1,1,1,1,1,1,1,1,1,1,1
19249416,Mizael,1651,14/02/1992,24,0,0,0,0,175,70,2,3,1,3,2,1,1,2,3,3,3,5,8,7,4,14,2,9,8,5,10,10,4,9,10,9,9,10,10,9,8,13,9,7,9,5,9,10,10,14,13,10,9,10,13,13,20,12,12,9,9,6,9,9,12,9,14,10,13,10,8,2,D/WB R,1,1,1,1,1,1,1,1,20,1,1,1,1,1,17
19249417,Renan,1651,28/07/1996,19,0,0,0,0,180,76,2,3,2,2,3,2,4,3,3,1,3,1,1,1,2,5,1,9,1,1,12,3,3,12,3,8,11,8,5,7,1,12,5,1,8,2,11,4,5,11,9,9,8,9,9,9,20,10,8,8,14,8,4,8,18,10,11,11,9,4,1,5,D C,1,1,1,1,1,1,20,1,1,1,1,1,1,1,1
19249456,Paulo Victor,1651,22/01/1995,21,0,0,0,0,188,87,4,9,8,1,13,5,9,7,9,8,8,7,1,1,2,4,9,1,2,3,3,1,2,1,2,9,6,11,7,8,6,13,3,1,5,2,11,7,6,10,14,7,13,20,15,8,9,5,14,9,4,7,9,9,15,11,10,9,11,1,12,6,GK ,20,1,1,1,1,1,1,1,1,1,1,1,1,1,1
19249459,Fernando Santos,1651,18/09/1991,24,0,0,0,0,176,67,1,4,1,3,3,3,2,3,1,1,3,13,12,9,11,11,7,4,11,1,7,12,6,7,12,14,10,7,11,7,12,13,8,10,10,11,6,14,9,13,11,12,6,10,11,11,20,9,7,12,7,12,9,10,11,11,12,10,11,8,10,4,AM C,1,1,1,20,1,1,1,1,1,1,10,1,1,1,1
19249461,Yuri,1651,09/01/1996,20,0,0,0,0,163,63,3,1,3,3,2,2,3,2,3,2,2,10,15,15,10,15,6,8,10,8,6,9,9,6,13,9,8,6,12,7,7,13,4,11,6,10,8,10,13,12,14,10,1,1,14,15,20,9,6,9,7,4,9,9,11,11,9,12,10,6,17,5,AM RL,1,1,10,10,19,20,1,1,1,1,1,1,1,1,1
19249465,Igor Pato,1651,18/06/1993,23,0,0,0,0,179,0,1,2,3,4,2,4,3,3,2,2,3,7,5,9,9,13,7,5,13,5,6,11,1,9,13,5,9,7,7,7,13,9,4,13,11,13,7,8,11,13,13,8,7,11,8,13,20,13,6,10,8,10,9,10,9,9,11,12,10,5,12,1,AM C,1,1,1,20,1,1,1,1,1,1,15,1,1,1,1
19249467,Róbson Duarte,1651,20/06/1993,23,0,0,0,0,174,68,3,3,1,2,3,3,2,4,3,2,1,7,5,13,13,12,7,13,7,4,5,8,8,2,8,9,11,9,13,7,7,13,5,9,12,13,8,7,8,12,9,3,7,9,13,10,20,12,9,10,10,10,6,9,16,10,14,11,10,14,9,1,S ,1,1,20,1,1,1,1,1,1,1,1,1,1,1,1
19249477,Anderson Ligeiro,1651,21/04/1995,21,0,0,0,0,168,57,3,2,1,1,2,1,3,1,1,1,3,3,7,13,11,13,4,13,9,3,7,11,5,4,10,10,9,7,10,8,8,11,19,10,7,10,9,8,9,15,15,8,2,10,12,17,20,10,5,10,10,6,8,10,10,13,13,10,9,1,13,1,AM/S C,1,1,18,20,1,1,1,1,1,1,12,1,1,1,1
19249478,Jean,1651,26/01/1993,23,0,0,0,0,182,80,1,3,1,1,3,3,3,2,3,2,3,8,8,8,8,14,6,10,7,6,10,11,3,13,11,10,12,11,10,8,9,10,10,9,12,9,11,10,10,15,15,10,11,11,17,15,20,9,8,10,8,10,7,10,15,13,11,11,10,10,9,4,D R,1,1,1,1,1,1,1,1,20,1,1,1,1,1,15
19249481,Diego,1651,08/05/1994,22,0,0,0,0,187,0,2,3,2,1,1,1,2,2,3,3,2,2,3,3,4,7,1,13,4,1,13,5,2,13,3,9,7,9,7,8,3,13,1,1,14,6,13,6,8,13,12,7,11,5,8,10,20,12,9,9,5,1,9,9,14,13,13,13,11,11,15,5,D C,1,1,1,1,1,1,20,1,1,1,1,1,1,1,1
19249483,Willians,1651,30/05/1995,21,0,0,0,0,179,0,2,1,2,1,2,3,1,3,3,2,1,4,4,6,9,15,8,8,7,1,11,15,6,13,14,9,10,8,10,8,14,8,8,3,2,4,11,9,13,15,15,9,8,7,12,15,20,8,8,6,9,9,6,9,9,12,11,10,12,8,8,3,DM C,1,1,1,1,1,1,1,1,1,20,15,1,1,1,1
19249485,Gabriel Elias,1651,14/03/1996,20,0,0,0,0,174,62,2,1,3,3,3,1,2,3,1,3,3,3,7,8,9,14,6,6,7,3,7,11,7,9,14,9,8,8,10,8,14,11,5,13,8,9,8,8,13,12,13,8,5,9,11,14,20,8,6,9,7,1,5,9,12,11,12,11,9,7,7,5,AM C,1,1,1,20,1,1,1,1,1,1,15,1,1,1,1
19249496,Renan,1651,14/10/1995,20,0,0,0,0,195,94,12,8,8,1,13,12,10,13,9,9,10,2,2,1,3,1,5,1,1,3,2,1,2,3,6,9,6,15,7,7,6,13,7,1,12,1,4,7,5,10,10,7,16,6,12,13,20,1,10,9,7,9,6,9,12,10,14,10,11,1,9,2,GK ,20,1,1,1,1,1,1,1,1,1,1,1,1,1,1
19249497,Igor Rodrigues,1651,05/01/1996,20,0,0,0,0,188,79,13,11,8,5,13,8,9,13,4,9,11,2,2,3,3,1,6,1,3,1,1,1,2,3,1,10,7,15,4,11,7,13,10,2,12,2,13,8,6,12,10,8,13,9,12,11,20,2,9,10,10,10,3,9,16,11,13,12,13,7,2,5,GK ,20,1,1,1,1,1,1,1,1,1,1,1,1,1,1
19249499,Dedé,1651,22/01/1995,21,0,0,0,0,184,77,3,4,3,1,1,2,2,3,2,2,1,6,8,10,9,11,6,12,11,7,13,10,5,13,11,13,11,12,9,9,8,10,16,8,4,9,13,14,13,13,12,9,12,10,13,12,20,14,14,13,12,11,4,10,8,12,10,9,11,2,5,5,D/DM C,1,1,1,1,1,1,20,1,1,18,10,1,1,1,1
19249500,Gustavo Blanco,1651,03/10/1994,21,0,0,0,0,174,66,2,2,3,2,2,1,1,1,2,2,3,12,11,12,12,13,11,6,11,4,10,12,12,10,13,8,12,10,12,7,12,10,13,15,7,14,12,12,11,13,13,9,7,10,13,13,20,12,7,12,5,12,4,15,13,9,13,14,13,8,15,5,DM/M/AM RC,1,1,6,18,10,15,1,1,1,16,20,8,13,1,1
19249501,Rodrigo Becão,1651,19/01/1996,20,0,0,0,0,191,80,1,2,3,1,2,2,2,1,1,1,3,4,7,7,7,9,7,14,7,5,13,8,10,14,9,13,11,13,9,9,7,10,13,8,8,12,12,14,14,12,12,10,15,8,13,12,20,14,14,12,12,10,4,5,11,11,12,11,12,10,11,12,D C,1,1,1,1,1,1,20,1,1,1,1,1,1,1,1
19249507,Ronaldo,1651,22/08/1996,19,0,0,0,0,194,0,14,13,8,10,12,10,14,13,10,6,13,4,2,3,3,3,7,1,1,1,1,2,3,1,7,7,6,11,6,10,8,14,7,3,7,1,8,9,8,14,7,9,16,16,15,13,20,4,11,10,10,4,9,9,12,11,12,9,13,10,9,4,GK ,20,1,1,1,1,1,1,1,1,1,1,1,1,1,1
19249508,Nickson,1651,26/08/1997,18,0,0,0,0,175,67,1,1,3,2,2,2,3,4,2,1,2,11,11,14,12,14,11,5,13,3,6,13,11,6,14,7,12,8,13,8,13,10,12,14,4,13,7,7,11,14,14,9,7,7,13,14,20,12,5,12,6,13,5,11,7,9,12,13,13,10,11,8,M/AM RC,1,1,11,20,14,17,1,1,1,1,17,10,13,1,1
19249509,Gabriel Morbeck,1651,20/08/1997,18,0,0,0,0,185,78,1,1,1,2,3,2,2,2,2,3,3,6,9,12,12,12,8,11,11,7,7,11,11,6,12,11,11,10,10,9,11,9,2,12,4,12,8,11,12,13,12,11,12,7,13,13,20,12,12,12,10,10,4,12,17,10,10,10,11,7,12,2,AM/S L,1,1,20,1,18,11,1,1,1,1,1,1,1,1,1
19249510,David,1651,17/10/1995,20,0,0,0,0,175,68,4,2,2,3,1,2,2,3,2,1,2,10,11,14,9,13,7,5,11,4,9,12,11,8,13,11,13,11,11,8,11,10,13,14,3,13,9,10,12,15,16,11,7,6,12,14,20,13,6,13,6,13,5,11,13,11,12,14,12,11,12,6,AM RL,1,1,10,13,20,18,1,1,1,1,10,14,13,1,1
19249516,Marciel,1651,02/02/1989,27,0,0,0,0,180,73,1,3,1,4,2,2,1,3,4,2,2,6,6,13,13,13,6,13,6,1,6,7,4,1,11,9,8,3,6,7,6,11,1,11,10,13,7,6,7,13,13,7,7,10,14,13,20,5,6,9,9,9,9,8,12,13,10,13,11,7,12,7,S ,1,1,20,1,1,1,1,1,1,1,1,1,1,1,1
19249526,Murilo,1651,20/11/1994,21,0,0,0,0,177,76,1,3,4,1,3,3,2,4,2,1,3,8,9,12,12,13,8,8,12,4,5,13,9,10,12,12,4,10,12,13,12,12,10,18,13,13,7,11,15,13,12,12,8,12,15,12,20,10,12,10,10,12,10,13,11,9,11,10,11,7,12,3,AM C,1,1,1,20,1,1,1,1,1,1,10,1,1,1,1
19249530,Danilo,1651,21/01/1992,24,0,0,0,0,173,66,4,1,1,3,3,1,2,3,3,3,2,7,7,14,14,9,7,8,4,3,7,11,6,6,14,6,10,8,5,7,10,10,9,15,7,14,7,4,9,13,13,9,4,9,4,13,20,10,8,9,8,7,9,9,18,10,10,10,13,7,4,1,AM/S C,1,1,17,20,1,1,1,1,1,1,10,1,1,1,1
19249600,Felipe Baiano,1651,31/12/1988,27,0,0,0,0,178,71,3,2,1,3,2,1,1,2,1,2,1,6,6,7,7,14,8,8,14,7,9,12,5,14,14,10,13,9,10,8,10,13,10,10,13,8,12,10,12,14,14,10,5,10,17,14,20,8,7,10,10,10,8,10,17,10,11,12,11,7,15,3,DM/M C,1,1,1,1,1,1,1,1,1,20,19,1,1,1,1
19249629,Caju,1651,17/07/1995,20,0,0,0,0,185,70,1,2,4,2,1,3,1,3,1,1,3,12,12,14,12,13,8,7,11,8,13,14,5,11,13,8,13,10,12,13,10,12,6,12,8,14,11,12,15,15,14,10,8,20,15,15,10,14,11,12,8,11,11,11,12,13,14,10,12,1,8,2,D L,1,1,1,1,1,1,1,20,1,1,1,1,1,13,1
19249630,Bruno Leonardo,1651,02/06/1996,20,0,0,0,0,186,79,3,1,2,1,1,3,4,2,1,1,3,6,2,6,3,9,4,14,5,4,13,9,1,14,13,8,11,10,9,9,6,14,10,5,2,8,13,8,9,14,13,9,13,5,13,13,20,8,10,10,4,8,10,10,10,10,10,13,10,10,2,3,D C,1,1,1,1,1,1,20,1,1,1,1,1,1,1,1
19249631,Lucas Veríssimo,1651,07/07/1995,20,0,0,0,0,189,75,1,2,3,1,1,3,1,2,3,1,2,6,7,10,10,10,9,13,10,11,13,11,7,14,11,13,12,12,12,13,8,13,19,8,12,8,13,12,10,12,12,15,14,10,13,13,20,14,13,12,13,10,12,11,15,10,10,11,11,2,6,7,D C,1,1,1,1,1,1,20,1,1,1,1,1,1,1,1
19249679,Kaiqui,1651,01/02/1993,23,0,0,0,0,181,66,2,2,3,1,2,2,1,3,2,3,2,6,2,7,7,13,6,6,10,3,13,13,1,11,13,9,9,6,8,7,13,13,7,9,12,9,7,7,12,13,13,7,6,3,14,13,20,9,6,9,9,9,9,9,14,13,11,12,11,5,11,5,M C,1,1,1,1,1,1,1,1,1,1,20,1,1,1,1
19249683,Douglão,1651,16/01/1995,21,0,0,0,0,188,88,4,2,3,1,3,1,2,2,1,3,1,7,6,14,9,13,7,11,8,2,7,6,5,3,8,9,11,3,13,8,6,9,9,7,13,9,8,7,8,12,7,7,14,9,13,11,20,10,14,9,9,9,9,9,13,12,10,12,12,13,15,6,S ,1,1,20,1,1,1,1,1,1,1,1,1,1,1,1
19249705,Warian,1651,14/06/1996,20,0,0,0,0,177,68,2,3,3,1,1,2,3,3,1,3,3,6,7,5,8,14,4,7,10,4,8,11,5,14,12,9,9,8,4,9,10,14,5,6,10,6,8,8,12,14,13,8,9,10,13,14,20,13,7,9,9,9,6,9,20,10,13,12,10,8,13,3,DM ,1,1,1,1,1,1,1,1,1,20,10,1,1,1,1
19249709,Tsunami,1651,04/01/1996,20,0,0,0,0,189,79,3,2,2,1,2,3,2,1,1,3,1,5,6,5,7,9,7,14,6,1,7,9,7,13,8,9,11,9,8,11,8,14,5,9,9,7,11,7,9,14,11,8,8,20,12,14,10,9,9,9,9,2,9,9,15,9,11,11,10,2,3,3,D/DM C,1,1,1,1,1,1,20,10,1,18,10,1,1,1,1
19249710,Denílson,1651,31/03/1994,22,0,0,0,0,186,0,2,3,2,1,4,3,3,1,1,1,1,6,5,6,6,12,3,7,6,6,8,7,5,13,7,9,9,9,8,9,7,13,9,4,9,6,4,8,8,13,9,3,10,20,13,11,9,12,10,9,7,5,9,9,13,13,10,9,10,7,6,3,D/WB L,1,1,1,1,1,1,1,20,1,1,1,1,1,19,1
19249714,Williams da Luz,1651,03/10/1997,18,0,0,0,0,177,69,2,1,2,3,1,1,1,3,3,1,1,10,13,11,9,13,8,7,10,7,7,11,3,9,13,10,10,9,6,9,10,7,10,12,4,9,4,7,10,15,10,8,7,20,17,14,10,9,4,10,10,4,10,10,17,11,12,12,11,1,13,4,AM LC,1,1,1,20,19,1,1,1,1,1,10,15,1,1,1
19249718,Arthur,1651,07/01/1998,18,0,0,0,0,178,0,2,2,2,2,3,1,1,1,2,2,1,4,3,5,8,9,1,12,2,1,9,11,2,14,8,9,8,10,9,8,8,14,8,1,3,8,11,11,9,13,10,9,12,4,14,9,20,7,9,9,9,9,9,9,15,9,9,12,11,13,12,1,D C,1,1,1,1,1,1,20,1,1,1,1,1,1,1,1
19249719,Gabriel Batista,1651,03/06/1998,18,0,0,0,0,193,0,12,8,8,1,10,11,12,11,7,7,10,4,1,2,1,1,8,1,2,2,1,1,2,2,5,7,6,13,6,12,5,12,16,1,9,3,12,6,3,9,13,5,11,4,5,12,20,1,10,9,8,4,9,9,19,12,9,11,9,3,14,8,GK ,20,1,1,1,1,1,1,1,1,1,1,1,1,1,1
19249721,Pepê,1651,06/01/1998,18,0,0,0,0,173,0,3,1,2,3,1,3,3,2,1,1,1,5,5,12,10,14,7,7,10,2,6,12,5,8,14,11,6,8,10,7,13,11,7,13,6,7,5,8,11,13,14,7,8,5,13,14,20,9,5,9,6,9,5,9,13,11,8,12,13,1,5,3,M/AM C,1,1,1,20,1,1,1,1,1,1,16,1,1,1,1
19249722,João Lopes,1651,16/01/1996,20,0,0,0,0,187,0,13,9,11,1,13,13,6,13,8,9,11,2,3,2,2,4,5,1,3,3,2,1,4,3,1,9,7,12,7,12,6,13,10,2,4,2,9,7,6,10,14,7,8,5,6,9,20,2,7,9,7,6,9,8,7,12,10,12,10,11,9,4,GK ,20,1,1,1,1,1,1,1,1,1,1,1,1,1,1
19249723,Pedro Pires,1651,22/01/1996,20,0,0,0,0,179,0,3,2,3,3,3,3,2,1,1,2,3,7,7,12,10,14,7,2,14,5,7,12,5,9,12,9,13,8,7,8,12,13,17,12,12,12,7,8,13,12,13,8,7,5,14,11,20,12,5,8,4,9,4,9,13,10,10,11,11,9,10,3,AM C,1,1,1,20,1,1,1,1,1,1,14,1,1,1,1
19249726,Pilar,1651,24/05/1997,19,0,0,0,0,178,72,1,2,3,3,2,3,2,1,2,2,4,6,6,14,14,10,7,14,4,3,6,8,7,1,12,9,11,1,13,7,7,12,9,11,8,14,8,7,8,14,10,4,5,10,13,13,20,5,7,9,5,7,4,8,8,14,11,13,12,6,18,1,S ,1,1,20,1,1,1,1,1,1,1,1,1,1,1,1
19249732,Esquerdinha,1651,16/11/1990,25,0,0,0,0,181,65,1,1,1,3,3,3,1,1,3,2,2,8,11,11,11,12,8,8,10,6,7,12,11,6,12,10,11,11,10,13,13,10,10,12,8,12,7,12,12,11,11,11,10,20,12,13,11,11,10,12,5,6,9,12,9,10,12,12,11,11,16,2,M/AM LC,1,1,1,19,20,1,1,1,1,1,10,17,1,1,1
19249752,Wellington Cézar,1651,21/12/1993,22,0,0,0,0,183,79,3,2,1,1,1,3,1,1,2,3,1,11,11,6,11,12,11,13,14,11,13,12,7,13,9,15,11,13,12,10,12,10,7,9,7,11,14,14,14,11,11,13,13,11,15,12,20,14,15,11,15,5,4,8,11,11,11,9,12,10,17,6,DM ,1,1,1,1,1,1,1,1,1,20,10,1,1,1,1
19249763,William Mineiro,1651,03/02/1993,23,0,0,0,0,183,0,2,4,2,4,1,3,3,2,3,3,2,7,5,2,2,7,5,14,2,2,14,9,2,14,8,10,14,10,8,12,6,13,1,3,10,8,14,8,9,14,12,9,6,9,13,11,20,7,10,10,9,3,7,10,10,11,10,12,11,1,4,3,D C,1,1,1,1,1,1,20,1,1,1,1,1,1,1,1
19249770,Neto Moura,1651,06/08/1996,19,0,0,0,0,176,72,1,3,2,2,2,2,3,2,3,2,4,10,9,11,11,12,10,11,12,5,13,13,10,14,15,13,13,14,11,9,11,15,17,10,9,12,8,14,12,12,13,6,9,11,15,12,20,9,9,12,8,9,11,13,8,12,12,12,12,1,18,6,DM/M C,1,1,1,1,1,1,1,1,1,18,20,1,1,1,1
19249773,Thiago Santos,1651,05/09/1989,26,0,0,0,0,181,78,1,2,3,3,3,2,2,2,1,1,1,6,8,9,9,11,7,12,8,11,14,11,8,14,10,14,13,15,13,13,10,13,9,11,9,10,13,15,15,13,11,11,12,9,13,12,20,14,13,13,13,11,7,6,9,13,10,12,9,9,12,1,DM ,1,1,1,1,1,1,13,1,1,20,11,1,1,1,1
19249777,Gláucio,1651,03/02/1994,22,0,0,0,0,184,76,3,3,3,2,1,3,1,3,1,3,3,5,3,9,12,11,5,12,5,1,3,4,7,1,7,9,10,8,7,6,5,11,1,9,3,12,6,5,6,12,11,5,11,20,5,12,9,9,9,9,9,5,9,9,20,9,11,9,14,1,13,3,S ,1,1,20,1,1,1,1,1,1,1,1,1,1,1,1
19249790,Rony,1651,11/05/1995,21,0,0,0,0,175,67,2,3,2,1,1,3,2,4,3,2,3,7,8,12,15,15,8,15,10,4,9,11,8,5,14,11,8,8,14,11,8,10,17,12,14,15,10,10,11,15,13,11,8,11,14,14,20,9,8,11,7,11,11,11,10,9,12,12,10,1,15,6,S ,1,1,20,1,1,1,1,1,1,1,1,1,1,1,1
19249821,Eric,1651,14/07/1990,25,0,0,0,0,192,87,3,2,1,3,3,1,1,3,2,2,1,7,7,14,10,10,8,14,9,2,6,5,5,4,10,9,11,5,10,9,9,13,9,9,10,10,9,8,9,9,7,9,16,20,13,6,10,14,13,9,9,9,9,9,12,10,4,11,10,2,7,4,S ,1,1,20,1,1,1,1,1,1,1,1,1,1,1,1
19249832,Núbio Flávio,1651,25/05/1992,24,0,0,0,0,180,74,3,3,4,2,2,2,2,3,1,4,1,5,7,10,13,11,6,13,6,1,4,7,8,1,8,9,12,3,8,5,7,10,5,8,5,13,6,6,7,13,13,7,6,10,13,12,20,5,13,9,9,3,8,9,19,10,11,12,12,11,4,1,S ,1,1,20,1,1,1,1,1,1,1,1,1,1,1,1
19249847,Pedro Henrique,1651,14/06/1993,23,0,0,0,0,184,81,1,2,1,3,2,3,3,2,2,2,2,11,10,11,8,12,10,7,10,10,6,11,6,10,12,7,10,8,10,10,10,11,9,10,2,10,7,10,9,11,12,13,12,20,14,12,8,10,10,10,4,7,10,10,9,11,11,12,11,7,1,2,AM LC,1,1,10,20,18,12,1,1,1,1,1,15,1,1,1
19249851,Robinho,1651,19/01/1995,21,0,0,0,0,166,62,3,1,1,3,4,1,2,1,2,2,1,7,10,13,10,13,8,5,11,4,5,12,12,5,12,10,12,9,9,8,11,10,6,14,4,12,7,8,10,14,15,10,3,10,12,14,20,12,6,10,10,6,6,11,17,11,11,11,11,1,7,5,AM/S RL,1,1,18,1,19,20,1,1,1,1,1,1,1,1,1
19249856,Fernando Sobral,1651,17/12/1994,21,0,0,0,0,178,70,3,2,2,2,2,3,1,3,2,3,3,6,5,13,8,11,6,6,9,1,6,8,7,7,13,6,5,5,12,7,11,12,4,13,2,7,7,7,10,11,13,10,8,10,11,13,20,8,7,9,7,9,9,9,10,10,11,10,9,8,9,1,AM C,1,1,1,20,1,1,1,1,1,1,10,1,1,1,1
19249860,Maksuel,1651,10/11/1993,22,0,0,0,0,187,0,3,3,2,1,3,2,2,3,2,2,2,7,7,7,3,14,5,7,12,4,13,13,2,8,12,6,10,6,9,8,12,14,9,4,4,11,8,8,10,9,11,3,11,9,11,12,20,9,9,9,9,9,7,9,11,9,11,11,12,13,1,3,M C,1,1,1,1,1,1,1,1,1,1,20,1,1,1,1
19249861,Rodney,1651,16/04/1990,26,0,0,0,0,173,72,2,3,4,2,1,2,1,1,1,1,4,6,8,7,7,9,8,9,7,6,11,12,5,14,10,8,10,9,9,10,7,14,3,9,10,8,14,9,11,14,14,9,2,9,13,14,20,14,9,10,6,8,8,10,15,14,11,12,9,5,15,5,DM ,1,1,1,1,1,1,13,1,1,20,10,1,1,1,1
19249867,Gabriel Vasconcelos,1651,24/10/1995,20,0,0,0,0,175,70,2,3,3,2,3,2,1,2,3,2,1,9,10,11,12,15,6,15,11,9,7,10,9,9,11,1,9,5,13,8,10,8,11,10,9,13,7,9,11,13,13,13,7,11,7,14,20,11,8,10,10,10,9,10,8,11,12,10,10,10,1,7,S ,1,1,20,9,12,12,1,1,1,1,1,1,1,1,1
19249872,Guilherme Lucena,1651,18/05/1994,22,0,0,0,0,173,68,2,2,1,2,3,3,2,2,1,3,4,9,11,10,9,14,8,8,8,8,9,10,3,10,12,8,11,9,5,10,10,12,4,11,3,9,10,9,10,10,14,9,3,11,10,14,20,13,6,10,9,10,8,10,10,12,8,12,13,9,6,6,D/WB/AM RC,1,1,1,15,14,18,1,1,20,1,1,1,13,1,19
19249875,Cassiano,1651,09/01/1997,19,0,0,0,0,171,0,1,3,3,4,1,1,2,2,1,3,3,9,9,11,12,9,9,9,8,4,9,10,9,6,11,3,11,8,11,10,9,15,15,10,8,12,7,12,12,12,12,10,7,20,11,12,9,15,10,10,10,3,6,10,18,12,11,12,10,1,8,1,S ,1,1,20,1,1,1,1,1,1,1,1,1,1,1,1
19249877,Raul,1651,04/04/1997,19,0,0,0,0,175,70,1,3,2,1,1,3,1,2,1,3,3,11,12,11,9,12,12,9,10,12,10,11,11,10,12,5,12,8,9,10,10,12,8,4,3,12,11,10,11,13,12,11,11,9,12,13,20,12,8,10,5,3,10,10,17,12,12,9,8,6,6,5,D/WB R,1,1,1,1,1,1,1,1,20,1,1,1,1,1,19
19249878,Lincoln,1651,07/11/1998,17,0,0,0,0,178,65,1,3,1,2,1,3,2,1,3,1,3,12,11,12,11,12,12,9,12,8,7,13,12,7,13,8,12,10,12,10,13,12,13,16,10,14,10,11,11,13,14,13,9,20,13,13,7,12,12,11,5,9,5,14,9,17,12,12,12,10,10,6,AM LC,1,1,5,20,19,14,1,1,1,1,15,12,1,1,1
19249888,Fernando,1651,03/11/1990,25,0,0,0,0,181,80,2,2,1,2,2,1,2,3,1,2,2,6,4,6,7,13,5,6,11,1,9,13,2,13,8,9,10,8,2,9,9,11,4,7,7,6,12,7,11,13,13,7,8,10,16,13,20,9,9,9,4,9,9,9,13,12,12,12,9,5,10,5,DM ,1,1,1,1,1,1,1,1,1,20,10,1,1,1,1
19249895,Ramires,1651,14/02/1987,29,0,0,0,0,185,88,1,3,1,2,2,2,4,1,2,2,1,9,9,7,5,15,9,9,9,1,9,10,7,15,15,9,10,10,7,7,11,11,10,1,12,7,15,10,14,13,15,7,9,2,14,15,20,14,8,10,6,6,5,10,11,12,12,13,11,1,1,3,DM ,1,1,1,1,1,1,1,1,1,20,10,1,1,1,1
19249898,Alisson,1651,01/02/1994,22,0,0,0,0,188,74,2,1,1,2,3,3,1,2,1,1,2,6,7,5,6,4,2,14,6,7,14,7,5,14,5,10,11,10,9,11,6,14,17,1,9,8,14,8,9,14,12,9,12,10,17,13,20,10,10,12,10,9,10,10,9,11,10,9,8,1,14,6,D C,1,1,1,1,1,1,20,1,1,1,1,1,1,1,1
19249901,Jean,1651,26/09/1994,21,0,0,0,0,183,81,2,1,2,3,2,2,2,1,2,1,2,7,8,10,10,11,8,14,13,10,13,11,6,13,11,15,13,14,11,12,11,12,10,10,9,11,13,15,14,11,11,14,14,14,14,11,20,14,14,11,13,11,8,10,12,11,9,11,12,9,9,2,DM ,1,1,1,1,1,1,14,1,1,20,10,1,1,1,1
19249903,Leandro Vilela,1651,29/06/1995,21,0,0,0,0,177,75,3,2,2,2,3,3,2,3,3,1,1,5,7,7,8,13,7,7,11,6,7,12,6,12,13,5,9,9,8,8,11,13,10,9,2,5,8,8,11,9,12,8,8,16,14,13,20,7,7,10,4,10,10,10,18,13,12,10,9,2,8,8,DM ,1,1,1,1,1,1,1,1,1,20,10,1,1,1,1
19249904,Yan,1651,29/11/1994,21,0,0,0,0,180,81,2,3,3,3,2,2,3,3,3,1,2,8,5,6,6,10,4,8,8,8,10,10,8,10,10,7,9,10,10,7,10,11,9,8,15,8,9,10,10,9,14,10,7,9,14,13,20,15,8,9,7,6,9,9,8,10,9,9,11,2,15,3,D/WB R,1,1,1,1,1,1,1,1,20,1,1,1,1,1,19
19249916,Raniel,1651,11/06/1996,20,0,0,0,0,185,71,2,4,3,2,1,2,4,1,2,3,3,8,9,13,11,12,13,9,9,6,7,12,11,8,12,10,13,10,12,10,12,11,10,13,10,13,8,12,12,15,14,8,12,6,12,14,20,13,7,10,8,10,6,15,10,12,12,9,8,6,8,2,AM/S RC,1,1,20,18,1,19,1,1,1,1,10,1,1,1,1
19249917,Caio César,1651,27/07/1995,20,0,0,0,0,193,76,3,3,1,1,3,2,2,2,1,1,3,6,8,9,10,11,9,12,9,10,7,10,10,8,11,13,11,13,9,9,10,9,16,8,11,11,10,11,12,13,12,7,16,13,3,13,20,11,10,9,13,1,10,10,9,9,11,12,10,8,4,3,AM RL,1,1,15,13,16,20,1,1,1,1,1,1,1,1,1
19249923,Léo Gomes,1651,30/03/1996,20,0,0,0,0,178,70,2,3,2,3,3,1,3,2,2,3,3,11,12,10,8,16,11,11,9,11,10,15,8,16,13,7,14,11,13,9,10,16,9,8,11,10,10,13,13,13,15,9,7,2,7,12,20,9,10,6,7,2,11,11,20,9,10,10,10,7,7,4,D/WB/DM R,1,1,1,1,1,1,1,1,20,16,13,1,1,1,19
19249924,Matheus Anderson,1651,06/03/1994,22,0,0,0,0,177,68,3,1,2,1,1,3,1,1,4,1,3,8,9,14,14,12,8,14,5,3,8,8,10,6,14,10,10,9,14,7,9,6,1,13,6,13,9,8,9,14,14,7,6,8,17,14,20,7,6,10,5,9,7,10,13,10,9,13,11,5,11,5,S ,1,1,20,1,1,1,1,1,1,1,1,1,1,1,1
19249926,Wanderson Lima,1651,09/02/1995,21,0,0,0,0,170,65,3,3,3,3,2,1,2,1,3,3,1,10,11,10,8,9,11,10,11,8,12,9,10,10,11,9,9,11,10,9,10,8,13,8,7,10,9,9,11,12,13,12,9,10,13,12,20,13,11,9,6,8,9,12,9,12,11,10,10,6,14,10,D/WB R,1,1,1,1,1,1,1,1,20,1,1,1,1,1,19
19249986,Bosco,1651,26/12/1992,23,0,0,0,0,186,78,3,2,1,2,2,1,1,3,1,3,1,7,5,3,8,13,6,7,8,2,11,13,5,13,13,8,13,5,8,7,6,11,6,6,13,7,9,8,11,13,13,8,12,10,17,13,20,7,10,10,3,5,7,10,10,13,9,10,10,8,17,5,DM ,1,1,1,1,1,1,1,1,1,20,10,1,1,1,1
19250011,Dioguinho,1651,05/08/1997,18,0,0,0,0,180,0,1,1,2,3,1,2,1,3,2,3,1,3,4,10,10,13,6,3,13,3,6,13,5,4,13,9,4,4,5,7,13,13,3,13,10,5,7,7,10,13,13,7,10,8,15,13,20,6,5,9,5,1,4,9,12,9,10,9,13,1,11,4,AM C,1,1,1,20,1,1,1,1,1,1,10,1,1,1,1
19250013,Hayner,1651,02/10/1995,20,0,0,0,0,174,68,3,3,4,1,3,2,3,2,2,2,2,10,11,12,10,13,9,7,10,11,11,12,8,11,12,13,10,9,9,7,10,9,13,13,5,13,11,12,12,14,15,8,7,9,13,14,20,14,7,12,14,12,4,8,12,13,10,12,12,16,17,15,D/WB R,1,1,1,1,1,1,1,1,20,1,1,1,1,1,19
19250014,Caio Ruan,1651,01/04/1995,21,0,0,0,0,190,87,3,2,4,3,1,3,4,2,1,1,1,7,5,6,7,9,6,13,6,6,12,6,1,11,5,7,14,10,7,9,5,14,5,6,14,6,13,8,9,13,9,12,13,10,13,11,20,7,13,12,10,5,6,10,16,11,12,12,10,7,20,4,D C,1,1,1,1,1,1,20,1,1,1,1,1,1,1,1
19250018,Bruno Bertinato,1651,31/05/1998,18,0,0,0,0,189,79,11,7,8,1,14,8,8,14,9,6,8,5,1,2,1,6,9,1,3,2,1,2,1,3,1,9,5,14,8,11,7,14,7,1,5,3,6,8,7,11,9,8,13,6,10,12,20,7,10,7,4,9,9,8,18,11,12,11,12,5,2,1,GK ,20,1,1,1,1,1,1,1,1,1,1,1,1,1,1
19250019,Alan Cardoso,1651,05/01/1998,18,0,0,0,0,175,69,3,2,1,2,3,1,2,2,3,2,2,11,15,13,10,12,9,10,8,8,6,10,4,8,13,10,10,10,11,13,11,10,10,10,6,11,10,11,12,14,13,7,8,20,12,14,6,12,7,10,10,9,4,15,9,10,11,11,12,4,13,6,D/WB L,1,1,1,1,15,1,1,20,1,1,1,15,1,19,1
19250020,Matheus Faulth,1651,14/02/1998,18,0,0,0,0,175,60,1,1,4,3,2,3,3,3,3,2,3,4,8,8,3,10,6,7,5,6,5,5,4,8,7,8,6,7,7,6,7,12,1,8,11,7,5,7,8,12,11,8,4,9,4,13,20,7,6,8,8,1,7,8,9,12,11,12,11,1,6,4,D/WB R,1,1,14,11,1,13,1,1,20,1,13,1,15,1,19
19250021,Adryelson,1651,23/03/1998,18,0,0,0,0,181,74,2,2,2,2,3,3,3,3,1,2,1,5,3,2,3,9,1,11,5,2,13,9,7,11,5,14,11,14,7,7,8,13,13,13,13,6,9,7,13,14,12,13,13,8,14,9,20,11,13,12,13,2,10,10,19,13,12,10,11,9,14,5,D C,1,1,1,1,1,1,20,1,1,1,1,1,1,1,1
19250022,Júnior Ramos,1651,03/03/1998,18,0,0,0,0,176,70,1,1,2,1,1,1,2,4,2,3,1,9,10,11,11,12,10,7,11,8,12,12,10,12,12,11,12,10,10,9,11,10,13,12,5,13,12,12,13,13,13,8,8,20,12,13,8,13,11,12,10,10,5,13,14,10,11,11,13,9,10,8,DM/M C,1,1,1,10,8,1,1,1,1,18,20,11,1,1,1
19250028,Magno,1651,26/07/1990,25,0,0,0,0,167,0,1,3,2,1,3,1,2,3,3,2,1,10,11,7,8,10,8,8,11,3,10,14,7,16,8,10,9,10,11,12,8,14,2,8,10,9,12,14,9,8,8,9,9,12,15,9,20,15,10,10,7,11,5,10,15,11,10,9,11,2,14,1,DM/M C,1,1,1,1,1,1,1,1,1,20,18,1,1,1,1
19250035,Maguinho,1651,06/01/1992,24,0,0,0,0,180,74,1,4,3,1,2,1,1,4,2,1,2,4,6,8,5,13,7,7,5,7,9,12,2,13,13,10,9,9,9,9,7,13,10,10,4,6,11,8,4,13,12,8,6,10,14,12,20,6,10,10,10,10,10,10,20,12,11,12,13,12,8,3,D/DM/M RC,1,1,1,1,1,1,1,1,18,18,20,1,13,1,15
19250042,Rodrigo Pinho,1651,30/05/1991,25,0,0,0,0,185,79,4,3,3,4,2,1,2,1,2,1,3,8,9,12,12,12,11,12,12,6,6,12,13,6,13,9,11,11,12,12,9,11,12,12,8,12,8,10,9,13,12,12,13,20,12,12,8,12,12,10,10,10,3,10,10,13,11,12,12,6,12,6,S ,1,1,20,1,1,1,1,1,1,1,1,1,1,1,1
19250048,Jonathan,1651,11/05/1991,25,0,0,0,0,196,88,14,7,13,8,10,12,7,10,6,3,10,4,2,3,2,2,8,1,2,3,3,3,1,3,6,5,12,11,9,7,8,14,2,2,12,3,8,9,8,14,13,9,14,10,12,12,20,8,12,10,10,1,8,10,18,14,9,12,11,8,16,1,GK ,20,1,1,1,1,1,1,1,1,1,1,1,1,1,1
19250053,Ivan,1651,30/11/1989,26,0,0,0,0,178,70,1,4,3,3,3,2,3,3,3,1,3,7,7,4,6,14,7,5,11,1,10,14,4,9,14,9,11,7,8,8,14,10,3,7,12,9,8,8,11,10,12,8,6,4,4,14,20,9,9,9,5,9,9,9,16,10,9,10,14,6,12,5,M C,1,1,1,1,1,1,1,1,1,1,20,1,1,1,1
19250101,Alisson Machado,1651,08/06/1995,21,0,0,0,0,190,87,13,8,8,1,9,9,9,9,9,6,8,1,3,1,3,3,4,6,1,3,1,1,4,3,3,7,6,15,7,8,6,13,6,2,1,2,9,7,6,8,10,5,14,10,9,7,20,6,13,5,7,9,7,9,8,11,9,11,10,10,6,3,GK ,20,1,1,1,1,1,1,1,1,1,1,1,1,1,1
19250116,Lucas Rocha,1651,19/06/1995,21,0,0,0,0,184,0,1,2,3,1,3,1,1,1,2,3,2,4,6,5,1,5,1,11,3,5,11,5,1,13,6,8,12,9,7,9,2,13,4,1,8,6,12,6,5,12,9,7,11,9,13,11,20,7,12,9,4,9,9,9,8,11,11,13,8,1,8,3,D C,1,1,1,1,1,1,20,1,1,1,1,1,1,1,1
19250117,Anderson,1651,05/03/1998,18,0,0,0,0,190,77,13,8,9,5,9,10,8,11,7,8,7,3,3,2,3,1,5,1,2,3,3,1,2,2,1,8,7,15,6,5,5,11,8,1,6,1,5,6,5,9,11,1,14,8,10,13,20,1,9,8,8,5,6,8,11,12,11,14,11,7,9,6,GK ,20,1,1,1,1,1,1,1,1,1,1,1,1,1,1
19250118,Gabriel Correia,1651,29/05/1998,18,0,0,0,0,182,0,2,2,2,2,2,3,4,3,3,2,1,5,4,13,12,13,4,2,7,1,2,9,7,5,13,6,4,6,10,6,13,13,8,13,10,8,6,5,5,10,8,1,9,8,13,6,20,5,5,8,5,8,8,8,15,9,12,11,11,2,11,2,AM C,1,1,1,20,1,1,1,1,1,1,10,1,1,1,1
19250185,Kalil,1651,10/04/1996,20,0,0,0,0,181,73,1,4,2,3,1,3,2,2,1,1,3,7,7,14,14,10,7,14,8,2,5,8,5,1,14,9,9,5,12,8,8,11,5,13,3,14,8,7,8,13,14,8,8,1,16,14,20,7,8,9,9,2,5,9,16,10,13,8,13,5,12,7,S ,1,1,20,1,1,1,1,1,1,1,1,1,1,1,1
19250186,Rafael,1651,27/12/1995,20,0,0,0,0,191,99,4,1,2,3,3,3,3,2,3,1,2,8,3,1,8,6,4,11,2,6,10,7,6,15,7,9,13,9,6,9,7,8,4,2,2,6,15,7,9,14,10,9,15,1,10,10,20,7,13,9,6,6,6,9,9,9,11,8,7,2,15,4,D C,1,1,1,1,1,1,20,1,1,1,1,1,1,1,1
19250187,Diego,1651,12/01/1995,21,0,0,0,0,187,80,1,1,2,3,3,1,2,2,1,2,3,3,7,9,8,14,5,7,7,5,7,10,4,8,14,8,8,6,7,8,12,10,6,13,14,10,6,8,11,13,10,8,13,9,11,12,20,7,9,9,9,9,9,9,16,12,11,11,10,9,18,3,AM C,1,1,10,20,1,1,1,1,1,1,15,1,1,1,1
19250188,Mota,1651,09/07/1995,20,0,0,0,0,187,78,2,3,3,3,2,3,3,3,1,1,2,7,8,3,1,14,5,5,7,7,9,9,4,11,9,3,5,9,9,8,9,13,6,9,1,7,6,9,9,14,14,5,9,8,12,14,20,7,8,9,9,9,4,9,15,11,11,13,11,10,4,1,D/WB R,1,1,1,1,1,1,1,1,20,1,1,1,1,1,17
19250189,Jefferson,1651,17/01/1997,19,0,0,0,0,179,75,3,4,2,3,2,3,3,2,2,2,2,7,5,11,11,15,9,15,6,4,8,10,6,7,13,6,11,6,11,9,8,12,4,11,10,11,10,9,10,15,13,11,10,20,17,13,7,8,10,10,9,10,8,10,16,9,12,13,10,6,16,8,S ,1,1,20,1,1,1,1,1,1,1,1,1,1,1,1
19250248,André Baumer,1651,18/02/1997,19,0,0,0,0,188,76,4,1,2,2,1,1,3,3,3,2,3,2,1,1,1,7,1,13,4,4,12,7,1,13,5,9,9,8,6,6,3,13,9,5,11,2,10,6,7,12,12,7,13,8,15,12,20,8,7,9,8,6,8,9,16,9,12,9,9,9,7,2,D C,1,1,1,1,1,1,20,1,1,1,1,1,1,1,1
19250249,Leonardo Leite,1651,28/01/1997,19,0,0,0,0,183,0,3,3,1,1,3,2,3,1,2,3,1,4,5,5,7,11,5,1,11,2,3,12,4,5,10,8,4,6,12,5,6,11,3,10,13,6,3,7,10,9,11,6,10,20,8,13,8,6,7,8,3,8,3,8,7,12,11,13,12,5,2,3,AM C,1,1,1,20,1,1,1,1,1,1,15,1,1,1,1
19250250,Igor Candiota,1651,27/07/1996,19,0,0,0,0,187,0,3,3,3,3,1,1,2,1,2,1,2,1,1,2,2,6,2,13,1,1,12,6,1,13,5,8,3,8,5,9,2,13,8,8,1,4,13,5,6,7,10,6,13,5,5,11,20,9,10,8,8,4,6,8,10,9,12,14,11,4,5,3,D C,1,1,1,1,1,1,20,1,1,1,1,1,1,1,1
19250252,Matheus Albino,1651,04/02/1995,21,0,0,0,0,196,86,12,11,9,1,12,8,7,11,7,1,9,1,3,2,2,2,6,1,3,1,2,1,3,2,1,5,6,8,6,7,5,12,2,2,3,1,7,6,5,9,13,6,13,10,15,9,20,2,9,9,7,8,9,9,16,10,13,11,11,6,9,5,GK ,20,1,1,1,1,1,1,1,1,1,1,1,1,1,1
19250253,Rodrigo Sampaio,1651,16/01/1996,20,0,0,0,0,171,0,1,2,2,2,4,3,1,1,1,2,3,3,1,4,6,11,5,5,9,4,7,10,1,12,12,7,11,6,5,9,9,10,2,1,13,1,11,7,10,5,9,6,3,1,13,7,20,7,7,5,7,5,3,7,18,10,13,9,9,5,6,7,DM ,1,1,1,1,1,1,1,1,1,20,10,1,1,1,1
19250254,Júnior Sutil,1651,04/02/1997,19,0,0,0,0,179,72,3,3,1,1,2,1,2,2,1,2,3,5,5,5,2,10,5,5,10,2,6,13,1,12,13,8,3,4,4,9,6,13,8,5,13,4,6,7,10,13,13,4,8,8,9,13,20,5,7,8,6,1,8,8,14,10,12,8,12,5,10,2,DM ,1,1,1,1,1,1,1,1,1,20,10,1,1,1,1
19250315,Daniel,1651,10/03/1989,27,0,0,0,0,180,77,2,1,1,3,1,1,2,2,1,2,1,2,4,8,3,10,1,9,7,7,9,10,3,13,9,10,13,9,10,13,9,12,5,6,12,8,10,10,10,14,14,10,8,20,15,14,10,10,7,6,8,5,10,10,18,13,10,14,9,1,15,1,D/WB L,1,1,1,1,1,1,1,20,1,1,1,1,1,19,1
19250321,Tchê Tchê,1651,30/08/1992,23,0,0,0,0,175,66,3,4,2,3,4,3,1,1,1,1,1,9,12,13,10,12,10,7,12,10,12,13,10,12,12,12,12,11,13,12,13,12,12,13,7,14,11,13,15,14,15,15,7,14,13,14,20,14,8,13,13,13,11,16,13,13,11,12,11,7,3,3,WB/DM/M RC,1,1,1,13,7,12,1,9,15,17,20,5,13,10,18
19250343,Erivaldo,1651,08/06/1984,32,0,0,0,0,180,79,2,1,1,1,1,1,3,1,3,2,1,6,4,8,13,13,6,10,4,2,3,7,7,3,13,9,13,2,10,7,6,11,4,13,13,13,5,6,7,13,9,7,9,10,9,10,20,7,6,9,4,9,7,9,16,11,11,9,12,12,16,2,S ,1,1,20,1,1,1,1,1,1,1,1,1,1,1,1
19250452,Hélio Paraíba,1651,17/04/1992,24,0,0,0,0,188,84,3,3,1,1,3,2,1,1,3,2,4,6,8,7,11,10,7,12,10,6,6,9,11,6,10,12,11,11,12,10,9,11,5,11,8,11,9,11,11,12,8,6,15,12,14,12,20,13,14,11,12,10,9,6,13,12,12,12,11,9,9,1,S ,1,1,20,1,1,1,1,1,1,1,1,1,1,1,1
19250461,Wallace,1651,22/06/1989,27,0,0,0,0,182,0,1,2,3,3,3,1,3,2,3,2,1,5,7,5,7,11,3,9,8,6,10,9,5,14,10,9,11,7,7,7,9,14,9,7,14,8,10,10,10,15,12,10,10,10,12,10,20,7,10,5,6,9,9,9,14,10,10,11,9,8,18,7,D/WB R,1,1,1,1,1,1,1,1,20,1,1,1,1,1,19
19250466,Jácio,1651,30/07/1989,26,0,0,0,0,175,79,3,1,2,3,2,2,3,3,1,3,1,5,8,8,8,14,8,8,11,2,8,12,7,14,9,10,11,7,10,10,9,14,5,2,8,8,12,9,12,14,14,7,4,10,11,13,20,8,7,10,6,7,10,10,17,13,9,11,9,6,8,5,DM/M C,1,1,1,10,1,1,1,1,1,20,18,1,1,1,1
19250487,Erick,1651,03/01/1997,19,0,0,0,0,172,0,1,3,1,2,1,2,3,1,2,3,3,9,7,15,11,14,12,15,9,8,9,11,5,5,11,10,12,9,11,9,10,12,10,9,2,10,7,9,9,13,13,10,4,7,11,14,20,8,7,10,8,9,4,9,9,12,10,12,10,7,12,7,S ,1,1,20,1,1,1,1,1,1,1,1,1,1,1,1
19250578,Leonardo,1651,28/05/1997,19,0,0,0,0,176,0,2,1,1,3,2,2,3,1,1,3,3,6,4,13,11,11,6,13,7,5,4,3,3,1,13,8,9,8,11,6,7,11,9,13,10,4,7,6,7,13,12,12,8,9,7,9,20,6,12,9,4,9,6,8,8,11,10,10,13,7,9,2,S ,1,1,20,1,1,1,1,1,1,1,1,1,1,1,1
19250579,Guilherme Mantuan,1651,02/08/1997,18,0,0,0,0,176,70,3,1,1,2,2,1,1,1,1,3,1,7,12,15,11,13,5,7,9,3,10,12,5,10,12,8,8,10,6,12,13,11,10,14,11,12,11,12,12,13,14,10,9,11,8,13,20,11,8,8,9,10,10,13,17,8,11,10,11,6,9,2,M/AM RC,1,1,1,17,14,1,1,1,15,1,20,1,1,1,15
19250580,Léo Príncipe,1651,13/08/1996,19,0,0,0,0,174,68,2,1,2,3,3,3,2,1,2,1,2,12,12,12,10,13,9,10,11,10,11,12,11,9,13,10,12,12,12,12,12,13,13,13,10,13,8,14,12,13,13,10,7,11,13,14,20,12,9,12,9,12,9,13,11,12,12,13,12,7,11,8,D/WB R,1,1,1,1,1,1,1,13,20,1,1,1,1,1,19
19250586,Rodrigo,1651,26/05/1994,22,0,0,0,0,180,76,3,2,2,1,3,1,2,1,1,1,1,7,5,13,12,13,11,5,12,2,5,11,3,5,11,9,9,8,10,6,12,8,9,11,1,4,7,7,12,12,11,7,5,20,6,11,9,12,8,9,7,9,4,9,11,11,12,9,10,11,6,8,AM C,1,1,1,20,1,1,1,1,1,1,10,1,1,1,1
19250588,Rodrigo Sam,1651,24/07/1995,20,0,0,0,0,184,0,3,2,2,2,2,3,3,3,1,4,3,2,4,5,4,6,4,11,7,9,11,10,5,10,8,12,12,10,7,10,4,15,10,5,10,7,11,12,11,12,11,10,12,10,12,13,20,11,11,10,8,10,9,10,17,10,10,10,9,5,14,5,D C,1,1,1,1,1,1,20,1,1,12,1,1,1,1,1
19250590,Marciel,1651,08/03/1995,21,0,0,0,0,186,82,3,3,2,3,1,2,1,3,2,2,3,8,12,13,12,14,12,11,14,7,12,14,10,11,14,11,13,13,13,12,14,13,14,13,9,10,14,13,11,11,11,12,11,20,12,13,9,13,13,8,9,11,10,10,20,12,12,13,12,1,12,7,DM/M C,1,1,1,1,1,1,1,1,1,20,19,1,1,1,1
19250761,Erik,1651,02/02/1995,21,0,0,0,0,171,57,2,1,3,1,1,2,2,3,2,2,3,10,13,14,14,14,9,12,8,9,9,10,7,9,12,9,12,9,9,8,11,11,12,13,13,13,10,9,11,14,14,10,5,20,13,14,10,13,7,11,10,10,10,11,7,12,12,12,11,8,16,8,AM/S L,1,1,20,1,18,1,1,1,1,1,1,1,1,1,1
19250971,Carlinhos,1651,16/03/1998,18,0,0,0,0,193,0,10,9,8,1,13,14,9,12,11,8,9,3,1,3,1,1,8,1,2,1,2,1,3,2,4,9,7,12,6,8,7,10,18,1,8,2,7,8,5,14,12,8,16,9,11,11,20,2,10,3,8,6,6,9,13,8,10,10,12,5,9,2,GK ,20,1,1,1,1,1,1,1,1,1,1,1,1,1,1
19250972,Ronaldo,1651,12/01/1998,18,0,0,0,0,184,80,1,3,1,2,3,3,3,3,2,1,3,4,8,9,9,10,5,13,7,5,12,12,10,12,12,11,12,13,12,11,7,12,3,7,10,8,12,13,12,11,11,12,12,9,12,10,20,13,12,10,7,10,6,10,15,12,11,9,13,1,7,3,D C,1,1,1,1,1,1,20,1,1,1,1,1,1,1,1
19250973,Thiago,1651,19/02/1998,18,0,0,0,0,182,74,2,2,3,3,1,2,3,1,1,1,2,5,1,2,3,4,1,10,1,1,13,4,1,13,5,8,7,8,4,10,2,13,8,7,6,3,12,5,6,12,7,3,11,8,15,8,20,10,6,8,8,8,8,8,20,10,12,13,13,8,7,2,D C,1,1,1,1,1,1,20,1,1,1,1,1,1,1,1
19250974,Caíque,1651,14/06/1998,18,0,0,0,0,172,64,1,2,2,2,2,2,3,2,1,1,2,11,13,12,3,12,11,7,11,6,10,11,3,8,13,8,8,9,7,5,12,10,20,13,9,5,8,6,8,12,13,9,3,20,12,13,10,13,5,9,9,9,9,9,7,11,10,10,10,3,10,6,D/WB L,1,1,1,1,1,1,1,20,1,1,1,1,1,19,1
19250975,Kleber,1651,02/08/1998,17,0,0,0,0,164,61,4,3,2,3,3,3,2,2,1,1,3,5,10,12,8,14,1,7,11,8,11,12,4,11,11,6,9,9,10,6,6,14,17,12,11,4,8,10,10,13,13,10,5,10,12,14,20,12,7,10,10,10,10,9,19,11,10,11,9,6,4,1,D/WB R,1,1,1,1,1,1,1,1,20,12,1,1,1,1,19
19250976,Andrey,1651,15/02/1998,18,0,0,0,0,175,73,3,2,1,2,2,3,3,2,1,2,3,8,8,11,10,10,8,11,12,5,13,13,5,12,13,12,11,13,10,11,11,12,12,10,8,12,13,14,12,12,13,11,11,10,14,13,20,13,11,12,10,10,18,12,19,12,13,10,12,7,6,6,DM/M C,1,1,1,13,1,1,1,1,1,20,18,1,1,1,1
19250977,Jean Pyerre,1651,07/05/1998,18,0,0,0,0,183,72,2,3,1,1,3,3,1,2,2,3,2,9,8,12,10,15,9,9,11,1,11,12,5,15,12,9,12,10,11,11,12,11,15,4,4,7,10,10,14,10,13,10,12,11,8,15,20,9,8,7,7,10,7,10,12,12,10,11,10,8,15,8,M C,1,1,1,14,1,1,1,1,1,12,20,1,1,1,1
19250978,Matheus Fernandes,1651,30/06/1998,18,0,0,0,0,183,67,3,3,3,3,2,2,1,1,3,3,3,9,7,12,11,15,9,6,14,5,9,13,7,11,12,11,13,8,8,10,13,9,10,11,12,11,9,10,14,12,11,11,11,11,8,11,20,10,8,10,10,9,10,10,18,9,12,11,12,4,11,6,M/AM C,1,1,1,20,1,1,1,1,1,1,16,1,1,1,1
19250980,Mauro Júnior,1651,06/05/1998,18,0,0,0,0,172,62,2,2,1,2,2,3,2,1,3,3,1,5,1,13,11,13,7,6,8,1,5,13,7,8,14,9,10,2,12,6,13,12,5,14,11,12,8,8,12,12,13,8,3,20,13,13,10,7,5,9,9,5,9,9,13,11,12,10,10,7,4,7,AM C,1,1,1,20,1,1,1,1,1,1,10,1,1,1,1
19250981,Renan Areias,1651,18/01/1998,18,0,0,0,0,174,66,1,2,2,3,2,3,1,1,4,1,2,6,6,11,8,13,6,6,10,2,12,12,4,11,11,5,6,8,7,7,11,13,14,6,4,11,13,12,11,13,13,7,7,10,16,13,20,7,7,9,6,9,6,9,14,12,9,10,12,10,11,1,DM ,1,1,1,1,1,1,1,1,1,20,10,1,1,1,1
19250982,Leandrinho,1651,11/10/1998,17,0,0,0,0,181,73,4,1,3,1,3,1,2,3,1,3,3,10,10,12,12,14,14,11,14,3,9,15,6,6,13,10,12,8,11,5,10,13,12,12,1,12,6,10,11,13,13,11,9,11,8,12,20,12,8,10,10,10,10,10,9,10,10,10,10,7,8,6,AM/S C,1,1,17,20,13,10,1,1,1,1,10,1,1,1,1
19250983,Loran,1651,20/07/1998,17,0,0,0,0,183,72,2,2,2,3,3,2,2,2,3,2,3,4,7,10,11,14,7,13,6,1,3,8,7,1,11,9,8,8,13,8,8,14,9,9,1,13,8,7,8,11,11,14,13,2,12,11,20,8,13,7,4,9,9,8,19,11,11,9,11,4,3,4,S ,1,1,20,1,1,1,1,1,1,1,1,1,1,1,1
19250984,Ramón,1651,19/08/1998,17,0,0,0,0,172,0,2,2,2,2,3,1,3,2,3,3,1,10,13,14,11,15,13,5,11,2,8,12,7,2,13,10,11,8,12,10,12,12,15,14,6,12,5,9,10,12,14,10,7,20,11,14,10,13,6,9,10,7,6,10,13,9,11,11,13,2,17,5,S ,1,1,20,1,1,1,1,1,1,1,1,1,1,1,1
19250985,Darlan Mendes,1651,16/04/1998,18,0,0,0,0,180,0,3,2,3,2,2,2,1,3,3,2,3,9,7,10,10,16,9,8,14,4,11,15,5,11,14,9,9,14,8,7,10,9,6,9,8,8,11,10,13,11,12,12,9,2,15,12,20,9,12,9,16,7,9,9,19,10,12,9,11,9,11,4,DM ,1,1,1,1,1,1,1,1,1,20,10,1,1,1,1
19251268,Alex,1651,23/11/1995,20,0,0,0,0,189,0,2,3,2,1,1,1,3,3,3,3,2,9,7,11,11,14,7,15,11,9,9,11,3,8,12,6,12,9,10,7,10,12,6,10,10,12,7,9,5,15,12,5,9,9,13,11,20,8,11,9,10,10,4,10,13,12,15,11,13,11,11,5,AM/S C,1,1,20,18,1,1,1,1,1,1,1,1,1,1,1
19251269,Artur,1651,17/12/1994,21,0,0,0,0,179,0,2,1,1,2,1,2,3,1,1,2,2,5,5,13,13,13,1,12,5,1,4,4,5,1,10,6,10,5,8,5,3,9,1,10,14,13,5,5,6,13,10,6,6,15,7,11,20,3,6,8,8,7,7,8,15,12,11,14,9,8,9,8,S ,1,1,20,1,1,1,1,1,1,1,1,1,1,1,1
19251322,Cristiano,1651,29/08/1993,22,0,0,0,0,178,76,1,3,3,1,1,1,2,2,2,3,1,7,11,11,4,15,4,9,6,5,10,11,1,11,14,10,7,10,10,12,9,12,9,10,5,10,11,10,11,15,11,10,8,20,6,14,11,11,7,10,12,9,3,10,11,11,14,12,11,9,4,3,D/WB/M L,1,1,1,1,12,1,1,20,1,1,1,18,1,18,1
19251417,Matheus Vital,1651,12/02/1998,18,0,0,0,0,175,65,2,2,2,1,2,2,4,3,3,2,1,7,11,13,11,12,8,8,10,3,4,13,8,8,13,10,13,10,10,10,13,12,14,15,10,13,10,12,12,14,14,8,8,10,13,14,20,13,8,10,10,11,5,14,19,10,10,9,11,7,5,3,M/AM LC,1,1,1,20,19,1,1,1,1,1,15,19,1,1,1
19251465,Jean,1651,26/10/1995,20,0,0,0,0,188,80,11,11,12,8,13,13,13,14,12,13,12,2,1,1,1,10,5,11,3,1,3,11,5,2,10,12,12,15,9,8,6,11,12,15,6,5,11,13,13,12,14,9,14,8,13,12,20,13,13,10,9,10,3,11,12,12,10,8,8,7,5,17,GK ,20,1,1,1,1,1,1,1,1,1,1,1,1,1,1
19251466,Yuri,1651,20/04/1994,22,0,0,0,0,173,74,3,1,2,2,4,2,2,1,3,2,1,7,11,9,10,11,8,10,11,9,14,11,9,13,11,13,13,14,9,10,8,9,13,8,8,11,13,14,14,13,12,9,8,10,14,13,20,14,12,14,12,13,5,13,9,9,11,10,10,10,8,6,DM/M RC,1,1,1,1,1,1,1,1,15,20,18,1,13,1,14
19251467,Flávio,1651,30/06/1996,20,0,0,0,0,178,0,1,3,1,3,2,3,1,1,1,2,3,4,7,8,8,7,8,9,8,8,10,6,5,11,10,9,10,9,10,13,10,13,9,9,5,7,9,10,10,15,15,10,9,9,8,13,20,8,9,9,9,8,9,9,8,8,11,11,12,1,13,1,D/WB R,1,1,1,1,1,1,1,1,20,1,1,1,1,1,19
19251468,Caaporã,1651,08/06/1995,21,0,0,0,0,175,65,1,2,3,2,3,1,2,2,2,3,1,7,7,12,12,12,8,5,9,8,7,8,6,4,9,7,9,7,6,7,11,8,4,10,6,12,8,9,9,14,10,6,8,6,12,15,20,12,8,9,9,1,10,9,16,11,8,11,10,2,17,5,AM LC,1,1,14,20,19,1,1,1,1,1,1,11,1,1,1
19251597,Ricardo Lopes,1651,28/10/1990,25,0,0,0,0,184,77,1,3,2,2,2,2,1,1,2,1,2,6,4,13,13,13,3,13,4,4,4,7,4,2,10,9,11,8,9,7,5,10,8,10,10,11,6,6,7,13,13,7,8,8,8,13,20,12,8,9,9,6,3,9,14,11,11,11,12,1,17,6,S ,1,1,20,1,1,1,1,1,1,1,1,1,1,1,1
19251605,Felipe Augusto,1651,06/03/1992,24,0,0,0,0,183,77,1,1,3,2,2,2,1,3,3,1,2,11,13,14,10,13,11,6,8,5,4,12,4,5,14,8,9,8,12,9,12,10,11,14,7,11,8,8,10,13,14,13,11,20,12,13,8,12,11,9,10,10,5,10,10,10,8,11,12,8,12,6,AM RL,1,1,14,1,17,20,1,1,1,1,1,13,13,1,1
19251610,Luiz Paulo,1651,24/04/1993,23,0,0,0,0,179,71,2,2,1,3,3,3,1,1,2,1,1,9,14,8,1,6,7,4,1,7,9,9,5,7,9,7,9,8,8,9,6,11,9,1,10,8,9,8,9,14,14,8,5,20,3,14,10,6,8,9,7,6,9,9,12,10,12,11,13,8,9,3,D/WB/M L,1,1,1,1,1,1,1,20,1,1,1,18,1,19,1
19251615,Bruno Alves,1651,13/09/1992,23,0,0,0,0,178,74,4,2,2,1,1,1,3,4,1,2,2,6,10,8,6,14,8,10,13,4,8,13,4,9,14,10,11,8,8,9,8,12,8,13,1,14,9,14,10,14,14,9,6,11,7,14,20,9,8,10,7,4,10,10,9,10,12,10,10,3,9,1,AM/S RLC,1,1,18,20,15,15,1,1,1,1,10,1,1,1,1
19251616,Tiago Pedra,1651,09/02/1990,26,0,0,0,0,180,78,4,2,3,1,3,2,3,3,3,2,3,6,3,7,6,10,6,6,11,4,5,9,1,12,12,13,13,8,7,10,6,13,9,9,9,6,11,12,11,13,13,9,9,10,13,13,20,13,10,9,9,7,9,9,9,13,10,10,12,10,6,2,DM ,1,1,1,1,1,1,1,1,1,20,10,1,1,1,1
19251658,Breno Bortolini,1651,16/09/1997,18,0,0,0,0,177,67,2,1,1,3,3,2,2,3,2,1,3,6,10,12,5,13,6,6,5,4,2,8,2,6,13,8,4,8,7,8,5,6,9,14,5,8,3,8,11,13,11,4,8,20,12,13,9,7,6,9,6,4,9,7,8,9,8,10,11,6,5,2,AM RLC,1,1,1,19,19,20,1,1,1,1,10,1,1,1,1
19251719,Alexandre,1651,05/09/1990,25,0,0,0,0,182,75,13,13,12,1,13,11,9,13,9,5,12,2,3,3,3,2,1,1,2,3,2,1,3,1,1,4,8,10,8,7,7,9,10,1,11,1,9,8,7,11,14,8,9,9,13,9,20,7,6,10,9,1,10,10,20,13,9,8,12,1,15,1,GK ,20,1,1,1,1,1,1,1,1,1,1,1,1,1,1
19251826,Cláudio Pagodinho,1651,23/02/1986,30,0,0,0,0,184,75,2,1,1,1,3,1,3,1,1,2,3,10,13,12,9,13,6,13,6,5,5,8,1,3,11,6,10,7,6,6,6,11,2,12,12,6,6,6,7,12,13,8,5,20,9,11,9,13,8,8,8,8,7,9,13,10,11,13,11,1,11,5,AM/S L,1,1,20,1,19,1,1,1,1,1,1,1,1,1,1
19251987,Heitor,1651,09/11/1989,26,0,0,0,0,190,78,1,1,1,2,1,1,2,2,3,2,2,4,4,14,4,5,7,14,10,10,6,7,8,11,5,13,7,14,8,13,6,6,4,1,7,11,7,10,14,12,14,14,17,12,11,13,20,13,13,10,10,10,10,10,13,11,12,10,11,3,13,6,D C,1,1,1,1,1,1,20,1,1,1,1,1,1,1,1
19252111,Geferson,1651,13/05/1994,22,0,0,0,0,181,77,2,3,2,1,1,3,3,1,1,1,3,12,12,12,11,13,7,12,11,11,14,12,11,13,12,12,13,13,13,13,11,13,13,13,9,11,13,13,12,14,13,11,10,20,10,14,6,13,11,12,11,13,11,13,16,12,12,13,11,6,12,7,D/WB L,1,1,1,1,1,1,1,20,1,1,1,1,1,19,1
19252216,Gabriel,1651,12/06/1997,19,0,0,0,0,182,0,12,12,5,1,12,12,9,12,9,9,9,2,3,2,1,4,3,1,2,2,3,1,3,1,1,9,5,13,6,5,5,12,9,2,9,2,9,6,5,10,10,6,7,17,12,9,20,4,5,9,6,9,9,8,20,11,12,10,11,12,7,7,GK ,20,1,1,1,1,1,1,1,1,1,1,1,1,1,1
19252217,Bruno,1651,24/12/1991,24,0,0,0,0,171,65,3,2,3,1,2,2,3,2,2,2,3,5,6,6,1,5,3,13,6,1,10,5,4,13,2,6,12,9,3,10,7,13,2,1,9,6,11,7,8,13,13,15,4,20,16,13,10,13,6,9,9,9,6,9,7,9,9,9,14,5,15,3,D LC,1,1,1,1,1,1,20,17,1,1,1,1,1,14,1
19252219,Júlio Vinícius,1651,29/04/1995,21,0,0,0,0,184,0,1,2,1,1,4,2,1,2,1,2,2,6,8,1,6,11,2,4,5,7,8,9,3,13,7,4,8,9,9,6,9,12,9,9,7,7,6,9,8,14,12,4,9,17,14,14,20,7,10,9,1,8,9,9,9,8,11,12,9,13,10,4,D/WB L,1,1,1,1,1,1,1,20,1,1,1,1,1,19,1
19252244,Charles,1651,02/07/1997,19,0,0,0,0,183,74,4,1,2,3,2,3,2,3,3,1,3,4,2,1,1,6,1,14,4,4,14,6,2,10,7,9,14,9,4,7,3,14,9,1,10,5,12,7,8,14,10,8,12,20,16,10,1,6,7,9,6,5,9,9,20,10,15,11,13,7,17,6,D C,1,1,1,1,1,1,20,1,1,1,1,1,1,1,1
19252381,Marcelo Hermes,1651,01/02/1995,21,0,0,0,0,177,68,2,3,2,3,2,3,2,2,2,1,1,9,12,12,7,12,8,10,7,12,12,12,7,12,11,11,13,13,11,12,9,12,10,13,8,12,12,13,13,14,14,9,9,20,14,14,9,13,9,12,9,11,6,12,10,16,8,12,14,7,10,14,D/WB L,1,1,1,1,1,1,1,20,1,1,1,1,1,19,1
19252409,Nivaldo,1651,03/08/1996,19,0,0,0,0,173,62,2,2,2,3,1,2,2,2,1,2,2,7,4,14,13,14,4,14,4,3,7,8,6,2,11,8,10,8,12,7,3,9,3,10,8,11,5,7,8,14,13,8,7,2,10,14,20,7,4,8,9,8,9,9,10,10,10,12,11,4,18,7,S ,1,1,20,1,1,1,1,1,1,1,1,1,1,1,1
19252410,Thiago Ennes,1651,05/03/1996,20,0,0,0,0,178,75,4,1,2,2,3,1,3,3,3,2,2,6,7,9,7,14,3,10,9,9,13,9,8,11,10,6,9,10,11,10,10,10,10,7,10,6,9,11,11,15,15,11,7,10,14,15,20,11,7,9,7,10,8,10,17,11,12,10,11,9,11,7,D/WB R,1,1,1,1,1,1,1,1,20,1,1,1,1,1,19
19252414,Djalma,1651,21/05/1999,17,0,0,0,0,172,0,2,1,3,3,2,2,2,2,2,1,2,3,4,10,10,11,3,4,5,1,3,12,4,7,11,3,4,4,10,4,10,10,3,10,6,5,4,8,10,13,11,7,4,8,14,9,20,6,4,7,8,3,7,8,10,13,12,13,10,1,10,6,AM C,1,1,1,20,1,1,1,1,1,1,10,1,1,1,1
19252678,Jean,1651,24/05/1994,22,0,0,0,0,180,0,2,1,3,3,4,1,2,2,1,1,1,5,6,4,5,9,1,6,5,5,4,7,4,9,7,7,7,7,7,5,5,14,4,6,13,5,5,7,7,14,14,7,11,20,9,14,4,4,9,7,7,3,7,7,10,10,9,9,11,6,5,1,D/WB L,1,1,1,1,1,1,1,20,1,1,1,1,1,17,1
19252679,Luan Gaúcho,1651,14/05/1993,23,0,0,0,0,178,67,3,2,2,3,1,2,4,1,3,1,1,12,14,6,1,10,10,5,3,3,6,4,1,7,8,7,5,6,7,7,6,10,5,7,5,6,7,6,7,14,10,1,9,20,9,11,12,6,7,7,7,3,7,11,20,10,12,11,7,4,7,6,D/WB/M L,1,1,1,11,14,1,1,16,1,1,6,20,1,18,1
19252682,Eduardo,1651,16/05/1992,24,0,0,0,0,184,0,3,3,3,2,1,1,3,2,2,1,3,2,1,3,1,10,2,2,8,1,8,8,1,7,11,7,3,5,3,2,2,11,4,2,6,1,7,4,8,11,11,3,3,16,7,11,20,10,7,7,7,7,7,7,20,11,10,11,9,12,5,4,DM ,1,1,1,1,1,1,1,1,1,20,10,1,1,1,1
19252683,Paulo José,1651,09/04/1991,25,0,0,0,0,173,0,2,3,3,2,1,2,2,3,3,2,1,3,2,5,8,12,1,1,5,1,4,9,1,2,12,7,6,1,3,4,8,9,2,13,10,7,5,4,5,12,12,4,1,7,13,12,20,10,3,7,7,7,7,7,9,11,13,8,14,2,10,4,AM C,1,1,11,20,1,1,1,1,1,1,15,1,1,1,1
19252685,Rodrigues,1651,11/04/1994,22,0,0,0,0,185,0,2,1,1,1,3,2,1,3,3,2,3,2,1,2,4,10,1,3,5,1,6,8,1,12,12,6,9,2,3,7,10,12,3,1,12,3,4,5,8,9,8,4,12,7,12,10,20,4,5,7,7,7,7,7,19,10,12,13,13,3,8,6,DM ,1,1,1,1,1,1,1,1,1,20,10,1,1,1,1
19252796,Patrick,1651,21/07/1996,19,0,0,0,0,190,0,3,1,1,3,1,1,3,2,2,3,2,2,2,2,1,5,1,11,1,1,12,5,1,6,4,8,6,4,5,8,4,12,1,6,2,2,11,4,5,9,7,5,13,7,15,5,20,6,9,8,7,2,8,8,7,10,12,10,12,6,15,7,D C,1,1,1,1,1,1,20,1,1,1,1,1,1,1,1
19252951,Jian,1651,21/04/1997,19,0,0,0,0,171,0,2,2,3,3,1,3,2,4,2,3,3,4,3,6,5,13,2,4,6,2,6,8,1,12,12,7,7,4,6,4,6,13,7,7,2,3,5,4,8,12,11,5,1,8,8,8,20,4,5,7,7,7,7,7,15,12,9,11,9,5,9,7,DM ,1,1,1,12,1,1,1,1,1,20,10,1,1,1,1
19253061,Douglas Melo,1651,07/04/1996,20,0,0,0,0,184,0,1,3,3,1,1,1,1,1,1,3,2,4,2,13,13,11,4,12,5,2,2,5,9,1,7,7,8,6,9,5,5,5,6,7,10,7,4,4,5,12,8,5,6,3,11,10,20,5,8,7,5,7,7,7,11,13,12,13,13,4,8,4,S ,1,1,20,1,1,1,1,1,1,1,1,1,1,1,1
19255926,Guilherme,1651,25/04/1995,21,0,0,0,0,186,82,12,10,9,13,11,10,13,14,6,13,9,1,3,2,3,9,2,8,3,4,5,9,4,3,10,9,8,12,12,10,5,11,11,6,13,4,11,11,12,10,8,7,12,5,12,10,20,12,15,10,8,10,6,4,11,15,12,10,11,13,13,4,GK ,20,1,1,1,1,1,1,1,1,1,1,1,1,1,1
19255927,Marcondes,1651,03/03/1993,23,0,0,0,0,184,83,1,3,3,2,3,1,1,1,2,2,3,4,5,4,6,9,3,13,5,8,14,11,7,14,12,14,12,12,12,14,6,14,14,3,7,6,12,13,15,14,8,9,13,8,14,14,20,10,14,15,8,12,11,5,12,13,13,15,15,10,12,7,D C,1,1,1,1,1,1,20,1,1,1,1,1,1,1,1
19255928,Matheus,1651,24/01/1992,24,0,0,0,0,192,87,2,3,3,2,2,2,4,1,2,3,3,4,4,5,5,9,6,14,4,6,13,11,6,14,9,14,11,12,9,12,6,10,12,3,9,6,12,13,14,13,8,10,17,20,13,12,7,13,15,9,12,9,12,9,9,12,11,8,13,12,10,7,D C,1,1,1,1,1,1,20,1,1,1,1,1,1,1,1
19255930,Lucas Ramon,1651,23/07/1994,21,0,0,0,0,178,72,2,3,1,3,2,1,3,2,2,3,3,8,11,12,5,12,9,11,12,13,11,10,6,12,11,11,13,10,10,12,7,10,12,7,3,7,12,11,13,13,13,12,8,14,14,13,20,14,11,13,15,9,9,10,10,13,8,12,11,12,13,7,D/WB R,1,1,1,1,1,1,1,1,20,1,1,1,1,1,19
19255931,Bidia,1651,09/02/1992,24,0,0,0,0,178,74,4,2,3,1,4,2,3,3,1,3,2,4,7,10,7,9,5,11,6,10,13,11,6,12,9,13,11,13,9,12,8,9,11,5,7,6,12,15,16,14,8,11,9,10,14,13,20,15,11,12,12,11,7,18,9,12,15,12,15,12,8,8,D/DM/M RC,1,1,1,1,1,1,1,1,16,20,18,1,1,1,1
19255932,Anderson Leite,1651,04/05/1993,23,0,0,0,0,183,79,1,3,1,1,2,1,2,1,1,2,3,5,7,9,9,11,6,12,10,4,12,12,7,13,11,13,12,11,13,12,8,9,11,4,8,7,12,11,13,13,8,12,11,11,13,11,20,14,12,14,13,11,9,13,14,13,12,12,11,8,7,10,DM/M C,1,1,1,1,1,1,1,1,1,17,20,1,1,1,1
19255933,Fabinho,1651,15/05/1992,24,0,0,0,0,163,0,3,1,1,3,3,1,3,3,2,2,1,3,2,13,9,13,3,6,8,1,6,13,2,5,13,5,8,2,7,5,11,13,9,13,7,9,7,7,10,13,13,7,1,9,10,13,20,7,4,9,6,9,9,8,17,11,11,11,13,11,9,7,AM C,1,1,1,20,1,1,1,1,1,1,10,1,1,1,1
19255934,Guga,1651,11/07/1997,18,0,0,0,0,170,63,3,3,4,3,1,1,2,3,2,3,2,11,8,11,8,12,10,6,8,3,4,12,9,4,13,7,12,9,11,10,13,7,9,11,4,10,7,10,9,14,13,12,5,20,11,13,12,9,6,11,3,13,6,8,10,11,9,14,10,12,13,4,AM C,1,1,1,20,1,1,1,1,1,1,10,1,1,1,1
19255935,Rangel,1651,29/12/1994,21,0,0,0,0,184,0,1,2,1,3,2,1,1,1,2,3,3,6,3,13,13,12,4,13,5,3,6,7,9,5,9,9,11,5,11,7,7,7,3,9,9,13,5,6,7,13,12,6,10,10,14,12,20,7,9,9,9,5,9,9,7,9,10,13,12,11,8,3,S ,1,1,20,1,1,1,1,1,1,1,1,1,1,1,1
19255936,Quirino,1651,14/10/1993,22,0,0,0,0,179,79,1,1,1,2,1,3,3,1,3,3,2,5,8,10,12,10,4,11,6,3,4,9,8,5,11,12,8,11,9,11,7,9,7,6,5,11,8,9,11,14,10,11,10,7,11,13,20,10,13,8,5,8,7,7,8,11,8,6,10,11,12,7,S ,1,1,20,1,1,1,1,1,1,1,1,1,1,1,1
19255938,Madison,1651,29/03/1990,26,0,0,0,0,181,0,1,1,2,3,2,2,1,4,3,3,2,6,7,12,13,13,6,13,3,3,3,7,6,1,8,9,13,4,6,7,5,8,5,9,9,13,4,6,8,13,13,4,9,17,11,13,20,12,5,9,7,9,6,9,13,13,11,11,13,3,17,6,S ,1,1,20,1,1,1,1,1,1,1,1,1,1,1,1
19256346,João Felipe,1651,29/09/1993,22,0,0,0,0,182,73,1,2,2,2,2,3,1,1,2,2,2,4,4,8,9,12,4,1,8,1,4,11,1,5,12,8,7,4,8,4,6,12,3,13,11,8,5,6,8,12,12,5,9,8,12,12,20,7,7,8,5,8,8,8,17,10,11,11,11,1,13,8,AM C,1,1,1,20,1,1,1,1,1,1,10,1,1,1,1
19256348,Henrique,1651,20/04/1992,24,0,0,0,0,187,82,1,1,2,1,2,1,3,2,3,3,1,6,2,2,2,13,7,9,8,5,12,11,5,14,9,9,9,8,6,5,9,11,3,6,14,7,11,8,11,14,12,8,13,10,11,12,20,14,9,9,9,4,8,9,10,12,12,9,12,1,13,8,D/DM C,1,1,1,1,1,1,18,1,1,20,10,1,1,1,1
19256400,Endrick,1651,07/03/1995,21,0,0,0,0,182,74,1,3,3,3,2,4,1,1,1,2,3,6,8,12,6,13,6,6,8,2,6,11,1,8,13,9,7,8,8,11,12,12,13,14,8,12,7,7,12,13,13,4,9,20,10,12,10,7,5,9,9,1,9,9,9,10,11,13,12,6,13,3,AM LC,1,1,1,20,17,1,1,1,1,10,15,14,1,1,1
19256408,Rominho,1651,20/03/1998,18,0,0,0,0,187,0,2,3,2,2,3,3,3,1,2,1,1,6,6,11,8,14,6,6,14,1,5,13,4,7,14,8,8,7,4,7,11,4,18,13,9,8,7,8,12,14,10,3,10,7,10,10,20,8,8,4,5,8,6,8,10,9,9,10,10,6,11,8,AM C,1,1,1,20,1,1,1,1,1,1,10,1,1,1,1
19256669,Samuel,1651,14/02/1997,19,0,0,0,0,182,67,2,2,3,3,3,2,2,1,3,1,1,1,1,5,6,9,5,5,9,3,9,11,1,13,8,8,3,7,6,4,5,12,8,8,11,3,11,7,11,13,10,2,10,9,13,13,20,6,6,8,8,2,8,8,14,11,11,11,14,5,8,3,DM ,1,1,1,1,1,1,1,1,1,20,10,1,1,1,1
19256846,Marlon,1651,19/02/1994,22,0,0,0,0,185,0,3,4,3,2,2,2,1,3,1,2,4,7,5,11,13,14,7,14,8,1,6,7,9,5,12,8,6,5,10,3,5,10,3,11,1,14,6,7,8,12,7,8,8,8,13,9,20,10,9,9,9,9,9,9,12,10,13,12,11,5,9,4,S ,1,1,20,1,1,1,1,1,1,1,1,1,1,1,1
19256904,Pedrinho,1651,23/03/1995,21,0,0,0,0,178,63,1,2,2,1,1,1,4,4,1,2,3,5,4,5,3,12,4,7,3,7,9,9,6,14,8,9,10,9,8,7,7,9,9,9,8,7,11,9,9,12,14,9,9,8,14,14,20,8,6,9,7,5,5,9,9,11,8,12,9,9,9,2,D/WB R,1,1,1,1,1,1,1,1,20,1,1,1,1,1,17
19256905,Cristiano,1651,19/09/1995,20,0,0,0,0,198,90,12,7,6,6,12,9,5,12,8,7,6,5,3,3,1,3,7,1,3,1,2,1,3,2,1,8,3,14,1,4,3,12,8,1,1,3,8,5,4,12,11,5,17,12,7,11,20,4,12,7,8,8,8,8,15,10,11,11,13,9,8,8,GK ,20,1,1,1,1,1,1,1,1,1,1,1,1,1,1
19256906,Jaílson,1651,07/09/1995,20,0,0,0,0,187,82,1,1,3,2,2,1,1,1,3,2,4,7,9,12,12,12,6,9,11,10,13,12,10,13,12,10,13,13,11,13,11,13,13,12,6,15,13,15,15,14,14,15,12,10,15,14,20,15,14,14,10,12,6,14,15,12,13,12,12,10,9,6,DM/M C,1,1,1,1,1,1,1,1,1,19,20,1,1,1,1
19256907,Igor,1651,21/03/1996,20,0,0,0,0,185,79,3,1,1,1,3,1,3,3,3,2,2,6,4,5,3,13,6,6,9,3,7,8,1,13,11,8,7,7,6,6,7,13,8,8,11,4,9,7,9,11,7,7,13,9,13,9,20,7,7,8,8,8,6,8,18,11,10,11,9,12,10,8,DM ,1,1,1,1,1,1,1,1,1,20,10,1,1,1,1
19256908,Wesley Natã,1651,18/04/1995,21,0,0,0,0,183,81,1,1,2,1,1,3,3,1,2,1,1,6,10,12,11,12,8,10,11,8,8,11,11,8,12,9,11,10,11,8,11,10,14,14,5,13,9,12,13,13,13,9,11,11,12,13,20,13,12,12,8,12,6,10,12,9,12,11,13,8,11,6,AM/S L,1,1,20,1,18,14,1,1,1,1,1,1,1,1,1
19256909,William Bergamin,1651,11/07/1996,19,0,0,0,0,196,0,8,12,10,9,12,11,8,12,9,9,9,1,3,2,3,2,6,1,1,2,2,2,3,2,1,9,9,9,8,9,7,13,8,1,13,1,9,8,7,14,17,8,17,3,11,11,20,3,12,9,9,4,9,8,20,10,11,13,13,4,15,1,GK ,20,1,1,1,1,1,1,1,1,1,1,1,1,1,1
19256910,Leo Oro,1651,07/06/1995,21,0,0,0,0,179,0,2,1,1,1,3,3,3,3,3,2,1,4,4,6,6,8,4,4,10,2,4,12,1,6,4,7,4,6,3,5,13,10,7,7,12,8,6,6,10,13,9,5,6,5,8,11,20,5,7,7,7,7,7,7,15,12,13,11,9,4,3,6,AM C,1,1,10,20,1,1,1,1,1,1,13,1,1,1,1
19256911,Lucas Scalon,1651,20/09/1995,20,0,0,0,0,182,79,2,1,4,1,1,3,3,2,3,2,2,5,5,1,1,8,6,13,5,1,13,8,5,13,5,9,13,9,5,11,7,13,4,9,8,6,13,6,8,8,12,9,10,10,11,9,20,9,10,9,9,3,9,9,14,11,11,12,12,3,8,1,D C,1,1,1,1,1,1,20,1,1,15,5,1,1,1,1
19257007,Caio Faier,1651,15/04/1996,20,0,0,0,0,175,0,2,3,2,2,4,3,2,2,2,2,3,4,4,3,2,10,4,4,12,1,5,9,1,11,10,5,9,6,5,7,6,12,8,8,1,1,5,6,9,11,12,5,4,16,15,12,20,5,5,7,7,4,8,8,13,8,11,11,10,6,18,7,DM ,1,1,1,1,1,1,1,1,1,20,10,1,1,1,1
19257202,Eduardo,1651,17/09/1997,18,0,0,0,0,184,0,3,2,1,1,3,2,1,1,2,1,1,2,1,1,1,5,1,12,1,1,13,6,3,13,3,8,8,8,6,5,5,13,5,4,10,1,11,5,6,8,8,3,11,20,15,10,8,3,9,6,6,7,8,8,10,10,10,9,7,8,12,8,D C,1,1,1,1,1,1,20,1,1,1,1,1,1,1,1
19257203,João Dias,1651,04/02/1998,18,0,0,0,0,159,0,3,2,1,1,2,1,3,3,3,2,3,3,5,7,6,10,4,2,11,1,3,11,1,7,14,7,8,2,4,3,10,10,5,13,1,9,7,7,12,14,9,6,1,1,7,12,20,9,4,7,5,6,7,7,7,11,10,8,12,7,15,6,AM C,1,1,1,20,1,1,1,1,1,1,15,1,1,1,1
19257204,Luiz Felipe,1651,05/10/1996,19,0,0,0,0,180,71,1,2,2,3,1,1,3,1,2,1,1,6,11,8,7,12,4,5,8,3,4,10,6,6,10,8,5,5,10,1,7,11,3,8,10,7,6,7,9,13,11,4,9,20,8,13,8,6,6,8,8,8,4,8,7,13,12,12,11,1,9,4,AM LC,1,1,1,20,18,1,1,1,1,1,12,15,1,1,1
19257205,Miguel,1651,28/07/1997,18,0,0,0,0,189,79,12,8,7,7,12,5,5,12,4,7,10,3,3,2,1,1,7,1,3,1,1,1,3,2,3,7,2,7,4,10,3,12,7,3,7,1,6,4,3,9,10,4,13,5,7,11,20,3,9,7,7,7,5,6,16,11,11,13,11,10,11,8,GK ,20,1,1,1,1,1,1,1,1,1,1,1,1,1,1
19257206,Wesley,1651,06/03/1997,19,0,0,0,0,192,0,3,1,3,1,2,3,1,3,1,1,2,6,6,5,4,14,3,5,11,2,6,10,2,12,9,6,11,5,7,6,8,12,8,8,2,5,9,8,11,10,11,7,16,3,8,13,20,6,10,8,8,8,8,8,19,8,10,12,12,6,13,5,DM ,1,1,1,1,1,1,1,1,1,20,10,1,1,1,1
19257208,Cleyson,1651,09/10/1997,18,0,0,0,0,179,0,2,3,2,1,2,4,3,3,2,2,2,4,5,13,13,13,6,13,6,2,3,5,2,2,13,3,10,2,8,6,5,10,1,13,9,9,6,6,7,13,13,7,6,8,6,13,20,8,4,9,6,5,9,9,17,11,9,9,11,2,11,3,S ,1,1,20,1,1,1,1,1,1,1,1,1,1,1,1
19257209,Fabian,1651,24/10/1997,18,0,0,0,0,184,0,2,2,2,1,3,1,1,1,1,2,1,2,1,1,1,2,1,10,5,2,10,2,1,13,5,5,7,8,5,4,2,13,8,3,6,3,11,5,6,13,11,6,9,20,5,13,8,6,6,8,7,8,8,8,15,11,11,10,11,6,9,7,D C,1,1,1,1,1,1,20,11,1,1,1,1,1,7,1
19257336,Diego,1651,21/09/1995,20,0,0,0,0,182,74,2,1,2,2,1,2,3,3,3,2,3,9,11,11,9,10,7,12,10,11,11,11,3,11,10,14,11,12,11,14,11,12,3,11,14,10,11,12,13,14,13,12,11,20,12,13,10,14,9,12,12,8,8,6,10,9,12,12,10,4,3,7,D/WB L,1,1,1,1,1,1,1,20,1,1,1,1,1,16,1
19257876,Vítor Bueno,1651,05/09/1994,21,0,0,0,0,185,80,1,3,2,2,3,1,3,2,2,1,1,12,12,15,13,13,11,10,16,9,8,14,13,6,15,11,12,12,12,13,15,13,14,14,10,14,5,11,11,14,14,12,13,11,14,14,20,12,12,12,8,12,11,14,14,13,12,13,11,14,11,2,AM C,1,1,1,20,1,13,1,1,1,1,10,1,1,1,1
19258125,Alysson,1651,05/06/1998,18,0,0,0,0,172,0,1,2,4,2,2,2,2,2,1,2,2,6,4,14,10,13,7,14,8,3,4,6,3,1,12,9,8,5,10,7,8,14,7,11,4,10,4,7,8,14,11,5,4,8,11,10,20,10,9,9,9,1,9,9,20,11,11,14,11,8,14,4,S ,1,1,20,1,1,1,1,1,1,1,1,1,1,1,1
19258259,Rodolfo,1651,30/10/1997,18,0,0,0,0,181,0,2,3,1,2,3,3,1,2,3,3,3,5,6,14,11,12,6,13,8,7,6,8,7,3,7,9,12,8,11,8,8,14,9,9,3,14,5,7,8,14,12,8,8,1,13,14,20,10,10,9,5,3,9,9,11,12,11,14,12,7,12,8,S ,1,1,20,1,1,1,1,1,1,1,1,1,1,1,1
19258260,Jean,1651,01/07/1994,22,0,0,0,0,180,68,1,1,1,3,4,3,3,3,3,1,1,13,11,10,8,10,13,9,10,11,11,12,13,12,8,3,11,9,10,9,10,9,8,11,12,11,11,10,10,11,11,11,10,20,12,10,5,10,9,10,5,10,10,11,12,14,11,12,10,7,12,6,D/WB L,1,1,1,1,1,1,1,20,1,1,1,1,1,18,1
19258297,Hiago,1651,10/01/1997,19,0,0,0,0,181,76,2,1,2,2,4,1,3,3,3,2,1,6,6,12,13,13,6,13,7,1,6,7,8,2,12,9,9,4,10,7,7,9,2,14,5,11,6,6,7,13,10,7,10,8,13,12,20,6,9,9,9,3,9,9,19,11,10,11,13,7,10,3,S ,1,1,20,1,1,1,1,1,1,1,1,1,1,1,1
19258298,Gabriel Calabres,1651,08/03/1998,18,0,0,0,0,184,75,1,4,2,1,2,2,1,3,3,1,1,9,5,12,13,15,9,8,15,8,8,12,7,7,15,10,12,10,7,10,14,12,18,13,10,13,9,9,12,11,12,10,9,10,11,11,20,9,11,8,7,10,9,10,7,18,12,12,12,2,4,6,AM C,1,1,1,20,1,1,1,1,1,1,10,1,1,1,1
19258526,Daniel Pessoa,1651,14/04/1995,21,0,0,0,0,179,76,2,3,2,1,1,3,1,4,1,2,1,7,8,11,11,12,7,10,10,2,3,10,3,4,10,6,13,8,12,7,10,10,6,12,5,11,6,7,10,11,10,8,10,13,13,11,20,7,8,9,6,8,9,9,17,12,9,11,9,1,4,8,S ,1,1,20,1,1,1,1,1,1,1,1,1,1,1,1
19258527,Jonatas Paulista,1651,05/02/1994,22,0,0,0,0,174,75,3,1,2,2,3,2,2,2,1,2,2,8,7,10,10,15,9,9,12,8,13,11,6,12,15,12,14,12,5,11,11,11,10,10,1,9,12,13,13,12,11,9,11,11,13,12,20,13,8,11,5,1,5,10,17,11,12,10,12,3,2,3,DM ,1,1,1,1,1,1,1,1,1,20,13,1,1,1,1
19258529,Matheus Alves,1651,18/11/1998,17,0,0,0,0,168,58,3,4,2,3,2,3,1,3,1,2,1,7,9,11,12,9,7,5,7,3,7,11,4,3,11,10,6,5,11,8,12,14,13,12,8,9,6,11,11,11,12,9,3,12,14,12,20,6,5,9,5,9,9,5,18,13,12,9,11,2,8,5,AM LC,1,1,14,20,15,11,1,1,1,1,1,1,1,1,1
19258530,Eron,1651,10/03/1995,21,0,0,0,0,169,64,3,1,2,1,2,1,1,1,3,2,2,7,7,6,1,13,4,9,4,7,10,9,1,9,10,7,9,10,9,6,9,13,4,6,13,7,8,9,9,12,14,9,4,10,13,12,20,12,8,9,9,5,4,9,11,10,11,12,12,1,15,8,D R,1,1,1,1,1,1,1,1,20,1,1,1,1,1,14
19258531,Lucas Barboza,1651,14/03/1996,20,0,0,0,0,185,83,2,1,1,2,3,1,2,2,2,3,4,6,5,7,4,10,8,10,8,3,12,13,5,12,6,9,10,10,11,9,10,11,6,1,10,7,12,8,10,12,11,8,13,4,12,12,20,12,14,9,9,9,9,9,13,10,11,13,10,5,4,5,D C,1,1,1,1,1,1,20,1,1,15,13,1,1,1,1
19258532,Souza,1651,06/10/1997,18,0,0,0,0,185,78,2,3,3,3,1,2,2,1,2,1,4,6,8,8,3,9,3,9,8,8,9,8,4,13,10,9,11,10,6,9,9,15,4,4,1,5,7,9,9,13,10,9,12,20,8,10,9,11,9,8,8,3,5,7,19,13,12,13,10,1,7,6,D L,1,1,1,1,1,1,1,20,1,1,1,1,1,14,1
19258533,Ítalo,1651,10/01/1996,20,0,0,0,0,186,78,3,1,3,2,3,3,1,3,3,3,2,5,2,1,4,3,2,13,3,1,13,6,3,11,5,9,6,9,6,10,1,13,4,1,3,5,13,6,7,13,11,7,10,8,11,12,20,8,7,9,7,9,9,9,20,10,11,12,10,8,9,8,D C,1,1,1,1,1,1,20,1,1,1,1,1,1,1,1
19258534,Mateus Santana,1651,16/03/1995,21,0,0,0,0,180,77,1,2,1,1,3,1,3,1,1,1,2,7,8,10,10,11,5,10,9,4,11,12,7,11,11,11,9,12,9,4,11,13,2,9,11,10,10,10,11,10,9,11,9,7,13,10,20,12,11,9,6,2,8,10,18,9,13,10,11,2,4,2,AM C,1,1,1,20,1,1,1,1,1,1,15,1,1,1,1
19258560,Léo Alemão,1651,15/01/1991,25,0,0,0,0,191,88,2,2,1,3,1,4,3,2,2,3,1,5,4,4,4,7,3,14,7,1,14,8,2,14,3,5,10,6,8,8,5,11,9,5,6,6,14,7,8,10,9,8,14,20,14,13,10,10,10,9,8,3,4,9,13,9,12,10,11,6,13,4,D C,1,1,1,1,1,1,20,1,1,1,1,1,1,1,1
19258567,Filipe Sertânia,1651,06/04/1990,26,0,0,0,0,175,68,3,2,1,3,1,2,3,2,2,1,1,5,3,12,13,13,7,12,9,1,7,9,7,7,13,10,8,5,6,8,12,13,2,13,6,13,8,8,7,13,12,8,7,10,11,13,20,8,6,10,6,9,10,10,19,11,11,10,11,7,6,2,AM/S C,1,1,18,20,1,1,1,1,1,1,10,1,1,1,1
19258642,Bruno Henrique,1651,30/12/1990,25,0,0,0,0,184,71,2,4,2,2,3,4,2,3,2,3,2,9,10,14,12,14,8,13,10,7,5,11,10,6,12,14,12,10,10,12,9,8,14,14,6,13,6,8,14,18,14,10,13,9,11,16,20,12,9,11,10,12,10,14,8,13,11,9,11,10,10,10,M/AM/S R,1,1,20,1,14,16,1,1,1,1,1,14,16,1,1
19258647,Pericles,1651,24/03/1994,22,0,0,0,0,176,73,1,1,2,4,3,3,2,1,1,1,1,7,8,8,9,12,5,8,12,4,13,12,8,12,11,16,12,10,9,8,12,12,5,3,12,7,12,12,13,12,12,12,9,10,13,12,20,10,9,10,15,12,10,12,9,13,11,12,8,4,5,4,DM ,1,1,1,1,1,1,1,1,12,20,13,1,1,1,1
19258648,Felipe Saturnino,1651,10/08/1995,20,0,0,0,0,180,76,1,1,3,2,2,1,2,1,1,2,1,4,4,6,4,13,4,13,9,6,13,10,9,13,9,15,6,15,11,12,2,13,17,3,10,9,9,9,14,13,13,13,10,20,16,11,11,13,12,13,13,14,6,13,15,10,11,11,10,4,4,5,D/WB L,1,1,1,1,1,1,1,20,1,1,1,1,1,18,1
19258649,Baiano,1651,12/10/1994,21,0,0,0,0,189,87,1,1,3,1,2,2,4,1,1,2,2,4,3,4,2,12,1,13,12,2,13,12,5,13,7,13,12,14,9,9,5,11,15,3,9,5,12,13,12,10,9,8,9,10,13,11,20,7,14,10,13,13,10,8,14,10,15,10,15,10,12,8,D C,1,1,1,1,1,1,20,1,1,1,1,1,1,1,1
19258651,Leonidas,1651,17/10/1995,20,0,0,0,0,173,70,2,3,3,3,2,3,2,2,1,2,3,7,9,14,13,13,7,9,6,4,4,13,9,8,13,5,11,6,10,7,11,11,12,14,11,11,6,10,12,13,13,11,7,20,13,12,11,11,10,10,5,10,4,13,7,13,12,11,11,6,12,5,AM C,1,1,1,20,12,12,1,1,1,1,11,1,1,1,1
19258652,Edson,1651,20/03/1995,21,0,0,0,0,168,65,1,3,1,2,1,1,1,1,1,2,1,9,5,13,13,13,9,11,9,4,5,11,9,3,13,12,5,4,13,12,11,13,4,11,13,14,7,11,12,12,11,13,6,8,14,13,20,8,8,13,10,12,10,9,15,12,14,10,12,3,14,2,S ,1,1,20,1,1,1,1,1,1,1,1,1,1,1,1
19258653,Matheus Rezende,1651,17/03/1995,21,0,0,0,0,188,72,3,3,1,1,2,2,3,1,2,2,4,8,6,10,6,12,4,11,11,4,12,12,8,12,12,8,10,9,10,8,11,12,7,4,10,8,11,12,12,12,11,11,4,10,9,12,20,4,11,6,10,11,10,10,20,12,13,11,14,1,6,1,DM ,1,1,1,1,1,1,1,1,1,20,12,1,1,1,1
19258656,Eduardo Nardini,1651,21/07/1997,18,0,0,0,0,180,0,1,1,1,2,3,1,2,2,3,3,4,6,6,11,10,12,4,10,5,6,6,11,2,7,12,9,9,4,9,4,12,8,9,12,9,6,7,7,8,11,11,10,9,20,12,10,14,13,7,9,9,9,9,9,20,11,9,14,12,1,12,6,AM C,1,1,12,20,1,13,1,1,1,1,11,1,1,1,1
19258657,Anderson,1651,14/04/1998,18,0,0,0,0,180,65,2,3,4,2,3,2,2,3,3,2,1,5,8,12,10,12,5,11,6,3,1,6,1,1,13,6,8,5,8,4,5,8,5,13,7,12,5,5,7,13,9,1,5,9,10,11,20,7,7,8,8,8,8,8,12,9,11,8,10,5,19,5,S ,1,1,20,1,13,13,1,1,1,1,1,1,1,1,1
19258658,Marquinhos Cipriano,1651,09/02/1998,18,0,0,0,0,171,0,3,1,2,2,3,3,2,1,3,1,1,6,10,12,12,11,6,8,10,5,4,10,4,6,12,6,6,4,12,2,11,11,20,13,5,12,6,7,8,11,13,7,1,20,13,12,12,12,6,10,10,7,10,10,16,10,10,11,12,3,16,3,AM RC,1,1,15,16,14,20,1,1,1,1,1,14,1,1,1
19258659,Luís Henrique,1651,07/03/1998,18,0,0,0,0,175,0,2,3,1,2,3,2,3,3,1,2,2,6,7,13,10,13,6,13,7,5,4,7,6,3,12,9,8,7,4,3,2,6,8,12,2,13,2,6,7,13,9,7,8,7,11,11,20,12,12,9,9,9,9,8,13,12,13,10,11,8,11,6,S ,1,1,20,1,1,1,1,1,1,1,1,1,1,1,1
19258661,Robert,1651,06/01/1998,18,0,0,0,0,171,66,1,1,3,2,2,2,2,2,2,2,1,10,13,10,12,12,8,14,7,3,7,8,7,2,12,4,10,5,12,7,9,9,9,12,9,13,7,4,8,12,13,8,4,20,6,12,11,10,7,9,6,8,8,9,15,10,12,11,10,5,1,8,S RL,1,1,20,1,15,15,1,1,1,1,1,1,1,1,1
19258662,Gabriel Barbosa,1651,17/03/1999,17,0,0,0,0,182,0,1,3,2,2,2,3,2,3,1,4,1,7,8,14,12,14,7,11,5,1,5,8,8,7,10,7,5,8,10,5,8,5,8,9,10,10,5,7,9,13,14,8,10,8,16,12,20,8,9,6,7,2,6,9,11,11,11,11,12,3,17,7,S ,1,1,20,1,1,1,1,1,1,1,1,1,1,1,1
19258663,Gritti,1651,17/12/1996,19,0,0,0,0,188,0,14,8,10,1,14,12,7,14,7,10,8,3,3,1,2,2,5,1,2,3,2,1,2,3,5,9,9,14,6,9,8,14,6,1,3,1,10,9,7,10,13,4,9,9,16,9,20,2,8,9,9,10,4,10,8,9,10,9,10,10,7,4,GK ,20,1,1,1,1,1,1,1,1,1,1,1,1,1,1
19258667,James Dean,1651,22/07/1997,18,0,0,0,0,176,0,2,3,2,1,3,1,3,3,1,4,1,7,12,12,12,13,7,14,13,6,4,13,2,4,14,9,9,8,8,8,5,12,9,11,9,11,5,7,14,13,14,8,8,20,11,14,1,9,7,11,6,11,9,9,20,11,9,11,14,1,5,7,AM/S L,1,1,20,1,16,12,1,1,1,1,1,1,1,1,1
19258668,Léo Santos,1651,10/01/1996,20,0,0,0,0,175,68,1,3,4,3,1,3,3,3,1,3,3,7,7,13,11,13,7,6,9,3,8,10,4,8,13,7,12,8,11,6,10,8,11,14,12,13,7,8,9,14,14,12,6,11,10,13,20,8,6,10,10,10,5,10,11,12,12,10,12,5,5,2,AM/S C,1,1,18,20,1,1,1,1,1,1,10,1,1,1,1
19258670,Sinho,1651,14/08/1996,19,0,0,0,0,185,0,2,1,3,2,4,4,3,2,2,3,1,10,7,6,5,11,14,7,12,7,9,9,2,14,9,5,7,8,7,5,6,12,4,4,4,12,9,8,13,14,10,3,10,9,13,10,20,10,7,9,6,9,9,11,17,11,11,11,11,9,15,6,D R,1,1,1,1,1,13,1,1,20,1,1,1,13,1,14
19258672,Horácio,1651,22/05/1997,19,0,0,0,0,182,74,4,2,2,2,1,1,1,2,1,2,3,3,2,8,6,14,4,7,7,4,11,11,6,13,14,9,6,12,7,6,8,14,5,8,4,8,10,8,12,14,9,4,8,10,12,11,20,12,7,9,8,6,9,9,20,11,11,11,11,4,13,3,M C,1,1,1,1,1,1,1,1,1,15,20,1,1,1,1
19258723,Kaio,1651,18/03/1995,21,0,0,0,0,173,62,1,2,3,2,3,3,1,3,2,1,1,4,6,9,9,11,9,10,7,7,11,12,7,11,11,9,12,12,11,12,10,12,5,11,10,13,11,11,11,10,11,11,5,10,16,11,20,12,10,10,6,2,10,10,7,11,8,12,11,6,16,6,DM ,1,1,1,1,1,1,1,1,1,20,12,1,1,1,1
19258885,Heré,1651,20/06/1994,22,0,0,0,0,176,70,1,1,3,2,4,3,1,1,3,1,1,6,7,13,13,13,6,13,6,5,6,7,6,2,13,9,10,5,9,7,4,7,4,13,6,13,6,6,7,13,10,7,6,16,7,11,20,6,7,9,5,9,9,9,16,12,11,11,12,11,1,3,S ,1,1,20,1,1,1,1,1,1,1,1,1,1,1,1
19258887,Allef,1651,24/01/1996,20,0,0,0,0,177,75,3,3,3,1,1,3,3,1,1,1,3,8,7,14,14,13,8,14,5,3,7,9,8,2,11,9,7,9,11,8,6,14,10,10,8,14,8,8,9,14,14,9,7,3,16,14,20,6,9,7,10,5,6,9,8,13,10,9,10,7,13,6,S ,1,1,20,1,1,1,1,1,1,1,1,1,1,1,1
19258901,Paulo,1651,15/03/1995,21,0,0,0,0,175,70,3,3,3,1,2,3,2,2,1,2,2,2,9,10,9,9,9,8,8,5,6,9,10,7,10,5,9,10,9,9,8,8,8,12,6,8,6,12,12,13,13,13,7,5,13,12,20,13,8,12,5,10,5,11,18,13,11,13,11,9,12,5,AM/S RL,1,1,16,1,19,20,1,1,1,1,1,1,1,1,1
19258902,André Luís,1651,03/09/1994,21,0,0,0,0,184,71,3,1,3,2,2,2,4,2,2,2,1,7,7,13,13,13,7,13,7,4,7,8,5,6,11,10,6,6,9,8,8,11,10,11,5,13,7,7,8,13,10,8,9,10,15,12,20,9,9,10,10,5,10,10,10,10,12,8,10,3,8,4,S ,1,1,20,1,1,1,1,1,1,1,1,1,1,1,1
19258904,Dierson,1651,01/08/1995,20,0,0,0,0,185,75,1,1,2,3,1,3,3,3,2,1,1,2,2,3,1,10,2,14,5,10,14,12,2,10,10,10,14,14,12,12,5,13,9,12,10,10,12,12,13,15,15,15,13,5,14,14,20,15,15,12,10,11,8,12,13,11,10,10,9,12,6,4,DM ,1,1,1,1,1,1,1,1,1,20,1,1,1,1,1
19258916,Liverson,1651,20/02/1997,19,0,0,0,0,181,0,2,2,3,2,3,3,1,2,4,1,2,7,11,9,7,10,6,8,7,10,9,9,1,9,10,9,8,9,8,11,7,11,9,3,4,10,11,10,11,13,11,10,9,20,3,12,10,12,10,8,4,9,9,9,19,9,11,11,11,4,7,4,D/WB L,1,1,1,1,1,1,1,20,1,1,1,13,1,19,1
19258917,Gabriel Silva,1651,03/03/1995,21,0,0,0,0,190,81,1,1,3,2,2,1,1,3,2,2,2,6,9,1,8,12,4,12,8,7,10,11,5,10,10,10,10,10,9,10,7,10,11,3,13,9,10,11,11,11,13,6,15,12,17,11,20,9,12,10,6,10,8,10,8,13,11,10,12,1,16,3,D C,1,1,1,1,1,1,20,13,1,1,1,1,1,7,1
19258918,Felipe Paulista,1651,21/01/1994,22,0,0,0,0,175,75,3,3,1,1,2,1,3,2,1,2,1,7,9,9,14,10,7,11,4,5,6,8,5,7,14,9,13,6,7,4,7,8,2,13,1,13,8,7,9,14,12,13,7,10,12,14,20,7,9,9,9,8,9,9,12,9,10,12,9,6,9,6,S L,1,1,20,1,15,14,1,1,1,1,1,1,1,1,1
19258925,Patrick,1651,30/11/1996,19,0,0,0,0,169,65,1,1,1,3,3,4,1,2,2,1,3,7,8,3,6,9,6,9,6,8,10,9,5,12,7,10,8,10,8,10,7,13,8,5,5,5,9,9,9,14,14,9,7,8,17,13,20,14,6,9,10,10,10,10,14,13,12,12,10,4,12,8,D R,1,1,1,1,1,1,1,1,20,1,1,1,1,1,1
19258926,Sabino,1651,25/10/1996,19,0,0,0,0,184,88,1,2,2,3,1,3,3,3,1,2,1,5,5,4,5,9,8,12,8,8,11,4,3,14,11,10,7,10,7,12,5,14,11,7,5,8,12,8,9,11,12,15,13,20,12,11,8,10,13,10,15,10,9,10,13,12,11,12,10,1,12,5,D C,1,1,1,1,1,1,20,1,1,1,1,1,1,1,1
19258927,Caio,1651,31/07/1997,18,0,0,0,0,180,62,4,1,2,1,1,1,2,2,1,4,1,9,9,13,9,12,12,8,13,7,7,13,6,7,13,10,7,2,10,10,14,13,2,13,8,13,7,9,8,15,15,11,8,20,16,15,10,7,8,10,6,5,10,10,12,12,10,13,10,1,1,5,AM C,1,1,1,20,12,12,1,1,1,1,1,1,1,1,1
19258928,Claudinho,1651,28/01/1997,19,0,0,0,0,172,60,1,2,1,4,1,3,1,3,1,1,2,9,14,12,13,14,8,11,9,3,6,9,4,6,14,9,7,4,13,9,9,12,9,13,7,10,9,8,10,12,12,4,8,10,9,11,20,11,8,9,10,5,8,10,17,14,12,12,9,2,1,6,S L,1,1,20,1,15,1,1,1,1,1,1,1,1,1,1
19258929,Igor,1651,01/04/1997,19,0,0,0,0,178,0,2,3,4,3,1,1,2,2,2,3,2,7,7,4,8,10,7,5,9,1,11,14,2,14,10,9,11,8,8,8,7,14,6,8,4,7,14,8,11,14,11,8,8,8,10,12,20,6,7,8,9,3,8,9,7,13,12,12,13,8,15,7,DM ,1,1,1,1,1,1,1,1,1,20,10,1,1,1,1
19258930,João Gabriel,1651,20/03/1996,20,0,0,0,0,171,65,1,3,2,3,3,2,2,2,1,4,3,5,8,13,13,14,6,9,9,1,7,9,7,8,9,7,7,5,5,7,10,10,2,9,12,8,2,8,9,14,13,4,8,8,7,14,20,9,6,9,6,9,9,8,20,11,11,11,9,10,9,5,AM/S C,1,1,18,20,13,13,1,1,1,1,1,1,1,1,1
19258931,Victor Paffaro,1651,25/05/1995,21,0,0,0,0,184,69,3,3,2,3,1,4,3,1,3,4,1,6,6,7,11,7,6,5,9,2,6,13,3,7,12,9,9,4,7,5,13,12,3,12,10,6,6,7,10,13,10,3,6,9,14,10,20,7,9,9,9,9,5,9,14,11,12,13,10,7,8,4,AM C,1,1,1,20,1,1,1,1,1,1,10,1,1,1,1
19258932,Pedro Henrique,1651,10/04/1997,19,0,0,0,0,178,80,1,3,1,3,1,3,3,1,3,3,3,6,5,13,13,11,6,13,7,3,6,7,7,6,9,8,9,8,13,6,7,9,5,9,10,11,4,6,4,8,13,7,10,8,14,10,20,7,9,9,9,2,9,8,9,8,13,14,11,7,12,5,S ,1,1,20,1,1,1,1,1,1,1,1,1,1,1,1
19259013,Caio,1651,01/01/1997,19,0,0,0,0,190,0,11,7,7,7,14,12,12,14,9,9,11,2,3,2,2,1,6,1,2,3,2,1,3,3,4,9,9,12,8,10,7,13,4,1,5,2,12,3,7,11,12,8,16,1,11,13,20,6,9,8,6,9,6,9,9,12,11,12,11,7,9,4,GK ,20,1,1,1,1,1,1,1,1,1,1,1,1,1,1
19259014,Fernando,1651,01/08/1997,18,0,0,0,0,188,0,14,10,13,6,9,14,14,14,9,7,14,6,2,2,2,7,8,1,1,1,3,2,1,3,3,9,9,7,6,12,6,14,19,2,11,3,11,9,6,13,7,9,14,9,10,11,20,1,9,10,5,9,9,10,15,11,10,9,11,4,18,1,GK ,20,1,1,1,1,1,1,1,1,1,1,1,1,1,1
19259015,Rodrigo,1651,25/01/1996,20,0,0,0,0,199,97,13,12,9,11,6,10,11,9,10,8,10,6,1,2,3,7,8,9,1,1,2,8,1,1,5,8,7,10,7,6,8,8,12,1,7,1,8,8,7,5,7,6,10,20,9,8,9,9,11,8,8,4,8,8,10,11,12,9,12,10,13,8,GK ,20,1,1,1,1,1,1,1,1,1,1,1,1,1,1
19259016,Warleson,1651,31/08/1996,19,0,0,0,0,184,0,5,12,7,1,14,14,12,14,9,9,13,4,2,3,2,2,9,1,3,1,2,1,2,1,4,8,8,14,5,10,7,14,6,1,10,3,12,8,7,13,7,8,7,10,11,12,20,2,8,8,4,6,4,9,9,9,12,11,10,9,5,2,GK ,20,1,1,1,1,1,1,1,1,1,1,1,1,1,1
19259017,Gabriel Lopes,1651,28/02/1998,18,0,0,0,0,195,0,12,9,10,9,12,13,7,10,9,6,7,4,2,1,3,5,9,1,3,3,2,1,3,1,3,7,7,15,4,9,6,13,14,2,6,3,9,7,6,13,6,2,13,1,6,13,20,2,11,8,9,7,9,9,16,10,12,13,9,3,9,7,GK ,20,1,1,1,1,1,1,1,1,1,1,1,1,1,1
19259018,Vitor Feitosa,1651,10/03/1996,20,0,0,0,0,180,74,1,2,2,2,3,1,4,1,1,3,2,4,1,2,2,7,1,13,1,1,13,4,1,13,6,9,8,9,5,11,5,13,3,2,1,4,13,6,7,13,11,7,5,5,16,12,20,4,7,8,8,1,8,9,19,11,12,11,12,6,10,2,D C,1,1,1,1,1,1,20,1,1,1,1,1,1,1,1
19259020,Olavo,1651,14/03/1998,18,0,0,0,0,182,78,3,3,1,2,1,1,1,3,3,3,4,2,1,1,3,5,1,12,1,3,13,6,4,13,5,8,6,8,2,7,4,13,3,1,11,3,6,5,6,13,9,6,10,9,13,10,20,4,9,8,7,8,8,8,12,11,13,11,11,9,10,8,D C,1,1,1,1,1,1,20,1,1,1,1,1,1,1,1
19259021,Caio Talarico,1651,16/01/1998,18,0,0,0,0,182,73,2,3,4,2,3,1,1,2,3,3,2,1,2,1,4,8,1,12,6,7,11,9,6,14,4,9,7,9,6,5,2,14,7,3,8,4,14,7,8,12,10,8,10,8,10,14,20,5,6,9,9,9,9,9,20,9,11,10,11,3,13,8,D C,1,13,1,1,1,1,20,1,1,1,1,1,1,1,1
19259022,Daniel Oliveira,1651,25/01/1998,18,0,0,0,0,193,0,3,1,3,1,1,2,2,3,2,3,1,1,2,3,2,6,1,13,3,1,13,7,1,13,6,5,12,9,6,9,2,12,3,2,6,3,11,5,7,7,8,6,14,11,12,8,20,5,11,9,9,9,8,9,12,10,11,11,12,7,1,5,D C,1,1,1,1,1,1,20,1,1,1,1,1,1,1,1
19259024,Jacy,1651,11/07/1997,18,0,0,0,0,192,0,2,1,3,2,4,3,3,1,2,3,3,4,1,3,1,8,2,12,6,1,14,8,1,14,3,9,9,9,6,5,3,14,3,1,3,7,14,7,8,8,9,8,14,3,8,11,20,9,13,9,7,1,5,9,18,9,12,11,12,3,1,1,D C,1,1,1,1,1,1,20,1,1,1,1,1,1,1,1
19259025,Thiagão,1651,16/04/1997,19,0,0,0,0,188,0,2,3,2,2,3,2,2,2,1,1,3,6,3,3,4,6,3,14,1,1,9,4,5,9,6,8,10,8,7,11,6,14,8,6,12,3,9,6,7,8,10,7,11,1,15,9,20,5,9,8,7,6,7,8,16,8,10,12,10,5,12,3,D C,1,1,1,1,1,1,20,1,1,1,1,1,1,1,1
19259026,Breno,1651,18/01/1997,19,0,0,0,0,180,0,2,4,3,2,3,1,1,2,3,1,3,10,13,11,9,9,10,9,10,9,10,10,9,10,12,11,10,11,8,10,10,11,6,12,10,11,11,8,10,10,11,10,8,10,15,11,20,11,8,12,12,11,10,12,9,11,11,11,13,11,13,3,D/WB R,1,1,1,1,1,1,1,1,20,1,1,1,1,1,17
19259027,Renan Lodi,1651,08/04/1998,18,0,0,0,0,171,0,3,1,2,1,2,2,3,3,3,2,3,7,8,8,9,14,5,10,7,9,8,10,9,13,10,8,7,11,10,10,9,15,9,10,7,8,8,11,11,11,15,11,5,20,11,15,10,8,7,10,6,10,7,9,15,11,12,12,12,7,15,6,D/WB L,1,1,1,1,1,1,1,20,1,1,1,1,1,17,1
19259028,Gustavo Silva,1651,12/10/1996,19,0,0,0,0,162,0,2,1,3,3,3,1,1,3,1,2,2,7,5,4,6,13,3,6,6,7,7,7,7,12,9,8,10,7,7,5,9,15,8,4,2,3,5,9,9,15,9,9,1,9,14,12,20,11,6,8,8,8,8,8,18,13,10,14,11,7,8,6,D/WB R,1,1,1,1,1,1,1,1,17,1,1,1,1,1,20
19259030,Matheus Borges,1651,18/05/1997,19,0,0,0,0,171,0,2,2,3,2,1,1,2,2,1,1,2,7,3,6,9,14,7,6,14,7,7,14,5,12,12,9,5,8,7,5,11,14,4,4,8,8,5,9,12,14,14,9,7,10,6,14,20,8,6,9,9,9,9,9,16,10,11,12,11,6,11,5,DM/M C,1,1,1,1,1,1,1,1,1,20,17,1,1,1,1
19259032,Gabriel Mello,1651,08/02/1998,18,0,0,0,0,170,0,2,1,1,1,1,3,1,1,3,2,2,6,5,8,6,13,6,6,12,4,6,13,4,6,13,9,4,8,8,5,13,10,6,13,10,12,4,8,10,12,13,8,4,8,12,13,20,6,4,7,9,9,4,9,14,12,14,11,12,4,9,1,M/AM C,1,1,1,17,1,1,1,1,1,1,20,1,1,1,1
19259033,Jefferson Castro,1651,11/02/1998,18,0,0,0,0,173,65,2,2,2,2,2,2,1,2,1,3,3,6,4,6,5,14,6,2,7,1,6,10,1,12,12,8,5,6,4,5,13,14,8,4,10,8,12,8,10,14,12,8,7,9,14,12,20,7,5,6,8,6,8,8,16,10,11,13,13,7,13,3,DM/M C,1,1,1,1,1,1,1,1,1,17,20,1,1,1,1
19259034,Matheus Anjos,1651,21/12/1998,17,0,0,0,0,186,0,2,1,1,1,3,2,2,1,2,3,3,8,8,12,11,14,14,6,13,4,6,12,3,6,14,10,7,2,6,10,14,14,17,13,8,12,4,10,12,11,13,11,13,10,12,12,20,8,10,9,5,3,10,10,8,12,10,11,10,3,7,2,M/AM C,1,1,1,20,1,1,1,1,1,1,17,1,1,1,1
19259035,Nicolas,1651,24/07/1997,18,0,0,0,0,181,0,3,1,1,3,3,1,1,1,3,1,3,11,14,10,4,13,8,7,10,5,7,12,5,9,14,7,6,4,9,8,12,12,10,8,8,10,5,9,13,14,10,9,8,20,13,11,9,14,7,9,10,8,6,10,15,10,11,12,12,3,15,3,M LC,1,1,1,1,10,1,1,1,1,13,17,20,1,1,1
19259036,Renzo,1651,17/07/1998,17,0,0,0,0,186,0,3,3,3,1,4,2,1,2,3,3,3,7,7,4,9,10,7,7,10,7,11,14,5,13,14,9,7,8,5,9,11,11,4,8,9,5,12,9,9,14,12,6,8,9,13,10,20,5,8,7,8,9,9,9,19,9,9,12,12,5,10,8,DM/M C,1,1,1,1,1,1,1,1,1,20,17,1,1,1,1
19259037,David Pereira,1651,23/03/1998,18,0,0,0,0,172,0,3,3,1,1,2,3,3,4,1,4,1,4,4,7,5,13,5,5,11,4,7,11,2,7,13,8,3,2,4,4,10,6,8,13,9,7,6,7,10,13,13,7,5,8,5,13,20,6,4,7,5,8,8,8,20,13,8,12,11,12,17,4,M/AM C,1,1,1,17,1,1,1,1,1,1,20,1,1,1,1
19259041,Somália,1651,20/07/1996,19,0,0,0,0,182,68,2,1,2,2,1,3,1,1,2,2,4,7,7,8,8,13,7,7,14,2,8,13,1,14,10,9,11,8,8,10,9,14,8,4,12,7,14,8,12,10,11,10,11,3,14,10,20,8,7,9,8,2,9,9,8,11,12,12,11,5,5,2,DM ,1,1,1,1,1,1,1,1,1,20,10,1,1,1,1
19259042,Marcelo,1651,02/04/1998,18,0,0,0,0,187,0,2,3,3,2,2,1,3,1,2,1,1,2,4,12,12,12,4,12,5,1,1,5,4,4,12,8,8,6,5,5,6,8,3,13,4,6,4,4,6,12,12,5,11,6,13,12,20,9,6,8,5,4,6,8,15,13,9,10,11,4,6,4,S ,1,1,20,1,10,13,1,1,1,1,1,1,1,1,1
19259043,Marcos Moser,1651,17/05/1998,18,0,0,0,0,187,0,1,2,3,2,2,1,2,2,2,1,1,6,6,12,13,11,4,13,7,1,5,6,4,1,9,4,10,8,8,4,5,9,9,9,11,13,6,6,7,13,13,3,7,8,7,13,20,6,8,9,9,8,9,9,13,11,9,14,13,4,10,2,S ,1,1,20,1,1,1,1,1,1,1,1,1,1,1,1
19259044,Valmir,1651,01/02/1997,19,0,0,0,0,177,0,2,3,2,2,3,2,3,2,1,1,3,4,4,11,13,13,6,13,7,1,6,7,3,2,12,9,11,8,8,5,7,6,9,12,10,12,7,6,7,13,11,3,7,8,8,12,20,11,8,9,5,9,7,9,8,11,10,8,10,9,12,5,S ,1,1,20,1,1,1,1,1,1,1,1,1,1,1,1
19259045,Vinicius Ferreira,1651,03/04/1998,18,0,0,0,0,176,70,3,3,3,1,2,2,2,4,4,2,1,8,10,11,10,11,10,7,11,5,3,10,10,4,13,11,8,7,12,6,10,6,11,13,6,11,4,5,10,13,11,13,10,20,11,13,5,9,11,7,3,10,3,9,11,16,5,11,10,12,13,10,AM/S RL,1,1,17,1,17,20,1,1,1,1,1,7,13,1,1
19259046,Chico,1651,01/01/1997,19,0,0,0,0,184,83,3,3,1,1,3,2,3,3,2,1,3,6,7,10,11,13,6,10,7,5,4,10,3,4,11,8,10,4,7,7,5,12,1,9,9,12,5,6,7,12,11,12,10,11,13,11,20,4,12,9,9,7,9,9,16,11,12,11,12,9,7,1,S ,1,1,20,1,1,1,1,1,1,1,1,1,1,1,1
19259047,Gabriel,1651,27/02/1997,19,0,0,0,0,181,77,2,1,1,1,1,1,2,3,1,2,2,3,6,13,14,14,7,14,4,3,6,8,7,7,14,3,8,3,11,8,8,11,9,13,5,13,6,7,8,14,13,6,11,3,11,14,20,10,7,7,5,9,9,9,15,11,12,11,13,1,12,1,S ,1,1,20,1,1,1,1,1,1,1,1,1,1,1,1
19259063,Gabriel Louzada,1651,06/05/1996,20,0,0,0,0,171,63,2,4,2,3,3,3,2,3,1,1,1,9,8,12,10,12,9,6,8,5,4,12,8,6,12,8,10,8,9,8,13,10,10,12,5,10,6,9,8,12,11,8,6,6,11,12,20,12,7,9,9,9,8,9,16,13,13,10,14,1,14,7,M/AM C,1,1,1,20,1,1,1,1,1,1,19,1,1,1,1
19259064,Igor,1651,31/07/1996,19,0,0,0,0,176,70,3,3,3,3,2,4,3,2,2,3,1,6,10,12,9,11,5,8,7,4,5,10,9,6,12,7,11,8,10,10,5,10,11,13,6,12,4,10,12,15,15,10,8,5,14,14,20,13,9,8,10,10,6,10,20,10,11,10,11,7,14,3,S RL,1,1,20,1,15,15,1,1,1,1,1,1,1,1,1
19259182,Marcão,1651,04/03/1997,19,0,0,0,0,194,0,2,3,4,2,3,1,2,2,2,1,2,1,1,2,1,7,1,13,1,6,13,5,1,13,6,9,5,9,6,9,1,13,3,3,8,3,13,6,7,9,10,7,14,8,12,13,20,4,10,9,9,9,8,9,16,12,13,14,11,7,14,5,D C,1,1,1,1,1,1,20,1,1,1,1,1,1,1,1
19259407,Wallace,1651,01/10/1995,20,0,0,0,0,186,78,12,11,13,8,13,12,13,14,12,11,12,4,2,1,2,8,7,5,2,3,2,8,2,3,8,10,12,11,12,10,4,12,5,10,3,5,12,13,13,10,14,8,12,5,13,10,20,12,12,12,6,10,5,10,17,12,11,12,12,10,5,7,GK ,20,1,1,1,1,1,1,1,1,1,1,1,1,1,1
19259408,Caíque,1651,31/07/1997,18,0,0,0,0,198,80,10,11,12,10,13,13,14,15,12,12,13,7,3,7,1,8,10,5,3,2,3,9,2,3,8,12,11,13,13,12,5,11,13,7,5,6,11,14,15,11,13,8,19,20,16,11,8,15,17,14,8,14,5,10,16,11,11,15,8,10,12,12,GK ,20,1,1,1,1,1,1,1,1,1,1,1,1,1,1
19259409,Bruno Bispo,1651,06/06/1996,20,0,0,0,0,186,78,2,2,2,1,4,4,3,2,1,2,1,5,6,8,7,9,6,13,8,7,13,9,7,13,9,12,10,11,11,9,5,11,12,4,4,11,12,13,12,12,12,9,12,17,13,12,20,13,13,12,7,7,5,10,8,15,11,10,11,1,11,1,D C,1,1,1,1,1,1,20,1,1,1,1,1,1,1,1
19259410,Léo Xavier,1651,07/09/1997,18,0,0,0,0,180,67,1,2,2,1,2,1,2,3,2,1,3,4,8,8,8,10,8,13,8,5,13,10,9,13,11,12,11,12,11,11,5,11,13,8,4,12,12,13,13,13,13,9,11,8,12,13,20,13,13,13,10,13,4,10,15,14,9,10,11,6,12,3,D C,1,1,1,1,1,1,20,1,1,15,1,1,1,1,1
19259411,Ramon,1651,03/05/1995,21,0,0,0,0,186,73,3,1,4,3,3,4,1,3,2,1,2,3,8,10,9,11,5,12,9,10,14,11,8,14,12,12,12,12,14,11,7,12,13,7,8,11,13,13,13,13,13,9,12,9,14,13,20,14,13,13,11,13,3,10,14,11,13,14,13,16,15,5,D C,1,1,1,1,1,1,20,1,1,12,1,1,1,1,1
19259412,Borges,1651,11/06/1996,20,0,0,0,0,186,0,2,1,3,3,2,3,3,3,2,2,1,6,8,10,9,11,5,10,10,4,14,11,5,14,11,13,11,13,9,12,9,11,14,7,6,11,13,14,14,13,12,8,13,5,13,13,20,13,13,13,11,12,5,11,9,11,10,11,12,1,16,6,DM/M C,1,1,1,1,1,1,1,1,1,20,18,1,1,1,1
19259413,Ronald,1651,31/01/1997,19,0,0,0,0,190,0,2,3,3,1,1,2,2,1,2,4,3,7,7,5,6,14,5,7,14,1,8,13,1,14,13,9,6,8,6,9,10,14,8,2,3,9,11,8,12,8,7,8,12,9,14,7,20,8,10,9,9,9,9,8,16,11,12,11,10,6,7,4,DM/M C,1,1,1,1,1,1,1,1,1,18,20,1,1,1,1
19259414,Flávio,1651,10/02/1996,20,0,0,0,0,177,73,2,2,2,2,2,2,1,4,2,3,3,11,12,11,12,13,4,6,12,5,12,13,8,10,13,13,13,12,13,8,11,12,14,13,5,12,13,12,12,13,13,10,8,10,13,13,20,13,9,12,11,13,4,13,13,10,12,13,13,12,11,8,DM/M C,1,1,1,15,8,13,1,1,8,18,20,10,14,1,9
19259415,Robert,1651,21/07/1996,19,0,0,0,0,162,0,2,3,2,2,2,1,3,1,1,4,2,6,7,13,6,13,6,6,8,1,5,10,2,8,12,9,9,4,6,6,10,13,9,12,7,4,6,7,7,13,13,7,1,9,12,13,20,10,5,4,7,9,9,9,16,11,12,10,13,9,4,5,M/AM C,1,1,1,20,12,12,1,1,1,1,18,1,1,1,1
19259463,Cristiano,1651,01/08/1998,17,0,0,0,0,177,0,1,1,3,2,3,2,2,2,1,2,2,9,10,12,12,12,9,8,11,4,6,12,11,4,12,10,12,9,10,8,11,9,10,14,4,12,4,11,11,13,14,10,8,9,16,13,20,11,7,10,8,10,3,12,9,11,9,13,13,10,14,1,AM/S RC,1,1,20,15,12,16,1,1,1,1,1,1,1,1,1
19259464,Gamboa,1651,11/04/1994,22,0,0,0,0,174,72,3,2,3,3,2,3,3,1,3,1,1,9,11,11,10,12,6,7,10,11,10,11,9,10,11,11,10,12,9,9,10,9,5,13,4,11,10,11,11,12,13,9,6,20,12,12,8,12,9,12,7,9,4,12,12,8,12,13,11,6,10,4,D/WB L,1,1,1,1,10,1,1,20,1,1,1,12,1,19,1
19259466,Wesley,1651,11/02/1997,19,0,0,0,0,194,0,3,1,4,1,1,2,1,1,1,3,4,7,12,12,9,10,8,6,9,8,8,7,6,10,12,10,10,9,9,7,9,11,17,11,9,9,10,9,9,13,13,10,14,20,13,13,5,12,11,10,6,5,5,10,11,9,11,9,11,9,18,7,D/WB/M/AM L,1,1,1,11,20,1,1,16,1,1,8,18,1,17,1
19259468,Éverson,1651,24/07/1997,18,0,0,0,0,190,71,1,1,2,3,2,1,1,1,3,2,2,6,7,8,8,10,5,13,8,8,13,11,9,13,10,12,10,11,10,9,4,9,13,6,6,11,12,12,12,12,11,9,14,9,13,12,20,13,14,12,12,8,5,6,17,10,12,13,13,13,5,2,D C,1,1,1,1,1,1,20,1,1,1,1,1,1,1,1
19259469,Sávio,1651,30/04/1996,20,0,0,0,0,189,83,2,2,1,1,2,3,1,3,1,2,1,9,9,10,10,11,10,11,11,8,13,11,11,13,12,11,12,11,10,9,10,9,14,4,5,11,12,13,13,13,12,9,13,8,13,12,20,13,13,12,11,10,4,12,20,9,11,14,10,5,4,2,DM/M C,1,1,1,1,1,1,1,1,1,20,18,1,1,1,1
19259470,Artur,1651,11/03/1996,20,0,0,0,0,181,68,3,2,2,2,3,1,2,2,3,1,2,9,8,8,11,12,9,8,15,8,12,11,4,12,13,10,8,9,7,11,15,15,4,7,9,10,12,9,12,15,11,13,11,8,10,14,20,9,6,10,6,9,9,10,9,9,10,10,10,12,7,5,DM/M C,1,1,1,1,1,1,1,1,1,20,17,1,1,1,1
19259471,Mário,1651,02/09/1995,20,0,0,0,0,179,70,3,2,2,1,1,3,1,3,3,4,1,4,9,12,11,13,6,9,11,6,6,12,13,7,12,11,12,12,10,8,11,10,20,13,4,12,7,10,11,14,14,8,8,9,13,13,20,13,7,12,7,10,5,10,17,9,12,9,11,5,18,8,AM/S L,1,1,20,10,18,12,1,1,1,1,1,1,1,1,1
19259472,Alexsandro,1651,21/06/1995,21,0,0,0,0,175,67,1,2,2,2,2,1,3,3,2,2,2,6,10,12,11,12,7,10,10,5,6,11,10,7,11,11,10,12,9,8,10,9,3,13,5,11,7,11,13,14,13,13,7,8,12,13,20,12,7,12,10,2,5,6,8,9,12,13,12,4,5,5,AM/S L,1,1,20,1,18,14,1,1,1,1,1,1,1,1,1
19259473,Fábio,1651,09/09/1996,19,0,0,0,0,184,0,2,3,1,1,1,1,1,3,3,3,3,7,10,12,10,13,9,7,8,5,5,10,6,5,12,7,12,7,8,5,11,11,6,10,4,15,10,9,10,13,13,6,10,11,12,13,20,12,6,10,10,10,10,10,7,11,8,11,11,11,14,5,S ,1,1,20,1,1,1,1,1,1,1,1,1,1,1,1
19259556,Jennerson,1651,04/07/1997,18,0,0,0,0,193,0,6,7,8,3,13,13,7,12,8,5,7,4,1,2,3,1,6,1,3,1,2,2,2,2,4,8,5,12,5,12,5,13,8,3,10,1,7,6,5,12,8,6,12,8,7,9,20,2,10,8,8,8,7,7,9,10,12,11,10,4,1,7,GK ,20,1,1,1,1,1,1,1,1,1,1,1,1,1,1
19259557,Frazan,1651,05/06/1996,20,0,0,0,0,181,0,4,2,2,3,3,2,1,4,2,4,3,6,4,1,6,6,4,14,5,3,14,7,1,14,1,10,12,6,9,6,6,14,10,5,13,6,9,8,4,13,14,9,11,8,10,14,20,7,9,7,10,10,10,10,7,13,11,12,11,9,14,8,D C,1,1,1,1,1,1,20,1,1,1,1,1,1,1,1
19259558,Jhonathan,1651,10/04/1997,19,0,0,0,0,186,0,1,1,3,1,1,1,3,1,2,2,2,7,5,1,2,7,6,14,7,4,14,8,5,11,3,7,12,9,5,5,3,13,6,4,7,5,14,7,7,14,14,8,9,9,14,14,20,6,11,9,4,1,9,9,17,12,11,14,10,7,14,8,D C,1,1,1,1,1,1,20,1,1,1,1,1,1,1,1
19259559,Wendel Lomar,1651,27/05/1996,20,0,0,0,0,183,81,2,1,1,2,2,3,1,2,1,2,1,7,8,7,6,9,3,12,7,6,10,10,6,13,10,12,11,14,11,12,8,10,11,6,7,8,12,12,14,10,11,12,11,20,12,11,6,14,13,11,8,5,10,8,14,11,10,11,10,5,10,5,D C,1,1,1,1,1,1,20,1,1,1,1,1,1,1,1
19259560,Bonilha,1651,26/01/1996,20,0,0,0,0,188,77,2,2,1,1,3,2,1,2,3,3,3,7,7,7,8,13,7,5,7,4,7,13,5,12,14,7,9,8,9,7,8,14,4,2,11,5,10,8,12,9,10,8,8,13,15,11,20,7,10,9,5,7,9,9,9,10,12,9,11,1,13,4,DM/M C,1,1,1,1,1,1,1,1,1,20,18,1,1,1,1
19259561,Douglas,1651,13/01/1997,19,0,0,0,0,173,70,3,2,1,2,1,3,4,3,1,2,1,12,10,12,10,11,12,10,13,6,13,14,12,14,12,15,12,13,11,12,14,12,6,11,13,10,13,13,13,12,13,12,10,20,14,12,11,14,15,11,12,12,6,12,9,11,10,11,12,8,7,8,DM/M C,1,1,1,1,1,1,1,1,1,20,19,1,1,1,1
19259562,Danielzinho,1651,11/01/1996,20,0,0,0,0,170,63,3,1,1,1,1,2,3,1,1,3,3,9,6,15,11,15,9,9,11,3,6,15,7,5,15,6,6,9,11,8,11,13,8,15,2,13,5,10,10,13,14,6,5,11,12,12,20,11,4,10,10,10,12,10,20,11,12,12,11,8,6,3,AM C,1,1,1,20,1,1,1,1,1,1,12,1,1,1,1
19259563,Matheus Alessandro,1651,10/07/1996,19,0,0,0,0,195,0,2,1,2,1,1,2,2,3,3,3,2,7,7,9,13,10,7,12,9,6,6,11,7,4,13,3,10,4,7,5,12,13,10,13,11,13,5,4,9,13,9,8,12,17,9,8,20,11,10,9,9,10,10,9,18,11,8,11,8,6,10,5,AM/S C,1,1,18,20,1,1,1,1,1,1,10,1,1,1,1
19259564,Felipe,1651,03/05/1997,19,0,0,0,0,176,0,1,2,3,1,3,1,3,3,3,3,2,7,5,13,14,13,7,14,7,3,5,5,3,4,14,1,14,4,6,6,7,13,7,13,9,14,8,6,8,13,13,8,9,9,4,12,20,4,9,8,9,9,9,9,16,10,9,10,11,10,13,1,S ,1,1,20,1,1,1,1,1,1,1,1,1,1,1,1
19259565,Patrick,1651,06/02/1997,19,0,0,0,0,178,69,3,2,1,2,1,2,2,1,3,2,3,8,13,12,10,13,6,13,7,3,5,10,2,3,11,7,13,8,11,7,12,10,15,14,11,10,5,6,8,11,13,7,5,10,9,12,20,5,7,9,4,9,7,9,19,8,14,11,10,5,3,7,S RL,1,1,20,1,15,15,1,1,1,1,1,1,1,1,1
19259566,Pedro,1651,20/06/1997,19,0,0,0,0,185,78,2,2,2,4,1,1,3,3,1,3,4,7,10,11,13,11,5,13,9,6,9,11,7,5,11,4,16,3,13,11,10,10,11,8,4,14,9,10,11,13,11,13,13,12,15,12,20,10,14,11,11,6,10,10,11,13,9,11,13,6,4,4,S ,1,1,20,1,1,1,1,1,1,1,1,1,1,1,1
19259589,Araújo,1651,16/05/1995,21,0,0,0,0,187,84,3,3,1,2,3,3,2,1,2,3,3,5,5,5,4,12,5,12,8,6,12,11,6,12,10,13,12,13,10,11,9,12,10,8,5,12,12,13,13,12,11,13,14,10,13,12,20,13,13,11,13,5,5,10,10,12,9,11,11,10,9,1,DM C,1,1,1,1,1,1,1,1,1,20,15,1,1,1,1
19259590,Lucas Costa,1651,02/04/1995,21,0,0,0,0,186,80,3,2,2,2,2,3,3,2,2,3,1,6,4,1,3,6,4,10,4,1,13,7,6,13,1,9,12,9,7,7,1,13,4,1,4,4,13,12,7,9,13,7,12,9,11,11,20,6,11,9,8,9,9,9,12,12,11,11,12,7,7,6,D C,1,1,1,1,1,1,20,1,1,1,1,1,1,1,1
19259592,Vitor,1651,11/01/1996,20,0,0,0,0,188,80,14,11,8,1,11,14,10,14,9,9,11,7,2,2,1,1,9,1,2,1,1,2,3,2,5,8,11,10,5,12,7,8,9,3,8,2,6,8,7,9,8,4,14,9,9,14,20,2,11,9,9,9,9,9,9,11,11,13,11,4,15,2,GK ,20,1,1,1,1,1,1,1,1,1,1,1,1,1,1
19259594,Klauss Mello,1651,01/03/1997,19,0,0,0,0,190,0,2,2,3,1,3,1,2,1,2,3,2,4,8,9,11,11,6,12,9,6,8,10,7,5,15,10,14,3,11,8,10,11,2,13,8,12,10,9,10,9,7,16,15,10,11,10,20,11,14,10,10,10,6,9,8,12,10,12,13,10,15,5,S ,1,1,20,1,1,1,1,1,1,1,1,1,1,1,1
19259596,Júnior Tavares,1651,07/08/1996,19,0,0,0,0,178,69,3,1,3,3,2,2,2,3,3,2,2,11,12,10,8,10,13,8,10,9,6,10,12,6,12,10,13,11,12,12,10,16,10,2,5,11,10,10,10,13,13,11,8,20,12,14,11,13,10,10,6,9,8,7,10,11,11,12,10,1,10,3,D L,1,1,1,1,1,1,1,20,1,1,1,13,1,15,1
19259597,Lima,1651,11/06/1996,20,0,0,0,0,181,73,1,3,1,2,1,3,2,3,1,3,3,8,6,10,10,14,8,8,11,6,8,12,4,10,12,9,6,9,10,4,14,10,10,13,1,11,9,9,12,14,14,9,6,11,3,14,20,7,7,10,10,4,10,10,11,8,12,13,12,11,15,2,AM C,1,1,1,20,1,1,1,1,1,1,13,1,1,1,1
19259598,Denilson,1651,18/04/1995,21,0,0,0,0,191,0,2,3,1,3,1,3,2,1,3,3,2,8,6,1,2,8,4,14,6,1,14,6,2,14,4,10,9,10,8,10,2,14,10,8,10,8,14,8,9,9,10,9,11,1,16,13,20,6,10,10,10,10,10,10,19,14,10,9,10,6,12,8,D C,1,1,1,1,1,1,20,1,1,1,1,1,1,1,1
19259600,Arthur,1651,12/08/1996,19,0,0,0,0,172,67,3,3,2,1,3,1,1,3,3,1,3,5,6,7,5,10,6,7,15,6,11,12,4,11,10,10,12,7,11,12,12,12,10,4,10,10,10,11,11,11,10,10,8,10,9,12,20,11,7,10,7,6,10,10,15,9,9,11,13,3,15,3,M C,1,1,1,1,1,1,1,1,1,15,20,1,1,1,1
19259601,Léo Tilica,1651,20/04/1995,21,0,0,0,0,172,62,1,1,2,2,1,1,2,2,3,1,1,7,10,11,10,9,8,8,8,3,5,10,8,5,11,10,12,6,9,11,8,9,5,13,3,10,11,11,12,13,14,9,6,10,12,14,20,11,8,10,10,6,10,12,15,11,11,9,11,8,7,2,AM RLC,1,1,14,20,18,15,1,1,1,1,1,1,1,1,1
19259602,Guilherme,1651,13/04/1995,21,0,0,0,0,178,65,2,1,2,2,3,1,1,2,1,2,2,8,11,13,11,11,9,9,10,8,8,11,10,7,12,8,11,10,11,12,11,12,10,13,11,14,11,12,12,13,14,11,11,11,12,13,20,13,10,11,12,11,7,14,18,11,9,11,12,8,1,6,AM RL,1,1,15,1,20,15,1,1,1,1,1,1,1,1,1
19259603,Vico,1651,03/12/1996,19,0,0,0,0,174,68,1,1,3,2,2,2,1,1,1,2,3,7,9,11,7,14,7,2,9,4,7,9,5,9,12,7,9,3,9,5,11,6,9,12,7,7,5,8,12,14,13,8,5,9,9,13,20,7,7,9,9,9,9,9,10,13,11,10,11,7,11,6,AM RLC,1,1,1,20,15,15,1,1,1,1,15,1,1,1,1
19259683,Santiago,1651,06/02/1997,19,0,0,0,0,183,76,3,3,1,1,2,2,3,2,2,2,3,6,3,13,10,8,6,13,4,4,5,7,1,2,13,9,10,7,10,7,7,8,9,13,11,13,2,6,7,13,13,10,10,20,15,13,9,8,10,8,9,1,9,9,17,12,9,11,14,1,9,6,S ,1,1,20,1,1,1,1,1,1,1,1,1,1,1,1
19259883,Miullen,1651,19/05/1998,18,0,0,0,0,180,72,2,2,1,1,1,3,2,4,1,2,1,4,3,8,12,14,7,11,8,4,4,8,4,5,12,9,9,8,12,3,8,7,5,11,11,13,6,7,8,14,13,8,9,9,11,13,20,5,12,8,9,9,6,8,7,10,11,12,11,9,1,6,S ,1,1,20,1,1,1,1,1,1,1,1,1,1,1,1
19259884,Léo Santos,1651,09/12/1998,17,0,0,0,0,186,78,1,1,1,3,1,3,2,1,2,3,3,8,6,7,7,12,6,13,5,4,12,10,7,12,13,12,11,12,12,13,9,12,12,13,8,7,12,11,12,15,12,12,13,11,9,14,20,9,11,8,10,7,9,11,20,12,12,11,14,10,11,1,D C,1,1,1,1,1,1,20,1,1,1,1,1,1,1,1
19259885,Fabrício Oya,1651,23/07/1998,17,0,0,0,0,168,0,3,1,3,2,3,1,1,3,2,2,1,11,11,12,10,12,13,6,12,3,6,12,12,10,12,8,11,9,11,10,12,11,12,13,3,10,6,12,12,11,12,8,6,14,10,11,20,11,5,13,6,12,5,14,17,13,12,12,13,6,13,9,AM C,1,1,1,20,12,14,1,1,1,1,15,1,1,1,1
19259886,Rafael Augusto,1651,26/09/1995,20,0,0,0,0,189,0,4,1,4,2,2,3,3,3,2,1,1,6,6,1,3,8,3,14,4,7,13,8,3,14,6,5,9,9,8,6,7,14,5,4,13,7,7,7,8,13,11,8,14,3,14,10,20,7,9,9,7,9,9,9,12,10,12,12,10,7,12,2,D C,1,1,1,1,1,1,20,1,1,1,1,1,1,1,1
19259887,Zé Guilherme,1651,09/02/1996,20,0,0,0,0,185,0,12,11,12,1,13,12,12,14,10,8,8,6,2,3,2,5,9,1,2,3,3,1,2,1,7,10,6,12,9,7,8,14,4,3,11,1,9,9,8,13,15,5,12,8,15,11,20,3,10,10,10,2,10,10,16,13,12,11,12,4,6,8,GK ,20,1,1,1,1,1,1,1,1,1,1,1,1,1,1
19260139,Igor,1651,07/02/1995,21,0,0,0,0,178,0,2,1,1,2,1,1,2,1,4,3,3,5,7,6,8,15,8,11,7,4,9,15,6,14,13,6,7,9,9,10,11,11,9,9,3,7,13,9,9,13,6,9,8,9,9,12,20,7,8,9,5,9,9,9,20,12,13,11,12,1,12,2,DM ,1,1,1,1,1,1,1,1,1,20,10,1,1,1,1
19260150,Thalisson,1651,07/05/1998,18,0,0,0,0,189,0,1,3,1,3,2,1,3,1,3,2,4,6,4,1,1,6,2,13,5,4,14,8,4,14,6,9,7,9,4,7,5,14,8,1,4,5,11,7,8,10,12,8,14,20,11,13,9,5,10,9,5,9,8,9,15,9,13,13,13,8,16,1,D C,1,1,1,1,1,1,20,1,1,1,1,1,1,1,1
19260151,Talysson Lalau,1651,05/07/1998,17,0,0,0,0,170,0,3,2,1,2,2,3,1,2,3,2,2,6,8,13,13,7,5,7,6,2,2,8,2,5,11,9,7,8,7,4,9,9,9,11,4,8,3,7,8,13,13,7,4,9,13,13,20,12,6,9,6,9,9,9,8,10,11,11,14,1,8,6,AM RLC,1,1,15,20,16,16,1,1,1,1,1,1,1,1,1
19260152,Riuler,1651,25/01/1998,18,0,0,0,0,182,0,2,1,1,3,1,2,2,1,1,4,1,5,6,8,8,14,7,11,14,1,12,11,5,11,14,11,11,8,6,8,11,11,7,9,11,4,11,8,13,9,10,5,11,12,13,12,20,12,12,7,6,9,5,9,7,12,12,11,15,2,17,6,DM ,1,1,1,1,1,1,1,1,1,20,13,1,1,1,1
19260153,Kady,1651,02/05/1996,20,0,0,0,0,170,0,3,1,1,2,3,3,3,2,3,3,4,10,14,12,11,14,6,8,7,7,4,9,3,5,14,8,8,3,6,8,6,11,2,13,9,9,5,8,9,12,9,8,5,20,10,13,10,11,5,9,8,2,6,9,20,12,12,9,11,4,8,8,AM RLC,1,1,13,16,17,20,1,1,1,1,1,1,1,1,1
19260154,Luccas Barreto,1651,19/09/1995,20,0,0,0,0,183,0,1,3,3,2,2,2,2,1,2,1,2,8,6,14,11,14,8,11,8,2,6,6,7,3,14,5,10,9,11,6,11,14,2,13,8,11,9,8,9,12,13,5,11,9,12,12,20,10,9,9,10,5,10,9,9,13,14,12,13,4,1,3,S ,1,1,20,14,12,12,1,1,1,1,1,1,1,1,1
19260155,Julio Rusch,1651,15/07/1998,17,0,0,0,0,168,0,1,1,3,3,3,2,3,2,4,2,1,13,12,5,8,14,14,7,12,2,11,11,4,10,11,9,7,8,7,8,12,14,9,5,9,7,11,8,13,11,10,8,6,20,12,11,10,9,6,7,4,2,9,9,14,10,8,9,10,11,4,1,DM/M C,1,1,1,1,1,1,1,1,1,18,20,1,1,1,1
19260156,Yan Sasse,1651,24/06/1997,19,0,0,0,0,173,64,4,3,2,3,1,3,1,2,1,1,2,9,11,15,11,15,9,9,10,6,7,14,7,10,14,4,9,8,8,11,14,15,14,12,8,11,7,7,12,9,11,11,8,10,12,13,20,8,8,9,6,10,10,10,20,9,8,12,12,8,5,8,AM C,1,1,1,20,12,13,1,1,1,1,12,1,1,1,1
19260157,Leonardo,1651,18/04/1998,18,0,0,0,0,180,0,1,2,1,4,2,1,2,3,2,1,2,4,11,11,2,12,1,8,3,7,9,9,2,14,9,9,5,9,8,6,5,12,9,3,2,6,6,5,8,14,14,8,10,20,10,14,10,7,8,9,8,9,7,9,11,10,12,11,10,1,9,4,D/WB L,1,1,1,1,1,1,1,20,1,1,1,1,1,16,1
19260169,Nathan,1651,06/05/1997,19,0,0,0,0,184,0,2,1,1,2,2,3,2,3,2,1,2,6,6,2,1,9,6,10,8,2,12,10,1,10,8,6,13,8,8,8,8,13,1,4,12,5,11,10,10,11,10,12,9,10,13,11,20,12,11,9,7,3,9,9,14,12,13,12,14,10,9,3,D/DM C,1,1,1,1,1,1,17,1,1,20,10,1,1,1,1
19260170,Marco Túlio,1651,13/03/1998,18,0,0,0,0,174,0,1,3,2,3,3,1,1,1,3,1,1,5,9,11,10,14,5,9,8,1,4,11,4,6,11,5,7,5,5,6,9,13,9,12,10,9,8,8,9,12,14,8,7,10,9,13,20,10,7,9,9,3,7,9,7,10,11,11,13,3,11,8,AM/S C,1,1,18,20,13,13,1,1,1,1,1,1,1,1,1
19260171,Ralph,1651,07/03/1998,18,0,0,0,0,185,0,1,3,2,2,3,3,2,2,3,3,3,7,7,4,8,14,7,7,14,7,12,11,4,11,14,12,9,8,5,8,12,14,3,7,8,8,13,8,11,6,11,8,14,7,8,9,20,13,12,9,5,9,11,9,13,11,11,9,12,2,9,8,DM/M C,1,1,1,1,1,1,1,1,1,20,16,1,1,1,1
19260345,Geovane Itinga,1651,05/05/1998,18,0,0,0,0,184,72,3,3,4,3,2,2,4,1,1,2,2,5,9,12,12,13,7,10,12,4,6,11,12,5,13,12,11,12,9,7,11,10,14,13,4,12,6,10,12,13,13,11,11,11,12,13,20,11,9,12,6,10,4,10,11,12,10,12,11,8,7,4,AM/S L,1,1,20,1,18,11,1,1,1,1,1,1,1,1,1
19260346,Alisson Borges,1651,23/01/1998,18,0,0,0,0,178,65,3,3,2,2,1,1,2,3,1,3,4,10,12,12,10,13,9,8,10,11,8,12,11,8,12,8,10,7,8,8,12,9,10,13,3,12,8,10,12,13,14,8,7,20,12,13,5,12,5,12,3,2,4,11,10,10,12,10,11,6,17,2,D/WB/AM L,1,1,1,13,16,1,1,20,1,1,10,13,1,19,1
19260347,Carlos Mateus,1651,16/04/1998,18,0,0,0,0,178,0,1,2,2,1,2,3,3,2,1,3,1,6,10,11,5,14,1,8,8,6,9,12,2,15,9,9,6,9,9,6,7,15,1,9,10,3,8,9,9,15,13,4,8,10,9,13,20,11,5,9,7,2,9,8,19,9,10,12,12,12,12,5,D R,1,1,1,1,1,1,1,1,20,1,1,1,1,1,15
19260394,Yan,1651,04/08/1998,17,0,0,0,0,175,71,1,1,3,3,3,3,1,3,3,1,2,10,11,14,10,13,7,7,10,4,5,12,11,5,13,11,12,11,10,8,12,10,14,13,3,12,6,7,10,14,15,10,8,20,12,14,6,11,6,12,5,3,4,7,14,14,11,11,19,8,12,2,AM/S RL,1,1,19,1,20,16,1,1,1,1,1,12,10,1,1
19260459,Juninho,1651,21/11/1996,19,0,0,0,0,179,73,1,3,2,3,3,1,3,2,3,3,1,10,14,12,11,14,7,12,8,1,5,8,4,2,11,8,7,6,10,7,6,11,1,13,10,11,4,7,9,13,14,12,6,10,12,13,20,7,9,9,9,9,5,9,10,10,12,12,13,8,8,2,S RL,1,1,20,1,15,15,1,1,1,1,1,1,1,1,1
19260460,Danilo,1651,10/01/1998,18,0,0,0,0,183,0,3,2,3,3,3,2,1,2,3,3,2,8,9,11,11,15,8,11,9,5,8,9,7,3,11,5,11,8,7,4,10,14,9,13,10,10,7,8,10,12,12,8,11,1,11,13,20,11,9,9,5,5,6,9,20,10,12,10,11,7,14,7,S ,1,1,20,1,13,13,1,1,1,1,1,1,1,1,1
19260461,Jeremias,1651,28/02/1997,19,0,0,0,0,173,0,2,2,2,2,3,1,1,3,2,1,3,7,8,12,10,14,7,7,9,7,7,12,4,7,12,8,9,6,6,7,12,14,9,13,11,9,7,9,13,12,12,7,5,10,9,11,20,12,5,9,7,6,8,9,14,8,10,11,11,5,13,4,AM C,1,1,1,20,12,12,1,1,1,1,15,1,1,1,1
19260481,Kaique,1651,29/05/1995,21,0,0,0,0,186,0,13,7,6,5,12,7,9,11,9,9,11,3,3,3,2,1,7,1,2,3,3,1,4,2,4,9,8,12,7,11,6,13,4,1,8,2,11,7,4,8,15,7,12,8,9,12,20,1,7,9,6,9,8,9,15,12,10,9,11,1,7,8,GK ,20,1,1,1,1,1,1,1,1,1,1,1,1,1,1
19260587,Talles,1651,12/02/1997,19,0,0,0,0,185,77,11,7,11,7,14,14,9,12,8,7,13,3,1,1,3,2,6,1,3,2,1,3,3,2,4,9,10,11,7,10,7,14,7,2,1,1,14,8,7,10,13,8,10,8,13,10,20,4,8,9,9,13,9,9,14,12,11,11,9,10,8,11,GK ,20,1,1,1,1,1,1,1,1,1,1,1,1,1,1
19260588,Mayc,1651,20/06/1996,20,0,0,0,0,185,78,1,2,1,3,3,1,2,1,4,3,4,8,7,5,6,13,3,12,6,12,13,9,5,14,14,8,9,10,7,13,7,11,3,14,12,12,8,10,10,13,14,10,8,20,15,13,10,7,13,9,10,10,10,10,20,11,11,11,9,7,7,4,D/WB L,1,1,1,1,1,1,1,20,1,1,1,1,1,17,1
19260589,Willian,1651,10/03/1994,22,0,0,0,0,175,73,1,2,2,3,1,1,2,3,1,1,2,12,7,9,7,14,7,7,13,4,6,12,7,6,14,8,10,6,14,9,8,8,4,13,8,10,9,9,11,14,14,9,8,5,15,14,20,8,5,9,7,9,7,9,9,11,12,8,13,3,2,1,M/AM C,1,1,1,20,1,1,1,1,1,1,17,1,1,1,1
19260590,Wesley,1651,14/04/1996,20,0,0,0,0,175,64,2,1,2,3,3,1,2,2,3,2,2,12,14,14,10,14,9,8,9,8,7,9,4,9,11,10,7,6,7,5,9,13,6,8,3,10,8,9,10,14,13,12,7,13,13,14,20,8,5,10,6,10,10,10,17,10,9,10,13,2,9,1,AM RL,1,1,11,1,19,20,1,1,1,1,1,1,1,1,1
19260597,Pedro,1651,07/07/1998,17,0,0,0,0,181,0,1,3,2,1,1,3,2,2,1,3,2,5,5,12,13,12,5,13,3,4,3,6,6,1,8,8,7,3,7,5,5,5,8,8,9,13,5,5,6,13,12,6,8,8,8,13,20,4,6,8,8,8,8,6,20,9,14,13,9,6,9,4,S ,1,1,20,1,1,1,1,1,1,1,1,1,1,1,1
19260600,Igor,1651,27/09/1995,20,0,0,0,0,187,0,1,4,3,4,1,4,1,3,3,2,4,4,2,1,1,6,4,12,4,6,13,6,1,12,5,7,11,8,5,3,3,12,8,5,8,4,8,5,6,12,11,6,10,8,13,13,20,4,7,8,8,8,6,8,11,11,9,11,13,10,14,8,D C,1,1,1,1,1,1,20,1,1,1,1,1,1,1,1
19260601,Erik,1651,16/06/1997,19,0,0,0,0,181,0,2,2,2,2,2,3,2,3,1,2,3,7,12,9,5,11,4,5,7,1,5,8,5,5,13,7,4,6,5,4,6,12,3,13,1,5,4,7,10,13,13,6,6,8,9,13,20,9,7,9,5,9,9,9,10,11,10,12,11,8,13,7,AM RLC,1,1,1,20,17,17,1,1,1,1,1,1,1,1,1
19260603,Léo,1651,04/06/1996,20,0,0,0,0,178,72,3,3,3,3,1,3,2,2,3,2,3,4,6,7,3,13,2,7,6,5,9,7,6,14,9,9,8,9,9,12,9,9,1,9,2,6,8,7,9,11,11,8,6,9,11,14,20,7,7,9,3,8,8,8,8,9,10,9,12,8,6,1,D/WB R,1,1,1,1,1,1,1,1,20,1,1,1,1,1,17
19260651,Matheus,1651,05/09/1997,18,0,0,0,0,180,79,2,2,1,3,1,2,3,3,1,1,2,3,6,10,11,10,7,10,9,1,4,8,11,4,10,9,8,9,13,12,9,13,5,11,12,10,7,8,9,11,11,8,10,14,13,11,20,12,8,9,4,5,7,9,19,10,11,12,12,4,5,2,S ,1,1,20,1,1,1,1,1,1,1,1,1,1,1,1
19260657,Jader,1651,14/01/1993,23,0,0,0,0,186,72,4,2,2,1,3,2,2,3,1,1,3,10,12,12,10,11,7,10,8,6,5,8,3,8,11,9,7,6,8,8,9,9,1,12,4,12,8,9,9,13,15,9,10,20,9,12,10,13,8,9,9,6,9,9,15,11,12,9,13,7,11,6,AM/S RL,1,1,20,1,17,17,1,1,1,1,1,1,1,1,1
19260708,Gaspar,1651,14/12/1994,21,0,0,0,0,168,0,4,3,3,2,1,3,2,3,3,3,2,6,6,8,6,13,6,4,9,5,7,13,6,6,13,9,9,8,4,8,13,13,8,13,3,6,8,8,12,9,10,8,1,9,16,10,20,13,5,9,9,4,7,9,20,8,10,10,11,1,10,2,M/AM C,1,1,1,17,1,1,1,1,1,1,20,1,1,1,1
19260709,Gil,1651,29/09/1993,22,0,0,0,0,187,0,1,1,3,1,2,3,1,1,1,2,3,6,4,13,13,13,6,13,4,1,6,7,10,4,9,5,10,3,11,7,2,7,2,9,10,13,7,6,7,12,8,7,12,9,15,10,20,10,8,7,4,9,8,9,11,12,13,8,12,4,8,6,S ,1,1,20,1,1,1,1,1,1,1,1,1,1,1,1
19260710,João Vitor,1651,31/03/1997,19,0,0,0,0,175,0,3,1,2,3,3,4,2,1,3,3,2,6,6,8,8,13,6,6,10,5,7,12,7,3,12,9,7,7,10,4,13,10,8,12,12,9,8,8,10,13,13,8,7,3,10,13,20,7,4,9,9,6,9,9,12,9,11,10,12,7,16,6,M/AM C,1,1,1,20,1,1,1,1,1,1,17,1,1,1,1
19260809,Daniel Rozen,1651,27/12/1993,22,0,0,0,0,174,0,1,3,1,1,3,2,1,2,3,2,3,8,8,14,13,14,8,8,8,3,8,13,6,9,14,9,11,5,10,8,11,11,4,13,1,8,9,9,11,13,14,9,7,9,17,14,20,7,7,10,10,8,10,10,20,12,13,13,9,3,7,8,AM C,1,1,1,20,1,1,1,1,1,1,10,1,1,1,1
19260825,Everton,1651,21/08/1995,20,0,0,0,0,175,64,1,3,3,2,3,1,3,2,3,2,3,9,11,11,2,14,5,14,10,10,10,11,10,14,12,10,12,11,12,12,11,14,11,6,11,5,10,10,14,13,14,14,11,11,13,13,20,9,10,12,10,14,10,13,7,11,10,11,11,9,12,6,D/WB R,1,1,1,1,1,1,1,1,20,1,1,1,1,1,19
19260880,Luã Lúcio,1651,02/06/1997,19,0,0,0,0,166,0,4,3,1,1,2,3,1,4,1,3,3,6,11,12,11,13,6,4,9,3,6,10,7,7,11,6,6,6,11,7,11,11,2,12,2,8,6,7,8,12,13,10,4,10,12,12,20,6,6,9,9,3,7,9,14,9,12,10,11,11,2,1,AM RL,1,1,13,1,20,16,1,1,1,1,1,1,1,1,1
19260882,Lucas Marques,1651,24/05/1995,21,0,0,0,0,176,68,1,2,2,2,2,3,2,1,3,3,2,9,7,11,11,15,9,8,13,5,12,13,5,12,11,13,13,12,9,9,13,12,17,10,9,8,14,8,7,12,12,8,5,14,14,11,20,8,9,12,10,10,10,10,11,12,10,11,11,8,5,5,DM C,1,1,1,1,1,1,1,1,1,20,15,1,1,1,1
19260883,Milla,1651,09/12/1997,18,0,0,0,0,175,65,3,2,3,1,3,1,3,3,1,4,2,7,9,11,13,11,7,11,12,7,7,9,1,4,11,9,6,3,7,8,11,8,9,13,1,8,6,8,9,12,12,8,9,12,13,13,20,10,6,9,9,1,8,9,9,12,11,11,11,5,14,6,AM LC,1,1,15,20,16,14,1,1,1,1,1,1,1,1,1
19260884,Allan,1651,03/03/1997,19,0,0,1,1,172,70,3,1,1,2,2,1,3,3,3,3,1,15,13,11,8,13,12,7,14,6,10,14,10,12,15,16,10,15,13,8,14,10,15,14,8,10,9,12,16,12,14,14,7,20,13,10,9,12,9,11,12,11,5,10,14,14,8,11,10,10,12,12,DM/M C,1,1,1,12,1,1,1,1,1,17,20,1,1,1,1
19260885,Léo Ortiz,1651,03/01/1996,20,0,0,0,0,185,0,2,1,1,3,3,1,2,2,2,2,3,8,3,2,1,8,12,11,7,7,13,8,13,13,7,9,13,10,5,7,5,12,8,10,12,6,13,7,8,12,10,8,8,10,10,13,20,8,8,10,8,9,9,10,13,12,11,12,13,1,18,1,D C,1,1,1,1,1,1,20,1,1,1,1,1,1,1,1
19260886,Gustavo Dinardi,1651,08/04/1998,18,0,0,0,0,171,78,1,2,4,2,1,1,3,3,2,3,1,2,4,9,1,10,1,8,5,4,13,10,1,10,9,9,10,9,4,5,5,14,4,8,3,5,8,8,8,11,13,8,5,9,12,12,20,11,12,9,9,9,9,9,16,12,11,9,8,8,15,4,D R,1,1,1,1,1,1,1,1,20,1,1,1,1,1,15
19260887,Silva,1651,07/09/1995,20,0,0,0,0,180,75,2,3,2,3,2,3,3,1,2,2,1,8,7,5,9,12,8,2,10,6,12,14,5,11,11,4,9,9,5,4,10,11,8,5,11,7,14,9,12,8,11,9,8,18,12,10,20,7,10,10,9,8,10,10,19,14,11,14,12,5,7,5,DM ,1,1,1,1,1,1,1,1,1,20,12,1,1,1,1
19260901,Anderson Preto,1651,30/12/1988,27,0,0,0,0,175,69,1,1,1,2,3,2,3,1,2,3,4,7,7,13,13,13,7,4,12,1,5,13,6,8,13,10,8,9,8,7,12,10,7,13,3,12,8,8,12,13,13,8,8,10,10,13,20,12,9,10,5,10,5,10,14,13,14,10,11,10,1,5,AM C,1,1,1,20,1,1,1,1,1,1,10,1,1,1,1
19260908,Charles Miller,1651,08/02/1994,22,0,0,0,0,175,68,3,1,3,2,3,3,1,2,2,1,1,7,10,11,9,11,9,3,7,11,3,12,9,2,12,11,9,11,9,9,10,8,2,8,7,11,7,10,11,11,12,10,6,10,11,9,20,12,8,10,7,8,5,11,17,10,10,11,11,3,10,6,AM RLC,1,1,1,20,17,17,1,1,1,1,10,1,1,1,1
19260915,Mauro,1651,11/07/1996,19,0,0,0,0,171,0,1,2,4,3,3,1,1,2,2,3,3,7,7,11,11,14,7,5,14,2,8,12,4,7,12,8,7,1,6,8,13,11,4,12,13,11,8,8,11,11,11,8,6,20,10,10,9,10,5,9,9,3,9,9,9,13,12,8,12,4,16,8,M/AM C,1,1,1,20,1,1,1,1,1,1,16,1,1,1,1
19260916,Yuri,1651,08/01/1996,20,0,0,0,0,182,0,2,3,1,3,3,3,3,2,1,3,2,9,12,11,12,13,4,9,6,4,9,11,7,14,14,10,9,11,12,9,8,14,10,9,3,8,9,13,13,12,13,5,10,20,13,12,10,13,10,10,10,10,10,10,14,12,11,10,12,8,15,7,D L,1,1,1,1,1,1,1,20,1,1,1,1,1,15,1
19260917,Bochecha,1651,10/10/1996,19,0,0,0,0,182,0,1,3,1,2,2,1,3,2,2,1,3,9,9,12,10,12,9,6,11,8,11,13,6,15,13,13,12,9,9,6,13,12,11,9,6,13,12,10,12,10,13,6,12,20,15,13,11,12,9,11,5,5,9,10,18,13,10,11,9,9,9,8,DM C,1,1,1,11,1,1,1,1,1,20,15,1,1,1,1
19260918,David Neres,1651,03/03/1997,19,0,0,0,0,177,74,1,3,1,1,3,1,2,1,3,2,3,11,13,15,12,13,10,8,12,7,6,12,11,6,14,12,12,11,12,11,12,12,13,14,10,13,7,12,13,14,15,12,9,20,13,14,10,11,13,12,8,12,8,14,8,14,14,14,13,6,12,5,AM RL,1,1,15,13,17,20,1,1,1,1,10,1,1,1,1
19260919,Viveiros,1651,17/01/1998,18,0,0,0,0,172,0,1,3,2,4,1,3,2,3,2,3,1,6,12,10,1,9,3,5,5,5,10,9,1,10,11,13,9,13,10,10,10,7,14,6,13,5,6,12,11,12,11,6,5,9,10,12,20,12,6,9,9,9,5,9,10,11,8,12,10,4,9,1,D/WB R,1,1,1,1,1,1,1,1,20,1,1,1,12,1,16
19260920,Pedro Vitor,1651,14/02/1998,18,0,0,0,0,171,63,1,1,1,3,2,1,1,2,1,2,3,6,6,10,9,13,6,3,8,1,12,11,2,12,10,5,7,7,8,7,5,11,2,7,10,7,9,8,10,11,12,7,6,3,5,11,20,7,6,8,8,8,6,8,10,10,12,10,12,1,15,7,DM ,1,1,1,1,1,1,1,1,1,20,14,1,1,1,1
19260921,Diego Costa,1651,21/07/1999,16,0,0,0,0,187,0,1,1,3,3,4,1,2,1,3,4,1,6,3,3,3,7,2,11,6,2,10,8,3,9,3,9,11,9,7,6,3,13,1,3,7,1,12,6,7,10,9,7,12,8,11,8,20,5,11,9,4,4,9,8,19,11,10,11,10,13,4,6,D C,1,1,1,1,1,1,20,1,1,1,1,1,1,1,1
19260922,Lucas Paes,1651,07/12/1997,18,0,0,0,0,195,95,12,8,9,6,12,10,11,14,12,5,6,3,3,3,3,6,5,1,2,1,3,3,1,1,4,3,9,12,4,10,8,14,12,2,7,2,9,9,7,10,14,9,14,8,14,12,20,3,11,10,8,2,10,9,15,13,11,11,11,5,2,8,GK ,20,1,1,1,1,1,1,1,1,1,1,1,1,1,1
19260923,Felype,1651,27/05/1997,19,0,0,0,0,178,0,2,2,1,2,3,3,1,2,1,3,1,7,8,11,11,14,8,6,10,3,8,10,8,6,13,8,11,5,11,10,9,14,6,11,1,11,9,8,10,14,15,9,10,10,10,12,20,8,7,9,9,5,9,8,10,11,12,8,10,2,2,5,S ,1,1,20,1,14,13,1,1,1,1,1,1,1,1,1
19260924,Vinícius,1651,20/01/1997,19,0,0,0,0,170,61,3,3,2,1,2,1,2,4,2,1,1,8,4,12,10,11,8,8,9,5,11,12,4,10,12,8,9,9,11,7,13,13,5,12,3,9,9,9,13,11,12,11,6,10,14,11,20,14,6,9,10,6,3,10,9,11,11,10,11,1,17,4,M/AM C,1,1,1,20,1,1,1,1,1,12,18,1,1,1,1
19260925,Danilo Romão,1651,13/04/1997,19,0,0,0,0,183,72,2,3,3,1,2,1,2,1,3,1,3,7,9,12,10,14,5,13,7,1,11,13,7,11,12,5,6,4,11,6,13,14,9,12,4,12,3,8,9,11,11,4,10,20,13,10,9,10,10,9,9,6,8,9,10,12,11,11,11,6,12,4,S C,1,1,20,15,13,13,1,1,1,1,12,1,1,1,1
19260947,Dionattha,1651,24/01/1998,18,0,0,0,0,175,0,1,3,4,2,3,3,3,1,1,2,2,7,9,12,11,12,5,7,8,7,5,12,6,8,12,9,11,6,9,4,13,8,5,13,10,7,6,8,12,13,13,8,5,10,12,12,20,8,6,7,9,4,9,9,17,13,10,11,11,8,14,8,AM LC,1,1,1,20,15,1,1,1,1,1,10,1,1,1,1
19260948,Richard Luca,1651,01/01/1998,18,0,0,0,0,177,0,2,2,3,2,3,1,1,2,1,3,2,6,3,13,10,13,6,10,5,5,5,7,4,4,9,5,6,6,12,4,6,11,20,9,8,10,7,6,7,12,10,7,6,16,13,11,20,11,12,9,8,8,9,9,19,11,14,13,11,6,12,1,S ,1,1,20,1,1,1,1,1,1,1,1,1,1,1,1
19261028,Jairinho,1651,19/06/1998,18,0,0,0,0,162,55,3,3,2,1,1,2,1,2,2,1,2,9,9,12,9,14,13,2,9,3,6,13,5,8,12,9,7,6,9,8,13,8,6,9,1,7,5,8,9,14,14,8,1,20,16,14,10,5,5,8,9,9,4,9,13,11,12,11,13,8,14,6,AM RLC,1,1,1,20,15,17,1,1,1,1,12,1,1,1,1
19261045,Negueba,1651,17/01/1998,18,0,0,0,0,178,65,2,1,3,3,1,3,1,3,2,1,1,7,8,10,11,9,4,10,5,4,3,9,9,5,10,10,10,10,11,9,7,8,5,11,8,11,5,9,11,12,12,8,8,10,13,12,20,13,7,9,7,9,5,10,10,12,9,9,11,2,9,8,AM/S RL,1,1,20,1,18,19,1,1,1,1,1,1,1,1,1
19261046,Joilson,1651,04/08/1997,18,0,0,0,0,178,0,2,2,1,1,3,2,2,2,2,3,3,6,7,11,6,13,6,3,8,4,8,13,1,11,10,9,8,8,7,7,9,8,3,13,10,5,5,8,10,13,12,8,7,20,9,11,8,13,7,8,6,9,9,13,16,10,8,12,11,8,11,3,M C,1,1,9,13,12,11,1,1,1,12,20,1,1,1,1
19261047,Lucas Ventura,1651,19/05/1998,18,0,0,0,0,180,0,1,3,1,1,3,1,1,2,2,1,3,5,6,8,8,9,7,8,9,6,11,11,8,11,10,12,11,13,9,9,11,10,9,9,10,9,10,12,12,11,11,11,9,8,12,11,20,10,11,10,9,10,8,10,18,12,10,9,10,10,9,2,DM/M C,1,1,1,1,1,1,1,1,1,20,19,1,1,1,1
19261048,Ivan,1651,02/07/1997,19,0,0,0,0,184,64,13,10,8,1,15,9,7,13,9,7,15,2,3,1,2,6,7,1,1,1,3,3,2,2,1,9,6,10,9,12,8,15,9,2,10,1,11,9,8,13,7,4,12,9,9,12,20,3,9,9,9,9,6,9,19,10,13,12,12,10,15,7,GK ,20,1,1,1,1,1,1,1,1,1,1,1,1,1,1
19261049,Ravanelli,1651,29/08/1997,18,0,0,0,0,180,71,1,3,2,2,2,2,1,1,3,1,1,10,8,11,9,15,9,7,11,7,4,10,10,4,12,12,9,12,8,9,11,9,11,12,5,11,7,9,13,11,13,13,12,15,5,11,20,15,8,8,5,12,7,11,7,9,12,9,8,7,11,2,AM C,1,1,1,20,1,13,1,1,1,1,10,1,1,1,1
19261058,Felipe Hideki,1651,04/10/1996,19,0,0,0,0,175,73,1,2,3,1,2,1,1,1,1,1,2,7,9,13,8,10,5,6,6,5,4,7,1,3,9,8,4,5,4,3,4,13,8,9,7,9,3,6,6,10,13,12,5,8,12,12,20,5,8,8,7,8,8,8,9,9,12,11,10,1,10,8,AM/S RL,1,1,16,12,20,16,1,1,1,1,1,1,1,1,1
19261062,Dênis Aguiar,1651,10/08/1998,17,0,0,0,0,192,0,5,12,8,5,13,13,8,13,9,9,9,5,1,2,1,1,9,1,2,1,1,1,2,3,3,9,10,14,4,11,6,13,8,1,11,3,7,7,5,10,16,5,14,9,13,6,20,1,10,6,9,9,8,8,17,11,11,11,12,10,14,2,GK ,20,1,1,1,1,1,1,1,1,1,1,1,1,1,1
19261063,Kevin,1651,07/09/1997,18,0,0,0,0,174,68,3,3,2,4,3,1,3,2,1,1,2,10,12,11,8,10,7,8,8,9,10,11,8,11,12,10,12,11,10,11,7,11,19,9,6,10,12,12,13,13,15,9,8,4,10,14,20,13,8,8,7,9,5,10,15,12,10,10,12,11,8,1,D/WB R,1,1,1,1,1,1,1,1,20,1,1,1,1,1,19
19261064,Léo Simas,1651,12/08/1998,17,0,0,0,0,172,0,2,3,1,1,2,3,1,2,3,1,3,5,6,10,9,14,1,9,5,7,11,11,3,16,11,9,12,9,9,13,10,9,2,9,12,4,9,10,10,9,12,10,4,9,6,13,20,10,8,9,9,1,5,9,7,11,10,9,11,1,5,4,WB R,1,1,1,1,1,1,1,1,15,1,1,1,1,1,20
19261069,Gabriel Fernando,1651,15/05/1995,21,0,0,0,0,186,0,2,2,2,1,3,1,2,1,2,2,1,5,3,2,7,9,3,11,2,3,14,8,6,14,7,5,10,9,8,7,7,11,15,6,11,7,13,7,9,10,8,12,12,9,10,8,20,7,12,9,9,9,9,9,18,9,9,10,10,11,13,5,D C,1,1,1,1,1,1,20,1,1,13,1,1,1,1,1
19261070,Victor Matheus,1651,06/04/1995,21,0,0,0,0,187,0,2,3,1,1,2,3,3,1,2,2,1,6,2,1,6,4,1,12,4,7,11,6,4,10,7,9,9,9,6,6,7,14,2,3,10,7,14,7,8,12,12,8,12,9,9,14,20,10,11,9,8,9,9,9,13,13,12,10,11,3,11,4,D C,1,1,1,1,1,1,20,1,1,1,1,1,1,1,1
19261072,Robson,1651,14/07/1995,20,0,0,0,0,175,0,3,3,2,3,2,3,3,3,1,3,3,6,7,7,7,15,8,4,12,1,10,15,5,10,11,8,6,5,9,9,11,14,9,2,12,8,7,9,14,15,9,9,10,1,12,13,20,13,13,8,6,9,8,9,14,11,11,11,11,5,7,7,M C,1,1,1,11,1,1,1,1,1,14,20,1,1,1,1
19261074,Silva,1651,06/03/1997,19,0,0,0,0,180,0,2,3,2,1,3,1,2,2,3,2,2,8,9,14,11,14,8,10,10,4,7,12,6,9,11,4,10,6,10,9,13,12,10,10,9,10,8,9,10,12,12,12,7,9,12,12,20,7,6,10,9,10,8,10,16,12,12,10,10,1,8,1,AM/S C,1,1,16,20,12,12,1,1,1,1,12,1,1,1,1
19261077,Jean Patric,1651,05/09/1997,18,0,0,0,0,180,70,3,2,3,2,2,1,1,3,3,3,3,7,10,12,8,12,7,10,7,7,5,9,1,2,11,9,8,8,7,4,9,13,9,14,9,9,6,8,9,14,11,8,6,9,14,12,20,8,6,9,9,6,9,9,9,13,11,9,14,1,11,2,AM/S R,1,1,20,13,14,18,1,1,1,1,1,1,1,1,1
19261088,Danrley,1651,03/07/1994,21,0,0,0,0,184,0,2,1,4,1,4,2,1,1,3,2,2,7,7,14,14,14,7,14,8,7,6,6,4,2,12,7,11,8,9,8,6,10,9,11,9,7,8,7,8,14,9,8,11,9,12,11,20,7,10,9,8,6,9,9,20,9,12,12,10,2,6,3,S ,1,1,20,1,1,1,1,1,1,1,1,1,1,1,1
19261115,Rafael Hammes,1651,20/04/1997,19,0,0,0,0,186,78,2,3,3,3,1,2,4,1,2,3,3,5,2,12,12,12,5,9,5,5,5,6,2,5,8,9,10,3,7,5,3,12,2,9,9,8,6,5,6,12,12,11,11,9,5,12,20,5,10,9,9,9,7,9,18,13,8,9,11,9,7,5,S ,1,1,20,1,1,1,1,1,1,1,1,1,1,1,1
19261117,Guilherme Dresch,1651,21/03/1998,18,0,0,0,0,170,65,3,3,1,1,1,3,3,3,2,3,3,6,7,10,10,12,6,7,8,1,4,9,1,6,10,9,7,2,5,7,7,13,3,9,6,9,3,7,8,13,13,7,5,9,15,11,20,11,5,9,9,9,9,8,8,10,13,10,12,7,12,3,AM LC,1,1,14,20,16,1,1,1,1,1,1,1,1,1,1
19261119,Santarém,1651,30/06/1998,18,0,0,0,0,162,55,3,3,2,1,3,3,2,2,3,1,3,6,8,12,8,14,6,8,8,6,5,3,2,2,11,4,9,3,7,3,8,9,5,12,7,7,4,7,8,13,11,6,2,9,14,10,20,10,5,8,8,8,8,8,20,14,9,9,12,9,12,2,AM/S RLC,1,1,18,15,20,15,1,1,1,1,1,1,1,1,1
19261120,Luan,1651,05/02/1998,18,0,0,0,0,180,66,2,1,3,3,1,3,4,2,3,3,2,5,6,11,8,13,5,5,5,4,2,10,2,7,10,8,6,7,13,2,7,12,4,12,5,7,5,7,10,13,11,6,10,20,15,8,5,7,5,3,6,8,7,8,13,11,10,11,11,6,6,4,AM LC,1,1,1,20,15,12,1,1,1,1,12,1,1,1,1
19261121,Marquinhos,1651,16/03/1998,18,0,0,0,0,165,0,1,2,2,2,1,4,3,1,3,4,1,10,12,9,7,13,5,5,7,5,4,10,6,6,11,7,6,7,9,6,10,10,5,13,8,6,5,7,11,12,10,6,2,9,8,12,20,6,5,8,5,8,8,8,19,10,13,12,10,8,11,1,AM RC,1,1,1,20,13,18,1,1,1,1,1,13,1,1,1
19261122,Luiz Henrique,1651,17/01/1998,18,0,0,0,0,174,60,1,1,1,2,2,3,3,2,3,3,1,8,10,12,6,15,8,8,8,4,3,10,2,7,11,9,9,4,8,9,14,13,8,12,11,6,9,9,6,12,12,9,8,20,16,11,9,6,7,9,4,6,6,9,8,11,9,12,13,4,7,2,AM C,1,1,1,20,14,14,1,1,1,1,1,1,1,1,1
19261129,Walter Guimarães,1651,03/03/1996,20,0,0,0,0,190,72,2,2,4,3,2,2,2,1,1,1,3,7,5,6,5,12,5,14,11,7,13,12,5,13,10,11,9,12,7,9,11,16,10,2,11,8,16,11,12,10,11,11,15,3,14,10,20,12,14,12,10,10,4,5,12,13,13,10,12,9,12,6,D C,1,1,1,1,1,1,20,1,1,1,1,1,1,1,1
19261130,Gllawcyo,1651,17/10/1995,20,0,0,0,0,172,65,2,3,1,2,2,2,2,1,1,2,3,12,14,12,11,14,8,9,8,5,6,8,2,8,12,7,8,8,10,7,11,9,9,12,11,6,7,8,9,12,14,8,10,9,15,13,20,7,8,9,9,9,9,9,14,12,8,11,11,7,15,6,AM/S RLC,1,1,18,16,16,20,1,1,1,1,1,1,1,1,1
19261132,Otávio,1651,27/06/1998,18,0,0,0,0,189,77,1,3,2,2,1,1,3,3,2,2,2,6,5,2,3,8,3,8,6,3,11,7,3,10,7,8,7,8,7,9,6,11,8,8,3,3,8,7,7,11,11,7,10,9,12,12,20,7,12,8,8,8,8,8,18,12,9,8,13,1,8,6,D R,1,1,1,1,1,1,13,1,20,1,1,1,1,1,1
19261136,Marcílio,1651,06/02/1995,21,0,0,0,0,184,81,2,1,2,3,1,2,1,2,2,2,2,12,11,10,9,13,9,13,12,12,14,13,7,13,13,11,13,12,13,13,13,13,6,4,11,12,13,14,14,13,13,13,13,3,13,12,20,14,13,11,12,11,10,11,7,8,10,10,11,10,11,5,DM/M C,1,1,1,1,1,1,1,1,1,16,20,1,1,1,1
19261138,Robinho,1651,20/08/1998,17,0,0,0,0,184,0,2,3,3,1,3,2,1,3,2,3,1,8,12,12,10,10,3,14,7,6,3,7,1,4,13,8,5,7,9,6,4,7,4,12,11,11,5,6,8,12,13,7,9,9,10,11,20,4,10,7,7,8,8,8,14,9,11,11,10,1,16,7,S ,1,1,20,1,14,14,1,1,1,1,1,1,1,1,1
19261230,Lucas Piauí,1651,31/05/1995,21,0,0,0,0,177,70,3,3,2,3,4,1,2,3,2,4,3,9,10,2,6,13,11,10,9,9,11,11,4,15,11,5,10,11,10,11,9,8,8,1,6,9,7,11,11,13,12,8,10,20,13,13,10,9,8,9,6,10,3,10,16,12,11,11,11,2,12,3,D/WB L,1,1,1,1,1,1,1,20,1,1,1,1,1,19,1
19261231,Igor Neves,1651,16/06/1995,21,0,0,0,0,183,79,3,2,2,3,3,2,2,2,3,3,1,9,6,14,11,11,9,11,9,1,7,6,7,1,12,10,9,2,11,9,5,14,1,10,13,15,5,9,10,15,14,9,10,20,13,13,10,11,11,10,8,7,5,10,20,11,8,12,11,5,14,6,S ,1,1,20,1,1,1,1,1,1,1,1,1,1,1,1
19261239,Henrique,1651,06/08/1992,23,0,0,0,0,160,61,2,2,3,2,2,2,2,3,2,2,2,8,5,11,14,10,8,14,9,8,8,9,4,7,11,10,10,5,11,9,7,13,10,10,13,12,7,8,9,13,14,9,1,9,12,12,20,14,7,10,8,10,7,10,13,12,8,12,10,4,15,6,S ,1,1,20,1,1,1,1,1,1,1,1,1,1,1,1
19261248,Joazi,1651,28/10/1996,19,0,0,0,0,168,67,1,3,3,2,3,2,1,1,3,2,2,6,8,10,7,15,2,11,5,8,10,12,9,15,12,8,10,12,5,8,11,15,7,4,13,5,8,11,11,15,12,11,4,11,17,14,20,10,8,11,11,11,8,11,17,12,14,10,10,10,7,1,D R,1,1,1,1,1,1,1,1,20,1,1,1,1,1,13
19261252,Matheus,1651,14/03/1997,19,0,0,0,0,169,0,1,3,3,2,4,2,1,3,3,3,1,8,9,2,2,12,13,9,7,4,10,9,4,14,9,8,7,10,9,9,9,7,9,9,6,8,11,9,9,15,8,9,6,9,10,10,20,6,8,9,9,7,9,9,17,12,12,10,10,10,9,8,D R,1,1,1,1,1,1,1,1,20,1,1,1,1,1,15
19261253,Feliphe Gabriel,1651,10/07/1997,18,0,0,0,0,184,74,1,3,2,2,1,3,2,2,1,4,2,4,6,1,3,7,2,11,3,3,10,7,4,13,5,9,5,9,7,7,6,12,6,4,9,2,13,6,7,12,9,7,7,20,10,11,9,6,9,9,8,1,7,11,11,11,11,11,9,5,7,1,D C,1,1,1,1,1,1,20,12,1,1,1,1,1,1,1
19261254,Dimas,1651,04/01/1995,21,0,0,0,0,183,0,2,3,3,1,1,3,3,1,1,1,3,4,1,5,1,7,1,11,6,6,13,2,1,12,4,9,12,9,7,10,1,13,2,9,9,6,13,6,7,13,9,7,10,12,13,12,20,4,9,9,9,1,9,9,7,13,13,11,11,2,6,8,D C,1,1,1,1,1,1,20,1,1,1,1,1,1,1,1
19261259,Glauco,1651,11/02/1995,21,0,0,0,0,189,73,6,10,7,10,11,14,9,14,3,8,9,8,2,2,2,8,10,1,3,2,3,3,3,1,5,10,10,13,9,9,8,14,6,1,9,1,14,9,8,12,17,9,11,2,11,11,20,7,10,10,8,3,3,10,11,9,13,10,10,4,6,3,GK ,20,1,1,1,1,1,1,1,1,1,1,1,1,1,1
19261263,Marcelinho,1651,27/07/1994,21,0,0,0,0,185,0,1,2,3,1,3,2,2,3,4,4,3,5,4,6,1,13,3,8,4,7,9,9,6,14,9,9,10,9,4,5,9,14,6,5,12,7,7,9,9,10,13,9,13,10,3,14,20,11,8,9,6,9,9,9,8,9,12,9,12,8,15,6,D/WB R,1,1,1,1,1,1,1,1,20,1,1,1,1,1,19
19261264,Paulinho,1651,20/02/1994,22,0,0,0,0,184,0,2,3,3,3,2,1,3,2,3,2,2,5,5,4,4,13,3,5,6,5,10,10,1,9,13,8,9,3,7,6,11,10,8,8,1,6,8,11,12,9,8,1,10,10,10,12,20,11,6,8,8,8,8,8,13,7,12,12,11,2,13,7,DM ,1,1,1,1,1,1,1,1,1,20,14,1,1,1,1
19261265,Diego Henrique,1651,21/04/1993,23,0,0,0,0,184,78,3,3,1,4,3,1,1,4,1,1,4,5,5,3,4,12,7,9,11,1,10,8,3,13,8,7,9,9,8,5,12,13,3,4,6,7,11,8,10,13,11,8,10,14,11,13,20,7,8,10,8,3,10,10,16,11,12,9,10,1,11,5,DM ,1,1,1,1,1,1,1,1,1,20,10,1,1,1,1
19261266,Luís Felipe,1651,10/08/1993,22,0,0,0,0,187,0,1,1,1,1,1,2,1,2,3,3,2,6,6,2,5,13,6,3,6,2,6,12,6,12,13,9,7,8,7,7,9,13,7,1,13,6,9,7,8,13,13,7,13,12,10,13,20,8,7,9,9,3,9,9,17,11,8,9,13,2,11,2,DM ,1,1,1,1,1,1,1,1,1,20,10,1,1,1,1
19261267,Roger,1651,11/01/1995,21,0,0,0,0,184,71,2,2,1,2,3,1,1,2,2,2,1,4,9,9,3,12,5,15,9,10,14,12,6,15,9,3,12,12,4,8,10,15,11,1,11,9,10,11,11,12,14,11,7,11,12,12,20,10,9,11,11,10,11,11,15,10,10,9,9,9,1,2,D LC,1,1,1,1,1,1,20,18,1,1,1,1,1,15,1
19261271,Guilherme,1651,25/02/1995,21,0,0,0,0,179,0,2,3,2,3,3,3,1,3,3,3,2,5,3,14,11,14,7,14,11,1,7,8,6,3,11,9,11,8,9,8,8,12,8,10,4,14,5,7,8,12,11,8,8,10,12,12,20,7,7,9,9,9,8,9,17,13,10,11,12,2,9,5,S ,1,1,20,1,1,1,1,1,1,1,1,1,1,1,1
19261272,Christian Savio,1651,08/12/1995,20,0,0,0,0,176,69,4,2,1,1,4,2,2,2,1,1,2,6,7,7,8,14,7,1,7,4,11,12,5,13,10,9,7,7,9,5,11,14,9,2,11,9,10,8,13,14,10,8,6,8,8,12,20,12,5,9,9,9,6,9,7,11,10,11,13,11,6,2,M C,1,1,1,1,1,1,1,1,1,14,20,1,12,1,1
19261273,Zé Ricardo,1651,09/03/1996,20,0,0,0,0,172,69,3,3,1,1,3,2,3,1,1,2,1,8,6,5,6,11,8,8,13,6,6,15,3,12,11,7,10,9,10,9,13,12,4,3,1,8,12,9,12,15,13,11,8,2,6,10,20,8,6,9,9,9,9,9,14,14,11,10,12,1,8,3,M C,1,1,1,1,1,1,1,1,1,15,20,1,1,1,1
19261274,Michel,1651,06/06/1997,19,0,0,0,0,179,0,3,1,1,1,2,3,4,3,1,2,4,7,11,11,6,10,3,7,7,5,7,9,2,12,9,7,9,9,8,11,6,11,1,2,12,7,9,8,8,13,11,8,6,20,15,8,9,7,6,9,9,3,8,9,8,11,11,13,12,1,15,5,D L,1,1,1,1,1,1,1,20,1,1,1,1,1,15,1
19261275,Addam,1651,04/08/1995,20,0,0,0,0,190,0,2,3,2,1,2,3,1,4,2,1,1,7,6,5,3,14,6,7,9,3,11,9,1,14,14,9,9,7,5,9,12,12,9,4,6,7,9,8,13,9,13,7,12,4,14,13,20,13,11,9,3,5,9,9,10,12,9,13,9,2,3,1,DM ,1,1,1,1,1,1,1,1,1,20,12,1,1,1,1
19261276,Kevin,1651,07/02/1995,21,0,0,0,0,182,0,3,2,2,2,3,3,3,4,1,3,3,7,6,5,3,8,3,14,4,5,14,8,7,10,4,9,8,9,8,14,1,12,3,3,12,7,12,7,7,12,10,8,11,3,10,8,20,5,9,9,9,1,9,9,17,10,10,14,11,5,5,1,D C,1,1,1,1,1,1,20,1,1,1,1,1,1,1,1
19261278,Danylo,1651,10/05/1995,21,0,0,0,0,164,0,1,3,2,1,2,2,2,1,3,1,2,8,9,9,7,15,5,10,6,9,7,11,4,12,10,9,11,11,10,12,8,14,7,9,2,9,8,10,10,15,15,10,3,11,9,15,20,9,8,10,10,2,6,10,8,11,10,13,11,1,6,1,D R,1,1,1,1,1,1,1,1,20,1,1,1,1,1,14
19261279,Renato Bruno,1651,22/04/1994,22,0,0,0,0,185,79,2,2,2,3,1,1,4,3,1,3,2,7,11,11,4,14,7,4,9,6,9,11,2,9,14,9,8,6,9,9,11,14,5,2,8,9,7,8,13,12,10,8,9,10,3,12,20,12,7,9,9,5,9,9,9,11,11,10,13,7,15,8,M RC,1,1,1,1,1,1,1,1,1,12,20,1,18,1,1
19261281,Victor Lindenberg,1651,17/12/1997,18,0,0,0,0,183,0,3,4,2,1,3,2,1,3,3,2,3,8,14,12,6,12,12,6,3,7,9,13,4,14,9,6,8,8,7,13,13,12,20,12,7,6,9,8,8,10,13,4,8,20,9,14,10,7,10,14,8,9,6,9,10,14,10,13,11,1,6,7,D/WB L,1,1,1,1,1,1,1,20,1,1,1,1,1,18,1
19261282,Ramon,1651,28/01/1997,19,0,0,0,0,181,0,3,2,2,3,2,2,1,3,2,3,3,4,3,13,13,13,5,13,7,1,5,6,5,1,12,5,7,8,8,4,5,9,3,12,6,13,4,6,7,13,13,3,7,2,11,12,20,7,9,9,9,9,9,9,17,10,12,10,12,2,6,5,S ,1,1,20,1,1,1,1,1,1,1,1,1,1,1,1
19261283,Fernandinho,1651,15/09/1994,21,0,0,0,0,166,64,1,1,1,1,3,3,2,2,1,2,3,9,12,12,14,14,7,14,7,4,6,9,6,2,10,9,9,6,8,9,6,14,9,9,11,9,6,8,8,14,13,6,5,20,16,13,10,7,5,9,5,9,9,9,9,13,11,11,10,5,18,4,AM/S L,1,1,19,1,20,1,1,1,1,1,1,1,1,1,1
19261284,Artur,1651,15/02/1998,18,0,0,0,0,168,65,2,1,3,2,2,2,2,1,2,2,1,9,12,13,11,14,8,8,10,2,7,14,5,9,13,10,7,6,6,7,9,14,6,14,6,9,8,9,10,12,13,15,4,20,12,14,10,14,6,7,5,3,7,10,18,11,12,9,12,8,10,4,AM RLC,1,1,1,20,15,15,1,1,1,1,10,1,1,1,1
19261285,Eduardo Oliveira,1651,19/09/1996,19,0,0,0,0,174,0,1,2,3,3,3,1,2,2,3,1,2,6,6,2,3,8,2,7,4,2,8,8,3,14,7,8,7,8,5,10,6,9,3,8,13,3,7,8,6,14,11,8,9,20,4,12,13,7,5,8,8,8,8,8,18,12,10,9,11,10,15,4,D/WB L,1,1,1,1,1,1,1,20,1,1,1,1,1,17,1
19261286,Marcos Guilherme,1651,08/05/1996,20,0,0,0,0,180,0,4,1,3,2,3,4,1,1,3,3,1,3,4,13,13,6,4,13,6,5,3,6,5,1,9,3,8,3,6,4,6,10,4,9,12,6,1,5,6,13,10,6,6,8,3,12,20,6,8,8,4,4,8,7,7,10,10,9,12,5,18,5,S ,1,1,20,1,1,1,1,1,1,1,1,1,1,1,1
19261287,Marcel,1651,17/04/1996,20,0,0,0,0,182,74,3,1,1,3,2,4,1,3,1,2,3,5,1,1,3,5,2,10,2,3,10,6,1,13,1,8,9,8,5,5,1,13,8,2,10,5,13,5,6,12,13,6,8,8,7,13,20,8,5,8,8,8,8,8,20,9,14,9,10,8,12,3,D C,1,1,1,1,1,1,20,1,1,1,1,1,1,1,1
19261391,Hyago,1651,03/01/1995,21,0,0,0,0,170,0,1,3,1,2,2,2,2,2,2,1,1,6,3,6,6,13,7,6,8,1,7,13,7,8,11,9,8,8,4,5,13,12,9,11,13,5,8,7,11,13,13,14,4,9,15,14,20,7,6,9,8,9,8,9,15,9,12,9,10,1,10,2,AM C,1,1,1,20,1,1,1,1,1,1,15,1,1,1,1
19261425,Ricardo Lima,1651,20/02/1994,22,0,0,0,0,189,79,3,2,2,2,1,1,2,2,1,3,1,7,4,2,2,8,6,15,7,4,15,9,2,10,9,8,14,10,10,11,4,15,10,6,4,9,11,9,10,12,9,14,14,9,12,12,20,9,13,10,10,6,7,10,9,10,12,12,9,2,14,2,D C,1,1,1,1,1,1,20,8,1,1,1,1,1,1,1
19261455,Thiago Santana,1651,04/02/1993,23,0,0,0,0,185,81,2,2,3,4,3,1,2,4,2,3,1,6,7,10,12,12,7,12,9,5,5,11,12,5,12,13,11,12,10,11,9,9,12,11,8,12,5,10,11,12,12,13,13,11,13,12,20,12,13,10,5,9,10,10,10,11,10,12,12,6,7,6,S ,1,1,20,1,1,1,1,1,1,1,1,1,1,1,1
19261463,Teco,1651,26/02/1993,23,0,0,0,0,180,73,1,3,3,3,1,1,4,1,2,4,1,7,9,12,10,10,4,7,3,5,5,6,6,2,12,9,6,5,7,6,7,10,4,13,13,10,5,6,7,12,12,8,8,9,14,12,20,7,7,9,6,7,8,9,11,10,9,11,13,6,6,8,AM R,1,1,14,8,1,20,1,1,1,1,1,1,1,1,1
19261492,Natan,1651,07/02/1997,19,0,0,0,0,170,70,3,3,2,2,1,2,3,1,2,3,2,11,13,11,12,14,6,9,12,4,6,8,6,7,14,5,7,8,12,8,9,10,15,13,10,9,6,8,9,13,12,8,3,10,4,12,20,9,7,9,4,9,9,9,18,12,12,11,11,3,8,6,AM L,1,1,13,1,20,1,1,1,1,1,1,10,1,1,1
19261500,Vitinho,1651,24/03/1998,18,0,0,0,0,176,66,3,4,3,1,3,2,1,2,3,3,2,10,10,13,10,12,10,8,11,5,8,12,4,8,13,5,10,8,10,10,12,11,19,13,6,11,8,11,11,13,15,14,7,13,15,13,20,12,6,10,9,10,3,11,11,8,10,9,11,1,15,7,AM LC,1,1,8,20,16,1,1,1,1,1,14,11,1,1,1
19261502,Khevin Fraga,1651,03/06/1997,19,0,0,0,0,169,0,3,2,2,2,1,1,3,1,3,1,2,2,5,6,7,8,5,5,13,2,7,13,5,13,9,6,8,7,7,4,9,13,2,4,11,5,6,7,9,7,8,6,3,8,10,12,20,5,3,8,8,8,6,7,20,13,10,10,10,1,11,1,DM/M C,1,1,1,12,1,1,1,1,1,20,18,1,1,1,1
19261503,Nino,1651,10/04/1997,19,0,0,0,0,188,79,3,1,2,1,2,2,3,1,3,1,3,5,3,5,1,7,2,11,4,4,13,7,6,13,6,9,11,9,6,10,3,13,4,5,10,6,11,6,7,13,9,6,13,9,12,12,20,7,9,9,9,8,9,8,18,10,11,10,11,1,1,2,D C,1,1,1,1,1,1,20,1,1,1,1,1,1,1,1
19261508,Juninho,1651,27/02/1998,18,0,0,0,0,176,68,3,2,1,1,1,2,2,2,4,3,3,5,4,11,10,13,5,4,7,1,5,12,3,6,11,8,3,2,3,3,13,13,3,13,2,8,6,7,10,12,11,6,5,9,8,12,20,5,6,8,8,4,8,8,4,10,13,10,10,7,1,4,AM C,1,1,1,20,1,1,1,1,1,1,10,1,1,1,1
19261511,Ronald,1651,05/02/1997,19,0,0,0,0,186,0,4,1,3,3,2,3,3,2,3,2,2,11,13,11,12,15,8,8,12,7,7,8,6,5,11,3,11,7,7,9,10,9,4,12,5,10,8,9,12,13,13,11,10,2,11,11,20,8,11,9,9,9,9,9,19,10,9,9,10,5,12,2,AM RLC,1,1,1,20,15,15,1,1,1,1,1,1,1,1,1
19261512,Paulo,1651,08/01/1997,19,0,0,0,0,187,0,3,2,1,3,3,3,3,3,3,2,1,9,11,12,7,14,7,6,9,7,7,11,1,8,11,12,5,5,7,7,7,10,5,14,11,8,6,8,12,13,12,8,14,2,11,13,20,11,10,8,14,3,9,9,10,13,11,8,11,4,15,2,AM RL,1,1,1,14,17,20,1,1,1,1,10,13,12,1,1
19261525,Breno,1651,24/01/1997,19,0,0,0,0,172,65,3,3,4,3,3,1,2,3,2,1,1,6,11,7,5,13,3,8,5,5,11,9,5,12,10,9,8,9,8,10,7,14,7,8,11,7,6,3,9,12,12,5,5,9,13,12,20,5,6,9,3,4,5,9,12,12,11,12,12,12,10,2,D/WB R,1,1,1,1,1,1,1,1,20,1,1,1,1,1,18
19261526,Guilherme Borges,1651,07/02/1998,18,0,0,0,0,170,55,3,1,2,1,3,3,3,1,1,2,2,6,10,11,4,11,1,9,1,6,11,10,7,14,9,7,10,10,9,6,9,13,9,6,12,7,11,10,9,13,10,9,3,8,13,11,20,8,8,9,9,9,9,9,13,10,10,13,9,1,10,8,D/WB R,1,1,1,1,1,1,1,1,20,1,1,1,1,1,18
19261527,Lucas Penteado,1651,05/03/1997,19,0,0,0,0,181,79,2,3,2,2,3,3,1,4,3,1,2,1,1,1,1,5,1,10,1,1,11,5,1,8,5,8,8,8,5,6,3,13,4,4,12,4,13,5,6,7,11,6,11,7,12,8,20,8,7,8,8,1,8,8,7,10,10,9,13,1,2,3,D C,1,1,1,1,1,1,20,1,1,1,1,1,1,1,1
19261528,Patrick,1651,03/06/1997,19,0,0,0,0,185,78,3,3,2,3,3,2,1,1,2,3,1,6,8,7,8,10,6,10,8,6,11,11,8,12,10,10,11,12,12,11,8,10,15,8,7,7,11,13,14,12,11,13,12,8,12,12,20,12,12,9,10,8,8,12,12,11,13,8,9,6,17,6,D C,1,1,1,1,1,1,20,1,12,1,1,1,1,1,1
19261609,Ícaro,1651,18/08/1990,25,0,0,0,0,183,82,2,3,3,1,3,1,3,1,3,1,2,6,6,1,1,8,6,13,7,5,11,8,5,13,7,7,11,9,8,10,8,13,3,5,3,6,13,6,8,13,12,8,11,10,7,12,20,6,8,9,9,9,4,9,18,10,9,10,12,3,10,1,D/DM C,1,1,1,1,1,1,20,1,1,19,1,1,1,1,1
19261610,Michel,1651,31/03/1992,24,0,0,0,0,192,90,2,1,3,3,3,3,1,3,1,1,3,6,4,1,1,6,2,11,2,1,6,5,1,12,3,9,13,9,7,8,2,13,4,2,11,4,11,6,7,13,10,7,15,9,8,12,20,6,12,9,9,3,8,9,8,10,9,10,11,3,1,8,D C,1,1,1,1,1,1,20,1,1,1,1,1,1,1,1
19261611,Edson Pacujá,1651,31/12/1990,25,0,0,0,0,175,68,3,1,3,3,3,1,3,3,1,3,1,7,5,7,1,11,2,8,4,7,10,6,1,14,8,9,11,9,8,10,8,6,4,6,9,6,10,8,9,14,12,8,8,10,9,12,20,13,7,9,5,9,6,9,18,10,11,11,11,4,17,8,D R,1,1,1,1,1,1,1,1,20,1,1,1,1,1,1
19261612,Rodolfo Mol,1651,23/05/1989,27,0,0,0,0,191,88,4,3,2,3,3,3,1,2,3,4,1,5,7,8,8,11,6,12,5,4,12,12,7,11,11,12,14,14,11,12,5,10,10,10,11,5,12,12,8,12,12,14,15,11,12,10,20,12,12,12,8,12,10,7,10,11,11,9,10,3,11,3,D C,1,1,1,1,1,1,20,1,1,1,1,1,1,1,1
19261641,Keiller,1651,09/10/1996,19,0,0,0,0,184,0,13,9,9,6,12,13,9,13,7,10,13,4,3,3,3,2,7,1,2,2,2,1,4,3,2,8,7,15,8,13,2,13,8,3,9,3,11,8,6,10,15,8,6,10,14,13,20,1,8,10,7,10,10,10,11,10,11,11,12,1,18,6,GK ,20,1,1,1,1,1,1,1,1,1,1,1,1,1,1
19261643,Ítalo,1651,15/12/1997,18,0,0,0,0,183,0,3,2,1,4,2,2,3,2,2,2,1,5,5,11,11,10,5,3,10,5,2,11,3,5,13,8,6,7,7,6,9,13,6,12,10,7,1,6,11,13,10,6,7,1,7,13,20,9,9,8,8,8,8,8,14,11,12,11,10,11,16,2,AM C,1,1,1,20,1,1,1,1,1,1,10,1,1,1,1
19261651,Tonhão,1651,10/10/1997,18,0,0,0,0,188,76,3,1,3,3,2,2,3,2,2,2,1,5,6,6,8,8,5,12,6,7,12,10,8,12,10,13,11,13,8,9,7,10,10,6,10,7,12,11,13,10,11,13,14,8,11,12,20,12,12,8,12,10,6,8,16,13,14,8,9,8,8,3,D C,1,1,1,1,1,1,20,1,1,1,1,1,1,1,1
19261652,Jefferson Bala,1651,06/01/1996,20,0,0,0,0,160,0,3,2,3,4,2,2,3,2,3,1,2,9,8,9,6,13,5,5,5,9,11,11,4,11,9,9,10,10,6,10,10,11,9,2,1,8,7,11,11,9,13,11,4,8,13,10,20,11,8,8,9,9,9,9,8,10,13,9,11,3,13,8,D/WB R,1,1,1,1,1,1,1,1,20,1,1,1,1,1,19
19261655,Chiclete,1651,22/04/1995,21,0,0,0,0,178,72,2,3,2,3,2,2,3,3,2,3,1,7,4,12,13,14,7,4,10,1,7,9,4,8,14,9,7,6,9,6,10,7,9,13,5,5,7,8,13,14,14,8,8,10,9,14,20,10,7,9,7,9,9,9,17,12,10,12,11,8,8,4,AM C,1,1,1,20,1,1,1,1,1,1,10,1,1,1,1
19261679,Caio Paulista,1651,11/05/1998,18,0,0,0,0,181,73,1,2,3,3,2,3,3,3,2,1,1,6,5,13,8,13,3,6,13,2,1,9,2,4,13,6,6,8,13,3,11,13,8,13,7,8,3,7,9,12,13,7,8,9,10,13,20,7,7,8,6,9,9,9,9,11,13,11,12,4,6,7,AM C,1,1,1,20,1,1,1,1,1,1,10,1,1,1,1
19261680,Caio César,1651,17/05/1997,19,0,0,0,0,177,85,3,2,1,3,1,3,1,3,1,2,1,7,4,11,14,14,7,14,9,8,5,9,5,6,13,10,11,9,9,8,8,11,6,12,1,13,9,4,9,14,11,5,9,8,9,12,20,9,7,10,5,9,10,10,11,11,10,11,12,1,11,8,S ,1,1,20,1,1,1,1,1,1,1,1,1,1,1,1
19261707,Murilo Prates,1651,03/05/1993,23,0,0,0,0,196,94,14,13,12,1,14,14,10,10,8,8,14,5,2,1,3,5,8,1,1,3,3,3,3,2,3,10,11,9,6,10,8,10,9,3,7,3,13,4,8,11,10,9,13,10,6,11,20,6,11,7,9,4,9,10,14,10,11,10,13,7,12,3,GK ,20,1,1,1,1,1,1,1,1,1,1,1,1,1,1
19261721,Lucas Pará,1651,06/02/1994,22,0,0,0,0,170,69,3,1,1,3,2,2,2,1,4,2,3,7,9,10,8,14,7,7,8,7,4,11,7,6,14,9,10,7,6,8,10,10,9,13,4,9,7,8,9,14,14,8,7,20,11,14,10,7,6,9,9,9,9,9,13,12,12,13,10,5,13,7,AM LC,1,1,1,20,18,1,1,1,1,1,10,10,1,1,1
19261921,Alemão,1651,28/02/1985,31,0,0,0,0,175,63,1,1,1,3,1,2,3,4,2,1,3,4,2,8,13,13,6,13,3,3,4,4,2,2,13,6,11,8,8,7,7,10,7,13,4,10,7,6,7,13,13,12,6,8,11,13,20,8,4,9,6,9,3,9,19,12,10,11,14,9,10,8,S ,1,1,20,1,1,1,1,1,1,1,1,1,1,1,1
19261949,Kayo César,1651,22/04/1990,26,0,0,0,0,188,83,4,2,1,1,1,2,4,3,3,3,1,5,4,4,7,13,8,8,11,8,12,8,4,9,9,5,12,8,6,6,11,14,9,6,14,8,14,8,13,9,8,15,14,12,10,10,20,12,15,10,5,10,8,10,20,11,13,12,11,6,12,8,DM ,1,1,1,1,1,1,1,1,1,20,10,1,1,1,1
19261991,Guerra,1651,07/03/1994,22,0,0,0,0,186,0,1,1,3,2,2,3,1,1,2,2,2,7,5,4,7,14,7,7,10,1,9,14,3,14,13,9,13,8,8,8,10,14,8,9,11,7,10,8,12,12,11,8,12,1,14,11,20,8,10,9,9,6,9,9,15,13,10,13,9,1,2,6,DM ,1,1,1,1,1,1,1,1,1,20,10,1,1,1,1
19262036,Léo Bahia,1651,04/11/1994,21,0,0,0,0,174,73,3,2,3,1,1,1,3,1,3,3,2,4,9,9,3,10,1,8,5,3,9,10,3,14,10,4,6,9,8,9,7,10,20,10,9,7,9,9,10,14,14,9,5,20,13,14,11,10,13,10,10,10,6,10,15,13,11,11,11,10,10,1,D/WB L,1,1,1,1,13,1,1,20,1,1,1,13,1,17,1
19262068,Leandro Sobral,1651,13/03/1992,24,0,0,0,0,170,70,1,1,3,3,1,2,3,1,1,3,2,9,8,5,9,11,9,9,12,4,11,7,5,12,6,7,12,10,9,6,9,14,9,3,14,10,8,8,10,9,14,13,5,10,9,13,20,8,8,9,3,9,6,9,20,11,12,12,10,6,9,4,DM/M C,1,1,1,1,1,1,1,5,8,20,18,1,1,1,1
19262109,Leonardo Lang,1651,05/08/1998,17,0,0,0,0,193,0,13,5,9,1,13,13,9,11,9,8,10,4,2,3,1,5,8,1,3,1,1,1,2,3,2,8,6,10,4,7,6,13,19,2,10,3,10,7,6,10,13,5,14,8,12,10,20,3,12,9,5,6,9,9,10,9,11,12,11,3,2,4,GK ,20,1,1,1,1,1,1,1,1,1,1,1,1,1,1
19262124,Berguinho,1651,18/02/1997,19,0,0,0,0,179,70,1,2,1,3,3,1,2,3,3,3,2,6,6,13,11,13,6,4,11,2,5,10,3,6,13,9,7,3,8,6,12,13,9,13,2,11,7,7,12,13,13,7,5,3,14,13,20,10,5,8,9,6,9,9,15,11,10,11,10,2,16,3,AM C,1,1,1,20,1,1,1,1,1,1,10,1,1,1,1
19262126,Jordan,1651,04/05/1998,18,0,0,0,0,173,73,1,1,1,3,2,3,2,1,1,2,3,14,13,11,3,12,14,8,6,7,9,9,3,9,9,7,6,8,9,6,9,15,19,8,2,7,6,9,9,11,13,9,4,20,7,13,9,11,5,8,8,8,7,8,18,8,10,10,13,10,4,6,D/WB L,1,1,1,1,1,1,1,20,1,1,1,1,1,19,1
19262127,Amílcar,1651,23/06/1998,18,0,0,0,0,172,0,3,2,2,1,3,1,1,1,3,1,3,7,4,14,14,9,7,14,8,6,4,6,5,2,13,6,11,4,11,8,7,12,9,12,3,9,7,7,8,14,11,8,8,1,5,14,20,6,7,9,8,4,9,8,20,12,11,12,13,1,19,2,S ,1,1,20,1,1,1,1,1,1,1,1,1,1,1,1
19262128,Fernando,1651,29/11/1998,17,0,0,0,0,166,0,3,3,1,1,2,3,2,1,1,2,1,4,6,7,2,14,2,7,7,7,9,6,2,12,10,8,7,9,7,10,9,12,8,8,6,5,9,9,10,13,10,4,2,8,10,9,20,14,6,8,6,8,8,8,12,13,10,13,10,4,1,4,D/WB R,1,1,1,1,1,1,1,1,20,1,1,1,1,1,19
19262160,Talles,1651,23/05/1998,18,0,0,0,0,170,63,3,2,1,1,3,1,3,3,3,3,3,11,13,13,8,11,8,5,8,3,4,8,3,5,13,5,6,8,5,5,9,13,9,13,1,4,6,8,10,13,10,8,3,20,10,11,17,6,5,9,3,4,9,9,13,9,11,13,10,3,7,8,M/AM L,1,1,1,1,20,1,1,1,1,1,1,19,1,1,1
19262161,Hernandes,1651,17/03/1998,18,0,0,0,0,189,0,3,3,3,3,1,1,1,1,2,3,4,6,6,8,13,13,6,6,8,1,5,9,2,7,13,9,4,7,7,6,13,13,5,13,5,6,2,7,12,11,8,7,11,16,11,10,20,7,8,9,9,9,9,9,13,12,8,10,11,6,5,5,AM C,1,1,1,20,1,1,1,1,1,1,10,1,1,1,1
19262424,Kaue,1651,26/05/1997,19,0,0,0,0,186,0,2,3,2,1,3,1,1,3,1,2,2,6,12,13,10,12,6,9,8,5,4,10,5,4,13,7,10,8,11,4,13,13,12,14,3,9,5,7,11,13,13,6,8,9,8,12,20,7,6,9,6,9,9,9,11,10,12,12,14,6,1,10,AM C,1,1,1,20,1,1,1,1,1,1,10,1,1,1,1
19262482,Thiago Jesus,1651,01/08/1988,27,0,0,0,0,175,69,1,1,1,2,3,2,1,1,3,3,2,7,2,14,9,11,7,4,12,4,6,14,8,3,14,9,11,7,11,8,9,13,9,13,8,10,5,8,12,14,14,8,6,10,7,14,20,8,5,9,7,1,9,9,17,12,10,9,11,6,18,8,AM C,1,1,1,20,1,1,1,1,1,1,10,1,1,1,1
19262564,Pedro Rosa,1651,28/08/1990,25,0,0,0,0,186,76,1,2,1,1,3,2,2,1,1,2,3,11,13,13,10,13,5,11,5,12,13,13,10,10,11,5,12,5,12,11,13,12,12,11,10,12,12,13,11,14,13,15,13,20,11,13,5,11,13,11,5,11,5,10,14,12,12,11,12,7,7,6,D/WB L,1,1,1,1,1,1,1,20,1,1,1,1,1,19,1
19262599,Rodrigo Ramos,1651,24/05/1995,21,0,0,2,0,178,66,3,1,1,2,3,2,1,1,3,3,1,11,11,10,12,12,6,10,9,10,9,11,5,11,12,10,12,11,11,12,11,12,10,13,2,12,10,12,12,14,12,7,8,9,9,13,20,11,7,10,10,4,8,10,20,11,11,10,12,7,14,12,D/WB R,1,1,1,1,1,6,1,9,20,1,1,1,8,9,19
19262888,Wagner,1651,27/05/1991,25,0,0,0,0,183,80,3,3,3,4,2,1,1,2,1,2,1,10,10,12,11,12,10,10,12,10,8,13,12,11,12,8,11,11,12,12,12,12,7,10,10,11,12,10,10,11,12,13,12,11,13,12,20,12,12,10,12,10,6,11,8,13,10,11,13,1,4,4,M/AM C,1,1,1,20,1,1,1,1,1,1,18,1,1,1,1
19263394,Adriano Apodi,1651,19/07/1988,27,0,0,0,0,175,73,1,2,1,2,1,3,2,2,3,2,2,10,11,13,9,12,10,6,10,11,8,12,11,9,12,10,11,10,8,7,10,10,12,15,5,14,7,10,13,16,15,8,7,4,13,16,20,14,7,12,7,11,4,10,12,13,8,11,12,7,14,5,D/WB R,1,1,1,1,1,14,1,1,20,1,1,1,13,1,19
19263581,Gabriel Biteco,1651,22/05/1999,17,0,0,0,0,189,0,1,1,3,3,1,1,3,1,2,3,2,9,9,12,10,10,9,6,9,4,3,11,12,3,12,7,11,10,11,9,8,9,8,16,9,10,8,12,12,13,13,11,15,20,9,13,10,12,10,8,10,5,9,10,17,12,10,12,9,4,14,6,S ,1,1,20,12,14,1,1,1,1,1,1,1,1,1,1
19263582,Ita,1651,12/03/1996,20,0,0,0,0,183,77,2,3,3,2,3,3,3,3,1,3,2,4,6,1,1,4,3,13,1,1,13,7,2,13,7,10,13,10,8,9,6,13,10,4,12,7,13,7,8,13,11,8,10,8,12,11,20,9,9,10,10,4,5,10,13,11,8,13,11,7,10,6,D C,1,1,1,1,1,1,20,1,1,1,1,1,1,1,1
19263583,Wesley,1651,10/02/1995,21,0,0,0,0,176,65,4,1,2,1,2,3,2,3,1,2,3,7,11,10,8,12,8,10,7,12,12,10,8,12,11,11,12,10,11,10,10,10,13,1,6,11,12,12,12,12,13,12,10,11,13,13,20,12,12,11,10,10,5,12,11,13,13,7,12,6,11,4,D R,1,1,1,1,1,1,1,1,20,15,1,1,1,1,13
19263584,Patrick,1651,23/11/1998,17,0,0,0,0,169,0,4,4,1,1,4,2,1,3,2,3,1,7,8,12,10,15,7,7,11,7,4,12,6,9,10,9,7,5,8,5,13,15,13,12,11,8,7,9,13,15,8,9,4,1,13,12,20,14,6,9,4,9,6,9,12,11,9,10,12,1,8,4,AM C,1,1,1,20,1,1,1,1,1,1,15,1,1,1,1
19263585,Kaio Felipe,1651,05/01/1998,18,0,0,0,0,175,0,1,3,1,2,3,3,3,3,2,1,1,6,3,11,10,10,6,11,5,2,3,7,7,3,13,9,12,6,11,5,4,8,4,13,2,9,5,4,7,10,12,3,6,15,12,13,20,11,5,9,9,9,7,9,12,9,10,11,11,9,7,6,S ,1,1,20,1,1,1,1,1,1,1,1,1,1,1,1
19263625,Evandro,1651,06/01/1997,19,0,0,0,0,170,66,3,1,2,2,1,2,2,2,3,1,1,11,12,11,7,13,6,9,5,8,11,11,4,15,10,9,6,10,9,10,8,14,9,4,2,7,9,9,9,14,13,9,8,20,16,13,1,12,8,9,5,9,7,9,10,13,14,11,9,12,18,5,D L,1,1,1,1,1,1,1,20,1,1,1,1,1,14,1
19263627,Marlon,1651,05/05/1993,23,0,0,0,0,189,79,1,1,1,3,2,1,3,1,4,3,1,6,10,11,6,9,7,12,6,11,11,11,7,10,9,12,11,11,11,10,10,11,7,6,10,10,10,12,11,12,10,7,15,20,12,13,7,13,13,11,9,10,10,11,15,10,12,14,11,7,12,1,D L,1,1,1,1,1,1,11,20,1,1,1,1,1,13,1
19263646,Rafael Mineiro,1651,27/11/1991,24,0,0,0,0,176,71,3,3,4,2,3,1,2,2,3,1,4,9,13,9,6,13,7,3,9,3,7,6,1,5,10,10,9,9,8,8,7,8,3,10,6,9,7,8,9,13,13,8,7,18,13,13,20,13,5,10,5,10,10,10,17,10,11,10,10,1,11,2,AM LC,1,1,1,20,19,1,1,1,1,1,10,15,1,1,1
19263659,Maktom,1651,04/03/1998,18,0,0,0,0,177,68,1,3,2,3,3,1,3,2,3,1,2,5,7,2,7,11,7,8,9,3,7,13,4,13,9,9,9,8,6,9,9,14,18,9,6,5,14,8,13,11,12,8,7,3,14,14,20,13,7,9,9,9,6,9,20,9,12,12,13,7,17,4,D/DM C,1,1,1,1,1,1,16,1,1,20,10,1,1,1,1
19263792,Dionatan,1651,23/08/1995,20,0,0,0,0,173,0,3,1,1,3,2,3,3,2,3,2,1,12,14,9,6,9,8,7,8,5,8,8,5,14,11,9,7,8,9,7,7,10,2,9,7,8,8,8,9,10,13,8,3,20,6,14,10,6,6,8,9,6,7,9,11,13,12,13,11,3,9,2,WB/M L,1,1,1,1,14,1,1,12,1,15,12,20,1,16,1
19263846,Ferreira,1651,19/02/1993,23,0,0,0,0,185,0,2,1,3,2,2,2,3,3,1,1,3,6,6,5,7,8,6,5,8,3,13,13,2,13,13,7,10,8,6,8,10,13,4,9,8,7,13,7,11,13,11,7,11,14,13,11,20,7,9,9,9,9,9,9,16,14,12,11,12,2,11,1,DM C,1,1,1,1,1,1,1,1,1,20,15,1,1,1,1
19263850,Diogo,1651,01/03/1995,21,0,0,0,0,182,0,3,3,3,3,2,1,3,2,2,1,2,5,7,11,13,13,6,11,6,1,6,6,4,6,8,8,9,5,12,7,6,11,1,8,14,8,7,6,8,13,13,2,7,9,8,12,20,8,7,9,7,7,9,9,7,13,13,13,11,8,12,4,AM/S C,1,1,20,16,1,1,1,1,1,1,1,1,1,1,1
19263862,Matheus,1651,19/12/1997,18,0,0,0,0,169,0,1,2,1,3,1,2,1,2,3,1,1,7,4,14,14,14,7,9,8,7,8,14,4,9,13,9,12,8,9,7,14,6,9,12,2,11,9,8,5,14,11,8,5,8,5,13,20,8,6,9,9,9,9,9,18,10,9,10,10,7,10,7,M/AM/S C,1,1,16,20,1,1,1,1,1,1,17,1,1,1,1
19263949,Batista,1651,22/09/1993,22,0,0,0,0,175,0,3,2,3,1,3,3,1,1,1,3,1,8,8,6,9,10,7,7,14,6,10,11,5,14,12,5,11,9,6,10,10,14,10,4,1,9,9,9,13,14,11,9,8,12,10,13,20,8,6,10,9,10,10,10,14,10,8,9,12,4,20,2,DM C,1,1,1,1,1,1,1,1,1,20,15,1,1,1,1
19263985,Felipe Zanelatto,1651,09/06/1994,22,0,0,0,0,172,66,3,4,3,1,2,3,2,2,1,1,3,8,6,10,10,14,8,8,9,4,9,10,7,10,14,10,6,3,11,8,10,14,10,13,14,12,10,9,13,14,13,9,3,3,8,11,20,14,6,10,10,2,8,10,8,13,10,10,12,9,1,3,AM C,1,1,1,20,1,1,1,1,1,1,15,1,1,1,1
19263987,Caio,1651,05/08/1997,18,0,0,0,0,182,80,12,12,5,1,12,11,5,12,8,7,8,4,1,1,2,1,6,1,1,2,2,1,1,2,1,8,6,15,4,8,4,11,6,1,3,2,9,5,4,10,4,1,7,7,11,6,20,1,5,8,8,7,4,8,14,10,11,11,11,2,10,5,GK ,20,1,1,1,1,1,1,1,1,1,1,1,1,1,1
19263988,Diego,1651,08/07/1998,17,0,0,0,0,189,81,9,12,9,1,12,14,8,14,7,4,8,3,2,1,1,1,3,1,1,1,1,1,3,2,4,8,4,12,4,7,6,8,6,3,8,2,5,7,5,9,8,7,13,11,11,14,20,2,10,8,4,1,8,6,7,13,10,12,11,4,3,4,GK ,20,1,1,1,1,1,1,1,1,1,1,1,1,1,1
19263989,Gabriel,1651,08/08/1996,19,0,0,0,0,182,75,3,3,2,2,1,3,1,1,2,1,1,5,5,3,1,7,2,13,2,2,8,6,5,12,3,7,5,8,7,8,5,14,2,5,9,4,13,6,7,14,9,7,9,8,14,13,20,4,8,8,8,8,8,8,19,12,11,10,10,13,1,8,D C,1,1,1,1,1,1,20,1,1,1,1,1,1,1,1
19263990,Murilo,1651,02/02/1996,20,0,0,0,0,190,74,1,3,3,3,3,2,3,3,2,2,2,6,1,2,3,6,4,12,5,1,13,7,1,13,2,9,10,9,6,8,6,13,9,3,10,5,12,6,7,12,9,7,11,8,11,11,20,4,8,9,7,9,4,9,8,12,11,9,10,7,10,2,D C,1,1,1,1,1,1,20,1,1,1,1,1,1,1,1
19263994,Jardel,1651,15/05/1996,20,0,0,0,0,172,63,3,1,1,1,1,3,1,1,1,2,1,7,5,5,4,14,4,8,5,7,8,9,1,13,9,1,10,9,6,9,5,9,2,9,5,7,9,8,8,14,14,8,6,20,16,13,10,7,5,9,4,7,9,9,14,10,9,12,8,11,8,5,D/WB L,1,1,1,1,1,1,1,20,1,1,1,1,1,16,1
19263995,Carioca,1651,12/12/1995,20,0,0,0,0,174,72,1,3,3,2,1,3,3,2,3,1,2,5,9,9,7,11,2,9,8,9,11,11,4,16,8,6,8,6,7,8,10,12,5,9,13,8,9,10,10,11,12,10,9,10,9,12,20,9,8,9,5,9,9,9,20,11,13,11,12,4,15,4,D/WB R,1,1,1,1,1,1,1,1,20,1,1,1,1,1,16
19263996,Rafael,1651,26/04/1997,19,0,0,0,0,168,62,2,3,2,3,1,4,4,2,1,3,2,4,5,7,1,11,1,8,7,5,9,9,4,11,8,8,7,8,6,9,6,10,5,7,1,5,10,8,8,15,15,8,1,8,5,15,20,7,7,8,5,8,5,8,17,7,13,12,13,5,16,4,D/WB R,1,1,1,1,1,1,1,1,20,1,1,1,1,1,16
19263997,Zamai,1651,23/05/1996,20,0,0,0,0,178,72,1,3,3,2,3,3,2,3,2,1,1,5,4,7,5,10,1,8,5,7,9,9,5,11,9,8,9,9,6,12,8,12,5,1,4,6,7,8,9,14,12,7,6,20,11,11,10,13,6,9,9,7,3,9,13,10,12,11,11,5,11,4,D L,1,1,1,1,1,1,1,20,1,1,1,1,1,15,1
19263998,Louzada,1651,25/02/1997,19,0,0,0,0,173,68,1,2,2,1,2,1,3,3,3,3,2,6,6,7,6,13,4,6,6,4,8,14,3,14,14,8,6,7,8,6,8,14,8,6,5,6,12,7,9,13,9,5,5,8,12,9,20,8,5,7,8,5,7,8,13,12,10,11,10,9,6,8,DM C,1,1,1,1,1,1,1,1,1,20,15,1,1,1,1
19263999,Will,1651,05/12/1996,19,0,0,0,0,177,66,3,1,1,2,2,2,2,3,3,3,4,3,4,2,6,13,5,2,10,1,5,13,3,11,11,5,9,7,5,7,9,13,8,8,1,5,4,7,10,13,10,6,7,8,9,10,20,5,4,7,7,8,7,8,10,11,10,13,12,1,13,4,DM C,1,1,1,1,1,1,1,1,1,20,15,1,1,1,1
19264000,Renato,1651,23/05/1996,20,0,0,0,0,182,69,3,2,1,3,3,2,1,2,3,4,3,4,5,3,7,13,7,7,10,5,6,14,6,12,9,5,7,8,9,9,8,14,6,8,12,8,5,8,13,14,12,8,6,8,11,14,20,8,7,9,4,8,7,9,18,10,10,10,10,11,17,5,DM C,1,1,1,1,1,1,1,1,1,20,15,1,1,1,1
19264001,Bruno,1651,03/03/1995,21,0,0,0,0,176,60,3,2,1,1,1,1,1,3,1,1,1,6,7,5,6,14,7,5,10,1,10,7,4,14,14,9,5,8,9,9,12,14,8,3,5,8,12,8,12,10,14,8,5,8,14,14,20,8,6,9,9,9,9,9,13,11,11,12,10,1,5,4,DM C,1,1,1,1,1,1,1,1,1,20,15,1,1,1,1
19264002,Jhonatan,1651,21/02/1995,21,0,0,0,0,163,55,3,2,3,2,3,3,3,1,1,2,2,6,6,9,9,14,7,6,14,4,8,14,3,9,14,8,7,8,11,8,14,6,5,13,7,13,9,8,11,14,14,4,1,8,15,14,20,8,5,9,9,3,9,9,20,13,11,11,14,7,7,1,M/AM C,1,1,1,20,1,1,1,1,1,1,16,1,1,1,1
19264003,Lê,1651,24/04/1996,20,0,0,0,0,178,63,2,2,3,2,2,1,3,2,1,2,2,7,6,9,9,12,7,7,7,3,8,10,4,8,12,4,8,3,7,5,13,11,5,11,10,5,4,8,13,14,13,7,7,8,14,12,20,8,6,9,9,6,9,9,16,13,13,12,12,9,9,2,M C,1,1,1,15,1,1,1,1,1,1,20,1,1,1,1
19264004,Alyson,1651,20/02/1996,20,0,0,0,0,174,68,1,4,3,4,2,2,3,1,1,1,1,5,2,8,8,10,6,5,13,1,7,13,3,5,14,8,6,6,13,5,9,9,3,13,9,9,5,8,11,14,12,7,8,5,10,11,20,7,6,8,8,2,7,8,14,12,11,10,8,2,13,7,AM C,1,1,1,20,1,1,1,1,1,1,15,1,1,1,1
19264006,Jeferson,1651,23/05/1997,19,0,0,0,0,174,63,1,3,2,3,1,3,2,2,1,1,3,5,5,7,7,13,5,5,6,1,4,9,4,6,13,8,6,7,7,6,9,13,8,13,9,8,7,7,11,13,13,6,5,8,9,13,20,8,6,8,7,7,8,8,9,12,11,12,10,9,1,5,AM C,1,1,1,20,1,1,1,1,1,1,15,1,1,1,1
19264007,Danielzinho,1651,10/03/1996,20,0,0,0,0,178,66,1,1,3,4,3,3,2,4,3,1,2,6,7,9,13,13,6,13,3,1,6,7,3,5,10,9,8,6,7,7,5,12,9,10,8,13,5,6,4,12,13,7,8,8,9,13,20,5,7,9,3,5,6,9,8,12,11,11,10,6,10,2,S ,1,1,20,1,1,1,1,1,1,1,1,1,1,1,1
19264009,Brener,1651,04/02/1996,20,0,0,0,0,175,65,3,2,2,3,2,3,2,1,2,2,1,7,5,14,14,12,7,13,7,1,7,8,6,2,8,7,7,8,12,3,8,10,1,9,1,7,8,7,8,14,14,8,6,9,15,14,20,10,10,9,8,5,3,9,7,11,8,13,11,9,11,2,S ,1,1,20,1,1,1,1,1,1,1,1,1,1,1,1
19264010,Soares,1651,04/07/1997,18,0,0,0,0,180,78,3,1,4,4,3,2,4,2,3,1,1,5,2,12,13,13,5,11,6,4,2,6,4,5,12,8,6,2,10,3,6,10,8,12,1,12,4,5,6,13,11,6,5,8,11,13,20,6,6,8,8,8,8,6,20,11,9,9,11,7,15,4,S ,1,1,20,1,1,1,1,1,1,1,1,1,1,1,1
19264134,Banguelê,1651,22/02/1998,18,0,0,0,0,180,0,3,1,2,1,3,3,2,3,2,3,2,9,8,9,7,10,9,11,9,6,12,11,5,12,10,14,10,13,8,12,10,11,18,10,13,7,12,13,13,12,10,11,11,10,14,12,20,13,11,13,10,6,10,10,18,19,10,11,12,8,3,7,DM/M C,1,1,1,1,1,1,1,1,13,20,16,1,1,1,13
19264135,Gabriel Pereira,1651,04/04/1996,20,0,0,0,0,180,0,3,1,1,1,3,1,2,1,3,4,2,8,10,12,7,13,6,3,3,5,6,6,5,5,10,5,7,8,4,8,7,6,6,10,7,5,5,3,8,13,13,8,9,20,9,13,10,7,7,9,7,4,9,9,8,10,10,10,12,7,13,3,M/AM L,1,1,1,12,20,1,1,13,1,1,10,16,1,15,1
19264138,Robinson,1651,05/03/1996,20,0,0,0,0,180,0,1,3,2,3,3,2,2,1,2,2,2,7,6,7,10,14,7,7,9,7,4,11,4,7,12,9,9,4,5,9,10,9,9,11,1,12,9,8,9,14,10,9,6,8,11,11,20,9,9,9,5,9,9,9,13,13,13,12,10,8,1,2,AM C,1,1,15,20,10,10,1,1,1,1,12,1,1,1,1
19264213,Matheus Padilha,1651,05/03/1998,18,0,0,0,0,171,0,1,3,2,3,3,3,3,2,2,1,2,7,12,15,6,12,8,5,8,5,10,12,5,14,13,10,6,9,9,8,12,13,18,10,6,7,4,10,9,13,15,8,7,20,12,13,7,12,6,7,10,10,4,10,8,10,12,11,9,9,8,3,D/WB L,1,1,1,1,15,1,1,19,1,1,1,14,1,20,1
19264235,Geovane,1651,15/05/1998,18,0,0,0,0,172,70,3,2,3,1,3,3,2,1,1,2,1,9,13,13,10,12,8,8,10,8,5,10,2,10,14,10,11,9,11,9,11,14,18,14,1,7,7,9,10,15,10,7,4,20,10,14,9,8,7,10,10,2,10,10,19,11,11,10,9,8,4,5,M/AM LC,1,1,12,15,20,13,1,12,1,1,12,16,11,12,1
19264236,Hurick,1651,26/01/1998,18,0,0,0,0,165,55,2,4,2,1,2,2,1,1,2,1,2,7,12,11,8,6,5,5,2,5,7,12,3,13,8,8,8,8,8,4,6,9,8,8,1,6,4,8,8,12,13,7,1,20,10,13,9,7,7,8,8,2,8,8,8,12,12,11,10,8,17,5,D/WB L,1,1,1,1,1,1,1,20,1,1,1,1,1,19,1
19264341,Matheus Alves,1651,15/12/1994,21,0,0,0,0,190,82,12,12,10,1,13,10,10,13,7,9,9,5,3,3,1,3,9,1,2,1,2,1,2,1,1,6,4,14,7,11,6,13,5,1,12,1,6,7,6,10,5,7,12,10,12,12,20,4,11,9,8,5,9,9,15,10,8,12,13,10,9,5,GK ,20,1,1,1,1,1,1,1,1,1,1,1,1,1,1
19264427,Lucas Anselmo,1651,17/01/1997,19,0,0,0,0,191,0,13,13,10,2,13,13,8,13,7,9,10,6,1,3,2,1,8,1,2,3,2,1,2,3,3,4,6,11,5,6,6,12,2,2,2,3,9,7,6,6,14,7,12,6,12,7,20,1,9,9,9,9,5,9,18,14,9,11,11,4,1,6,GK ,20,1,1,1,1,1,1,1,1,1,1,1,1,1,1
19264428,Gabriel Machado,1651,11/01/1996,20,0,0,0,0,171,0,4,3,2,3,2,3,2,1,1,1,3,5,5,9,3,12,1,10,7,9,9,9,9,14,11,10,8,11,10,11,8,15,10,9,10,9,8,10,10,13,12,10,8,20,13,14,7,11,8,10,10,6,6,10,16,11,11,12,9,8,9,5,D/WB L,1,1,1,1,1,1,1,20,1,1,1,1,1,16,1
19264429,Rony Fernandes,1651,18/07/1997,18,0,0,0,0,189,0,1,3,4,3,3,3,1,3,1,4,2,5,1,1,4,3,1,13,3,1,12,7,2,13,4,6,8,9,7,9,3,13,2,7,6,6,12,6,7,13,8,7,7,8,11,11,20,10,11,8,9,9,9,9,11,11,11,9,11,6,13,2,D C,1,1,1,1,1,1,20,1,1,1,1,1,1,1,1
19264431,Murilo Santos,1651,22/10/1997,18,0,0,0,0,177,67,1,1,3,1,2,1,4,3,1,1,1,5,4,14,14,14,3,14,7,5,6,9,8,2,11,4,9,9,11,8,9,10,3,10,1,13,8,8,9,13,14,9,9,20,15,14,6,7,10,9,10,1,10,10,8,11,12,8,10,5,5,2,S ,1,1,20,1,1,1,1,1,1,1,1,1,1,1,1
19264432,Belão,1651,05/04/1997,19,0,0,0,0,172,0,2,3,2,3,2,1,2,2,2,3,1,6,8,6,4,15,3,8,5,4,10,5,3,12,10,5,6,10,9,8,6,7,8,9,11,6,11,9,9,15,13,9,7,10,14,11,20,9,8,9,6,5,9,9,18,9,10,12,12,1,9,4,D/WB R,1,1,1,1,1,1,1,1,20,1,1,1,1,1,16
19264433,Gabriel,1651,29/09/1997,18,0,0,0,0,171,0,1,2,2,3,1,3,3,3,2,2,1,6,7,5,6,10,3,9,7,7,9,9,1,15,6,7,7,10,7,6,5,12,9,9,10,8,9,9,9,15,15,9,3,20,9,15,10,8,8,9,8,3,7,9,17,10,11,12,10,1,12,3,D/WB L,1,1,1,1,1,1,1,20,1,1,1,1,1,16,1
19264434,Marlon Martins,1651,02/01/1997,19,0,0,0,0,178,74,2,3,3,3,2,1,1,1,4,1,2,7,8,12,15,14,13,13,8,5,7,12,5,4,13,6,14,9,8,7,10,13,8,10,12,12,9,8,10,10,12,9,6,7,12,14,20,14,9,10,5,1,8,9,18,10,11,11,13,1,10,4,S ,1,1,20,12,1,1,1,1,1,1,1,1,1,1,1
19264435,Paulinho,1651,26/08/1997,18,0,0,0,0,174,72,4,1,2,3,2,3,2,1,1,2,1,7,7,9,9,8,7,4,14,4,8,14,1,7,8,7,6,8,5,3,11,14,19,9,1,11,6,8,11,14,14,8,9,8,14,14,20,7,7,9,9,2,9,9,10,11,12,10,11,6,5,1,AM C,1,1,10,20,1,1,1,1,1,1,15,1,1,1,1
19264436,Damião,1651,20/10/1997,18,0,0,0,0,178,0,2,2,3,3,1,1,1,2,2,1,2,6,5,3,8,14,7,7,8,1,11,14,5,14,9,9,12,8,7,9,14,14,8,8,7,5,9,8,10,13,10,8,4,9,9,11,20,8,7,8,6,7,3,9,14,9,11,13,11,3,3,8,DM/M C,1,1,1,1,1,1,1,1,1,20,18,1,1,1,1
19264437,Pedrão,1651,03/03/1997,19,0,0,0,0,181,72,1,2,1,1,1,2,2,1,3,2,1,6,4,2,4,13,6,5,9,4,8,13,2,13,13,9,10,8,8,8,6,12,3,9,12,4,11,7,10,12,11,7,9,9,15,13,20,11,8,9,9,7,6,9,20,8,11,11,12,1,4,2,DM C,1,1,1,1,1,1,1,1,1,20,15,1,1,1,1
19264438,Mateus Henrique,1651,28/01/1997,19,0,0,0,0,174,0,2,1,1,3,1,3,3,3,3,3,2,5,6,10,10,14,8,8,10,1,7,14,4,6,12,7,6,4,10,9,14,14,9,11,2,11,10,9,11,14,14,9,8,6,13,14,20,10,6,10,7,1,5,10,20,10,8,9,12,5,2,1,M/AM C,1,1,1,20,1,1,1,1,1,1,18,1,1,1,1
19264439,Júlio,1651,07/01/1997,19,0,0,0,0,193,0,2,1,4,2,1,1,3,2,3,3,3,6,2,2,4,8,5,14,6,6,14,8,3,14,3,8,9,9,8,11,5,14,12,1,10,6,12,7,8,14,8,8,15,1,12,9,20,6,10,9,5,3,4,9,13,10,10,12,9,8,6,2,D C,1,1,1,1,1,1,20,1,1,1,1,1,1,1,1
19264440,Guilherme,1651,04/06/1997,19,0,0,0,0,183,0,3,1,4,3,2,3,1,2,2,3,2,4,5,1,4,8,1,14,4,1,14,8,1,13,3,9,11,9,5,5,5,14,9,5,10,3,14,7,8,14,14,8,7,4,7,13,20,6,10,9,9,9,9,9,14,10,11,11,14,1,4,4,D C,1,1,1,1,1,1,20,1,1,1,1,1,1,1,1
19264441,Frizzo,1651,24/07/1998,17,0,0,0,0,184,0,1,1,2,1,3,1,2,2,3,1,4,2,7,7,6,12,3,6,8,5,8,13,3,13,13,6,10,8,4,8,9,13,20,9,11,1,9,3,8,11,13,4,9,20,14,13,12,8,8,9,9,2,9,9,16,10,13,10,14,7,17,8,D/DM/M LC,1,1,1,1,1,1,1,16,1,20,18,1,1,15,1
19264442,Éverton,1651,17/03/1997,19,0,0,0,0,179,72,3,3,2,2,3,1,3,1,2,2,2,8,6,14,14,14,8,9,8,6,8,12,8,8,14,9,8,9,10,6,14,8,10,13,2,13,7,9,10,14,13,9,5,4,14,13,20,14,7,10,10,3,10,10,20,12,8,13,12,3,7,2,AM C,1,1,15,20,1,1,1,1,1,1,14,1,1,1,1
19264689,Léo,1651,22/03/1998,18,0,0,0,0,178,0,3,1,3,2,4,1,1,3,3,3,2,7,7,9,9,14,5,5,14,1,7,11,2,9,12,9,7,2,10,5,10,12,4,11,9,10,7,8,12,14,14,7,4,6,7,14,20,10,6,9,9,9,9,9,20,12,12,12,12,5,8,1,AM C,1,1,1,20,1,1,1,1,1,1,15,1,1,1,1
19264767,Kaique,1651,16/05/1995,21,0,0,0,0,196,0,9,9,7,8,12,9,8,7,8,7,7,1,3,3,1,2,6,1,2,2,1,1,2,1,4,8,4,13,4,9,4,12,5,1,1,2,8,5,4,10,13,5,12,6,13,9,20,3,10,6,8,8,8,8,10,12,9,11,13,9,16,4,GK ,20,1,1,1,1,1,1,1,1,1,1,1,1,1,1
19264768,Marquinho,1651,08/05/1992,24,0,0,0,0,169,67,2,2,2,2,2,3,2,1,1,2,4,6,6,5,4,9,6,5,8,4,9,12,2,13,13,9,10,8,8,6,9,13,9,7,11,6,10,7,12,13,13,3,5,20,10,13,5,8,6,9,7,7,9,9,10,13,13,9,11,8,9,4,DM C,1,1,1,1,1,1,1,1,1,20,15,1,1,1,1
19264770,Rafa,1651,19/03/1993,23,0,0,0,0,186,0,1,1,4,2,1,2,2,3,2,3,3,1,1,1,4,7,1,13,2,1,13,7,3,7,2,9,11,5,7,10,4,13,1,6,3,6,9,6,7,13,13,7,8,8,9,12,20,5,10,8,6,7,7,9,12,11,9,11,11,10,8,8,D C,1,1,1,1,1,1,20,1,1,1,1,1,1,1,1
19264772,Lucas Paraíba,1651,16/05/1993,23,0,0,0,0,181,0,2,1,4,2,2,4,2,2,2,1,1,7,5,3,5,10,7,7,13,1,10,13,5,13,9,9,11,8,8,8,7,14,9,9,5,8,14,8,10,14,11,8,10,1,10,11,20,5,13,9,6,9,9,9,11,11,11,12,10,5,5,4,DM/M C,1,1,1,1,1,1,1,1,1,20,16,1,1,1,1
19264773,Mateus Oliveira,1651,27/09/1994,21,0,0,0,0,176,68,1,1,3,3,2,1,3,3,2,3,2,6,3,8,7,9,6,5,8,4,6,13,1,6,11,9,9,8,5,2,13,9,9,11,4,9,8,7,12,12,9,7,4,8,11,12,20,13,4,9,9,8,9,9,10,11,9,13,8,8,10,2,AM C,1,1,1,20,1,1,1,1,1,1,15,1,1,1,1
19264840,Gabriel Santana,1651,18/02/1997,19,0,0,0,0,196,0,10,9,10,1,13,8,10,13,9,8,8,2,2,1,3,5,5,1,3,1,3,1,3,1,1,8,7,9,6,12,6,13,2,1,8,3,7,7,6,10,14,7,12,9,14,11,20,4,13,9,9,9,8,9,18,12,11,11,11,3,9,5,GK ,20,1,1,1,1,1,1,1,1,1,1,1,1,1,1
19264842,Pedro,1651,03/05/1997,19,0,0,0,0,194,0,1,2,3,1,3,3,3,1,2,3,3,2,1,6,1,4,1,13,5,6,13,7,1,13,6,9,9,9,5,7,5,13,9,1,10,3,13,6,7,11,8,7,14,2,14,9,20,8,11,9,6,6,8,9,8,9,13,11,12,5,6,7,D C,1,1,1,1,1,1,20,1,1,1,1,1,1,1,1
19264845,Quereiro,1651,15/12/1997,18,0,0,0,0,186,0,2,1,4,3,3,1,2,2,3,2,2,6,4,10,13,13,3,13,4,6,2,7,3,3,12,9,11,3,7,7,4,6,5,12,6,13,2,4,7,11,13,7,12,10,9,11,20,8,8,9,6,3,4,9,7,12,12,11,10,1,11,2,S ,1,1,20,1,1,1,1,1,1,1,1,1,1,1,1
19264876,Ramon,1651,13/08/1992,23,0,0,0,0,187,0,1,3,2,1,3,3,3,1,2,2,2,3,6,3,4,8,1,8,2,6,7,8,1,13,8,8,10,8,7,8,6,14,8,6,2,6,8,7,7,11,14,7,13,20,15,14,10,5,8,8,6,8,8,8,8,11,12,11,11,2,7,3,D/WB LC,1,1,1,1,1,1,15,20,1,1,1,1,1,16,1
19264883,Chocolate,1651,12/04/1994,22,0,0,0,0,184,75,3,2,1,3,2,2,1,1,1,1,1,6,6,9,13,10,6,13,4,2,3,7,9,1,12,9,10,4,10,7,7,10,6,12,4,12,7,6,7,11,10,7,9,9,14,12,20,9,9,9,6,9,6,9,12,11,11,11,10,2,14,1,S ,1,1,20,1,1,1,1,1,1,1,1,1,1,1,1
19264976,Matheus,1651,26/02/1999,17,0,0,0,0,170,0,3,1,1,2,3,3,2,3,3,2,1,6,3,9,7,14,6,6,12,1,4,10,1,7,14,8,8,5,7,6,10,6,2,13,5,5,2,8,10,14,10,7,2,5,12,13,20,7,6,6,8,8,8,8,12,13,9,14,12,2,2,1,AM C,1,1,1,20,1,1,1,1,1,1,10,1,1,1,1
19264978,Rodolfo,1651,24/05/1997,19,0,0,0,0,182,0,3,3,2,4,1,1,2,1,2,1,2,5,5,3,6,13,5,4,8,4,6,13,3,12,11,7,4,7,7,6,6,13,8,5,12,5,6,6,8,13,11,6,6,16,10,12,20,3,6,8,8,8,5,8,19,12,14,12,11,2,10,7,DM/M C,1,1,1,1,1,1,1,1,1,20,16,1,1,1,1
19264980,Arthur,1651,14/05/1999,17,0,0,0,0,191,0,4,6,7,7,12,10,7,12,5,8,8,5,2,1,2,1,8,1,3,3,3,1,3,2,3,6,6,12,5,7,4,12,8,1,10,3,10,5,4,9,12,1,10,7,15,11,20,1,8,8,8,4,8,8,7,10,12,9,10,5,11,8,GK ,20,1,1,1,1,1,1,1,1,1,1,1,1,1,1
19264981,Pedro,1651,22/02/1999,17,0,0,0,0,188,0,12,6,8,3,12,5,9,12,8,8,6,5,1,2,1,1,7,1,1,1,3,1,1,3,2,8,4,12,4,7,4,12,4,1,6,2,4,5,4,12,14,6,12,4,9,8,20,1,6,7,8,8,8,6,20,11,13,11,9,1,13,5,GK ,20,1,1,1,1,1,1,1,1,1,1,1,1,1,1
19264984,Willian,1651,04/11/1998,17,0,0,0,0,190,0,2,2,3,1,3,3,1,3,3,1,3,1,6,6,1,10,1,7,1,6,8,8,2,12,8,7,4,8,3,4,7,14,6,7,2,6,5,7,7,12,9,4,15,20,8,8,8,10,11,8,8,8,8,8,17,9,10,10,11,8,17,8,D/WB L,1,1,1,1,1,1,1,20,1,1,1,1,1,16,1
19264985,Thiago Aleixo,1651,30/06/1998,18,0,0,0,0,175,0,2,3,3,2,2,2,1,1,2,3,1,1,2,4,1,7,1,6,1,3,7,4,1,13,7,8,6,8,6,7,5,11,8,7,9,1,5,6,6,13,13,6,4,20,6,13,8,8,4,6,8,8,8,8,7,12,13,12,12,3,5,8,D/WB L,1,1,1,1,1,1,1,20,1,1,1,1,1,16,1
19264986,Messias,1651,19/01/1998,18,0,0,0,0,175,0,1,3,1,3,2,1,3,2,3,2,1,3,8,4,4,10,1,7,1,6,6,8,2,12,5,5,6,8,7,9,7,10,4,3,7,2,9,7,8,14,12,6,6,8,11,13,20,13,6,8,5,2,8,8,18,11,12,9,15,1,7,1,D/WB R,1,1,1,1,1,1,1,1,20,1,1,1,1,1,16
19264987,Yan,1651,02/03/1999,17,0,0,0,0,180,0,2,1,3,1,1,1,2,4,3,2,1,4,5,4,4,6,1,13,1,1,5,5,1,11,3,4,6,8,5,5,1,13,5,1,9,2,11,5,6,11,12,6,10,2,14,13,20,7,8,8,7,8,6,8,19,12,11,10,11,3,2,5,D C,1,1,1,1,1,1,20,1,1,1,1,1,1,1,1
19264989,Miguel Augusto,1651,08/03/1998,18,0,0,0,0,190,0,1,3,3,1,3,1,1,3,3,1,1,1,3,2,1,6,1,13,5,1,13,5,1,13,5,8,6,8,6,3,5,13,4,4,2,5,9,5,6,7,8,6,10,8,13,10,20,7,11,8,8,8,8,8,20,13,12,10,12,5,12,7,D C,1,1,1,1,1,1,20,1,1,1,1,1,1,1,1
19264990,Yago,1651,15/04/1998,18,0,0,0,0,180,0,3,3,3,1,2,2,2,1,2,3,3,1,1,5,4,5,1,13,3,1,13,4,3,10,2,8,8,8,2,7,5,12,4,5,9,1,10,5,6,11,8,5,6,12,13,9,20,7,5,7,8,4,8,8,10,11,13,10,10,1,9,1,D C,1,1,1,1,1,1,20,1,1,1,1,1,1,1,1
19264991,Mateus,1651,26/02/1998,18,0,0,0,0,184,0,3,3,2,2,2,1,2,2,2,2,3,2,3,6,7,14,5,6,5,1,8,9,2,14,13,8,9,5,4,8,11,6,8,3,10,7,9,8,12,9,10,7,8,8,10,12,20,10,7,8,6,8,8,8,7,11,13,10,13,2,1,3,DM/M C,1,1,1,1,1,1,1,1,1,20,16,1,1,1,1
19264992,Matheus,1651,29/01/1998,18,0,0,0,0,180,0,3,3,3,2,2,3,3,3,2,3,2,5,2,1,5,13,5,5,11,1,7,13,4,9,13,1,6,5,6,6,5,12,8,5,2,6,9,7,11,13,12,6,9,8,14,11,20,12,7,8,8,5,8,8,12,11,11,11,11,1,11,3,DM/M C,1,1,1,1,1,1,1,1,1,20,16,1,1,1,1
19264993,Weslley,1651,15/06/1999,17,0,0,0,0,170,0,1,2,3,3,2,1,1,3,1,3,4,5,5,4,3,13,2,5,10,2,7,9,1,12,10,5,4,7,4,4,8,13,4,5,9,1,11,7,11,13,9,6,3,7,5,12,20,6,6,6,7,8,3,8,20,9,9,10,11,7,12,6,DM/M C,1,1,1,1,1,1,1,1,1,20,16,1,1,1,1
19264995,João Vítor,1651,28/06/1998,18,0,0,0,0,187,0,2,2,1,1,3,2,3,2,2,3,4,5,6,8,7,14,6,6,7,1,4,14,2,8,14,8,6,1,5,6,14,11,5,13,8,9,4,8,12,13,9,7,10,2,10,8,20,9,11,7,8,8,8,8,9,9,10,11,10,13,10,3,AM C,1,1,1,20,1,1,1,1,1,1,15,1,1,1,1
19264996,Walter,1651,18/02/1998,18,0,0,0,0,179,0,3,2,2,1,4,1,1,2,2,1,3,6,6,8,8,10,6,5,9,1,7,10,1,8,13,3,7,7,4,4,14,14,8,12,4,7,7,8,12,12,8,7,5,8,8,11,20,7,6,8,7,3,8,8,20,10,10,10,13,5,9,6,AM C,1,1,1,20,1,1,1,1,1,1,15,1,1,1,1
19264997,Matheus,1651,15/01/1998,18,0,0,0,0,183,0,1,1,2,2,3,2,2,2,1,3,2,4,4,7,7,13,5,5,10,3,4,13,1,7,13,7,8,6,6,3,9,7,4,13,11,5,3,7,10,12,9,4,7,20,11,11,8,6,7,8,6,7,8,8,13,10,12,12,11,1,8,8,AM C,1,1,1,20,1,1,1,1,1,1,15,1,1,1,1
19264999,Bruno,1651,01/06/1999,17,0,0,0,0,163,0,2,4,1,3,1,1,1,2,3,2,3,6,6,13,13,13,6,13,5,3,4,7,8,4,13,9,5,4,8,7,5,9,18,13,11,13,5,6,8,12,10,7,1,8,11,12,20,12,8,9,4,9,5,9,20,10,12,11,9,9,9,8,S ,1,1,20,1,1,1,1,1,1,1,1,1,1,1,1
19265000,Gabriel Cotias,1651,23/08/1998,17,0,0,0,0,175,0,3,1,3,2,2,3,2,2,3,1,1,5,3,13,13,12,3,13,6,1,4,6,8,1,8,8,9,5,7,5,6,11,5,8,1,9,5,5,6,13,11,2,6,8,4,12,20,5,6,8,8,8,8,6,17,13,10,9,10,8,5,7,S ,1,1,20,1,1,1,1,1,1,1,1,1,1,1,1
19265001,Victor Hugo,1651,18/02/1998,18,0,0,0,0,175,0,2,1,1,2,1,2,1,3,3,2,3,6,5,14,14,13,6,10,7,6,2,5,4,3,14,8,10,3,5,5,6,7,8,13,11,5,4,6,8,14,9,6,5,8,8,12,20,12,8,8,4,8,5,8,17,9,10,10,8,9,13,1,S ,1,1,20,1,1,1,1,1,1,1,1,1,1,1,1
19265002,Igor,1651,01/02/1998,18,0,0,0,0,188,0,1,1,3,1,1,3,2,2,1,3,2,5,4,13,13,12,5,12,6,3,3,6,8,2,8,8,10,7,9,6,6,4,1,8,4,7,6,5,6,13,9,5,10,3,4,10,20,6,9,8,8,8,8,8,9,11,10,9,12,1,4,5,S ,1,1,20,1,1,1,1,1,1,1,1,1,1,1,1
19265003,Mateus Grippa,1651,03/04/1999,17,0,0,0,0,183,0,2,3,2,2,3,4,2,3,3,2,4,5,3,13,13,13,5,13,2,3,1,5,4,1,10,8,10,5,12,3,5,4,5,10,11,13,1,5,6,13,8,6,10,8,15,10,20,4,6,6,8,7,7,8,14,9,8,9,11,11,10,7,S ,1,1,20,1,1,1,1,1,1,1,1,1,1,1,1
19265004,Rafael Souza,1651,17/08/1999,16,0,0,0,0,175,0,1,3,2,3,2,2,2,2,1,1,1,4,1,7,12,9,4,12,5,1,4,5,5,2,10,8,7,4,12,1,1,12,5,11,1,10,5,4,5,12,12,5,5,7,15,12,20,6,5,8,8,5,8,6,7,10,11,9,11,6,9,4,S ,1,1,20,1,1,1,1,1,1,1,1,1,1,1,1
19265373,Rodrigo Maranhão,1651,11/12/1992,23,0,0,0,0,179,80,1,3,3,2,2,2,1,3,3,1,2,8,6,12,14,14,8,13,6,1,8,9,8,6,10,6,14,6,12,8,9,14,3,10,4,14,9,8,9,14,14,9,4,10,17,14,20,6,6,10,9,7,5,9,17,11,11,11,11,6,5,4,S ,1,1,20,1,1,1,1,1,1,1,1,1,1,1,1
19265456,Marcão,1651,14/01/1991,25,0,0,0,0,183,75,2,3,3,3,1,4,1,2,2,2,3,8,10,7,8,14,8,4,11,6,14,11,8,11,12,10,8,9,4,6,11,13,3,8,5,8,12,9,11,14,14,9,12,13,13,14,20,10,8,10,12,10,8,10,17,11,11,13,12,9,6,6,DM ,1,1,1,1,1,1,1,1,1,20,10,1,1,1,1
19265526,Douglas Dôpo,1651,02/02/1993,23,0,0,0,0,179,61,3,2,2,2,2,2,3,2,3,2,1,7,6,3,8,13,7,7,12,6,12,13,1,13,10,7,11,9,5,6,8,13,3,4,2,7,13,8,9,13,13,8,6,8,11,13,20,6,8,10,6,4,6,10,14,10,12,10,11,9,9,2,DM ,1,1,1,1,1,1,1,1,1,20,10,1,1,1,1
19265538,João Lucas,1651,08/06/1991,25,0,0,0,0,184,79,3,3,1,1,2,1,3,1,2,3,3,6,5,9,4,11,3,10,7,9,11,10,2,14,11,8,12,11,11,10,9,14,4,7,9,9,11,11,11,14,14,11,11,20,10,14,11,14,9,11,5,7,8,10,19,12,13,8,11,6,5,1,D/WB L,1,1,1,1,1,1,1,20,1,1,1,1,1,19,1
19265725,Newton,1651,03/02/1991,25,0,0,0,0,189,0,2,1,2,1,1,3,1,4,2,3,1,2,2,13,13,8,6,10,7,1,6,6,6,1,11,3,11,1,6,7,5,13,2,11,11,13,7,6,8,13,13,7,11,16,11,13,20,12,13,9,9,9,6,8,15,12,12,13,11,9,9,8,S ,1,1,20,1,1,1,1,1,1,1,1,1,1,1,1
19265762,Diego Rocha,1651,27/02/1992,24,0,0,0,0,190,89,3,2,2,3,3,2,1,2,2,2,1,5,3,5,6,6,1,7,5,6,13,8,2,13,6,5,9,7,7,9,7,10,9,2,2,6,8,7,6,13,12,3,14,20,9,11,10,11,11,9,9,8,9,9,18,12,12,11,12,1,9,1,D/WB LC,1,1,1,1,1,1,20,19,1,1,1,1,1,18,1
19265858,Richarlison,1651,10/05/1997,19,0,0,0,0,181,71,2,2,2,4,4,1,3,1,2,2,3,10,10,14,13,12,9,12,12,8,6,12,12,8,13,8,11,11,12,12,10,11,14,12,11,10,7,11,12,12,14,12,11,18,13,13,20,12,15,10,6,11,13,14,12,13,14,13,12,7,13,8,S RL,1,1,20,1,15,15,1,1,1,1,1,1,1,1,1
19265859,Mardley,1651,14/02/1995,21,0,0,0,0,183,0,2,4,1,1,2,2,3,2,3,1,2,7,9,6,7,15,8,8,9,3,9,15,5,14,15,5,12,9,7,9,12,14,8,1,14,8,8,10,8,7,9,9,11,20,11,6,10,8,10,9,5,9,8,9,11,10,10,9,13,10,4,7,DM ,1,1,1,1,1,1,1,1,1,20,12,11,12,1,1
19265866,Rodrigo Fumaça,1651,06/03/1995,21,0,0,0,0,186,79,3,1,3,3,3,1,3,3,3,1,1,6,7,13,13,12,6,13,7,4,4,6,4,4,8,9,9,8,6,7,7,9,7,8,7,13,6,6,7,13,8,7,10,9,12,11,20,5,9,9,8,9,9,9,12,9,12,9,11,3,7,6,S ,1,1,20,1,1,1,1,1,1,1,1,1,1,1,1
19265871,Wellissol,1651,16/02/1998,18,0,0,0,0,182,74,3,1,3,3,2,1,1,3,3,1,3,8,11,12,6,12,5,1,5,1,4,6,1,5,11,8,3,1,3,4,8,11,8,14,6,10,3,5,6,11,11,9,9,16,10,11,20,10,8,8,8,5,8,8,16,13,11,12,11,6,12,2,AM LC,1,1,13,18,20,1,1,1,1,1,10,10,1,1,1
19265969,Erivan,1651,09/02/1996,20,0,0,0,0,188,0,2,1,3,4,1,1,2,3,1,2,1,6,3,13,13,11,1,12,7,1,6,7,10,1,10,6,7,8,13,5,7,11,9,10,12,12,7,6,7,13,12,7,7,16,10,11,20,8,8,9,9,7,8,9,12,9,11,12,11,13,9,5,S ,1,1,20,1,1,1,1,1,1,1,1,1,1,1,1
19266039,Jhonatan Silva,1651,12/09/1990,25,0,0,0,0,180,75,2,1,3,4,2,2,3,3,3,2,1,5,9,9,5,10,8,8,10,2,9,11,4,12,10,10,10,9,8,8,8,14,6,6,13,8,10,9,13,14,13,8,9,20,10,13,10,10,12,10,10,10,10,10,15,12,11,11,10,3,5,7,DM L,1,1,1,1,1,1,1,15,1,20,10,1,1,13,1
19266046,Gilvan,1651,08/02/1993,23,0,0,0,0,182,70,3,3,1,4,4,3,3,3,1,2,1,10,12,13,13,13,7,11,6,2,5,7,8,7,13,6,8,5,7,8,4,13,9,13,6,12,4,7,8,13,10,8,5,10,9,13,20,9,7,9,3,9,9,9,10,10,13,9,10,3,10,7,AM/S L,1,1,17,1,20,1,1,1,1,1,1,10,1,1,1
19266054,Paulinho,1651,20/07/1992,23,0,0,0,0,178,77,2,3,1,1,1,2,3,3,1,2,1,6,5,13,13,13,6,12,7,3,5,4,8,1,12,9,10,5,7,7,7,10,1,12,12,13,4,6,7,13,13,7,3,10,8,13,20,8,8,9,8,9,9,9,10,9,10,12,11,7,9,5,S ,1,1,20,1,1,1,1,1,1,1,1,1,1,1,1
19266182,Vinicius,1651,30/04/1996,20,0,0,0,0,194,89,2,3,2,3,4,3,4,1,4,1,1,7,7,9,5,14,7,6,9,3,7,14,3,8,12,9,7,5,8,4,11,14,3,11,6,10,9,9,11,14,11,8,13,9,11,10,20,8,12,9,5,8,9,9,12,11,12,11,12,5,9,2,M/AM C,1,1,1,20,1,1,1,1,1,1,17,1,1,1,1
19266203,Alemão,1651,25/05/1990,26,0,0,0,0,174,66,2,1,3,2,1,1,2,1,3,3,1,12,14,13,9,12,13,7,12,7,9,12,12,8,12,13,11,12,11,12,12,10,15,13,7,13,11,13,13,16,14,12,9,12,13,16,20,13,10,11,8,10,11,14,17,11,11,10,11,3,12,2,D/WB R,1,1,1,1,1,12,1,1,20,1,1,1,15,1,17
19266204,Alyson,1651,08/05/1997,19,0,0,0,0,184,0,13,9,8,1,13,5,8,12,9,6,12,2,3,3,2,5,7,1,1,2,2,1,2,3,3,9,5,15,7,7,6,13,9,1,1,2,11,7,6,11,9,4,8,9,7,7,20,2,6,9,9,1,6,9,17,11,9,11,14,2,2,4,GK ,20,1,1,1,1,1,1,1,1,1,1,1,1,1,1
19266205,Rodolfo,1651,01/05/1992,24,0,0,0,0,182,78,2,2,2,3,1,2,2,1,2,2,3,5,11,13,10,10,4,6,5,5,6,11,7,5,11,8,11,9,10,12,12,12,10,12,8,12,9,11,13,13,12,11,11,8,13,13,20,13,9,10,8,7,8,10,19,11,11,10,10,8,13,5,AM RL,1,1,15,1,18,20,1,1,1,1,1,1,1,1,1
19266222,Watson,1651,04/03/1994,22,0,0,0,0,173,64,3,3,3,2,1,4,1,2,2,1,1,10,10,12,8,10,11,9,8,12,12,11,6,11,10,11,13,13,12,11,12,16,12,11,12,12,12,14,12,13,13,7,7,11,13,13,20,14,7,11,7,2,7,11,16,14,12,10,11,8,6,8,D/WB/M/AM R,1,1,1,1,1,17,1,1,20,1,1,1,17,1,17
19266223,Leonardo Silva,1651,21/01/1996,20,0,0,0,0,173,64,3,3,2,2,1,2,1,1,2,4,1,8,8,10,9,14,4,6,14,7,6,14,6,8,14,9,10,5,6,9,8,11,4,13,8,6,7,9,11,9,12,10,7,10,10,14,20,8,6,13,8,8,10,10,15,11,12,9,11,4,14,6,M/AM C,1,1,1,20,1,1,1,1,1,1,17,1,1,1,1
19266224,Guilherme Garutti,1651,08/03/1994,22,0,0,0,0,194,86,3,3,3,2,2,1,4,3,2,1,1,6,5,5,8,7,6,12,9,8,11,10,7,10,8,11,10,10,9,10,10,9,10,8,9,10,10,12,12,10,11,9,12,10,10,9,20,11,12,10,8,9,3,9,12,11,9,10,12,11,10,7,D C,1,1,1,1,1,1,20,1,1,1,1,1,1,1,1
19266234,Augusto,1651,22/02/1992,24,0,0,0,0,178,0,1,1,3,3,1,4,3,3,2,3,3,4,7,7,2,12,1,6,6,5,8,8,2,13,8,5,9,8,5,7,7,9,9,4,2,7,7,7,8,13,13,7,4,20,10,13,10,13,7,9,9,6,9,9,18,11,11,11,11,7,2,3,D/WB L,1,1,1,1,13,1,1,20,1,1,1,13,1,19,1
19266236,Bruno Lima,1651,17/12/1994,21,0,0,0,0,180,0,3,2,3,3,1,3,4,1,2,1,2,3,5,7,7,12,4,5,5,1,7,10,3,7,12,9,8,7,3,6,12,10,3,13,3,5,7,7,9,12,12,7,6,13,6,12,20,6,5,9,7,3,9,9,13,9,11,10,10,7,17,6,M/AM C,1,1,1,17,1,1,1,1,1,1,20,1,1,1,1
19266238,Dener,1651,06/09/1996,19,0,0,0,0,184,0,2,2,1,3,3,2,1,3,1,1,1,6,3,8,8,14,6,4,14,4,6,13,5,3,14,8,5,7,13,7,10,11,8,13,11,7,3,8,11,14,8,8,10,1,13,12,20,6,8,4,8,8,8,8,13,13,12,13,14,1,14,1,M/AM C,1,1,1,20,1,1,1,1,1,1,17,1,1,1,1
19266240,Felipe,1651,12/06/1992,24,0,0,0,0,185,0,14,13,7,9,14,14,10,14,3,6,10,7,2,3,3,1,9,1,1,1,1,2,2,2,1,9,10,10,8,9,7,9,9,3,10,1,9,8,7,12,8,8,11,1,14,10,20,7,10,8,9,4,8,9,17,9,11,12,12,4,11,2,GK ,20,1,1,1,1,1,1,1,1,1,1,1,1,1,1
19266241,Flaysmar,1651,04/08/1993,22,0,0,0,0,197,91,14,10,8,1,14,14,8,10,9,4,10,5,2,2,3,3,10,1,3,2,2,1,3,1,8,10,12,14,9,11,8,12,8,3,5,3,12,9,8,13,13,13,13,20,13,12,9,13,13,13,10,8,9,10,11,13,11,12,9,11,1,6,GK ,20,1,1,1,1,1,1,1,1,1,1,1,1,1,1
19266242,Gabriel Santos,1651,10/02/1993,23,0,0,0,0,187,0,1,4,2,3,2,3,2,3,1,1,2,6,6,4,6,11,6,6,11,1,8,13,1,13,11,5,9,8,8,8,7,13,9,9,9,7,8,8,11,13,9,5,13,8,14,11,20,6,8,9,9,9,9,9,18,11,10,9,14,1,15,4,DM/M C,1,1,1,1,1,1,1,1,1,20,17,1,1,1,1
19266243,Jackson,1651,02/07/1984,31,0,0,0,0,179,0,1,1,1,3,3,3,2,3,2,3,1,7,7,7,8,11,7,5,7,4,8,12,7,8,9,9,12,8,5,9,14,14,9,9,14,12,9,9,10,8,9,9,5,9,10,6,20,14,6,9,9,4,9,9,7,10,10,9,9,4,3,3,M/AM C,1,1,1,20,1,1,1,1,1,1,17,1,1,1,1
19266244,Jailson,1651,08/09/1988,27,0,0,0,0,185,0,3,2,3,2,3,3,1,2,1,1,2,6,6,4,6,13,6,5,8,6,8,9,3,13,13,3,10,8,8,8,11,6,9,9,5,7,12,8,9,13,13,8,12,9,11,13,20,6,8,9,7,2,9,9,18,9,9,13,13,5,15,8,DM/M C,1,1,1,1,1,1,1,1,1,20,17,1,1,1,1
19266246,Léo Marques,1651,16/07/1992,23,0,0,0,0,181,0,1,2,3,2,3,3,1,2,4,3,2,5,3,13,13,13,6,13,5,1,5,7,6,5,10,9,10,2,8,7,4,8,9,10,5,13,7,6,7,12,11,7,7,8,14,13,20,12,7,9,5,7,9,9,17,9,12,12,12,6,16,2,S ,1,1,20,1,1,1,1,1,1,1,1,1,1,1,1
19266249,Wellinton,1651,25/09/1996,19,0,0,0,0,191,83,1,2,2,3,1,3,1,1,3,2,4,7,7,5,9,12,7,1,8,4,10,8,7,14,8,8,9,8,9,9,8,14,1,1,10,6,5,9,7,14,11,9,11,8,14,13,20,5,11,9,9,4,9,9,15,11,10,8,10,1,6,1,DM/M C,1,1,1,1,1,1,1,1,1,20,17,1,1,1,1
19266258,Luan,1651,10/06/1994,22,0,0,0,0,173,61,3,2,3,2,2,4,3,3,3,3,2,8,11,9,7,10,5,7,6,10,9,10,7,9,10,10,12,11,10,10,8,10,2,11,12,14,14,12,11,14,13,11,7,20,14,14,7,13,4,11,10,5,10,10,8,10,8,12,8,3,14,2,D/WB L,1,1,1,1,1,1,1,20,1,1,1,1,1,17,1
19266259,Leandro,1651,25/02/1995,21,0,0,0,0,178,72,2,2,3,2,1,1,3,1,2,2,1,9,6,6,6,11,6,10,7,9,11,8,5,15,11,7,11,10,9,11,8,13,1,4,4,7,8,11,11,12,14,11,9,2,9,15,20,8,9,9,6,1,9,9,8,10,10,10,12,7,6,1,D/WB R,1,1,1,1,1,1,1,1,20,1,1,1,1,1,17
19266360,Alan,1651,14/12/1993,22,0,0,0,0,185,0,4,1,3,3,3,1,1,4,2,2,3,4,7,6,8,9,7,9,5,2,9,12,2,13,7,10,9,9,7,9,6,12,10,9,12,7,13,8,11,10,12,8,11,13,15,13,20,7,9,10,10,8,10,10,11,12,11,8,11,3,14,1,D/DM C,1,1,1,1,1,1,16,1,1,20,10,1,1,1,1
19266403,Arthur,1651,25/04/1998,18,0,0,0,0,176,0,3,3,3,2,2,1,3,2,1,3,2,8,6,14,13,14,8,14,8,7,7,8,5,4,14,10,9,7,9,5,9,12,10,13,8,12,9,8,9,14,12,9,8,3,13,10,20,13,10,10,4,3,10,9,7,9,11,11,10,2,18,7,S ,1,1,20,1,1,1,1,1,1,1,1,1,1,1,1
19266470,Cléo Silva,1651,21/11/1989,26,0,0,0,0,173,65,2,3,1,1,1,2,2,3,1,2,3,8,8,9,9,10,8,7,8,5,7,14,5,10,13,10,9,4,13,9,10,7,3,12,12,11,7,9,11,15,14,15,7,9,17,14,20,14,13,10,13,10,6,10,14,13,12,13,10,1,5,8,AM C,1,1,1,20,1,1,1,1,1,1,10,1,1,1,1
19266471,Wallace,1651,17/01/1991,25,0,0,0,0,190,78,2,2,1,4,3,1,3,3,3,1,4,6,2,1,1,9,4,14,7,5,14,4,6,14,7,8,14,10,9,11,8,10,7,1,3,7,14,8,9,14,11,9,11,10,11,11,20,7,12,10,10,9,6,10,8,12,9,12,11,3,4,2,D C,1,1,1,1,1,1,20,1,1,1,1,1,1,1,1
19266474,Buiú,1651,27/04/1996,20,0,0,0,0,171,67,3,1,2,3,1,2,3,4,2,3,2,10,10,12,9,12,10,6,10,10,8,12,11,8,12,9,12,8,9,9,10,9,10,13,4,12,9,10,11,14,14,13,6,4,12,13,20,13,8,12,6,10,5,14,7,12,12,12,11,4,14,6,D/WB/M/AM RC,1,1,1,15,1,17,1,1,20,1,12,1,18,1,19
19266476,Edson Kolln,1651,19/06/1991,25,0,0,0,0,195,86,12,13,10,5,14,13,8,14,7,3,12,7,2,2,2,6,9,1,2,3,2,1,2,2,6,10,7,15,6,10,8,14,10,1,14,1,12,9,8,11,8,7,17,11,13,12,20,8,14,9,10,9,10,9,8,11,8,11,12,11,14,5,GK ,20,1,1,1,1,1,1,1,1,1,1,1,1,1,1
19266493,Nuno,1651,18/05/1998,18,0,0,0,0,182,64,1,3,3,1,3,2,1,1,1,3,3,5,5,6,8,10,5,7,7,1,6,8,1,9,7,4,6,7,7,5,7,11,16,3,7,5,13,7,10,13,10,7,10,15,11,11,20,5,8,8,8,8,8,8,12,13,10,12,11,1,11,2,D/DM C,1,1,1,1,1,1,17,1,1,20,8,1,1,1,1
19266494,Guga,1651,29/08/1998,17,0,0,0,0,175,0,1,1,3,2,2,1,3,1,2,1,1,14,12,7,3,12,14,5,2,1,8,6,3,13,9,7,8,9,5,6,7,11,5,14,1,12,9,7,9,13,11,7,5,2,15,13,20,13,6,9,8,7,5,9,16,11,11,11,11,5,8,7,D/WB RL,1,1,1,1,1,1,1,17,20,1,1,1,1,15,18
19266495,Deivid,1651,28/03/1996,20,0,0,0,0,184,0,1,1,3,1,1,1,1,2,3,1,4,5,6,12,11,13,5,13,6,1,2,6,5,1,13,8,10,7,8,5,6,8,8,13,3,9,6,5,6,13,13,5,7,20,9,13,2,7,7,7,5,7,4,8,20,10,12,13,10,1,12,3,S ,1,1,20,1,1,1,1,1,1,1,1,1,1,1,1
19266496,Leonardo,1651,14/05/1996,20,0,0,0,0,181,0,1,1,2,1,3,1,2,2,1,1,3,4,3,3,1,8,1,6,5,5,7,7,1,13,7,7,8,8,6,5,6,13,7,8,9,5,6,6,7,13,13,6,9,9,11,13,20,12,8,8,8,8,7,8,12,11,10,12,10,4,9,7,D/WB R,1,1,1,1,1,1,1,1,20,1,1,1,1,1,16
19266576,Zé Carlos,1651,11/02/1995,21,0,0,0,0,182,0,11,6,9,8,11,10,5,11,6,8,9,5,3,3,3,1,7,1,3,2,1,1,2,2,1,8,6,7,3,6,3,10,8,1,13,2,5,4,3,10,12,4,4,11,9,8,20,2,4,8,7,8,4,8,17,9,10,12,10,6,7,5,GK ,20,1,1,1,1,1,1,1,1,1,1,1,1,1,1
19266578,Bagio,1651,30/03/1995,21,0,0,0,0,181,0,3,3,2,1,2,4,1,2,3,4,3,4,6,7,6,12,6,6,10,2,7,7,4,12,11,8,10,4,6,9,10,14,3,1,13,6,11,8,10,14,10,7,7,1,8,10,20,7,7,8,5,8,7,8,7,9,10,9,13,5,1,7,DM ,1,1,1,1,1,1,1,1,1,20,10,1,1,1,1
19266625,Marlon,1651,20/05/1997,19,0,0,0,0,173,68,2,3,2,1,3,1,2,1,2,3,1,10,10,11,6,11,6,7,8,10,10,11,8,11,12,11,11,11,9,10,11,10,13,11,6,11,9,12,12,14,13,14,7,20,11,14,8,14,6,10,13,10,8,8,16,12,10,11,10,2,6,7,D/WB L,1,1,1,1,1,1,1,20,1,1,1,1,1,16,1
19266626,Carlos Eduardo,1651,17/11/1996,19,0,0,0,0,179,0,2,2,1,1,3,3,3,4,2,1,3,7,9,8,5,13,6,7,6,1,8,9,1,12,9,4,5,8,6,8,6,14,5,9,2,6,7,8,9,14,13,7,9,9,12,14,20,8,7,8,6,9,9,9,13,9,10,10,9,8,2,2,D/WB R,1,1,1,1,1,1,1,7,20,15,7,1,1,4,16
19266707,Mateus Silva,1651,27/08/1996,19,0,0,0,0,172,69,3,2,3,1,3,3,2,1,2,1,3,9,9,10,8,15,9,6,11,5,7,9,3,10,10,8,9,9,10,10,8,9,9,8,9,14,6,11,12,13,14,15,5,8,15,14,20,7,3,9,5,4,9,9,17,11,8,12,11,11,7,6,AM C,1,1,15,20,10,13,1,1,1,1,7,1,1,1,1
19266708,Brenner,1651,04/01/1996,20,0,0,0,0,175,74,3,2,3,1,2,3,4,2,3,3,2,9,12,8,6,11,6,6,5,1,5,6,5,8,10,9,4,8,6,3,6,13,6,10,7,7,3,7,8,13,12,12,6,20,16,13,9,8,7,9,9,6,3,13,11,12,10,11,13,8,16,7,D/WB/M/AM L,1,1,7,1,17,1,1,16,9,1,1,18,1,20,6
19266709,Juninho,1651,16/03/1995,21,0,0,0,0,175,66,1,3,3,1,1,1,2,1,2,3,1,11,11,11,11,11,10,7,11,4,6,12,6,6,12,10,8,7,10,11,11,16,20,9,8,12,11,11,12,14,14,15,7,20,10,14,7,10,6,10,11,8,10,10,10,12,11,12,10,1,14,1,AM LC,1,1,15,20,17,13,1,1,1,1,1,1,1,1,1
19266710,André Krobel,1651,28/03/1995,21,0,0,0,0,173,0,3,1,2,2,3,2,1,2,2,1,3,7,5,8,6,14,4,9,6,4,9,10,4,13,10,9,11,9,10,10,9,14,6,2,1,8,7,10,10,14,14,10,4,2,14,15,20,12,6,9,9,9,9,9,15,9,11,11,10,1,4,7,D/WB R,1,1,1,1,1,1,1,1,20,1,1,1,1,1,17
19266735,Lucca,1651,20/02/1998,18,0,0,0,0,175,64,3,1,2,3,2,1,1,4,2,3,1,2,5,7,7,11,3,5,5,5,6,14,1,6,12,6,5,1,4,5,10,9,1,11,1,8,7,6,8,8,12,6,7,20,9,13,8,7,6,7,7,7,7,7,8,10,9,12,11,10,13,8,AM C,1,1,1,20,1,1,1,1,1,1,15,1,1,1,1
19266736,Gabriel Vinicius,1651,28/12/1997,18,0,0,0,0,168,0,3,2,2,3,3,3,1,2,1,2,2,6,6,5,6,11,6,6,9,4,7,13,1,12,9,3,8,2,5,5,11,13,8,8,5,6,10,4,8,8,11,7,4,8,9,10,20,4,7,8,8,8,8,8,20,9,10,9,11,5,15,3,DM ,1,1,1,1,1,1,1,1,1,20,10,1,1,1,1
19266810,Luiz Felipe,1651,24/02/1997,19,0,0,0,0,189,0,12,8,7,6,12,9,7,12,5,8,7,3,3,2,3,1,7,1,1,3,2,1,2,1,1,5,5,14,2,11,4,12,8,3,2,3,11,5,3,11,4,5,9,8,11,11,20,1,8,7,8,5,5,8,20,12,11,12,12,7,13,6,GK ,20,1,1,1,1,1,1,1,1,1,1,1,1,1,1
19266811,Pereira,1651,31/01/1997,19,0,0,0,0,184,0,3,3,2,3,3,3,1,1,3,3,1,4,4,5,1,7,1,11,1,2,12,6,1,13,3,8,6,8,2,6,3,11,1,1,6,3,12,5,6,10,9,6,11,7,11,9,20,8,9,8,8,8,8,8,13,10,12,11,11,4,13,4,D RC,1,1,1,1,1,1,20,1,15,1,1,1,1,1,11
19266812,Gianluca,1651,17/03/1997,19,0,0,0,0,189,0,11,7,8,6,13,7,8,13,4,5,9,4,1,2,2,1,8,1,1,2,3,1,2,3,4,8,8,15,5,6,5,13,8,2,12,3,4,6,4,12,6,6,14,20,15,10,9,1,9,8,6,8,8,8,14,10,10,10,12,1,16,8,GK ,20,1,1,1,1,1,1,1,1,1,1,1,1,1,1
19266813,Laison,1651,28/04/1997,19,0,0,0,0,183,0,1,1,1,3,1,2,3,2,3,3,2,2,4,2,3,11,4,4,12,1,5,8,2,10,12,8,9,6,4,2,5,11,4,8,9,4,11,5,7,12,11,5,10,16,9,12,20,7,8,8,8,3,5,8,7,8,11,11,14,11,9,7,DM ,1,1,1,1,1,1,1,1,1,20,10,1,1,1,1
19266815,Vitor Gabriel,1651,07/09/1997,18,0,0,0,0,181,0,2,3,3,4,1,2,2,3,3,4,4,4,2,12,12,10,3,12,4,1,4,5,4,1,8,6,6,1,5,5,1,11,1,9,1,8,3,4,6,12,12,4,5,3,9,12,20,11,7,8,5,2,8,8,17,11,11,10,14,2,8,1,S ,1,1,20,1,1,1,1,1,1,1,1,1,1,1,1
19266816,Lucas Costa,1651,29/03/1995,21,0,0,0,0,180,74,3,2,1,1,3,3,3,3,2,2,3,5,6,11,13,13,5,13,7,1,5,6,3,1,10,8,9,4,6,5,5,9,3,10,1,6,6,5,7,13,13,6,9,8,8,13,20,4,8,8,5,3,8,8,17,10,11,14,12,3,11,7,S C,1,1,20,15,1,1,1,1,1,1,1,1,1,1,1
19266817,Matheus Henrique,1651,13/03/1996,20,0,0,0,0,187,0,1,1,2,1,3,1,1,2,1,2,2,3,6,13,9,13,5,13,6,2,4,5,3,1,10,8,7,7,5,5,5,8,7,10,7,13,1,5,6,13,9,2,12,14,12,12,20,6,8,8,8,2,4,8,16,9,11,11,10,9,7,7,S ,1,1,20,1,1,1,1,1,1,1,1,1,1,1,1
19266818,Igor Paim,1651,05/11/1997,18,0,0,0,0,170,67,2,2,3,1,1,4,3,3,3,1,3,5,5,13,11,11,5,6,7,4,5,9,3,6,13,8,11,7,3,4,8,10,1,13,10,9,6,6,7,13,12,2,4,9,6,13,20,5,5,8,8,8,8,8,9,10,10,9,11,8,4,2,AM C,1,1,12,20,1,1,1,1,1,1,7,1,1,1,1
19266891,Maurício,1651,09/10/1996,19,0,0,0,0,183,0,1,2,2,1,1,2,2,3,4,2,1,4,1,3,1,4,2,12,1,4,13,6,1,11,5,8,9,8,4,7,1,13,7,6,10,4,13,5,6,13,10,6,8,8,8,9,20,8,8,8,8,4,8,8,12,12,10,11,9,9,16,2,D C,1,1,1,1,1,1,20,1,1,1,1,1,1,1,1
19266892,Beto,1651,30/05/1995,21,0,0,0,0,168,0,2,1,1,1,2,2,2,3,1,1,1,2,5,10,11,12,5,3,7,2,5,12,2,5,11,8,7,7,5,6,11,9,8,11,7,8,4,6,7,13,12,7,1,12,10,12,20,12,4,8,8,5,6,8,20,10,11,13,13,12,10,6,AM C,1,1,15,20,1,1,1,1,1,1,12,1,1,1,1
19267111,Giovanny,1651,19/09/1997,18,0,0,0,0,175,69,2,3,3,3,3,1,2,2,3,1,3,10,9,15,12,12,10,10,12,10,9,13,11,10,14,11,11,11,10,11,11,10,10,12,10,14,11,9,10,9,12,11,10,10,13,12,20,14,12,13,12,10,10,13,9,10,8,11,11,12,1,5,AM/S RLC,1,1,20,17,17,15,1,1,1,1,1,1,1,1,1
19267149,Evandro,1651,14/01/1997,19,0,0,0,0,174,71,3,1,1,2,3,1,1,4,1,1,3,7,8,12,13,12,9,13,11,10,7,10,13,6,13,12,12,11,13,11,10,12,12,13,9,13,5,10,12,14,12,10,5,14,13,13,20,13,13,12,9,11,6,11,13,13,12,14,12,10,11,7,S ,1,1,20,1,1,14,1,1,1,1,1,1,1,1,1
19267279,Arthur Bonaldo,1651,18/06/1996,20,0,0,0,0,181,73,2,2,3,3,1,3,2,2,1,3,3,7,7,4,6,13,7,5,13,1,12,13,5,8,10,10,5,8,8,5,12,13,4,6,8,11,5,8,10,9,9,7,5,19,13,8,20,9,8,10,10,1,9,10,13,9,10,10,12,1,1,4,M C,1,1,1,1,1,1,1,1,1,1,20,1,1,1,1
19267308,Sabão,1651,18/08/1991,24,0,0,0,0,171,72,3,3,3,3,1,2,1,2,3,1,2,5,9,14,14,14,7,13,8,2,5,9,8,1,13,9,9,6,7,6,8,9,5,12,10,9,6,7,9,14,14,8,5,10,9,14,20,6,4,8,7,9,9,9,10,12,10,7,11,2,9,7,AM/S L,1,1,20,1,17,1,1,1,1,1,1,1,1,1,1
19267358,Jean Carlos,1651,16/06/1993,23,0,0,0,0,178,71,1,1,3,2,4,3,2,1,2,1,2,7,12,13,12,11,4,7,8,4,5,4,13,5,11,10,11,12,11,11,10,10,12,7,9,11,11,12,11,13,12,11,7,8,12,13,20,12,9,10,8,9,7,12,11,12,10,11,12,11,10,9,AM/S R,1,1,20,1,10,18,1,1,1,1,1,1,1,1,1
19267399,Thiago Santos,1651,02/08/1990,25,0,0,0,0,184,82,1,1,1,3,3,2,3,2,2,1,1,8,7,10,11,13,8,12,9,6,7,7,8,5,10,10,9,9,11,8,7,12,10,10,1,11,7,8,9,13,11,14,14,11,13,12,20,14,14,10,4,10,9,10,11,13,13,9,12,1,4,7,S ,1,1,20,1,1,1,1,1,1,1,1,1,1,1,1
19268335,Nunes,1651,23/09/1990,25,0,0,0,0,194,81,13,6,9,4,13,9,5,13,7,9,8,2,3,2,1,2,4,1,3,1,2,2,1,2,6,9,8,11,5,9,6,10,5,1,11,2,12,7,6,13,10,7,16,10,8,9,20,4,11,9,7,8,9,9,7,11,10,12,10,5,2,1,GK ,20,1,1,1,1,1,1,1,1,1,1,1,1,1,1
19268864,Diego,1651,26/02/1996,20,0,0,0,0,175,68,2,1,1,3,2,1,3,3,3,2,3,4,14,14,11,12,5,11,11,13,13,14,10,11,13,10,13,13,13,13,13,12,10,13,8,13,13,11,12,15,15,12,10,6,13,14,20,14,13,12,5,12,5,12,20,13,9,10,11,6,9,6,D/WB R,1,1,1,1,1,1,1,1,20,1,1,1,1,1,19
19269649,Maxwell,1651,11/02/1995,21,0,0,0,0,178,68,2,2,2,2,1,3,3,1,2,1,1,6,11,13,12,10,6,7,14,6,5,10,8,4,12,8,10,12,11,11,11,10,12,11,9,11,10,12,12,14,12,11,10,11,12,13,20,13,11,11,8,10,7,11,10,12,10,11,12,12,9,9,AM/S L,1,1,18,1,20,1,1,1,1,1,1,1,1,1,1
19269920,Elias,1651,12/07/1995,20,0,0,0,0,186,74,8,10,11,5,14,14,14,14,8,14,12,5,1,1,1,1,9,1,1,1,3,3,2,1,1,7,8,15,8,9,1,14,10,2,7,2,11,9,8,13,16,9,13,11,13,10,20,4,9,10,10,10,7,10,15,10,11,10,13,12,3,4,GK ,20,1,1,1,1,1,1,1,1,1,1,1,1,1,1
19269921,Klaus,1651,11/01/1994,22,0,0,0,0,187,79,2,1,3,2,1,3,2,3,3,1,1,9,6,4,7,10,5,15,4,1,14,10,6,14,9,15,13,11,4,8,8,14,8,1,12,9,14,9,10,14,14,10,14,9,7,14,20,10,9,11,7,11,9,11,15,11,12,9,12,2,12,7,D C,1,10,1,1,1,1,20,1,1,1,1,1,1,1,1
19269922,Matheus Sehbe,1651,08/10/1993,22,0,0,0,0,180,80,2,2,3,2,1,2,3,4,1,1,2,7,5,14,14,13,5,13,8,2,6,3,4,2,9,6,10,4,6,6,5,12,9,8,12,12,7,7,8,14,14,8,9,8,15,14,20,7,7,9,8,4,8,9,19,11,10,10,13,8,10,5,S ,1,1,20,1,1,1,1,1,1,1,1,1,1,1,1
19270227,Matheus Thuller,1651,10/03/1999,17,0,0,0,0,184,0,3,4,3,1,1,2,2,1,3,2,3,1,1,7,5,6,5,11,6,1,11,11,1,13,7,12,12,9,6,6,6,11,12,3,13,5,12,6,10,12,12,7,11,9,16,11,20,6,8,9,9,12,9,9,16,10,12,12,11,9,13,5,D C,1,14,1,1,1,1,20,1,1,11,1,1,1,1,1
19270228,Hugo,1651,03/01/1998,18,0,0,0,0,166,0,2,1,3,1,3,2,1,1,1,3,1,8,8,9,7,15,8,8,15,3,12,12,4,11,11,9,9,8,8,5,12,14,17,9,11,7,8,12,14,12,7,5,6,9,11,8,20,13,8,8,6,9,9,9,11,11,9,13,10,10,15,4,M C,1,1,1,1,1,1,1,1,1,15,20,1,1,1,1
19270229,Patrick Lopes,1651,09/03/1998,18,0,0,0,0,177,0,2,3,1,3,2,3,3,3,1,1,3,8,9,12,10,13,12,7,11,6,4,11,5,7,11,11,9,8,9,4,11,6,9,13,4,7,5,7,8,12,11,8,6,20,10,12,10,9,5,8,9,9,9,8,20,11,9,12,15,5,9,7,AM R,1,1,15,11,14,20,1,1,1,1,1,1,1,1,1
19270230,Iacovelli,1651,13/03/1998,18,0,0,0,0,179,79,1,3,3,3,2,1,2,1,4,2,2,8,7,9,11,10,7,11,10,6,5,10,11,5,11,9,12,12,13,7,9,9,9,11,6,11,7,8,8,11,11,8,10,10,13,11,20,13,12,9,6,9,9,8,10,10,11,11,11,10,13,3,S ,1,1,20,1,1,1,1,1,1,1,1,1,1,1,1
19270232,Hugo Souza,1651,31/01/1999,17,0,0,0,0,182,0,4,8,9,1,11,11,8,11,6,6,9,3,2,1,2,2,8,1,3,2,2,1,3,2,2,8,8,13,5,8,5,13,5,1,8,2,11,6,5,10,12,5,11,8,11,13,20,1,6,8,8,11,8,8,20,9,12,10,10,9,10,2,GK ,20,1,1,1,1,1,1,1,1,1,1,1,1,1,1
19270234,Théo,1651,29/01/1998,18,0,0,0,0,170,0,4,1,2,3,1,1,2,3,3,1,2,6,7,4,9,14,6,8,10,1,12,9,6,11,10,12,10,9,10,10,15,8,5,2,9,8,12,11,11,11,15,9,3,20,12,15,1,13,9,9,11,9,9,9,8,11,9,10,11,6,13,6,DM ,1,1,1,1,1,1,1,1,1,20,12,1,1,1,1
19270235,Lucas Abreu,1651,09/07/1998,17,0,0,0,0,195,0,1,1,1,3,1,1,2,3,2,1,2,7,5,12,12,14,7,5,13,4,7,12,3,7,14,5,6,8,6,8,13,14,8,11,11,6,6,8,10,11,12,8,15,20,13,12,10,6,11,9,9,1,9,9,9,11,12,12,12,11,4,8,AM C,1,1,1,20,1,1,1,1,1,1,14,1,1,1,1
19270236,Lucas,1651,30/01/1998,18,0,0,0,0,176,0,3,1,3,1,2,3,3,2,1,1,1,8,13,11,11,13,6,6,3,6,4,7,3,7,10,7,9,2,5,8,10,6,4,12,2,7,4,7,10,13,11,8,8,10,12,12,20,8,6,9,7,9,9,9,18,11,11,10,11,13,13,1,AM RL,1,1,12,11,20,16,1,1,1,1,1,1,1,1,1
19270237,Michael,1651,27/05/1999,17,0,0,0,0,175,0,4,1,2,2,2,3,3,1,3,2,3,8,12,12,8,12,6,7,5,3,7,12,5,7,11,5,4,8,8,5,11,13,8,12,9,5,9,7,8,12,12,7,5,20,10,12,8,7,6,6,8,8,7,8,11,12,11,11,12,8,5,3,D L,1,1,1,1,1,1,1,20,1,1,1,11,1,14,1
19270238,Alan Carius,1651,04/04/1997,19,0,0,0,0,175,74,3,1,1,2,1,1,1,1,3,3,1,11,13,11,10,11,7,13,8,1,6,8,1,3,11,6,7,8,8,7,7,12,2,9,4,11,6,7,5,11,10,11,5,20,11,8,17,7,4,9,7,9,9,9,14,10,12,13,11,5,3,4,S L,1,1,20,13,15,13,1,1,1,1,1,1,1,1,1
19270243,Filipe,1651,31/01/1998,18,0,0,0,0,193,0,6,8,8,4,11,11,12,13,9,4,13,5,2,3,1,1,7,1,1,1,1,1,3,2,2,9,8,12,11,8,6,12,17,2,3,2,8,7,6,12,15,8,15,8,9,10,20,3,10,12,6,3,5,9,11,11,11,9,14,2,14,6,GK ,20,1,1,1,1,1,1,1,1,1,1,1,1,1,1
19270244,Samuel,1651,19/01/1998,18,0,0,0,0,184,0,3,2,2,3,3,2,1,1,1,3,2,5,11,10,1,10,1,6,6,1,10,10,1,13,8,6,10,9,4,5,5,11,16,12,8,6,9,6,7,12,12,7,10,15,11,12,20,12,9,9,6,11,9,9,18,11,9,10,11,9,4,1,D R,1,1,1,1,1,1,1,1,20,8,1,1,1,1,14
19270245,Pedrinho,1651,13/04/1998,18,0,0,0,0,163,0,2,2,3,2,3,2,3,1,3,1,2,9,11,12,10,12,9,7,9,9,8,11,6,11,11,11,9,12,11,11,11,11,13,13,6,11,9,13,12,11,13,7,4,20,13,12,11,10,7,12,5,10,9,9,9,11,11,12,11,6,8,4,AM C,1,1,1,20,1,1,1,1,1,1,15,14,1,1,1
19270246,Renan Guedes,1651,19/01/1998,18,0,0,0,0,159,0,3,1,1,1,3,3,2,1,2,2,3,6,8,11,11,13,4,7,9,6,7,11,5,6,11,9,11,6,5,8,11,10,11,9,8,7,4,7,8,11,12,8,1,10,13,12,20,11,8,9,5,8,9,9,9,12,14,10,11,4,1,5,AM RLC,1,1,1,16,15,20,1,1,11,1,12,1,1,1,1
19270247,Rafael Bilu,1651,21/04/1999,17,0,0,0,0,177,0,3,1,1,2,1,2,1,3,3,1,1,12,14,12,12,12,9,8,9,6,5,9,1,8,12,12,6,5,6,8,6,7,7,13,6,9,6,8,9,12,13,9,8,11,11,13,20,8,11,9,8,11,9,9,7,10,10,10,14,1,16,3,AM R,1,1,13,14,14,20,1,1,1,1,1,1,1,1,1
19270248,Dawhan,1651,03/06/1996,20,0,0,0,0,177,69,2,2,1,1,1,1,1,2,2,1,3,9,9,8,10,15,9,6,11,2,12,10,4,12,11,12,13,10,11,11,14,13,7,6,4,7,14,5,10,15,12,12,13,1,12,15,20,12,9,7,5,3,10,10,7,11,11,11,13,13,10,4,DM ,1,1,1,1,1,1,1,1,1,20,12,1,1,1,1
19270249,Arlindo,1651,29/12/1996,19,0,0,0,0,175,0,2,1,3,2,1,1,1,2,3,1,1,5,4,9,11,13,5,12,10,1,2,9,11,2,10,10,10,9,8,1,3,10,8,8,5,11,6,5,6,11,10,12,7,8,8,9,20,8,11,8,4,7,8,7,10,10,14,10,10,10,11,8,S ,1,1,20,1,1,1,1,1,1,1,1,1,1,1,1
19270251,Carlinhos,1651,12/02/1997,19,0,0,0,0,195,80,3,1,1,1,3,2,2,2,1,1,1,7,5,12,12,13,8,13,9,4,5,10,4,7,11,6,12,6,8,9,11,9,11,12,6,14,8,8,10,13,12,14,13,11,8,12,20,11,13,10,7,4,7,10,20,11,11,11,13,9,12,4,S ,1,1,20,1,12,11,1,1,1,1,1,1,1,1,1
19270252,Roni,1651,15/04/1999,17,0,0,0,0,188,0,2,3,2,3,1,3,3,2,1,2,3,6,3,9,9,11,6,6,13,5,10,11,1,11,10,7,12,8,3,6,9,13,9,9,4,6,11,7,11,13,13,4,11,10,9,13,20,7,8,8,3,8,7,9,15,9,12,11,10,7,14,2,DM ,1,1,1,1,1,1,1,1,1,20,14,1,1,1,1
19270253,Antonio Guilherme,1651,20/03/1999,17,0,0,0,0,180,0,2,2,1,4,1,4,1,2,1,3,4,5,6,1,4,8,1,11,2,6,14,6,4,14,3,9,7,9,5,8,7,14,7,1,5,6,12,7,8,12,11,8,10,9,6,9,20,5,6,9,8,3,4,9,16,11,10,13,9,1,7,3,D C,1,1,1,1,1,1,20,1,1,1,1,1,1,1,1
19270256,Bruno Ré,1651,06/12/1989,26,0,0,0,0,182,75,3,2,2,3,2,3,1,2,1,3,2,8,4,8,1,14,3,7,7,8,9,8,3,14,9,8,8,10,10,10,7,14,10,3,13,6,10,10,10,13,12,10,11,20,10,14,10,14,7,10,10,10,9,10,10,9,12,12,12,3,9,7,D/WB L,1,1,1,1,1,1,1,20,1,1,1,1,1,19,1
19270268,Willian Silva,1651,31/01/1994,22,0,0,0,0,177,66,3,1,2,1,3,1,4,1,2,3,2,5,5,8,14,14,7,14,8,7,5,8,7,5,14,7,7,8,7,3,6,8,2,13,1,14,8,7,7,14,14,12,8,8,10,14,20,11,7,9,6,9,6,9,15,12,10,12,10,4,3,5,S ,1,1,20,1,1,1,1,1,1,1,1,1,1,1,1
19270301,Pablo,1651,18/01/1993,23,0,0,0,0,197,101,13,11,6,1,12,13,11,13,9,9,7,2,2,3,3,2,5,1,3,3,1,1,1,1,1,6,11,12,6,10,6,13,3,2,11,1,6,2,6,10,6,7,12,9,4,8,20,5,11,9,9,9,9,9,10,11,11,10,8,9,3,2,GK ,20,1,1,1,1,1,1,1,1,1,1,1,1,1,1
19270320,Duda,1651,19/04/1994,22,0,0,0,0,181,0,1,3,3,2,3,3,1,1,1,2,3,7,9,8,8,7,4,9,4,5,9,10,4,14,6,10,11,5,11,12,10,11,9,4,5,9,8,11,11,15,15,11,10,9,4,15,20,11,8,10,10,10,10,10,17,11,11,9,11,7,6,7,D/WB R,1,1,1,1,1,1,1,1,20,1,1,1,7,1,17
19270321,Guilherme,1651,08/07/1994,21,0,0,0,0,170,65,4,4,3,2,1,3,1,3,1,4,2,7,6,6,7,14,7,7,10,3,7,14,1,8,11,9,8,1,7,8,9,14,9,9,1,5,9,8,11,13,10,8,2,8,10,12,20,7,7,9,4,9,9,9,18,11,10,11,10,6,12,1,M C,1,1,1,10,1,1,1,1,1,1,20,1,1,1,1
19270322,Prezzi,1651,14/01/1996,20,0,0,0,0,187,86,13,8,8,9,10,13,6,13,6,9,11,4,2,3,1,4,6,1,3,3,2,1,1,2,1,6,8,10,6,8,6,13,4,2,1,3,9,7,6,11,7,6,11,9,13,12,20,1,9,9,9,9,9,9,17,11,12,13,12,13,12,8,GK ,20,1,1,1,1,1,1,1,1,1,1,1,1,1,1
19270323,Ribeiro,1651,01/04/1997,19,0,0,0,0,174,67,3,2,1,2,2,1,1,3,1,3,2,9,14,6,7,10,7,7,6,6,9,9,6,14,8,9,7,9,9,6,6,8,4,9,10,6,4,9,6,13,14,13,7,20,12,14,9,8,6,9,6,9,9,9,18,10,10,10,12,11,12,7,D/M R,1,1,1,1,1,1,1,1,20,1,7,1,17,1,7
19270324,Sananduva,1651,25/02/1996,20,0,0,0,0,177,69,1,2,1,2,1,2,3,1,3,2,3,6,4,5,7,13,6,4,13,1,10,13,1,13,11,9,9,8,4,8,9,13,4,7,1,3,7,7,10,13,11,11,7,11,16,13,20,9,6,9,9,9,6,9,13,13,11,10,13,1,12,6,DM ,1,1,1,1,1,1,1,1,1,20,7,1,1,1,1
19270325,Jeferson,1651,26/06/1996,20,0,0,0,0,184,76,1,1,1,3,1,2,1,1,1,3,1,6,4,13,13,12,6,13,6,5,5,7,6,1,11,7,7,8,5,7,7,10,2,11,1,9,6,6,7,13,13,7,11,10,9,13,20,6,9,9,5,2,5,9,15,10,8,10,12,9,5,7,S ,1,1,20,1,1,1,1,1,1,1,1,1,1,1,1
19270326,Kayron,1651,03/04/1995,21,0,0,0,0,185,0,1,3,3,3,2,2,3,1,3,3,1,5,2,13,8,13,5,13,6,5,5,6,2,2,9,8,8,4,7,6,5,10,1,9,1,7,5,5,6,12,8,3,10,8,15,10,20,11,9,8,8,5,8,8,8,11,12,12,9,11,6,3,S ,1,1,20,7,1,1,1,1,1,1,1,1,1,1,1
19270430,Mateus,1651,03/08/1994,21,0,0,0,0,194,0,9,8,10,3,11,12,12,15,9,9,12,5,2,2,3,5,9,1,2,2,2,1,1,3,6,9,10,12,9,11,8,15,4,2,5,3,7,9,7,8,13,9,14,11,4,13,20,3,11,9,9,9,9,9,11,11,13,10,11,4,7,4,GK ,20,1,1,1,1,1,1,1,1,1,1,1,1,1,1
19270431,Léo Carioca,1651,06/01/1986,30,0,0,0,0,193,89,1,2,3,1,1,1,3,2,3,4,1,5,6,7,5,5,2,8,3,7,11,6,4,13,8,7,8,9,8,10,7,12,3,8,9,7,14,8,8,14,10,8,12,20,8,11,10,9,10,9,9,9,5,9,10,10,12,10,10,3,10,4,D/WB LC,1,1,1,1,1,1,20,19,1,1,1,1,1,18,1
19270432,Dener,1651,14/09/1991,24,0,0,0,0,185,79,1,2,1,3,3,1,3,2,1,2,3,5,5,6,5,8,2,13,6,2,11,8,4,9,7,9,8,9,7,9,4,13,6,6,7,6,13,6,8,13,13,7,12,10,11,13,20,9,10,9,9,3,9,9,10,11,10,10,12,5,5,4,D/DM C,1,1,1,1,1,1,20,1,1,18,10,1,1,1,1
19270436,Wellinton Pimenta,1651,29/10/1986,29,0,0,0,0,176,0,1,3,3,1,3,2,2,3,3,2,3,6,6,13,13,13,5,14,3,1,7,8,10,2,12,4,9,9,9,4,5,12,10,11,10,13,8,8,8,13,13,8,8,9,14,14,20,6,6,9,10,1,10,10,15,12,14,11,12,1,11,8,S ,1,1,20,1,1,1,1,1,1,1,1,1,1,1,1
19270439,Felipe,1651,03/04/1992,24,0,0,0,0,193,90,3,1,2,3,3,1,3,2,3,3,3,7,3,12,14,14,7,14,6,5,4,8,4,1,12,8,8,4,9,5,5,11,9,11,4,14,6,7,4,14,12,8,13,9,12,13,20,6,10,9,3,9,7,9,16,11,13,11,10,7,7,2,S ,1,1,20,1,1,1,1,1,1,1,1,1,1,1,1
19270484,Diego,1651,28/07/1998,17,0,0,0,0,180,0,14,10,9,3,12,14,11,12,4,9,11,3,2,3,1,4,6,1,1,3,1,1,3,2,4,9,6,11,7,9,7,14,13,2,1,3,7,4,5,7,10,6,12,8,10,11,20,1,7,8,7,7,9,8,9,11,10,11,11,2,10,8,GK ,20,1,1,1,1,1,1,1,1,1,1,1,1,1,1
19270485,Lucas César,1651,04/05/1998,18,0,0,0,0,177,0,1,2,1,2,1,1,1,2,1,1,3,6,5,6,5,8,4,9,2,7,12,8,3,13,8,6,10,9,7,9,6,14,9,4,6,5,10,12,12,7,9,9,9,9,7,11,20,12,7,9,9,9,8,9,15,10,13,12,13,11,19,7,D R,1,1,1,1,1,1,12,1,20,1,1,1,1,1,11
19270487,Wenderson,1651,07/06/1998,18,0,0,0,0,175,70,1,4,3,4,3,1,3,2,1,1,2,4,7,11,11,13,6,7,8,6,6,13,1,8,9,4,5,8,7,3,13,9,8,12,10,10,6,7,8,11,12,7,3,20,11,8,16,13,8,9,9,9,9,9,15,12,12,10,9,4,11,3,AM C,1,1,11,20,13,1,1,1,1,1,12,1,1,1,1
19270488,Mateus,1651,30/01/1998,18,0,0,0,0,161,0,3,2,3,3,3,3,1,1,3,1,1,11,13,12,10,14,9,8,7,7,4,8,2,7,11,7,5,8,7,6,8,12,14,12,3,9,6,8,9,14,14,8,1,20,11,14,9,7,7,9,7,9,9,9,13,13,12,10,14,1,15,2,AM RL,1,1,13,13,20,17,1,1,1,1,1,1,1,1,1
19270489,Rickson,1651,04/03/1998,18,0,0,0,0,167,0,2,3,2,1,3,3,3,1,4,3,2,7,7,3,6,13,7,7,13,2,11,12,4,14,14,9,5,7,7,6,11,6,9,9,10,4,7,8,13,12,8,8,4,9,15,9,20,12,7,9,9,9,6,9,18,12,11,13,8,1,9,1,M C,1,1,1,1,1,1,1,1,1,13,20,1,1,1,1
19270490,Gabriel Arruda,1651,18/04/1996,20,0,0,0,0,169,0,3,2,3,4,3,4,1,2,3,1,2,6,6,6,9,12,8,6,11,1,12,10,6,11,8,9,8,4,9,10,15,11,4,3,13,8,11,9,12,15,13,7,3,9,11,13,20,12,7,9,9,9,4,9,19,14,10,10,9,12,14,3,M C,1,1,1,1,1,1,1,1,1,14,20,1,1,1,1
19270492,Antônio Carlos,1651,17/05/1998,18,0,0,0,0,186,0,1,3,2,3,1,2,1,3,2,2,1,7,7,11,11,14,7,14,8,2,4,8,3,2,14,9,10,8,11,3,6,8,1,14,11,14,8,7,5,14,12,8,14,4,12,14,20,6,8,9,9,9,9,7,7,12,10,9,12,1,7,7,S ,1,1,20,1,1,1,1,1,1,1,1,1,1,1,1
19270493,Gleison,1651,18/03/1997,19,0,0,0,0,189,0,2,1,2,3,1,1,1,3,3,3,3,5,1,1,1,5,2,13,3,2,12,6,2,13,1,7,7,9,5,8,1,13,6,4,9,4,13,6,6,10,12,7,9,20,9,13,10,8,10,9,6,9,6,9,8,12,12,10,11,7,6,6,D C,1,1,1,1,1,1,20,1,1,1,1,1,1,1,1
19270494,Matheus Lu,1651,15/12/1997,18,0,0,0,0,175,0,2,3,3,2,3,4,1,2,1,3,2,8,11,10,12,13,6,8,6,1,4,8,5,4,10,9,7,7,10,4,4,9,8,10,1,7,4,4,8,13,13,7,7,11,13,13,20,9,6,7,7,9,8,9,11,10,12,13,8,6,11,5,AM/S RL,1,1,20,14,16,16,1,1,1,1,1,1,1,1,1
19270752,Juliano,1651,12/09/1996,19,0,0,0,0,183,73,1,3,3,3,1,2,2,1,2,1,1,7,5,9,9,13,5,5,14,1,5,14,7,7,9,9,7,5,12,8,10,14,7,8,2,10,7,9,12,14,11,4,8,10,9,13,20,8,10,8,9,9,9,9,17,12,10,11,9,5,1,5,M/AM C,1,1,1,20,1,1,1,1,1,1,17,1,1,1,1
19270753,Jair,1651,03/08/1994,21,0,0,0,0,174,65,2,3,4,2,3,2,4,2,3,4,1,11,9,10,6,10,13,10,9,9,10,12,12,11,11,11,12,12,12,10,10,11,14,12,7,9,11,11,12,10,12,12,6,8,12,10,20,12,11,14,17,10,10,10,15,12,12,11,11,10,5,13,DM/M C,1,1,1,1,1,1,1,1,1,20,17,1,1,1,1
19270755,João Pedro,1651,17/03/1996,20,0,0,0,0,177,0,1,1,2,2,1,3,2,2,2,2,2,6,6,13,11,10,5,11,7,6,4,8,6,4,13,7,11,5,8,3,4,9,9,13,10,9,7,6,8,13,9,8,3,16,16,11,20,9,6,9,4,9,9,9,8,10,10,9,10,10,12,4,AM/S C,1,1,20,17,1,1,1,1,1,1,1,1,1,1,1
19270756,Rodrigo Festuccia,1651,13/06/1995,21,0,0,0,0,189,0,13,13,10,1,13,12,8,13,9,6,10,2,2,1,2,2,3,1,3,2,2,1,1,1,5,9,4,12,6,7,6,13,3,2,2,1,11,7,6,10,6,7,8,8,15,13,20,4,11,9,3,9,9,9,16,10,12,13,10,9,12,3,GK ,20,1,1,1,1,1,1,1,1,1,1,1,1,1,1
19270758,Guilherme,1651,04/07/1997,18,0,0,0,0,189,0,11,7,11,1,14,7,7,8,8,5,4,3,1,2,3,1,4,1,1,2,3,3,1,1,2,8,4,13,4,6,6,13,5,2,10,3,13,7,5,14,8,7,11,6,15,13,20,1,10,7,8,8,8,8,19,9,12,11,9,5,7,1,GK ,20,1,1,1,1,1,1,1,1,1,1,1,1,1,1
19270759,Jamilson,1651,05/04/1996,20,0,0,0,0,192,0,13,13,8,4,12,9,8,11,8,9,9,7,1,1,3,1,9,1,2,3,3,1,2,1,1,9,7,10,7,7,6,13,3,2,4,1,11,7,6,13,13,6,12,5,13,11,20,3,11,9,7,7,6,8,17,12,8,12,12,12,1,2,GK ,20,1,1,1,1,1,1,1,1,1,1,1,1,1,1
19270760,Gilberto,1651,28/06/1993,23,0,0,0,0,179,73,2,3,3,1,1,1,1,1,4,3,3,11,9,13,7,11,8,6,10,6,6,11,10,7,15,12,11,8,9,6,8,7,14,16,10,12,5,8,9,13,10,7,9,20,14,12,13,12,8,8,14,12,6,13,15,12,11,12,10,7,9,13,AM/S RL,1,1,16,10,16,20,1,1,1,1,1,1,1,1,1
19270761,Gabriel Balduino,1651,10/12/1997,18,0,0,0,0,193,0,13,6,9,1,9,12,6,13,8,8,3,2,2,1,3,2,3,1,1,1,1,2,1,3,1,8,8,13,6,5,5,13,5,3,5,3,9,6,4,6,11,6,15,12,8,10,20,1,9,8,8,8,8,8,8,9,12,11,11,7,9,7,GK ,20,1,1,1,1,1,1,1,1,1,1,1,1,1,1
19270762,Fagner,1651,24/01/1997,19,0,0,0,0,175,0,3,3,1,4,3,1,2,3,1,1,2,6,6,13,13,13,6,11,7,1,4,10,9,5,11,9,6,8,12,6,10,13,5,11,8,7,5,7,8,13,13,8,3,1,12,13,20,4,6,9,7,6,9,9,10,11,10,12,10,2,2,8,AM/S C,1,1,17,20,1,1,1,1,1,1,1,1,1,1,1
19270763,Felipe,1651,01/07/1997,19,0,0,0,0,175,0,1,3,4,1,1,2,4,1,1,2,1,6,4,5,8,12,6,1,7,4,5,13,4,8,13,9,7,8,4,7,13,13,9,13,2,7,8,8,7,13,13,8,8,8,6,13,20,6,5,8,9,3,6,9,20,11,11,10,12,5,11,3,M/AM C,1,1,1,17,1,1,1,1,1,1,20,1,1,1,1
19270764,Fellipe,1651,25/08/1997,18,0,0,0,0,190,0,1,1,4,1,2,3,2,3,3,1,2,6,2,3,1,8,3,14,3,5,8,8,4,14,6,6,8,9,6,7,1,14,3,4,9,6,13,7,8,8,10,8,14,6,14,11,20,9,11,9,6,4,9,9,15,9,10,10,10,1,9,5,D C,1,1,1,1,1,1,20,1,1,1,1,1,1,1,1
19270765,Breno,1651,13/06/1996,20,0,0,0,0,172,0,4,1,3,2,1,2,3,2,1,1,3,6,4,8,4,13,6,4,12,4,4,13,1,7,12,8,9,8,7,5,8,13,3,12,9,12,8,8,10,13,13,4,2,9,11,13,20,13,4,9,9,7,9,9,19,12,10,11,12,8,7,1,M/AM C,1,1,1,20,1,1,1,1,1,1,17,1,1,1,1
19270774,Diego Pituca,1651,15/08/1992,23,0,0,0,0,175,69,2,1,2,3,2,2,2,1,2,2,3,8,7,9,9,14,8,8,9,2,12,14,4,14,12,9,10,9,10,10,13,14,10,3,13,10,10,10,13,13,10,10,4,9,10,9,20,9,7,10,10,10,10,10,20,11,12,11,9,1,14,5,DM/M C,1,1,1,1,1,1,1,1,1,17,20,1,1,1,1
19270775,José,1651,19/03/1997,19,0,0,0,0,173,0,2,2,3,2,1,2,2,1,1,4,1,1,6,8,8,13,4,6,13,2,3,13,4,5,11,8,4,7,4,6,13,13,9,11,1,4,5,8,11,10,12,4,5,8,9,13,20,6,5,8,9,9,6,9,7,11,12,12,12,6,5,3,M/AM C,1,1,1,17,1,1,1,1,1,1,20,1,1,1,1
19270777,Lucas,1651,02/01/1996,20,0,0,0,0,188,0,1,3,3,1,1,1,2,2,2,2,2,1,1,5,6,4,1,14,5,1,9,5,3,14,7,9,11,9,5,6,7,14,2,1,8,5,13,7,8,13,14,8,12,5,7,13,20,7,8,9,7,9,6,9,17,10,10,10,9,9,5,4,D C,1,1,1,1,1,1,20,1,1,1,1,1,1,1,1
19270778,William,1651,22/07/1995,20,0,0,0,0,181,71,1,3,1,2,1,1,1,1,3,3,2,6,4,13,13,12,6,13,6,1,5,7,6,3,13,6,10,7,10,2,7,13,6,13,1,11,4,6,7,13,12,9,10,8,6,13,20,6,7,9,9,8,8,9,8,11,9,10,13,4,13,8,S ,1,1,20,1,1,1,1,1,1,1,1,1,1,1,1
19270795,Léo Cereja,1651,15/04/1997,19,0,0,0,0,175,71,2,2,3,1,1,2,1,3,3,2,3,8,8,10,10,14,8,8,10,5,9,14,6,9,13,10,11,6,6,10,7,14,4,12,1,11,10,10,12,14,11,10,8,14,11,14,20,8,8,10,8,10,10,10,11,11,11,8,11,8,16,7,M/AM C,1,1,1,20,1,1,1,1,1,1,17,1,1,1,1
19270796,Saraiva,1651,09/03/1998,18,0,0,0,0,184,0,2,1,3,3,2,3,2,1,4,1,3,7,6,8,9,12,7,3,6,2,7,14,2,5,14,9,7,8,7,6,14,15,4,12,2,8,7,10,12,7,10,9,12,9,10,9,20,9,10,9,9,6,9,9,9,13,12,10,12,4,15,4,M/AM C,1,1,1,20,1,1,1,1,1,1,17,1,1,1,1
19270798,Handerson,1651,07/03/1998,18,0,0,0,0,187,0,1,1,2,2,1,1,2,1,1,3,2,4,2,5,2,7,1,13,4,1,13,3,3,8,3,9,7,9,7,7,2,13,9,1,8,6,13,6,7,13,9,13,14,10,11,10,20,5,13,9,9,9,4,9,13,11,13,12,11,3,9,6,D C,1,1,1,1,1,1,20,1,1,1,1,1,1,1,1
19270799,Marcos,1651,08/04/1996,20,0,0,0,0,184,0,3,2,4,3,2,3,1,1,2,1,2,1,1,6,4,7,1,13,5,1,13,7,2,13,5,9,12,9,7,8,2,13,4,2,7,2,13,6,7,9,11,7,9,10,13,12,20,10,9,9,6,9,9,9,8,10,10,11,13,2,11,3,D C,1,1,1,1,1,1,20,1,1,1,1,1,1,1,1
19270801,Mayco,1651,15/01/1998,18,0,0,0,0,181,0,2,2,2,1,3,2,2,3,1,1,1,7,7,9,9,14,7,5,10,4,4,12,4,7,9,14,6,8,9,4,14,14,12,9,10,10,6,9,11,14,12,9,6,5,13,11,20,7,8,9,9,9,9,9,20,9,8,9,12,7,11,7,M/AM C,1,1,1,20,1,1,1,1,1,1,17,1,1,1,1
19270803,Thiaguinho,1651,02/01/1998,18,0,0,0,0,191,0,3,2,1,3,3,2,3,2,2,3,4,7,7,10,10,12,4,7,11,7,7,14,8,7,14,9,6,9,10,7,14,10,10,13,10,9,9,10,12,14,11,9,15,9,11,14,20,7,10,10,10,8,5,10,17,13,10,12,11,5,15,4,M/AM C,1,1,1,20,1,1,1,1,1,1,17,1,1,1,1
19270804,Udson,1651,17/06/1996,20,0,0,0,0,172,67,1,2,4,2,1,1,2,2,3,1,2,6,6,6,8,11,6,6,10,1,4,13,4,10,13,8,8,8,5,7,11,11,8,8,11,5,10,8,11,13,13,8,3,8,14,13,20,7,7,8,9,9,5,9,18,12,11,12,11,4,10,7,DM/M C,1,1,1,1,1,1,1,1,1,20,17,1,1,1,1
19270805,Vitor,1651,24/06/1996,20,0,0,0,0,191,0,1,1,1,1,3,4,3,2,3,1,1,6,6,8,8,8,6,3,13,5,5,12,2,8,13,9,8,8,8,8,13,13,3,13,5,10,8,8,9,13,11,7,13,9,11,12,20,8,8,9,9,2,9,9,17,8,13,11,14,10,18,8,M/AM C,1,1,1,17,1,1,1,1,1,1,20,1,1,1,1
19270806,Wendel,1651,07/07/1996,19,0,0,0,0,183,0,2,1,3,1,3,1,2,2,3,1,3,7,7,8,9,14,5,7,14,6,7,14,6,9,14,5,9,8,9,8,14,12,9,13,4,5,8,9,13,14,12,6,7,1,13,12,20,12,8,9,6,9,9,9,7,10,10,9,11,1,6,4,M/AM C,1,1,1,17,1,1,1,1,1,1,20,1,1,1,1
19270809,Bruno Xavier,1651,27/11/1996,19,0,0,0,0,179,72,2,1,2,3,3,2,1,1,3,2,3,11,11,7,11,15,9,11,11,5,9,12,7,4,13,10,13,8,8,9,13,8,10,11,9,12,7,10,11,15,13,10,6,20,11,13,11,14,8,10,1,10,6,9,11,12,11,13,11,1,11,4,AM/S C,1,1,17,20,13,13,1,1,1,1,1,1,1,1,1
19270810,Caique,1651,10/10/1995,20,0,0,0,0,184,70,3,1,1,2,2,3,2,1,1,3,3,6,4,9,7,15,9,9,15,3,13,10,9,12,14,10,12,9,7,12,15,12,3,7,7,10,9,13,12,12,13,9,11,11,11,12,20,9,7,10,5,9,6,10,12,11,9,11,12,5,8,6,DM/M C,1,1,1,1,1,1,1,1,1,20,17,1,1,1,1
19270816,Gabriel,1651,29/03/1996,20,0,0,0,0,175,60,2,3,2,1,3,3,1,3,2,3,2,7,5,6,6,13,2,8,7,7,7,8,3,12,8,8,8,9,8,6,6,12,5,7,12,6,7,9,9,14,14,9,5,8,13,14,20,9,7,9,9,9,6,9,19,11,10,9,10,2,9,7,D/WB R,1,1,1,1,1,1,1,1,20,1,1,1,1,1,17
19270817,Gabriel Tonini,1651,12/05/1996,20,0,0,0,0,182,0,1,1,1,3,4,3,1,2,3,2,2,7,4,6,8,14,7,7,8,1,8,10,1,12,14,9,7,8,7,9,10,14,7,9,12,6,10,9,12,13,12,9,8,2,11,14,20,8,9,9,9,3,9,9,12,10,10,11,10,10,10,6,DM/M C,1,1,1,1,1,1,1,1,1,20,17,1,1,1,1
19270818,Guilherme,1651,27/04/1999,17,0,0,0,0,179,70,1,2,3,3,4,3,2,3,1,3,2,5,7,7,8,12,7,7,9,1,6,11,2,6,14,9,9,8,5,9,10,11,9,13,9,5,7,9,13,10,12,9,6,8,9,14,20,9,7,9,9,8,9,9,20,10,13,11,12,6,10,1,M/AM C,1,1,1,17,1,1,1,1,1,1,20,1,1,1,1
19270819,Guilherme Pedroso,1651,29/11/1996,19,0,0,0,0,177,0,1,1,1,1,1,3,1,2,2,3,1,6,6,7,8,13,1,6,9,3,6,13,4,3,13,9,9,7,5,5,8,13,3,13,7,8,8,8,9,13,9,8,7,8,14,10,20,7,5,9,9,9,9,9,9,10,12,13,8,1,9,1,M/AM C,1,1,1,20,1,1,1,1,1,1,17,1,1,1,1
19270820,Gustavo Lizzoni,1651,20/01/1995,21,0,0,0,0,188,82,14,14,6,1,11,14,10,9,9,5,7,5,1,1,2,1,7,1,2,1,1,1,2,2,4,8,10,10,8,10,7,14,9,2,12,1,12,8,6,11,7,8,13,20,11,11,10,2,10,9,9,7,6,9,10,12,12,11,11,11,8,4,GK ,20,1,1,1,1,1,1,1,1,1,1,1,1,1,1
19270821,Gustavo Schliemann,1651,02/09/1997,18,0,0,0,0,183,74,2,4,1,4,1,3,3,1,3,2,3,7,7,4,8,12,7,5,15,2,7,10,7,12,10,8,7,7,6,7,12,8,8,8,10,4,13,9,8,10,13,9,11,8,15,15,20,6,9,8,4,1,8,8,17,12,10,13,11,4,7,3,DM/M C,1,1,1,1,1,1,1,1,1,20,17,1,1,1,1
19270823,João Victor,1651,25/02/1999,17,0,0,0,0,160,57,2,2,1,1,2,2,1,1,2,1,3,6,4,8,9,14,6,10,6,5,4,12,4,2,14,4,7,3,10,8,7,8,8,13,9,11,4,7,8,14,14,8,1,10,7,10,20,7,6,8,6,8,7,8,8,8,10,10,11,2,12,3,AM/S C,1,1,17,20,1,1,1,1,1,1,1,1,1,1,1
19270824,Linnyker,1651,14/04/1996,20,0,0,0,0,182,0,3,1,3,1,2,3,1,3,1,3,2,5,3,3,7,13,6,6,9,4,6,11,3,12,8,9,10,6,7,5,9,12,9,2,12,4,8,8,10,13,9,8,6,8,8,10,20,6,6,9,9,6,8,9,18,11,14,10,9,12,2,1,DM/M C,1,1,1,1,1,1,1,1,1,20,17,1,1,1,1
19270825,Lucas Vinícius,1651,09/01/1998,18,0,0,0,0,188,81,4,1,1,2,2,3,2,3,2,3,1,3,3,6,4,9,5,7,4,6,8,6,3,12,8,8,7,8,8,8,8,9,3,5,9,3,6,4,8,14,10,8,8,20,8,13,8,7,10,8,8,8,6,8,16,11,10,11,10,1,7,8,D/WB L,1,1,1,1,1,1,1,20,1,1,1,1,1,17,1
19270826,Lucas Nathan,1651,17/11/1998,17,0,0,0,0,183,73,2,2,3,2,3,1,3,2,1,3,2,4,5,9,6,12,5,9,6,1,5,10,5,5,13,8,6,3,6,2,9,10,8,13,8,8,7,6,7,13,13,7,10,10,8,13,20,8,6,8,6,8,3,7,20,12,12,12,14,8,7,3,AM/S C,1,1,17,20,1,1,1,1,1,1,1,1,1,1,1
19270827,Ricardinho,1651,10/03/1993,23,0,0,0,0,180,72,3,2,2,2,3,3,2,1,3,3,2,7,5,14,13,14,7,14,7,4,6,3,5,1,14,5,10,8,9,8,6,12,7,13,3,14,7,6,8,14,13,5,8,1,14,14,20,7,8,9,9,4,9,9,14,9,11,12,10,11,14,1,S ,1,1,20,7,1,1,1,1,1,1,1,1,1,1,1
19270828,Rafael Rosa,1651,17/10/1996,19,0,0,0,0,192,88,1,2,2,3,3,3,3,1,1,1,2,3,7,7,13,14,7,7,9,1,7,12,3,8,13,6,5,6,8,8,14,14,9,12,11,12,8,8,9,13,10,8,15,6,11,10,20,13,13,9,9,6,9,9,8,9,10,14,9,9,5,6,AM C,1,1,13,20,1,1,1,1,1,1,13,1,1,1,1
19270829,Samuel Fabris,1651,09/07/1996,19,0,0,0,0,184,0,3,1,3,4,2,2,2,2,4,3,3,7,6,6,8,14,2,7,9,7,11,13,7,15,10,8,9,7,7,8,9,11,3,8,9,8,9,9,12,9,10,4,7,8,13,8,20,8,9,7,6,8,8,8,20,12,11,11,11,1,15,6,DM/M C,1,1,1,1,1,1,1,1,1,20,17,1,1,1,1
19270830,Vinicius Henrique,1651,17/04/1996,20,0,0,0,0,170,0,2,3,4,3,1,1,1,4,3,3,1,6,6,9,13,11,6,10,6,3,6,8,5,2,14,8,7,7,10,8,9,10,4,13,5,10,7,7,8,14,11,6,3,8,11,14,20,8,7,8,8,1,8,7,11,14,12,9,12,1,18,1,AM/S C,1,1,17,20,1,1,1,1,1,1,1,1,1,1,1
19270845,Daniel,1651,06/02/1995,21,0,0,0,0,181,0,2,3,1,3,2,3,3,3,2,2,2,6,6,6,8,13,6,6,12,1,7,13,6,8,9,7,4,4,10,8,10,13,9,9,8,9,8,6,11,13,11,6,6,8,12,9,20,7,5,7,9,9,7,9,19,9,13,11,13,5,2,6,M/AM C,1,1,1,20,1,1,1,1,1,1,17,1,1,1,1
19270846,Gabriel Rodrigues,1651,15/02/1996,20,0,0,0,0,193,0,4,3,3,2,2,1,3,3,3,1,1,7,4,13,13,13,7,13,8,6,5,8,2,3,13,10,8,5,8,3,8,13,10,13,10,13,6,7,8,10,10,8,14,10,12,12,20,9,9,8,10,10,10,10,18,11,12,11,10,1,9,2,S ,1,1,20,1,1,1,1,1,1,1,1,1,1,1,1
19270847,Gabriel Carvalho,1651,09/11/1997,18,0,0,0,0,184,0,2,1,1,3,1,1,1,2,3,3,3,2,1,2,3,4,1,13,1,1,12,3,1,13,4,8,7,8,2,5,1,13,8,8,5,3,6,5,6,6,8,6,7,16,8,9,20,9,8,8,8,7,8,8,14,11,9,10,9,1,7,7,D C,1,1,1,1,1,1,20,1,1,1,1,1,1,1,1
19270848,Léo,1651,25/04/1995,21,0,0,0,0,194,87,1,3,2,2,2,2,3,3,1,3,1,3,1,1,3,7,6,12,4,5,13,6,3,13,4,9,8,9,7,6,3,13,3,5,11,6,13,6,7,13,9,7,13,9,8,10,20,11,9,9,8,9,9,9,10,12,11,10,11,8,3,5,D C,1,1,1,1,1,1,20,1,1,1,1,1,1,1,1
19270849,Leonardo Mutton,1651,19/06/1995,21,0,0,0,0,175,0,2,3,2,2,2,1,1,2,1,2,1,7,2,7,7,11,7,8,9,3,8,9,5,13,7,9,5,6,7,7,8,14,6,5,10,7,11,8,11,14,14,8,6,20,16,14,6,7,7,9,6,7,9,9,14,10,11,9,10,1,7,3,DM ,1,1,1,1,1,1,13,13,1,20,1,1,1,1,1
19270851,Lucas,1651,18/01/1995,21,0,0,0,0,179,0,1,2,3,3,2,1,2,2,2,2,2,6,5,4,8,13,6,6,8,1,9,11,5,13,10,9,9,8,5,7,7,13,9,9,12,8,8,8,11,10,12,4,6,8,15,13,20,6,7,9,7,6,9,9,12,12,10,7,8,1,12,1,DM/M C,1,1,1,1,1,1,1,1,1,17,20,1,1,1,1
19270852,Lucas Passarelli,1651,28/06/1996,20,0,0,0,0,187,0,13,8,7,9,9,10,9,13,9,6,9,3,2,1,1,2,6,1,3,2,1,2,1,1,2,6,9,11,8,14,7,13,9,3,6,3,10,8,7,10,15,8,8,9,6,13,20,3,10,9,4,9,9,9,11,10,9,11,11,8,12,8,GK ,20,1,1,1,1,1,1,1,1,1,1,1,1,1,1
19270853,Gustavo Salomão,1651,28/06/1997,19,0,0,0,0,183,0,3,3,2,2,4,1,3,1,2,3,2,7,7,8,3,11,4,9,8,8,9,10,2,14,10,9,8,9,10,8,7,12,9,9,1,6,7,10,10,13,11,10,8,20,16,12,9,14,8,8,9,6,9,9,12,10,11,10,10,3,7,7,D/WB L,1,1,1,1,1,1,1,20,1,1,1,1,1,17,1
19270855,Wesley,1651,22/06/1995,21,0,0,0,0,178,68,2,1,2,3,2,2,2,2,1,3,3,8,7,5,9,13,8,8,11,5,7,12,1,13,11,7,9,9,8,6,12,14,3,2,3,8,11,9,10,9,10,9,6,10,9,13,20,7,9,10,9,2,10,10,9,11,15,10,10,10,13,2,DM ,1,1,1,1,1,1,1,1,1,20,1,1,1,1,1
19270865,Felipe Teixeira,1651,19/07/1993,22,0,0,0,0,179,0,4,3,1,1,2,3,2,3,1,3,1,5,3,12,12,12,5,12,6,2,5,6,1,3,12,8,4,5,6,6,6,12,9,13,5,10,4,5,6,12,12,6,3,16,5,12,20,6,5,9,9,8,9,9,13,11,9,11,12,8,10,2,S ,1,1,20,1,1,1,1,1,1,1,1,1,1,1,1
19270867,Gabriel,1651,29/08/1996,19,0,0,0,0,183,79,3,2,2,1,3,2,2,1,3,2,3,6,7,7,7,11,8,8,11,3,9,15,4,10,15,9,9,3,7,5,10,8,7,9,13,9,9,10,12,7,10,10,9,7,10,11,20,10,10,8,9,9,5,9,8,8,11,11,12,11,9,8,DM/M C,1,1,1,1,1,1,1,1,1,20,17,1,1,1,1
19270869,Kaio,1651,04/03/1996,20,0,0,0,0,197,0,1,2,3,3,2,3,1,2,3,4,1,4,5,7,7,6,5,4,7,1,4,11,4,7,11,6,6,5,7,7,12,12,3,12,10,8,5,7,9,12,12,7,12,6,15,12,20,8,11,9,9,9,9,9,14,9,9,8,10,3,9,2,M/AM C,1,1,1,20,1,1,1,1,1,1,17,1,1,1,1
19270870,Lincon,1651,21/02/1997,19,0,0,0,0,185,78,2,2,2,2,3,1,3,3,2,1,3,4,1,12,12,12,4,9,6,1,2,10,6,5,12,8,6,6,4,5,6,10,8,13,8,7,4,5,6,12,10,1,6,18,9,10,20,10,7,8,8,8,7,8,8,11,13,8,10,4,14,1,AM/S C,1,1,17,20,1,1,1,1,1,1,1,1,1,1,1
19270871,Lopes,1651,12/08/1988,27,0,0,0,0,184,0,3,1,1,4,3,2,2,1,1,2,2,6,6,3,8,10,6,6,8,2,7,13,5,12,11,8,7,5,8,6,11,13,3,6,11,7,8,5,9,13,12,8,7,20,3,13,8,12,6,9,9,2,3,9,8,12,12,12,12,7,9,2,DM/M C,1,1,1,1,1,1,1,1,1,20,17,1,1,1,1
19270872,Lucas,1651,31/12/1995,20,0,0,0,0,175,0,2,2,1,1,1,2,3,3,3,1,1,6,4,8,8,8,5,3,14,5,7,7,6,4,11,8,7,3,7,7,9,10,5,10,3,7,6,8,12,14,10,8,6,9,13,9,20,13,5,8,8,1,6,8,18,10,11,13,10,1,14,1,M/AM C,1,1,1,17,1,1,1,1,1,1,20,1,1,1,1
19270873,Ralph,1651,06/10/1996,19,0,0,0,0,193,0,1,3,1,3,3,3,1,1,2,3,2,1,1,1,2,7,1,12,3,1,13,7,2,13,4,9,10,9,7,8,4,13,9,4,5,5,9,6,6,9,7,7,14,8,14,9,20,4,12,9,9,9,8,9,17,10,12,10,12,1,15,6,D C,1,1,1,1,1,1,20,1,1,1,1,1,1,1,1
19270874,Maranhão,1651,20/10/1996,19,0,0,0,0,180,0,1,4,1,3,1,3,1,1,1,3,1,6,7,13,13,13,5,13,6,3,4,4,4,5,11,9,10,6,9,6,5,9,2,11,10,13,7,6,7,13,13,7,9,9,12,13,20,9,8,9,9,6,6,9,15,9,9,9,13,8,7,6,S ,1,1,20,1,1,1,1,1,1,1,1,1,1,1,1
19270875,Matheus,1651,06/04/1996,20,0,0,0,0,181,0,2,3,3,3,2,4,1,1,2,2,3,5,5,7,7,12,5,1,6,2,4,8,1,5,11,9,6,8,3,4,12,12,1,12,11,8,4,7,6,12,8,7,7,16,12,12,20,5,4,9,6,9,5,9,9,11,12,12,11,10,13,5,M/AM C,1,1,1,20,1,1,1,1,1,1,17,1,1,1,1
19270876,Oswaldo,1651,10/06/1989,27,0,0,0,0,187,0,13,7,8,1,11,11,9,13,9,7,7,3,2,2,2,1,5,1,2,3,2,1,2,1,1,9,5,14,7,8,6,13,9,3,12,1,8,7,5,13,12,7,11,9,10,11,20,1,9,9,9,9,3,9,20,10,10,11,12,3,7,2,GK ,20,1,1,1,1,1,1,1,1,1,1,1,1,1,1
19270878,Pedro,1651,08/04/1995,21,0,0,0,0,177,0,3,4,1,2,1,1,3,2,2,1,1,7,6,14,14,14,5,14,8,1,5,8,4,5,11,9,10,2,9,8,8,14,9,10,13,10,6,7,8,14,12,8,5,3,15,11,20,7,7,9,8,2,5,9,11,11,13,13,10,10,9,3,S ,1,1,20,1,1,1,1,1,1,1,1,1,1,1,1
19270879,Peixoto,1651,13/07/1994,21,0,0,0,0,185,0,2,2,1,1,3,3,1,1,2,2,3,7,4,12,14,14,7,14,6,5,5,8,5,1,9,4,8,7,7,8,5,9,1,9,6,14,6,7,8,14,9,8,10,4,14,11,20,7,7,9,1,4,9,9,17,11,11,12,12,10,10,6,S ,1,1,20,1,1,1,1,1,1,1,1,1,1,1,1
19270881,Ruan,1651,14/01/1994,22,0,0,0,0,186,86,3,2,3,2,4,1,2,1,1,1,1,8,6,1,1,7,4,11,1,1,14,6,4,14,4,10,14,10,4,12,4,10,6,2,9,8,14,8,9,14,12,9,12,8,10,13,20,13,10,10,6,10,9,10,7,11,12,12,9,4,11,6,D C,1,1,1,1,1,1,20,1,1,1,1,1,1,1,1
19270882,Wesley,1651,14/02/1994,22,0,0,0,0,172,0,1,4,4,3,3,2,3,1,2,4,3,6,7,9,9,14,7,5,11,5,8,9,4,9,11,8,9,5,5,9,7,11,4,10,10,9,5,9,12,14,14,9,7,3,14,14,20,10,6,9,9,9,9,9,13,10,10,10,11,1,11,6,M/AM C,1,1,1,20,1,1,1,1,1,1,17,1,1,1,1
19270883,William Lemos,1651,05/06/1993,23,0,0,0,0,167,0,3,2,2,3,2,2,1,3,3,3,3,6,4,8,7,14,6,6,8,1,8,14,2,7,10,9,9,7,9,5,13,10,9,10,6,10,8,9,12,13,13,8,1,8,14,11,20,8,4,9,7,2,4,9,16,11,13,11,11,6,15,7,M/AM C,1,1,1,17,1,1,1,1,1,1,20,1,1,1,1
19270884,Yagho,1651,19/04/1995,21,0,0,0,0,184,0,3,2,3,2,1,2,2,2,2,1,3,8,7,9,9,15,7,8,14,7,8,15,6,13,11,9,7,8,10,8,9,14,3,9,9,10,6,10,12,7,7,5,9,8,13,8,20,9,11,9,9,6,9,9,16,9,12,9,12,11,14,3,DM/M C,1,1,1,1,1,1,1,1,1,17,20,1,1,1,1
19270908,Cezinha,1651,26/12/1989,26,0,0,0,0,174,71,3,3,2,1,1,1,1,1,1,2,1,7,7,9,8,14,7,7,13,2,7,8,3,8,11,9,9,6,8,9,10,14,5,10,10,10,9,9,12,14,14,9,5,1,13,14,20,14,6,9,7,9,9,9,15,12,12,12,12,1,13,6,M/AM C,1,1,1,17,1,1,1,1,1,1,20,1,1,1,1
19270910,Everaldo,1651,28/05/1994,22,0,0,0,0,172,57,2,1,3,1,3,2,3,2,2,1,3,8,11,11,8,13,7,10,6,6,5,9,12,7,9,9,10,7,11,6,8,13,5,12,8,13,7,8,9,12,12,3,4,10,16,12,20,11,3,10,6,10,6,10,8,11,12,11,11,9,6,7,AM/S L,1,1,17,10,20,10,1,1,1,1,1,1,1,1,1
19270911,Glécio,1651,13/03/1997,19,0,0,0,0,176,65,2,2,1,2,2,2,1,1,1,3,4,6,5,7,4,10,1,6,6,7,9,5,3,10,9,8,9,9,9,9,7,12,8,9,5,6,10,9,9,14,14,9,6,20,13,14,5,8,6,9,9,6,9,8,20,9,12,12,13,11,9,3,D/WB L,1,1,1,1,1,1,1,20,1,1,1,1,1,17,1
19270912,Gustavo Felipe,1651,28/01/1997,19,0,0,0,0,185,75,2,1,1,2,3,1,3,4,1,1,1,3,3,1,1,6,1,13,5,4,13,7,1,13,5,9,10,9,7,11,6,13,9,1,8,2,13,2,7,8,10,7,11,11,12,10,20,7,9,9,9,9,9,9,9,10,11,11,13,10,11,1,D C,1,1,1,1,1,1,20,1,1,1,1,1,1,1,1
19270913,Igor,1651,26/02/1996,20,0,0,0,0,186,76,4,1,4,3,3,2,3,1,3,3,1,6,6,3,5,13,6,6,7,4,9,12,1,13,12,7,9,8,7,3,8,13,6,9,2,7,6,8,11,13,10,8,7,10,11,10,20,6,10,9,6,7,9,9,15,8,12,11,10,3,19,8,DM/M C,1,1,1,1,1,1,1,1,1,20,17,1,1,1,1
19270915,Jô,1651,01/05/1995,21,0,0,0,0,191,92,2,3,3,1,1,2,3,1,2,1,1,6,5,8,14,11,8,12,8,8,6,9,4,1,10,6,14,6,9,9,7,14,4,10,14,12,9,8,7,11,10,14,14,20,16,10,10,10,14,10,9,10,9,10,15,11,12,12,11,7,11,5,S ,1,1,20,1,1,1,1,1,1,1,1,1,1,1,1
19270916,João Pedro,1651,04/01/1996,20,0,0,0,0,187,74,1,1,3,2,3,1,3,1,2,1,1,5,7,6,2,7,1,14,5,1,14,8,6,14,6,7,9,9,5,6,5,14,9,1,2,5,13,7,8,13,10,8,12,9,9,9,20,5,11,9,9,7,6,9,13,13,13,10,11,10,14,8,D C,1,1,1,1,1,1,20,1,1,1,1,1,1,1,1
19270917,Michel,1651,05/09/1990,25,0,0,0,0,173,67,1,2,1,3,3,1,1,3,3,2,2,7,8,8,3,10,2,9,6,5,10,8,5,10,8,9,10,10,5,7,6,11,10,3,8,8,9,10,10,14,13,10,3,12,10,12,20,13,6,10,7,7,10,10,15,10,11,8,10,9,14,2,D/WB R,1,1,1,1,1,1,1,1,20,1,1,1,1,1,17
19270918,Keké,1651,11/10/1995,20,0,0,0,0,177,71,3,1,2,3,3,1,2,1,1,1,1,4,3,14,9,14,7,14,8,1,5,8,2,1,10,5,11,8,8,5,8,8,3,9,10,14,6,7,8,14,13,11,8,10,9,14,20,7,7,8,8,9,9,9,17,12,13,10,11,4,12,1,S ,1,1,20,1,1,1,1,1,1,1,1,1,1,1,1
19270919,Romildinho,1651,12/12/1997,18,0,0,0,0,186,0,3,2,3,2,3,3,1,3,1,1,2,8,8,12,8,14,8,8,10,4,6,9,5,7,14,7,12,6,10,8,14,12,8,13,9,11,6,10,13,13,13,7,10,20,9,13,10,10,4,9,9,2,8,10,17,13,10,8,12,9,6,2,M/AM C,1,1,1,20,1,1,1,1,1,1,17,1,1,1,1
19270920,Ruster,1651,24/08/1996,19,0,0,0,0,167,70,2,3,2,2,3,1,1,3,2,3,3,4,4,13,13,12,6,10,5,2,3,5,4,3,7,9,10,8,9,6,7,13,8,9,7,11,6,6,7,13,13,7,1,7,8,13,20,9,8,9,9,4,7,9,16,11,13,12,12,2,1,6,S ,1,1,20,1,1,1,1,1,1,1,1,1,1,1,1
19270921,Vinicius,1651,25/02/1994,22,0,0,0,0,186,75,2,3,2,3,2,4,2,1,1,3,2,3,1,2,1,7,1,13,4,3,13,7,2,13,6,9,11,9,7,6,1,13,3,1,3,5,13,6,7,13,13,7,11,11,9,13,20,6,9,9,9,7,9,9,8,9,12,10,13,1,7,1,D C,1,1,1,1,1,1,20,1,1,1,1,1,1,1,1
19270937,Caio Henrique,1651,06/05/1995,21,0,0,0,0,173,75,1,1,2,4,3,1,2,1,3,1,2,7,7,11,14,14,7,11,9,2,5,9,10,7,13,9,5,3,11,8,8,7,5,12,4,14,9,7,9,14,10,7,2,11,13,10,20,7,6,6,6,4,7,9,8,11,12,10,13,7,7,3,AM/S C,1,1,20,17,1,1,1,1,1,1,1,1,1,1,1
19270940,Luan,1651,16/02/1995,21,0,0,0,0,179,0,3,2,4,1,3,1,4,2,2,3,3,5,4,7,6,12,5,5,8,2,6,7,6,7,12,9,5,5,10,5,8,12,3,13,12,4,7,7,9,12,12,7,3,16,12,12,20,8,4,9,6,9,9,9,8,13,11,10,11,7,8,1,M/AM C,1,1,1,20,1,1,1,1,1,1,17,1,1,1,1
19270941,Matheus,1651,11/04/1996,20,0,0,0,0,177,0,4,1,2,1,1,1,3,1,1,2,3,5,6,12,14,12,4,14,5,2,6,8,5,5,12,8,8,8,7,5,5,14,9,11,10,13,7,7,8,13,9,4,6,1,5,12,20,7,8,9,9,9,8,9,12,10,11,10,12,5,16,6,S ,1,1,20,1,1,1,1,1,1,1,1,1,1,1,1
19270959,Bernardo,1651,14/05/1995,21,0,0,0,0,186,76,1,1,1,2,1,3,3,4,3,2,3,6,10,10,8,11,7,10,12,13,15,12,8,16,12,16,14,17,8,12,8,9,15,7,10,9,12,15,16,15,12,13,14,20,17,14,10,16,12,13,10,11,3,17,14,17,7,12,14,10,12,8,D/DM/M RLC,1,1,1,10,1,1,14,15,16,20,20,1,1,11,12
19270960,Divino,1651,27/05/1997,19,0,0,0,0,165,0,3,3,2,1,1,2,2,3,3,3,1,5,2,6,9,11,6,7,11,1,8,14,2,9,12,9,6,7,9,9,11,14,5,11,2,12,8,9,12,14,13,4,3,9,10,13,20,8,5,9,9,4,9,9,15,10,9,14,11,2,4,4,M/AM C,1,1,1,20,1,1,1,1,1,1,17,1,1,1,1
19270961,João Bruno,1651,23/04/1996,20,0,0,0,0,184,73,3,3,3,1,3,3,1,3,1,2,3,5,3,1,1,6,3,9,4,1,14,4,3,14,3,8,7,7,7,7,4,13,3,8,3,4,12,6,7,12,10,7,12,3,12,10,20,4,9,8,6,8,7,8,20,11,11,10,12,2,4,7,D C,1,1,1,1,1,1,20,1,1,1,1,1,1,1,1
19270962,Jordan,1651,06/02/1998,18,0,0,0,0,183,0,13,11,10,1,13,13,7,13,5,9,10,2,2,2,2,2,7,1,2,1,1,2,3,1,3,9,7,14,6,8,6,13,9,3,2,2,9,7,6,9,9,7,6,2,12,8,20,4,6,9,9,9,8,7,15,10,12,11,11,8,12,6,GK ,20,1,1,1,1,1,1,1,1,1,1,1,1,1,1
19270963,Júlio,1651,20/01/1998,18,0,0,0,0,180,0,2,2,3,2,3,2,2,2,1,2,3,7,7,9,5,14,7,3,13,3,7,14,4,9,13,9,9,7,8,5,10,7,5,12,1,8,8,9,8,14,9,9,9,2,14,13,20,11,6,9,9,8,6,9,15,12,10,12,12,1,4,7,M/AM C,1,1,1,20,1,1,1,1,1,1,17,1,1,1,1
19270981,Felipe Alves,1651,13/08/1991,24,0,0,0,0,182,77,2,1,2,2,2,1,1,3,1,3,3,8,6,8,8,14,8,8,9,3,10,9,4,12,14,10,14,9,9,12,9,12,10,10,11,6,12,9,12,14,14,9,11,10,16,14,20,7,7,9,6,6,3,10,19,12,10,13,13,7,14,4,DM ,1,1,1,1,1,1,1,1,1,20,10,1,1,1,1
19270994,Marcos,1651,17/05/1993,23,0,0,0,0,185,83,14,14,8,6,14,14,10,14,7,10,12,3,3,3,3,5,7,1,2,2,3,2,3,3,3,5,11,15,9,10,8,14,9,1,9,2,9,9,8,12,7,6,13,10,16,12,20,4,7,10,7,7,10,10,16,10,11,11,11,1,1,8,GK ,20,1,1,1,1,1,1,1,1,1,1,1,1,1,1
19270995,Luiz Otávio,1651,09/10/1992,23,0,0,0,0,194,88,2,1,3,2,3,3,2,3,1,2,3,8,4,2,5,9,2,14,6,4,13,9,1,14,8,10,12,10,7,11,4,14,5,3,1,8,13,8,9,14,11,5,17,11,12,9,20,9,11,10,10,3,10,10,13,11,8,12,9,9,8,7,D C,1,1,1,1,1,1,20,1,1,1,1,1,1,1,1
19270996,Ricardo,1651,27/02/1994,22,0,0,0,0,185,76,3,1,2,1,2,3,4,1,2,2,2,8,5,4,7,14,8,8,10,4,8,14,7,13,14,10,11,9,10,9,9,14,2,6,12,9,8,9,8,14,11,9,11,11,16,11,20,13,7,10,5,10,7,10,13,9,10,12,11,6,10,8,DM/M C,1,1,1,1,1,1,1,1,1,20,18,1,1,1,1
19270997,Gabriel Passos,1651,14/09/1995,20,0,0,0,0,179,72,1,1,2,1,1,1,3,2,1,2,1,2,5,8,2,13,1,9,2,8,12,9,2,15,9,9,6,10,7,8,9,14,4,8,13,5,9,9,9,11,13,9,9,10,13,13,20,10,7,9,9,5,9,8,19,10,10,12,11,6,6,4,D R,1,1,1,1,1,1,1,1,20,1,1,1,1,1,1
19271010,Lucas Bacelar,1651,29/01/1995,21,0,0,0,0,174,73,3,3,3,4,2,3,1,1,2,3,1,7,7,10,14,14,7,14,8,5,4,8,4,1,11,5,7,7,9,7,8,12,7,10,6,14,6,7,8,14,13,4,9,20,7,14,9,8,7,9,9,9,9,9,16,13,12,12,7,1,13,3,S ,1,1,20,1,1,1,1,1,1,1,1,1,1,1,1
19271024,Daniel Santos,1651,07/05/1993,23,0,0,0,0,179,0,3,1,3,3,3,3,2,3,1,3,2,7,4,14,14,14,7,13,8,1,5,6,6,5,10,6,8,7,9,8,5,12,7,9,3,14,8,7,8,14,14,8,7,9,9,14,20,6,9,9,9,9,9,9,11,11,10,9,9,2,11,6,S ,1,1,20,1,1,1,1,1,1,1,1,1,1,1,1
19271025,Danubio,1651,24/03/1995,21,0,0,0,0,182,71,3,3,2,2,2,3,3,1,2,3,2,6,7,11,11,11,6,12,7,1,5,6,7,2,10,9,12,6,7,7,7,11,3,10,11,13,7,6,7,10,9,7,10,9,6,13,20,11,7,9,9,3,9,9,7,8,13,11,11,12,10,5,S ,1,1,20,1,1,1,1,1,1,1,1,1,1,1,1
19271075,Isael,1651,11/03/1997,19,0,0,0,0,191,92,14,13,8,3,14,8,8,14,8,5,11,2,3,3,1,2,7,1,1,1,3,2,3,1,3,6,11,11,8,8,7,14,9,2,1,1,7,8,6,13,12,6,15,1,12,12,20,2,10,9,7,9,9,9,17,12,10,13,13,6,5,7,GK ,20,1,1,1,1,1,1,1,1,1,1,1,1,1,1
19271077,Mattheus Silva,1651,12/08/1997,18,0,0,0,0,169,64,1,2,2,3,1,3,2,1,3,2,1,6,9,7,2,12,3,6,7,7,9,8,7,11,8,9,6,9,8,11,6,12,9,4,5,6,9,9,9,13,14,9,6,20,9,14,10,6,6,9,4,6,4,9,11,10,12,10,12,6,5,5,D/WB L,1,1,1,1,1,1,1,20,1,1,1,1,1,19,1
19271078,Gabriel Santiago,1651,01/04/1997,19,0,0,0,0,189,85,3,3,1,2,1,3,2,2,2,3,4,7,2,1,2,8,7,13,6,1,13,8,1,13,5,10,13,10,6,8,4,12,5,3,11,6,13,7,8,13,13,8,13,9,7,13,20,8,11,10,8,10,10,10,9,9,13,11,10,12,12,2,D C,1,1,1,1,1,1,20,1,1,1,1,1,1,1,1
19271079,Hugo Ribeiro,1651,02/11/1997,18,0,0,0,0,180,70,2,3,1,3,2,3,2,2,3,3,1,7,7,4,7,13,8,7,14,1,13,10,6,12,10,7,7,9,8,9,14,13,9,4,7,7,9,13,13,13,12,7,9,9,13,13,20,13,12,10,9,10,4,9,13,11,10,8,12,1,7,1,DM C,1,1,1,1,1,1,1,1,1,20,15,1,1,1,1
19271080,Lucas Lucena,1651,07/10/1996,19,0,0,0,0,180,71,2,2,3,1,1,1,3,1,3,1,2,7,8,8,9,10,8,12,9,9,13,10,8,12,10,12,11,11,9,9,9,9,10,10,7,11,12,13,12,13,12,9,10,10,13,12,20,13,13,12,10,10,5,12,8,10,11,11,10,3,9,3,D/DM C,1,1,1,1,1,1,18,1,1,20,8,1,1,1,1
19271081,Cadu,1651,08/08/1997,18,0,0,0,0,172,70,3,2,1,3,2,1,2,1,1,2,4,7,7,9,7,14,7,6,8,2,6,14,3,6,13,9,5,6,11,6,12,14,4,12,11,7,9,8,11,13,11,13,6,9,15,10,20,10,8,9,8,9,7,9,9,12,11,14,10,11,7,5,M/AM C,1,1,1,20,1,1,1,1,1,1,18,1,1,1,1
19271082,Luan,1651,23/01/1996,20,0,0,0,0,172,66,2,3,2,1,1,3,2,2,3,4,3,8,12,13,14,14,8,13,10,8,8,9,4,6,14,8,11,5,11,9,5,12,9,15,8,11,7,9,10,13,14,8,6,10,12,13,20,11,5,10,6,6,10,9,13,12,9,10,12,6,1,2,AM/S L,1,1,18,1,20,11,1,1,1,1,1,1,1,1,1
19271083,Hugo Freitas,1651,03/01/1997,19,0,0,0,0,178,71,3,2,3,3,2,2,2,1,4,4,1,9,14,12,11,12,8,11,9,8,8,9,4,4,12,1,7,4,10,7,10,13,9,10,12,12,7,8,10,13,13,8,9,20,12,13,10,12,7,10,10,3,4,10,13,11,11,11,12,10,10,4,AM/S R,1,1,20,1,1,18,1,1,1,1,1,1,1,1,1
19271084,Andrei,1651,10/04/1996,20,0,0,0,0,163,0,1,2,1,2,1,3,2,1,3,2,1,6,8,12,9,14,8,4,9,6,6,11,4,8,9,3,9,9,7,9,10,14,10,9,11,8,9,9,13,14,14,6,3,10,12,13,20,12,5,8,3,2,5,10,18,10,9,10,10,1,10,3,AM RC,1,1,10,20,13,15,1,1,1,1,13,1,1,1,1
19271094,Renan,1651,13/10/1997,18,0,0,0,0,188,0,2,3,4,2,3,2,2,2,3,4,3,9,12,12,5,15,4,8,4,6,10,9,3,14,10,9,8,9,10,6,9,14,9,7,9,4,7,9,10,13,13,6,13,20,11,13,10,11,6,9,8,9,9,9,15,9,11,12,11,6,8,3,D/WB L,1,1,1,1,1,1,1,20,1,1,1,1,1,19,1
19271095,Rangerson,1651,21/07/1998,17,0,0,0,0,187,0,2,2,3,1,2,3,3,2,3,3,2,3,3,2,1,6,3,13,6,3,13,7,2,13,4,9,7,9,6,4,2,11,1,5,10,3,9,6,7,13,11,7,8,10,10,11,20,8,9,9,6,5,5,9,10,13,11,9,14,5,7,6,D C,1,1,1,1,1,1,20,1,1,1,1,1,1,1,1
19271096,Léo Gomes,1651,30/04/1997,19,0,0,0,0,184,0,2,2,2,3,3,1,1,3,2,3,3,3,6,8,4,11,6,9,7,5,8,12,4,14,8,9,12,8,8,6,10,14,3,3,8,5,12,8,11,14,13,4,10,1,9,14,20,14,10,5,8,9,9,9,11,13,13,11,11,4,17,4,DM C,1,1,1,1,1,1,15,1,1,20,10,1,1,1,1
19271097,Iago,1651,13/06/1997,19,0,0,0,0,179,0,3,3,3,3,2,1,2,1,3,2,2,5,11,11,9,12,6,6,7,6,7,11,5,7,11,7,7,8,7,8,11,13,9,9,4,11,7,7,8,12,13,6,5,8,12,12,20,10,5,9,8,3,7,9,7,11,8,10,11,9,13,8,D/WB/AM R,1,1,1,14,1,16,1,1,20,1,12,1,12,1,18
19271098,Hercules,1651,20/06/1997,19,0,0,0,0,178,0,1,3,1,1,4,2,3,3,2,2,1,7,11,11,7,10,7,7,2,6,3,9,5,8,10,5,8,8,9,9,7,11,9,9,13,8,8,8,8,13,14,10,7,20,12,14,5,12,8,9,9,6,6,9,20,13,13,9,11,11,11,6,D/WB/AM L,1,1,1,1,17,1,1,20,1,1,1,15,1,18,1
19271314,Marco Tulio,1651,06/01/1996,20,0,0,0,0,178,0,2,3,1,3,1,1,1,1,1,3,2,6,3,14,14,7,6,12,8,1,3,7,7,6,12,8,8,6,11,7,8,9,8,11,12,12,6,6,7,13,10,7,9,8,7,9,20,6,5,8,8,7,5,8,20,11,10,10,11,13,15,5,S ,1,1,20,12,1,1,1,1,1,1,1,1,1,1,1
19271315,Patrick,1651,02/12/1997,18,0,0,0,0,183,0,3,2,1,2,1,4,2,2,1,1,3,5,7,9,5,12,5,1,7,5,5,7,1,6,8,8,4,4,7,6,7,6,8,8,5,7,5,7,11,13,13,5,6,8,10,13,20,6,9,8,7,8,6,13,18,12,10,11,9,1,8,6,AM RC,1,1,2,15,1,20,1,1,8,6,12,1,13,1,10
19271316,Rafael,1651,08/01/1995,21,0,0,0,0,176,71,4,4,3,1,3,2,3,3,2,1,2,6,4,7,5,13,6,6,10,1,7,13,1,12,13,9,8,8,3,8,11,13,9,2,11,8,11,7,11,8,11,12,6,9,12,13,20,7,7,9,4,7,9,9,17,13,10,12,12,7,13,2,DM/M C,1,1,1,1,1,1,1,1,1,18,20,1,1,1,1
19271361,Maicon,1651,24/03/1994,22,0,0,0,0,172,0,1,1,3,1,3,4,1,2,1,1,2,7,4,4,6,10,5,7,12,2,7,11,1,12,13,4,10,5,8,6,11,14,6,9,1,6,14,8,10,10,13,8,6,9,9,13,20,6,7,9,6,5,5,9,17,8,10,12,10,11,5,2,DM ,1,1,1,1,1,1,1,1,1,20,10,1,1,1,1
19271363,Régis Wenzel,1651,09/06/1986,30,0,0,0,0,180,79,1,1,3,1,2,3,4,3,2,3,3,3,2,13,13,13,6,13,5,1,5,2,8,4,13,4,11,8,9,7,2,12,4,13,12,11,6,6,7,13,13,9,9,10,16,13,20,6,13,9,5,1,8,9,14,11,9,10,12,1,17,2,S ,1,1,20,1,1,1,1,1,1,1,1,1,1,1,1
19271441,Cássio,1651,04/04/1995,21,0,0,0,0,168,67,1,3,1,1,3,2,2,1,2,3,2,6,5,1,1,8,4,7,5,4,6,6,1,11,4,8,9,6,7,4,6,12,3,2,1,6,5,7,7,14,14,16,4,20,9,14,9,8,7,8,8,7,8,8,9,12,10,14,9,1,5,6,D L,1,1,1,1,1,1,1,20,7,1,1,1,1,15,4
19271444,Alemão,1651,01/06/1993,23,0,0,0,0,185,0,2,1,3,3,1,2,3,2,1,1,4,2,5,5,1,7,4,13,4,4,10,7,1,13,4,8,8,8,5,7,6,13,8,7,4,3,13,5,7,6,9,6,12,9,8,9,20,5,6,7,6,6,8,8,8,12,11,10,11,7,10,1,D RC,1,1,1,1,1,1,20,1,15,15,6,1,1,1,10
19271445,Valdeir,1651,03/01/1994,22,0,0,0,0,175,82,2,1,2,3,3,2,3,3,2,1,1,7,8,13,11,14,8,9,9,4,8,10,6,3,10,6,6,5,8,8,10,14,6,9,1,10,9,8,9,9,8,8,7,20,9,12,7,8,7,9,9,1,7,12,9,12,12,12,14,1,2,8,AM/S C,1,1,18,20,12,1,1,5,1,1,8,9,1,6,1
19271449,Felipe,1651,08/02/1993,23,0,0,0,0,189,84,4,3,1,2,3,1,2,4,1,3,1,7,8,10,8,10,8,12,9,8,11,10,9,12,10,10,11,11,11,11,9,11,10,9,7,11,12,15,13,12,11,6,16,20,12,11,9,14,14,10,10,10,3,11,7,10,12,11,9,1,17,1,M C,1,1,1,13,1,1,1,1,1,15,20,1,1,1,1
19271450,Jean Michel,1651,29/03/1995,21,0,0,0,0,181,0,3,1,3,3,3,1,3,3,2,2,3,3,4,8,8,10,3,12,5,1,3,5,1,1,7,7,7,4,9,4,5,8,7,8,13,10,3,3,5,12,10,4,7,7,7,12,20,2,4,7,7,1,6,7,8,11,14,11,10,3,14,6,S C,1,1,20,15,1,1,1,1,1,1,10,1,1,1,1
19271622,Breno,1651,24/01/1996,20,0,0,0,0,177,0,1,2,3,1,3,2,3,1,3,1,1,4,5,13,8,13,5,6,7,2,6,12,1,7,10,8,4,3,3,6,9,11,6,10,9,7,7,6,7,13,13,6,8,8,6,13,20,4,6,8,8,5,8,15,7,12,10,13,10,7,16,4,AM C,1,1,14,20,4,4,2,3,8,13,15,4,4,3,5
19271691,Luiz Gustavo,1651,06/04/1997,19,0,0,0,0,177,69,1,2,2,3,1,3,4,1,3,2,3,2,1,6,11,10,3,12,4,2,3,4,5,1,7,7,7,5,10,3,4,8,1,8,10,12,2,3,4,12,12,4,3,9,12,12,20,4,6,7,6,6,7,7,14,9,10,13,10,7,9,2,S ,1,1,20,1,1,1,1,1,1,1,1,1,1,1,1
19271862,Tatto,1651,18/12/1987,28,0,0,0,0,161,0,4,3,1,3,1,3,4,2,2,1,4,4,5,1,4,8,1,7,7,7,9,9,4,14,9,9,11,9,8,9,7,11,9,9,5,7,12,8,9,14,14,8,2,20,14,14,10,13,5,9,9,9,8,8,8,13,14,10,11,6,12,5,D/WB L,1,1,1,1,1,1,1,20,1,1,1,1,1,16,1
19271927,José Aldo,1651,25/07/1998,17,0,0,0,0,160,0,1,1,1,2,2,3,3,4,1,3,3,5,7,7,10,13,3,1,7,1,6,13,5,12,12,8,4,7,4,3,11,10,8,8,11,4,4,7,11,13,12,2,1,8,12,12,20,8,5,6,7,8,8,13,8,10,10,14,11,6,12,5,M RC,1,1,1,10,1,8,1,1,1,15,20,5,18,1,7
19272133,Rafael,1651,20/12/1991,24,0,0,0,0,174,65,2,2,3,1,1,2,1,2,3,1,3,6,3,13,13,13,6,8,8,5,6,11,5,6,13,9,9,7,9,6,6,6,9,13,13,10,6,7,8,13,13,13,6,9,10,13,20,11,4,9,9,9,9,8,9,10,11,13,9,1,14,7,AM C,1,1,15,20,1,1,1,1,1,1,10,1,1,1,1
19272138,Wellerson,1651,16/06/1996,20,0,0,0,0,187,0,2,2,3,2,2,3,2,1,1,2,1,1,1,1,1,4,2,11,1,1,11,4,1,11,3,8,4,7,1,5,1,11,2,1,10,1,11,3,4,11,11,4,11,8,14,11,20,2,8,8,7,6,8,8,9,11,13,10,12,10,12,3,D C,1,1,1,1,1,1,20,1,1,1,1,1,1,1,1
19272323,Sidney,1651,25/01/1998,18,0,0,0,0,178,0,4,3,3,1,3,2,2,3,2,1,2,4,6,4,7,9,2,8,6,7,9,8,2,14,7,8,7,9,4,8,4,9,4,4,11,4,7,9,9,11,12,9,8,20,10,12,8,5,8,8,5,8,5,8,11,10,12,12,10,9,11,3,D/WB L,1,1,1,1,1,1,1,20,1,1,1,1,1,17,1
19272324,Kauê,1651,04/01/1997,19,0,0,0,0,180,68,2,3,2,1,2,3,4,2,3,1,3,5,5,14,14,12,7,14,7,7,5,9,4,4,14,9,9,8,9,7,9,11,9,13,12,14,8,7,9,14,12,8,10,20,15,14,10,6,7,9,9,9,9,9,7,12,13,9,10,3,13,3,S ,1,1,20,13,1,1,1,1,1,1,1,1,1,1,1
19272325,Jobson,1651,13/09/1995,20,0,0,0,0,177,0,3,1,3,1,3,3,2,1,3,3,3,3,6,9,8,11,7,8,8,7,5,14,2,9,11,7,7,6,8,8,10,14,2,10,8,9,8,8,9,14,14,8,5,9,16,14,20,6,7,9,9,4,9,9,17,12,8,12,12,2,11,4,AM C,1,1,12,20,1,1,1,1,1,1,13,1,1,1,1
19272326,Yuri,1651,05/06/1997,19,0,0,0,0,190,0,4,3,4,1,2,3,2,1,2,3,3,2,1,1,1,5,1,12,1,1,11,3,1,10,4,8,10,7,5,4,2,12,8,1,6,3,12,4,5,11,8,5,12,10,12,12,20,6,10,8,8,2,8,8,9,13,11,13,11,6,17,7,D C,1,1,1,1,1,1,20,1,1,1,1,1,1,1,1
19272391,Marcos Paulo,1651,14/10/1997,18,0,0,0,0,173,0,1,2,1,2,3,3,2,3,4,2,2,5,5,7,6,9,5,5,8,1,3,6,1,5,13,8,6,5,6,5,10,13,4,13,11,6,7,7,11,13,9,4,5,7,14,11,20,8,4,8,8,4,8,8,7,9,11,9,11,1,18,1,AM C,1,1,1,20,1,1,1,1,1,1,15,1,1,1,1
19272394,Lineker,1651,30/07/1998,17,0,0,0,0,171,0,2,2,3,1,3,3,2,2,3,2,3,3,2,7,7,13,5,2,11,1,5,13,1,5,12,8,7,1,3,5,13,13,5,12,11,5,7,6,9,13,13,6,1,1,8,13,20,4,5,8,8,8,8,8,20,12,5,9,6,5,6,14,AM C,1,1,1,20,1,1,1,1,1,1,15,1,1,1,1
19272395,Gustavo,1651,18/05/1998,18,0,0,0,0,175,0,3,1,3,2,3,3,3,1,2,3,1,8,7,7,4,13,8,8,10,4,8,11,1,13,14,8,11,9,9,8,8,9,3,8,11,8,14,9,12,15,11,9,5,3,2,12,20,8,9,9,6,9,7,9,17,12,10,13,11,6,1,4,DM ,1,1,1,1,1,1,1,1,1,20,10,1,1,1,1
19272397,Jefferson,1651,25/01/1997,19,0,0,0,0,178,64,2,3,1,1,2,1,2,2,1,2,1,1,5,7,7,12,5,4,7,1,4,13,2,5,11,2,5,1,6,4,8,9,6,11,4,5,6,7,11,13,11,2,7,7,15,13,20,6,4,8,8,7,4,8,16,10,9,11,11,3,13,8,AM C,1,1,1,20,1,1,1,1,1,1,15,1,1,1,1
19272398,Bruno,1651,28/02/1997,19,0,0,0,0,191,92,3,8,5,6,10,13,8,13,5,5,8,3,1,2,3,1,8,1,1,1,1,1,4,3,3,8,5,15,6,8,5,13,6,3,1,3,7,6,5,11,11,6,14,5,8,10,20,3,8,8,7,8,8,8,17,10,12,11,11,3,1,3,GK ,20,1,1,1,1,1,1,1,1,1,1,1,1,1,1
19272399,Vinícius,1651,08/06/1999,17,0,0,0,0,180,0,3,1,3,1,1,2,2,3,3,1,2,3,4,7,12,12,3,12,1,1,3,4,6,1,8,7,5,5,9,4,1,7,7,9,8,5,1,3,4,12,11,4,4,4,5,12,20,7,4,7,7,5,7,7,19,10,12,10,13,11,13,8,S ,1,1,20,1,1,1,1,1,1,1,1,1,1,1,1
19272400,Cristiano,1651,07/10/1997,18,0,0,0,0,173,0,2,2,1,4,2,1,2,3,2,1,1,7,4,6,7,10,4,8,6,7,6,6,5,9,9,8,5,9,8,6,8,11,7,3,6,5,7,8,8,15,12,4,8,20,14,12,7,7,6,8,6,8,8,8,15,13,12,13,10,12,6,6,D/WB L,1,1,1,1,1,1,1,20,1,1,1,1,1,16,1
19272401,Dentinho,1651,01/04/1999,17,0,0,0,0,188,0,3,2,3,2,2,2,3,3,3,3,2,1,2,8,13,13,4,13,5,1,2,5,1,1,8,7,9,6,6,5,5,9,3,8,6,11,5,4,6,12,7,4,12,1,7,11,20,10,10,7,7,1,7,7,19,13,10,10,11,10,6,8,S ,1,1,20,1,1,1,1,1,1,1,1,1,1,1,1
19272402,Théo,1651,25/02/1999,17,0,0,0,0,188,0,1,2,3,3,1,1,3,3,1,3,2,1,1,2,1,5,1,13,1,1,8,5,1,9,4,7,7,7,1,4,1,13,7,6,3,4,13,4,5,6,11,5,13,7,7,8,20,7,9,7,7,7,4,7,8,9,12,9,12,11,10,7,D C,1,1,1,1,1,1,20,1,1,1,1,1,1,1,1
19272403,Lucas,1651,21/06/1998,18,0,0,0,0,183,0,5,6,6,7,12,12,7,12,7,7,8,2,3,1,3,1,4,1,1,1,2,1,2,1,1,7,5,11,4,11,1,8,3,2,9,2,4,4,3,10,11,4,8,8,11,5,20,1,6,7,7,5,7,7,14,11,13,11,10,1,10,4,GK ,20,1,1,1,1,1,1,1,1,1,1,1,1,1,1
19272404,Filipe Renan,1651,23/01/1998,18,0,0,0,0,177,0,3,3,1,3,1,2,3,1,1,1,2,5,2,9,13,12,5,12,6,1,1,6,7,1,9,6,10,5,13,5,6,13,4,9,3,6,1,5,6,13,12,6,4,8,10,12,20,8,4,8,8,8,8,8,19,12,11,10,13,7,7,1,S ,1,1,20,1,1,1,1,1,1,1,1,1,1,1,1
19272521,Jackson,1651,22/11/1987,28,0,0,0,0,175,70,1,1,2,1,3,4,1,1,2,1,4,7,5,13,13,13,7,13,8,3,7,8,9,4,13,10,8,9,9,8,8,9,1,13,5,12,7,7,6,13,13,8,4,10,9,13,20,11,8,10,10,10,10,10,18,9,13,9,11,13,20,7,S ,1,1,20,1,1,1,1,1,1,1,1,1,1,1,1
19272674,Filippe Formiga,1651,16/09/1992,23,0,0,0,0,169,68,3,2,4,3,3,1,4,2,2,1,3,5,9,8,6,14,3,9,4,8,10,9,5,10,10,10,7,10,9,12,6,13,10,6,13,6,12,9,9,13,14,8,4,10,10,14,20,9,6,10,6,10,7,10,20,12,11,13,9,7,14,4,D/WB R,1,1,1,1,1,1,1,1,20,1,1,1,1,1,18
19272708,Sorín,1651,22/10/1994,21,0,0,0,0,175,68,2,4,1,4,3,1,2,3,3,3,1,7,5,5,8,10,7,7,7,1,10,12,1,13,7,9,9,3,9,8,10,14,9,7,4,7,10,8,12,12,10,8,8,13,8,11,20,8,6,9,4,7,7,9,7,10,8,11,11,8,8,4,DM/M C,1,1,1,1,1,1,1,1,1,20,18,1,1,1,1
19272709,Vitor Lins,1651,25/04/1997,19,0,0,0,0,170,67,1,3,3,2,2,1,1,1,1,2,2,8,6,14,14,14,8,9,8,4,5,10,7,2,13,10,10,8,10,7,9,12,9,12,1,10,8,8,10,13,14,9,4,10,7,14,20,12,7,10,9,4,10,10,17,11,11,12,9,8,8,7,S C,1,1,20,15,1,1,1,1,1,1,1,1,1,1,1
19272710,Sérgio,1651,20/06/1996,20,0,0,0,0,172,69,2,3,1,1,1,3,1,3,3,2,2,6,8,4,9,13,8,8,10,5,10,11,5,10,14,9,7,8,8,10,12,15,7,9,4,8,10,9,13,15,15,9,5,1,11,15,20,9,10,9,9,9,9,9,14,12,9,11,12,5,2,3,DM ,1,1,1,1,1,1,1,1,13,20,13,1,1,1,1
19272711,Edmílson,1651,08/01/1994,22,0,0,0,0,174,72,1,4,2,1,2,3,3,1,2,2,2,3,3,7,9,13,7,2,14,7,4,14,5,7,10,9,5,8,5,8,10,14,9,9,10,13,9,8,13,14,13,8,5,2,10,14,20,8,6,9,9,9,6,9,11,11,11,10,10,8,12,4,M C,1,1,1,15,1,1,1,1,1,1,20,1,1,1,1
19272712,Williams,1651,06/06/1995,21,0,0,0,0,169,67,2,2,2,2,1,1,3,1,2,1,1,5,6,4,3,13,1,8,7,5,12,9,7,11,8,8,11,10,9,10,8,15,4,8,2,8,9,9,9,14,11,5,5,20,9,11,10,8,8,9,9,2,9,9,14,13,11,8,11,4,4,4,D L,1,1,1,1,1,1,1,20,1,1,1,1,1,1,1
19272743,Felipe,1651,10/04/1994,22,0,0,0,0,185,0,2,3,3,3,2,1,2,1,3,2,1,8,8,8,9,12,8,8,13,1,11,14,5,14,9,4,14,9,9,10,7,12,1,7,13,8,8,9,8,14,11,4,10,5,17,13,20,7,10,10,10,10,5,10,7,12,9,11,9,7,11,4,DM ,1,1,1,1,1,1,1,1,1,20,10,1,1,1,1
19272744,Bruno Melo,1651,26/10/1992,23,0,0,0,0,183,72,2,1,3,1,2,3,2,1,3,1,2,10,11,12,6,12,8,8,7,10,11,12,5,13,13,11,12,12,11,8,8,11,5,8,5,15,11,12,12,13,15,11,7,20,15,13,8,13,8,11,8,7,5,8,18,13,12,11,9,8,7,7,D/WB L,1,1,1,1,1,1,1,20,1,1,1,1,1,19,1
19272752,Júnior Mandacaru,1651,04/07/1993,22,0,0,0,0,178,74,2,3,4,1,2,2,3,1,3,1,2,6,10,11,13,13,6,13,6,6,5,5,8,3,13,9,5,3,8,7,6,9,4,13,1,10,7,6,8,13,11,12,6,20,13,11,10,14,7,9,8,9,5,9,14,11,11,11,9,11,10,4,AM/S L,1,1,20,1,18,1,1,1,1,1,1,1,1,1,1
19272761,Alexsander,1651,06/09/1998,17,0,0,0,0,169,62,1,2,1,2,3,2,1,1,1,1,2,6,3,14,9,13,6,6,10,1,6,10,3,7,13,9,4,5,6,4,12,10,4,15,4,8,6,7,8,13,13,4,3,20,13,13,10,11,4,9,5,9,3,8,20,14,12,13,10,7,5,3,AM C,1,1,1,20,10,1,1,1,1,1,10,10,1,1,1
19272777,Gabriel,1651,09/02/1999,17,0,0,0,0,187,0,3,2,3,2,2,2,1,3,2,4,1,1,1,2,6,11,1,14,6,1,5,7,4,11,10,6,12,9,8,9,6,14,3,6,6,5,14,7,8,12,12,6,10,8,12,12,20,6,11,9,9,4,9,9,8,9,13,9,12,10,4,8,D C,1,1,1,1,1,1,20,1,1,1,1,1,1,1,1
19272974,Pepeta,1651,12/05/1988,28,0,0,0,0,183,72,4,2,2,3,1,2,3,3,3,3,2,5,3,12,12,12,5,10,1,1,5,6,9,5,11,9,8,5,12,6,5,11,6,12,8,9,4,5,7,12,12,3,8,12,11,12,20,11,8,9,8,15,9,8,17,13,10,9,8,1,16,4,S ,1,1,20,1,1,1,1,1,1,1,1,1,1,1,1
19272977,Flávio,1651,25/06/1988,28,0,0,0,0,169,72,2,4,1,2,1,4,4,2,1,1,1,5,10,9,1,14,4,7,3,3,8,9,2,13,11,9,9,6,8,8,8,10,3,10,14,6,9,7,9,14,14,8,5,10,13,14,20,6,11,9,8,9,9,9,9,10,11,11,11,7,11,3,D/WB R,1,1,1,1,1,15,1,1,20,1,1,1,15,1,19
19272986,Lorran,1651,01/04/1992,24,0,0,0,0,182,0,2,3,3,3,1,3,1,3,1,1,3,4,6,4,6,14,4,9,3,5,10,10,5,15,10,9,11,9,10,11,5,12,9,1,7,7,9,10,10,13,13,10,8,20,12,12,10,10,9,9,4,7,9,9,8,10,8,11,8,10,11,5,D/WB L,1,1,1,1,1,1,1,20,1,1,1,1,1,19,1
19272993,Carlos Jamisson,1651,29/07/1995,20,0,0,0,0,186,0,3,1,3,3,1,2,2,1,4,1,1,5,7,7,5,12,1,8,7,7,9,9,5,14,9,9,8,9,9,7,9,10,2,9,4,7,5,9,9,14,10,7,9,20,15,12,9,11,10,9,6,8,6,9,10,8,10,12,11,3,6,2,D/WB L,1,1,1,1,1,1,1,20,1,1,1,1,1,19,1
19273071,Daniel Cruz,1651,03/06/1990,26,0,0,0,0,186,85,1,1,1,1,3,1,3,1,2,2,1,6,8,7,13,14,6,14,9,5,8,11,14,8,7,9,12,13,12,11,11,11,13,8,11,10,12,13,13,13,12,13,14,11,11,13,20,13,14,10,9,9,8,7,12,12,12,11,13,13,10,10,S ,1,1,20,1,11,11,1,1,1,1,1,1,1,1,1
19273072,Jonata,1651,26/11/1997,18,0,0,0,0,188,75,1,2,2,3,3,3,2,2,2,1,2,4,3,5,12,12,3,13,5,3,5,8,11,4,7,10,11,12,12,12,10,12,10,11,8,8,12,12,11,13,12,11,14,9,12,13,20,12,15,10,10,10,4,4,9,12,12,10,12,8,6,3,S ,1,1,20,1,1,1,1,1,1,1,1,1,1,1,1
19273073,Kanu,1651,04/02/1990,26,0,0,0,0,182,72,1,1,3,3,3,2,1,3,3,2,1,8,4,14,14,14,7,10,7,2,8,9,10,4,14,5,10,9,11,9,8,12,1,13,12,14,9,8,9,14,13,9,7,1,9,14,20,14,9,10,7,9,10,10,7,13,10,10,11,6,11,6,S ,1,1,20,1,1,1,1,1,1,1,1,1,1,1,1
19273074,Sérgio Raphael,1651,23/10/1992,23,0,0,0,0,189,84,1,3,3,3,1,1,4,2,4,4,2,8,3,4,6,9,4,13,5,6,14,9,1,14,4,10,11,10,9,8,6,14,6,1,3,6,14,8,9,7,13,9,13,10,12,12,20,9,11,10,5,10,6,10,20,12,10,11,11,5,13,3,D C,1,1,1,1,1,1,20,1,1,1,1,1,1,1,1
19273275,Liziero,1651,07/02/1998,18,0,0,0,0,174,64,2,2,4,3,2,3,2,2,3,2,1,7,9,10,7,12,10,5,11,4,7,11,5,10,11,9,11,8,9,3,12,11,14,13,1,11,9,11,8,9,10,8,8,20,11,9,8,11,8,8,5,9,8,9,17,9,12,12,14,10,5,5,DM/M C,1,1,1,12,1,1,1,1,1,20,18,1,1,1,1
19273276,Militão,1651,18/01/1998,18,0,0,0,0,185,0,1,3,1,2,3,3,3,3,3,2,1,5,7,8,6,10,7,11,9,5,11,10,3,10,10,14,11,13,9,5,11,14,8,9,1,7,11,11,11,11,10,12,11,10,15,11,20,12,12,13,9,3,9,9,20,10,11,10,12,3,4,8,D/DM C,1,1,1,1,1,1,17,1,1,20,15,1,1,1,1
19273277,Dodô,1651,17/11/1998,17,0,0,0,0,166,68,1,3,3,3,1,1,1,2,2,1,2,8,8,14,8,13,7,12,7,11,9,13,10,10,14,10,9,12,11,12,13,12,2,14,8,13,8,12,12,15,12,8,5,11,13,14,20,12,12,11,1,6,11,11,9,9,13,12,11,7,6,2,D/WB R,1,1,1,1,1,1,1,1,20,1,1,1,1,1,19
19273278,Guilherme,1651,15/05/1998,18,0,0,0,0,188,0,2,2,3,1,2,3,2,1,4,2,1,8,8,9,8,12,5,10,9,1,11,12,5,14,14,10,7,9,9,12,12,14,8,13,9,12,7,9,10,11,10,9,11,20,6,14,10,10,8,10,8,4,10,9,18,11,8,12,11,2,7,4,D/M/AM LC,1,1,1,20,1,1,18,15,1,1,18,1,1,15,1
19273279,Arthur Gomes,1651,03/07/1998,17,0,0,0,0,175,68,2,2,3,3,3,4,2,1,1,3,1,9,11,16,12,11,11,10,11,8,7,12,11,11,12,7,11,8,10,12,11,11,11,14,7,10,5,10,12,14,14,6,5,8,12,15,20,11,7,12,5,3,9,11,20,11,11,11,8,6,16,8,AM R,1,1,13,1,13,20,1,1,1,1,1,1,1,1,1
19273471,Lucão,1651,29/01/1998,18,0,0,0,0,190,98,13,11,10,6,12,11,10,11,11,11,12,6,1,1,2,9,8,7,1,3,2,9,3,2,10,10,11,11,10,11,10,11,9,2,11,3,10,11,10,11,11,12,15,5,14,11,20,6,11,8,7,9,5,10,20,11,10,13,9,10,18,4,GK ,20,1,1,1,1,1,1,1,1,1,1,1,1,1,1
19273472,Vitinho,1651,23/07/1999,16,0,0,0,0,176,0,3,3,2,2,2,2,2,3,2,3,2,7,10,11,10,10,7,8,6,9,7,10,8,9,10,7,10,10,8,8,10,10,8,12,7,12,7,10,12,13,12,7,6,8,10,13,20,11,6,8,7,9,9,12,17,12,11,11,10,10,9,7,D/WB/M R,1,1,1,1,1,14,1,1,20,1,1,1,18,1,19
19273511,Guilherme Nunes,1651,12/07/1998,17,0,0,0,0,183,0,1,2,4,1,3,2,3,1,1,1,1,5,2,5,8,13,7,9,9,1,11,8,3,13,9,10,8,9,6,11,9,13,8,5,9,3,13,8,12,13,11,4,9,20,15,12,10,8,8,10,10,10,9,15,8,10,10,10,14,8,4,3,DM C,1,1,1,1,1,1,15,12,1,20,1,1,1,1,1
19273512,Giovane Mário,1651,23/03/1998,18,0,0,0,0,168,58,1,2,1,2,2,2,3,2,3,3,2,4,7,3,8,14,7,7,11,1,11,12,6,12,14,9,6,5,9,6,13,14,8,9,10,6,7,8,12,12,13,3,1,20,16,14,12,8,9,9,6,9,5,9,17,10,11,13,10,4,15,2,M C,1,1,1,10,1,1,1,1,1,13,20,1,1,1,1
19273516,Diego Valderrama,1651,19/09/1994,21,0,0,0,0,177,66,2,1,3,3,3,3,3,2,1,1,2,6,3,9,7,13,7,5,11,1,5,14,1,8,13,9,8,8,9,9,9,13,9,12,11,9,11,8,12,14,14,4,8,10,14,14,20,8,5,9,9,9,4,9,12,10,11,11,9,5,5,3,M/AM C,1,1,1,18,1,1,1,1,1,15,20,1,1,1,1
19273536,Mateus Oliveira,1651,19/08/1995,20,0,0,0,0,171,70,3,1,2,1,2,2,1,4,1,2,2,8,5,14,14,10,8,13,4,3,6,7,8,3,10,4,12,3,11,9,8,13,5,9,12,11,7,8,9,14,10,9,2,10,17,12,20,10,8,9,4,10,10,10,13,10,11,12,8,9,6,7,S ,1,1,20,1,1,1,1,1,1,1,1,1,1,1,1
19273570,Jefferson Garcia,1651,02/01/1996,20,0,0,0,0,181,73,1,2,1,1,1,3,3,2,2,1,3,5,4,13,13,11,2,8,4,1,3,6,4,1,13,8,7,7,9,5,6,10,8,13,13,13,4,5,6,13,13,5,8,8,9,13,20,5,6,8,8,6,7,8,20,14,8,11,11,7,3,2,S ,1,1,20,1,1,1,1,1,1,1,1,1,1,1,1
19273581,David Duarte,1651,24/01/1994,22,0,0,0,0,192,84,2,1,2,3,2,1,1,2,1,1,2,6,7,6,6,13,7,16,9,12,13,11,6,14,9,11,12,12,11,11,6,11,10,5,11,10,11,13,13,11,11,9,16,2,15,13,20,13,17,8,11,10,10,8,13,11,12,8,11,1,8,8,D C,1,1,1,1,1,1,20,1,1,1,1,1,1,1,1
19273583,Gélson,1651,20/01/1994,22,0,0,0,0,186,73,1,1,2,2,3,2,1,1,2,3,3,7,5,4,5,13,7,7,13,3,7,12,3,12,11,3,10,9,8,8,13,13,10,10,9,5,9,8,11,13,10,8,13,10,17,13,20,7,10,10,10,10,10,10,19,10,10,11,9,2,18,1,DM ,1,1,1,1,1,1,1,1,1,20,10,1,1,1,1
19273584,Matheus Oliveira,1651,06/09/1996,19,0,0,0,0,171,0,1,3,3,1,3,3,3,2,1,1,1,7,9,7,5,10,4,6,6,8,9,10,3,13,6,9,6,10,8,8,10,15,9,9,12,8,8,10,10,15,10,7,8,20,10,12,10,11,8,8,9,4,9,9,9,12,10,10,12,1,9,3,D/WB L,1,1,1,1,1,1,1,20,1,1,1,1,1,19,1
19273585,Silas,1651,30/05/1996,20,0,0,0,0,176,72,2,3,1,4,1,2,3,3,1,3,2,7,5,5,6,14,7,6,10,2,9,14,3,12,14,3,8,5,5,7,14,14,4,9,10,7,5,8,7,14,14,7,7,10,12,14,20,9,7,9,2,9,8,9,9,13,9,12,12,1,12,3,M C,1,1,1,1,1,1,1,1,1,1,20,1,1,1,1
19273692,Ayrton,1651,14/04/1996,20,0,0,0,0,173,70,1,3,3,1,2,3,1,3,3,1,3,8,6,13,14,14,8,14,5,1,7,9,6,2,12,6,11,6,12,9,5,10,10,11,7,14,8,8,9,14,12,9,2,9,14,11,20,13,7,10,10,3,6,10,13,11,12,9,11,3,15,2,S ,1,1,20,1,1,1,1,1,1,1,1,1,1,1,1
19273697,Sandes Neto,1651,08/04/1996,20,0,0,0,0,179,72,1,1,1,2,3,2,1,1,1,3,1,7,5,13,14,14,4,14,8,1,6,8,6,1,14,9,8,4,9,7,7,14,9,13,11,13,5,7,8,8,10,11,10,10,12,13,20,7,9,9,9,2,5,9,14,10,12,9,10,5,14,7,S ,1,1,20,1,1,1,1,1,1,1,1,1,1,1,1
19273701,Eduardo,1651,09/01/1997,19,0,0,0,0,177,0,3,3,2,1,2,3,3,2,2,2,1,5,2,6,7,13,5,1,7,3,4,11,2,5,10,5,5,4,6,6,13,7,8,10,6,3,4,7,10,11,11,11,7,9,14,13,20,6,5,8,8,8,7,8,11,11,10,8,10,6,1,3,AM C,1,1,1,20,1,1,1,1,1,1,10,1,1,1,1
19273702,Leandro,1651,06/03/1999,17,0,0,0,0,189,0,2,4,3,2,1,3,3,2,2,1,3,3,6,4,2,9,1,4,3,4,6,6,1,10,6,7,6,7,5,6,5,7,4,7,8,3,7,5,6,13,12,5,13,8,8,13,20,10,9,7,7,4,7,7,20,12,11,10,11,6,11,5,D R,1,1,1,1,1,1,1,1,20,1,1,1,1,1,15
19273703,Vinicius,1651,16/04/1999,17,0,0,0,0,186,0,9,10,8,1,12,15,7,12,8,8,9,2,2,3,1,1,4,1,1,3,3,1,1,1,2,8,3,12,4,3,4,12,5,2,8,2,8,5,4,7,10,2,11,7,11,11,20,1,7,8,8,8,7,8,10,10,11,9,12,9,14,6,GK ,20,1,1,1,1,1,1,1,1,1,1,1,1,1,1
19273774,Alessandro,1651,13/03/1997,19,0,0,0,0,194,90,2,1,2,1,1,1,1,1,2,1,3,4,1,10,11,12,3,10,4,1,3,5,4,1,8,8,8,1,10,4,4,9,6,10,10,12,4,4,4,12,9,5,15,20,11,9,9,7,13,8,8,8,8,8,12,12,12,10,12,4,14,2,S ,1,1,20,1,1,1,1,1,1,1,1,1,1,1,1
19273896,Índio,1651,24/01/1998,18,0,0,0,0,173,66,3,3,2,2,2,3,2,2,3,2,1,7,8,10,10,10,7,8,8,7,4,9,9,4,10,8,9,3,10,7,10,11,6,7,9,10,7,8,9,13,13,14,6,20,12,13,8,7,7,9,3,5,9,10,15,11,10,11,11,3,1,1,AM/S C,1,1,17,20,1,1,1,1,1,1,10,1,1,1,1
19274206,Cícero,1651,10/05/1997,19,0,0,0,0,178,66,3,2,2,3,2,2,3,2,2,3,3,5,5,3,7,13,1,5,14,6,10,9,1,14,10,9,12,4,5,6,10,13,5,1,3,7,7,8,12,13,11,8,8,8,11,10,20,8,6,9,9,5,4,9,17,10,11,11,12,1,11,3,DM ,1,1,1,1,1,1,1,1,1,20,10,1,1,1,1
19274207,Marthã,1651,20/06/1997,19,0,0,0,0,181,69,2,2,1,1,3,1,1,2,3,3,2,4,8,7,4,11,7,7,4,7,9,12,5,13,9,8,7,8,6,8,12,13,4,7,10,7,8,8,9,7,10,8,10,9,10,11,20,8,9,7,8,3,5,8,19,9,11,13,11,5,12,2,D RC,1,1,1,1,1,1,1,1,20,12,15,1,1,1,15
19274258,Jackson,1651,25/02/1996,20,0,0,0,0,182,0,3,1,2,2,1,2,2,3,2,3,4,4,6,6,4,12,5,5,6,1,7,13,1,13,8,8,4,3,3,8,6,13,3,7,10,5,11,6,7,13,11,3,8,3,13,11,20,6,6,8,8,7,8,8,14,13,12,11,11,9,18,7,D/DM R,1,1,1,1,1,1,1,1,17,20,10,1,1,1,13
19274259,Lucas Mineiro,1651,24/02/1996,20,0,0,0,0,178,71,2,3,3,1,3,1,2,1,3,1,1,8,8,3,8,14,8,8,10,4,6,9,9,10,12,12,7,9,7,5,12,14,10,10,3,10,8,9,13,14,14,9,7,10,11,14,20,9,7,10,13,6,10,16,14,8,11,9,11,1,16,1,DM/M C,1,1,1,7,7,1,7,12,1,16,20,8,1,10,1
19274330,Menezes,1651,22/08/1997,18,0,0,0,0,177,72,3,4,1,1,3,3,3,3,3,3,3,7,7,6,4,14,7,7,7,1,8,10,1,13,9,5,5,8,8,10,10,14,9,9,7,5,9,8,12,14,11,12,8,10,11,11,20,8,8,7,9,6,5,9,17,12,13,10,13,12,15,2,DM ,1,1,1,1,1,1,1,1,12,20,10,1,1,1,9
19274607,Dudu Mandai,1651,26/01/1993,23,0,0,0,0,172,68,3,3,2,1,2,2,1,1,3,2,3,8,10,7,10,5,6,8,6,6,6,8,4,8,4,6,6,8,7,8,6,13,7,7,11,10,6,7,8,13,9,13,5,20,12,11,9,13,5,8,4,8,7,9,13,13,9,11,12,1,10,2,AM/S L,1,1,20,1,18,1,1,15,1,1,1,10,1,15,1
19274612,Lipe,1651,07/04/1997,19,0,0,0,0,174,0,3,2,1,2,2,3,2,3,3,1,2,3,5,7,7,8,5,5,13,1,4,11,2,6,13,8,5,4,4,2,10,13,4,13,11,9,7,7,10,12,10,6,4,8,12,12,20,7,4,8,8,8,7,8,15,11,7,9,11,8,1,7,AM C,1,1,1,20,1,1,1,1,1,1,15,1,1,1,1
19274636,Thiago Gregório,1651,13/01/1996,20,0,0,0,0,188,76,1,1,3,2,3,3,1,3,4,1,2,4,2,8,12,9,4,6,4,3,4,2,9,1,5,5,7,6,12,5,2,7,4,8,5,12,2,4,5,12,12,1,12,11,14,11,20,3,8,8,8,8,8,7,8,11,8,10,11,4,9,1,S ,1,1,20,1,1,1,1,1,1,1,1,1,1,1,1
19274637,Giovani,1651,01/07/1999,17,0,0,0,0,173,0,3,1,1,1,3,2,2,4,1,3,3,4,1,1,1,11,4,5,6,1,5,9,1,11,7,7,9,6,3,3,7,13,5,7,7,2,11,6,11,13,12,2,7,7,12,13,20,7,4,5,7,7,7,7,19,11,12,11,9,11,6,8,DM ,1,1,1,1,1,1,12,1,1,20,10,1,1,1,1
19274672,Bryan,1651,03/08/1996,19,0,0,0,0,176,74,1,1,3,2,2,4,3,1,1,1,3,7,12,12,6,8,5,5,6,4,4,6,3,4,12,6,5,6,6,6,6,9,3,13,1,6,4,5,6,12,12,11,5,9,14,12,20,6,7,8,8,4,4,8,16,11,9,11,13,1,16,2,AM RL,1,1,13,1,16,20,1,1,1,1,1,1,1,1,1
19274673,Igor Mutante,1651,25/01/1996,20,0,0,0,0,182,0,1,4,1,3,3,1,3,3,1,2,2,2,3,12,11,12,4,12,3,4,4,5,5,1,10,8,10,4,10,4,4,5,4,11,9,12,3,4,5,12,12,5,5,8,7,12,20,5,6,8,8,8,7,8,7,10,13,13,13,9,13,6,S ,1,1,20,1,1,1,1,1,1,1,1,1,1,1,1
19274705,Melk,1651,26/09/1995,20,0,0,0,0,183,78,2,2,2,1,1,3,2,3,2,1,3,7,7,13,13,14,5,7,9,1,4,5,3,8,14,8,9,6,7,5,11,13,9,13,8,8,3,8,13,12,14,8,9,7,10,14,20,10,9,9,9,3,9,8,18,12,12,10,11,6,3,1,AM C,1,1,1,20,1,1,1,1,1,1,10,1,1,1,1
19274707,Léo Coelho,1651,17/05/1993,23,0,0,0,0,189,88,2,1,1,1,1,3,2,2,2,1,1,3,6,1,6,8,6,12,5,6,12,8,1,12,7,4,9,10,7,8,5,12,10,8,12,6,12,6,8,12,11,7,11,10,6,11,20,10,9,10,5,10,8,10,12,11,13,10,11,1,9,4,D/DM C,1,1,1,1,1,1,20,1,1,18,10,1,1,1,1
19274734,Neguete,1651,06/03/1990,26,0,0,0,0,196,85,12,8,11,1,14,12,10,14,9,10,10,1,3,1,3,3,3,1,2,2,1,2,2,3,6,7,8,15,8,10,8,10,10,2,11,3,12,9,8,9,14,5,17,10,8,10,20,4,15,8,10,10,10,10,17,12,9,9,10,14,7,7,GK ,20,1,1,1,1,1,1,1,1,1,1,1,1,1,1
19275421,André Anderson,1651,23/09/1999,16,0,0,0,0,182,0,3,1,2,2,1,2,2,1,3,1,1,7,5,12,13,11,7,11,11,5,3,9,9,7,13,10,13,9,13,8,10,13,17,11,9,12,5,7,4,13,12,12,9,10,6,13,20,9,12,9,4,6,8,10,8,11,11,11,11,1,15,5,S ,1,1,20,13,1,1,1,1,1,1,1,1,1,1,1
19277236,Júnior,1651,21/01/1992,24,0,0,0,0,172,69,1,3,2,1,2,2,1,3,2,1,1,4,6,8,3,9,2,9,8,8,10,10,2,10,10,10,12,10,10,11,9,14,4,9,11,8,9,10,10,14,14,10,4,11,6,14,20,14,7,10,10,10,10,10,18,12,10,13,10,9,7,8,D/WB R,1,1,1,1,1,1,1,1,20,1,1,1,1,1,19
19277609,Luís Soares,1651,30/06/1991,25,0,0,0,0,179,77,1,3,2,1,1,2,2,2,3,3,2,8,12,13,12,11,7,6,11,4,9,12,11,9,12,9,12,13,11,10,11,10,13,9,10,13,12,12,12,14,13,13,7,11,14,14,20,13,9,11,8,10,8,13,10,12,11,10,11,12,12,10,AM/S R,1,1,20,1,1,20,1,1,1,1,1,1,10,1,1
19277610,Ronaldo,1651,26/08/1984,31,0,0,0,0,175,74,2,1,2,2,1,3,2,3,2,3,1,6,10,9,2,12,8,4,8,8,8,10,6,14,10,7,9,9,8,12,7,14,2,7,9,9,9,6,9,12,13,4,10,10,14,14,20,8,6,9,6,9,9,9,17,11,10,12,12,2,19,7,D/WB R,1,1,1,1,1,1,1,1,20,1,1,1,15,1,19
19277996,Bruno Nascimento,1651,22/01/1996,20,0,0,0,0,172,67,2,1,2,3,2,3,1,2,1,3,2,8,5,10,10,14,8,8,9,5,9,14,4,7,13,10,8,7,7,6,13,14,11,12,12,13,10,9,13,14,11,9,2,11,8,12,20,14,6,9,5,4,10,10,11,12,10,11,12,11,10,10,M/AM C,1,1,1,20,1,1,1,1,1,1,18,1,1,1,1
19278009,Willames José,1651,22/01/1990,26,0,0,0,0,187,86,1,1,1,2,2,3,4,2,1,4,1,5,6,4,3,5,13,14,9,4,13,5,3,13,8,12,12,13,11,11,5,12,12,13,12,6,11,13,13,13,12,11,15,1,11,13,20,12,15,10,12,11,8,6,11,12,11,13,12,11,13,10,D C,1,1,1,1,1,1,20,1,1,1,1,1,1,1,1
19278010,Thiago Papel,1651,30/12/1991,24,0,0,0,0,186,79,1,3,2,1,3,1,2,1,1,3,3,6,1,2,3,7,3,11,3,5,13,5,1,13,3,10,13,10,8,8,2,13,1,5,6,7,13,7,8,13,13,8,7,10,11,13,20,9,12,10,8,6,10,10,12,11,11,9,9,6,9,3,D C,1,1,1,1,1,1,20,1,1,1,1,1,1,1,1
19278011,Jair,1651,04/04/1992,24,0,0,0,0,171,67,3,3,4,1,2,3,2,3,2,1,1,7,7,8,8,13,7,7,9,3,8,14,3,14,11,9,12,8,5,7,13,14,4,7,12,8,10,8,9,10,13,8,6,8,16,11,20,7,11,8,3,5,8,9,19,10,11,13,12,4,8,8,DM C,1,1,1,1,1,1,1,1,1,20,15,1,1,1,1
19278012,Tiago Lima,1651,12/10/1984,31,0,0,0,0,186,75,3,1,3,1,1,3,1,3,3,2,2,9,7,11,11,16,9,4,10,4,9,16,7,9,15,9,11,9,9,10,12,13,3,12,13,10,10,10,13,9,11,7,13,1,12,11,20,10,11,4,9,9,9,9,12,8,10,11,12,11,7,6,M/AM C,1,1,1,18,1,1,1,1,1,1,20,1,1,1,1
19278013,João Paulo,1651,04/05/1990,26,0,0,0,0,169,67,1,4,3,3,1,1,1,3,2,3,1,12,13,12,11,10,12,4,13,4,5,12,13,4,12,10,11,12,10,11,11,9,12,7,9,11,11,12,12,13,12,9,4,11,13,12,20,13,5,10,8,9,7,9,12,12,11,10,12,11,9,8,AM RC,1,1,1,19,1,20,1,1,1,1,1,1,15,1,1
19278014,Ferreira,1651,02/02/1985,31,0,0,0,0,188,79,12,9,6,1,10,12,9,12,6,9,8,1,2,1,1,1,3,1,2,2,2,1,2,3,3,4,8,14,4,10,5,12,9,1,13,2,10,6,5,12,11,4,12,12,9,9,20,3,10,9,9,9,4,9,8,13,10,10,11,7,10,4,GK ,20,1,1,1,1,1,1,1,1,1,1,1,1,1,1
19278015,Roger,1651,12/04/1992,24,0,0,0,0,180,76,2,2,1,1,2,3,1,2,1,1,2,7,12,8,10,11,5,9,6,5,3,6,6,2,12,9,10,8,8,5,7,8,2,13,11,11,6,5,7,12,12,5,8,10,10,12,20,12,8,9,4,4,9,9,20,10,11,10,10,7,15,1,AM/S R,1,1,20,1,1,18,1,1,1,1,1,1,1,1,1
19278016,Igor Cariús,1651,01/05/1993,23,0,0,0,0,173,68,2,1,3,2,1,3,1,3,2,3,3,9,8,8,9,13,7,9,9,9,11,10,5,11,11,10,13,11,9,8,10,11,8,3,3,9,10,10,10,15,15,10,4,20,12,15,10,11,7,10,4,4,10,10,8,11,14,12,10,8,13,7,D L,1,1,1,1,1,1,1,20,1,1,1,1,1,15,1
19278101,Jadson,1651,09/07/1992,23,0,0,0,0,189,85,3,3,1,2,2,2,1,3,1,3,1,1,1,1,1,5,1,12,1,1,7,6,4,11,4,3,6,8,6,9,4,13,2,2,9,2,13,5,6,8,10,6,13,16,10,9,20,8,12,8,7,6,8,8,17,9,12,9,12,1,19,4,D C,1,1,1,1,1,1,20,1,1,1,1,1,1,1,1
19278311,Luiz Fernando,1651,25/10/1993,22,0,0,0,0,169,56,3,3,3,2,2,3,1,3,3,3,1,10,10,11,11,10,11,7,11,5,7,11,9,8,11,8,11,9,10,10,12,11,10,10,8,11,7,11,13,15,16,9,6,20,11,14,8,13,9,9,6,10,5,11,20,14,9,11,12,1,10,4,AM C,1,1,1,20,12,1,1,7,1,1,15,10,1,8,1
19278386,Leandrinho,1651,21/09/1996,19,0,0,0,0,174,70,2,2,3,4,2,4,2,2,3,3,2,13,13,14,13,13,12,11,13,14,11,14,12,12,15,5,12,14,13,11,15,13,9,12,12,14,14,14,12,14,14,16,11,20,13,12,5,13,14,13,5,12,5,12,16,9,14,14,12,12,14,5,M/AM LC,1,1,1,20,17,1,1,1,1,1,17,1,1,1,1
19278721,Luigi,1651,25/01/1997,19,0,0,0,0,180,77,1,1,3,2,2,2,3,1,1,1,1,9,7,9,11,8,9,9,12,5,9,13,6,9,10,3,9,10,7,10,15,15,7,9,13,10,11,10,13,11,11,9,9,9,10,8,20,8,7,10,10,6,6,10,14,8,11,10,11,12,3,4,M/AM C,1,1,1,20,1,1,1,1,1,1,18,1,1,1,1
19278722,Matheus Peixoto,1651,16/11/1995,20,0,0,0,0,190,89,3,1,3,2,1,3,1,2,3,1,1,3,7,8,11,10,7,11,10,4,5,10,11,5,10,13,8,12,8,7,10,8,2,12,5,12,8,11,11,12,10,5,14,9,12,11,20,12,14,12,6,9,5,9,9,12,12,13,10,9,8,7,S ,1,1,20,1,14,1,1,1,1,1,1,1,1,1,1
19278723,Kaynan,1651,16/07/1997,18,0,0,0,0,176,0,3,2,1,1,3,3,3,3,2,3,1,8,9,12,12,13,8,10,10,7,8,11,11,7,13,9,11,10,9,8,11,9,10,13,4,13,8,11,11,13,14,9,8,9,12,14,20,12,6,12,8,10,4,10,19,12,9,11,13,10,9,6,AM/S L,1,1,20,1,17,14,1,1,1,1,1,1,1,1,1
19278724,Zeca,1651,06/03/1997,19,0,0,0,0,190,80,4,2,3,2,3,2,1,1,3,2,2,7,8,13,9,13,7,8,8,7,9,11,1,9,11,10,5,6,8,7,11,13,2,11,8,9,3,8,8,12,11,8,13,9,13,11,20,12,12,10,10,8,10,10,11,13,8,12,11,12,5,7,M/AM C,1,1,13,18,12,12,1,1,1,10,20,1,1,1,1
19278773,Douglas,1651,29/09/1994,21,0,0,0,0,189,90,14,8,7,3,14,13,9,13,8,9,13,1,1,2,2,5,4,1,3,3,1,1,4,3,4,9,9,15,8,6,7,13,9,1,7,2,12,8,7,14,6,8,14,8,9,13,20,7,10,9,9,2,9,9,7,12,12,11,10,3,6,2,GK ,20,1,1,1,1,1,1,1,1,1,1,1,1,1,1
19278774,Raul,1651,28/07/1997,18,0,0,0,0,185,77,10,12,11,8,11,12,12,13,9,9,13,4,2,2,1,2,7,1,2,1,1,1,2,2,3,9,7,9,4,11,7,14,7,3,7,1,7,8,7,14,7,8,11,9,8,13,20,5,8,9,9,8,9,9,10,11,10,11,9,1,16,1,GK ,20,1,1,1,1,1,1,1,1,1,1,1,1,1,1
19278775,Padel,1651,10/08/1994,21,0,0,0,0,177,72,1,3,2,3,3,3,1,1,3,3,3,4,8,5,4,9,2,8,2,7,8,9,5,11,9,8,8,6,9,7,9,10,4,6,14,7,7,9,9,14,12,9,10,9,11,12,20,9,9,3,6,8,7,8,19,11,12,12,9,5,10,6,D/WB R,1,1,1,1,1,1,1,1,20,1,1,1,1,1,19
19278957,Felix,1651,02/04/1998,18,0,0,0,0,185,0,3,3,1,1,3,3,3,3,2,1,2,7,4,3,3,8,4,13,7,6,13,8,2,12,3,9,11,9,7,7,6,14,9,9,11,6,11,7,8,14,9,8,11,9,15,11,20,9,10,9,5,9,9,9,15,12,11,12,10,10,7,6,D C,1,1,1,1,1,1,20,1,1,1,1,1,1,1,1
19278958,Baiano,1651,23/06/1998,18,0,0,0,0,172,0,1,3,2,1,2,2,3,3,3,3,1,5,5,3,7,14,6,6,12,1,7,12,3,13,9,6,5,7,5,7,12,7,8,8,6,7,6,8,11,11,8,4,2,7,11,10,20,6,5,8,8,7,8,8,10,11,12,9,10,11,1,5,DM C,1,1,1,1,1,1,1,1,1,20,15,1,1,1,1
19278959,Paulo Vítor,1651,01/07/1999,17,0,0,0,0,170,0,1,3,3,2,1,1,3,2,2,2,1,5,7,5,8,12,8,8,11,4,7,15,5,13,15,9,6,8,7,9,11,15,20,9,1,6,11,9,12,12,15,9,3,2,9,15,20,8,6,9,9,9,9,9,20,11,10,10,10,5,1,7,DM/M C,1,1,1,1,1,1,1,1,1,18,20,1,1,1,1
19278960,Francisco,1651,21/02/1999,17,0,0,0,0,184,0,2,3,3,1,1,2,2,4,1,1,1,8,10,14,14,13,6,8,7,5,4,9,7,6,11,7,6,3,8,5,8,12,6,10,1,7,6,4,8,14,13,4,12,3,13,14,20,8,10,8,9,9,9,9,10,11,10,10,12,6,1,4,AM/S R,1,1,17,13,1,20,1,1,1,1,1,1,1,1,1
19279326,Rômulo,1651,09/01/1994,22,0,0,0,0,187,0,3,2,2,2,2,2,3,1,2,2,1,7,7,12,13,13,4,13,7,1,7,7,10,3,13,10,6,8,11,7,6,11,1,13,9,11,8,7,8,13,13,8,10,9,14,13,20,12,7,10,10,10,5,10,16,10,13,11,14,12,1,5,S ,1,1,20,1,1,1,1,1,1,1,1,1,1,1,1
19279328,Paulo Victor,1651,22/03/1996,20,0,0,0,0,177,0,2,2,2,1,2,1,3,3,1,3,2,7,5,9,9,14,7,6,7,2,5,12,5,8,14,7,9,6,14,8,14,10,8,13,3,9,9,8,8,14,14,6,6,6,15,14,20,10,7,9,6,3,4,9,17,12,13,10,12,4,10,2,AM C,1,1,10,20,1,1,1,1,1,1,15,1,1,1,1
19279515,Hugo Pereira,1651,11/07/1996,19,0,0,0,0,191,85,10,8,11,9,13,13,7,13,8,9,11,4,1,3,2,1,9,1,3,3,2,1,1,3,4,9,8,8,5,9,6,11,4,3,4,1,7,7,6,12,15,7,10,6,6,13,20,2,9,9,8,9,9,9,9,10,13,10,12,4,7,1,GK ,20,1,1,1,1,1,1,1,1,1,1,1,1,1,1
19279516,Ismael,1651,30/08/1996,19,0,0,0,0,176,0,1,2,1,2,1,1,3,2,4,2,3,7,9,12,8,13,7,5,9,7,7,9,2,7,9,8,10,8,6,9,10,6,9,9,13,9,8,9,9,10,13,9,9,20,16,14,10,8,5,9,9,3,4,9,19,11,10,11,13,8,9,1,M/AM LC,1,1,1,18,20,1,1,10,1,1,1,16,1,14,1
19279522,Frank Martins,1651,02/02/1998,18,0,0,0,0,186,0,1,2,1,3,4,1,1,3,1,2,1,6,7,12,13,12,6,13,8,5,5,8,7,2,11,7,10,8,10,6,8,13,9,11,8,12,4,6,8,13,12,7,9,9,7,12,20,8,9,7,9,9,9,9,8,11,11,13,10,1,20,6,AM/S C,1,1,20,16,1,1,1,1,1,1,1,1,1,1,1
19279583,Daniel Costa,1651,31/03/1990,26,0,0,0,0,180,71,1,1,1,1,2,1,2,3,3,1,1,7,5,13,6,13,7,7,10,5,7,9,1,8,13,10,12,2,8,7,13,13,3,13,11,13,7,8,6,13,13,8,8,10,14,13,20,11,6,10,10,10,9,9,13,11,12,11,11,5,16,4,AM C,1,1,1,20,1,1,1,1,1,1,10,1,1,1,1
19280720,Pablo Oliveira,1651,24/05/1995,21,0,0,0,0,183,79,1,1,2,1,2,2,1,1,1,3,1,7,4,7,7,12,7,7,9,5,10,12,1,14,8,6,9,8,8,9,9,14,2,9,5,7,10,8,10,11,8,8,12,10,9,8,20,6,10,9,6,3,9,9,9,12,10,9,10,7,7,5,DM ,1,1,1,1,1,1,1,1,1,20,10,1,1,1,1
19280847,Vitinho,1651,04/01/2000,16,0,0,0,0,171,0,2,2,3,2,3,3,2,4,1,3,3,6,12,13,13,12,11,13,12,1,6,11,7,3,13,9,6,5,9,4,11,10,16,14,3,12,5,7,8,12,14,7,4,10,13,13,20,9,5,9,9,9,8,9,8,16,5,9,12,6,15,7,S LC,1,1,20,15,15,13,1,1,1,1,1,1,1,1,1
19280849,Bruno Rodrigues,1651,07/03/1997,19,0,0,0,0,180,0,3,1,2,1,1,1,2,2,1,2,3,6,5,12,6,11,6,6,11,4,5,13,2,7,12,6,6,6,12,5,10,13,9,14,12,7,6,7,11,11,12,7,6,9,10,11,20,7,8,8,9,5,9,9,11,11,10,10,8,5,11,2,AM C,1,1,10,20,1,1,1,1,1,5,10,1,1,1,1
19281625,Victor Luiz,1651,05/12/1997,18,0,0,0,0,177,74,3,4,2,2,3,1,1,1,4,3,1,11,11,10,9,10,11,8,9,9,9,11,10,11,10,8,11,9,8,11,11,10,3,10,10,12,11,12,11,13,11,11,9,20,11,12,9,12,11,9,8,9,6,10,10,12,11,14,12,5,15,8,D/WB L,1,1,1,1,1,1,1,20,1,1,1,1,1,18,1
19281626,Cesinha,1651,07/02/1999,17,0,0,0,0,169,64,3,1,3,3,2,2,1,3,2,1,1,6,4,12,11,13,6,6,13,2,4,9,6,6,12,9,10,6,9,9,10,10,15,15,3,8,5,7,9,13,11,7,5,20,13,12,10,11,6,9,7,4,4,8,14,12,12,13,13,6,14,1,AM C,1,1,1,20,1,1,1,1,1,1,10,1,1,1,1
19281631,Rick Sena,1651,08/08/1997,18,0,0,0,0,167,0,2,2,1,1,3,1,1,2,1,2,4,11,9,13,11,12,12,8,8,10,4,10,10,5,12,8,11,9,10,9,7,9,10,14,8,11,5,10,11,13,15,10,6,10,10,13,20,14,9,9,6,10,7,11,18,12,11,11,10,7,11,2,AM/S RL,1,1,20,1,19,18,1,1,1,1,1,1,1,1,1
19283439,Renatinho Silva,1651,24/02/1994,22,0,0,0,0,173,61,1,2,3,2,3,2,2,1,1,2,2,8,8,14,11,14,8,8,11,1,6,12,2,6,14,10,12,8,9,9,9,14,3,13,1,12,9,9,11,14,12,9,5,8,13,9,20,7,6,10,10,10,7,10,17,13,13,10,10,3,9,8,AM C,1,1,1,20,1,1,1,1,1,1,10,1,1,1,1
19283477,César,1651,16/05/1995,21,0,0,0,0,190,81,10,9,8,3,10,11,9,9,6,6,11,3,1,1,1,4,6,4,1,2,2,5,2,3,8,9,9,14,7,15,11,18,7,1,8,1,9,12,11,6,6,6,10,5,11,7,20,12,14,9,8,9,7,9,19,12,12,7,10,8,13,1,GK ,20,1,1,1,1,1,1,1,1,1,1,1,1,1,1
19283478,Júlio Pacato,1651,20/07/1994,21,0,0,0,0,178,72,2,3,1,3,3,1,3,3,1,2,1,6,8,11,9,11,5,9,11,3,11,13,7,11,12,12,11,10,9,13,11,11,13,8,5,8,12,15,14,13,9,10,9,11,13,11,20,12,9,11,7,10,11,14,10,12,11,9,13,15,12,7,M C,1,1,1,15,1,1,1,1,1,13,20,1,1,1,1
19283479,Marcinho,1651,28/07/1995,20,0,0,0,0,174,72,3,3,2,1,3,3,2,3,1,4,2,10,9,13,7,12,11,6,9,1,4,13,11,4,13,12,8,7,11,11,13,11,11,13,3,12,7,12,11,13,13,8,6,15,11,11,20,10,7,8,3,11,8,7,8,12,10,9,10,11,10,10,AM C,1,1,1,20,1,1,1,1,1,1,10,1,1,1,1
19283480,Jean,1651,19/10/1995,20,0,0,0,0,173,66,3,2,3,2,3,1,2,2,2,2,2,6,6,11,11,13,6,6,13,4,4,10,7,6,12,9,6,8,11,4,7,8,9,12,10,7,5,7,12,12,9,4,6,8,9,11,20,8,4,9,7,9,6,9,7,14,11,11,9,4,5,8,AM C,1,1,1,20,1,1,1,1,1,1,10,1,1,1,1
19283481,Wellisson,1651,09/08/1996,19,0,0,0,0,184,79,1,1,3,3,2,1,1,2,3,4,1,3,7,11,13,11,5,12,8,1,3,11,11,3,10,13,11,13,11,11,7,11,12,9,2,12,9,8,11,13,9,8,12,20,14,11,11,11,14,10,3,10,7,3,10,14,10,11,13,11,12,4,S ,1,1,20,1,1,12,1,1,1,1,1,1,1,1,1
19283504,Caio Ulises,1651,05/01/1993,23,0,0,0,0,170,69,3,3,1,2,1,3,1,3,3,1,1,5,9,7,13,13,6,6,7,2,6,4,2,6,12,4,8,6,6,6,5,9,5,12,10,10,6,7,8,13,13,7,4,18,16,13,20,8,5,9,9,8,9,9,15,11,9,10,12,7,15,2,AM/S RL,1,1,20,1,16,16,1,1,1,1,1,1,1,1,1
19283609,Raphael Alemão,1651,08/08/1996,19,0,0,0,0,177,71,2,3,1,1,3,3,1,4,2,3,3,8,8,14,14,13,6,11,7,6,8,12,6,3,8,8,9,9,7,9,11,9,9,9,3,7,8,5,9,12,14,9,8,10,12,14,20,7,7,10,7,10,8,10,16,11,10,12,13,7,17,7,AM/S C,1,1,18,20,1,1,1,1,1,1,10,1,1,1,1
19283715,Maílson,1651,20/08/1996,19,0,0,0,0,194,0,14,13,11,1,13,12,13,13,10,8,14,3,1,1,3,1,6,1,2,3,3,1,3,3,5,10,6,11,8,10,8,14,2,2,11,2,14,9,8,10,13,8,12,6,14,11,20,3,10,10,10,10,9,10,16,8,10,13,10,1,2,6,GK ,20,1,1,1,1,1,1,1,1,1,1,1,1,1,1
19283769,Pedro,1651,20/11/1997,18,0,0,0,0,170,0,3,3,2,1,2,1,3,2,3,4,1,5,6,12,7,11,7,7,14,2,8,14,2,13,11,4,7,5,5,8,10,7,9,12,11,6,11,8,7,10,14,8,3,9,6,14,20,6,7,8,9,9,6,9,18,12,11,10,10,6,15,5,DM ,1,1,1,1,1,1,1,1,1,20,10,1,1,1,1
19283941,Dias,1651,18/01/1981,35,0,0,0,0,182,85,14,12,14,9,14,14,7,6,9,9,7,5,1,3,1,2,9,1,2,3,3,2,3,3,2,4,11,8,8,5,7,14,9,3,11,1,11,8,7,13,14,8,7,4,10,14,20,5,8,9,9,8,6,9,19,11,12,10,12,10,5,2,GK ,20,1,1,1,1,1,1,1,1,1,1,1,1,1,1
19283949,Léo Ávila,1651,13/12/1996,19,0,0,0,0,186,0,1,2,3,1,2,2,1,3,3,3,3,8,7,12,14,13,8,14,9,4,6,9,8,1,11,9,12,8,10,9,7,13,9,10,11,7,6,8,9,14,10,9,14,8,10,12,20,7,10,9,5,10,5,9,16,11,13,9,12,3,14,1,S ,1,1,20,1,1,1,1,1,1,1,1,1,1,1,1
19284037,Ayrton,1651,19/07/1997,18,0,0,0,0,180,72,1,3,1,3,3,1,3,3,2,2,2,9,10,9,7,13,5,10,9,9,10,11,3,13,9,10,12,11,11,9,8,10,16,8,12,9,10,6,11,14,14,11,11,20,11,14,11,10,10,9,10,9,10,10,13,10,10,13,12,7,16,5,D/WB L,1,1,1,1,1,1,1,20,1,1,1,1,1,19,1
19284049,Matheusinho,1651,11/02/1998,18,0,0,0,0,164,60,2,3,3,2,3,2,4,4,3,1,1,11,11,16,10,13,10,6,10,5,5,11,12,6,14,11,13,9,11,11,12,12,14,16,9,13,5,11,12,14,16,9,5,11,12,14,20,14,5,12,9,13,7,14,17,13,10,12,12,5,10,7,M/AM RC,1,1,1,20,10,17,1,1,1,1,10,10,17,1,1
19284057,Alexandre,1651,01/10/1992,23,0,0,0,0,179,0,3,1,1,2,1,2,2,3,2,2,3,4,7,4,8,10,7,7,12,3,8,13,4,13,9,8,10,9,8,7,8,13,4,8,9,7,13,8,10,13,13,8,5,9,13,13,20,8,8,10,9,10,10,10,20,12,11,10,11,11,9,2,DM ,1,1,1,1,1,1,1,1,1,20,10,1,1,1,1
19284118,Dênis Oliveira,1651,31/10/1997,18,0,0,0,0,188,0,2,2,1,1,4,3,3,1,3,2,2,5,4,12,13,12,5,13,6,5,5,6,2,2,11,8,10,4,6,6,5,9,5,11,11,8,2,5,6,13,11,6,13,8,15,12,20,5,8,8,5,8,7,7,17,9,12,11,12,5,14,2,S ,1,1,20,1,1,1,1,1,1,1,1,1,1,1,1
19284154,Douglão,1651,18/03/1997,19,0,0,0,0,182,78,2,1,3,2,1,1,2,1,1,1,3,4,2,1,1,7,5,13,5,1,13,7,1,13,6,9,7,9,5,9,4,13,9,3,8,6,13,6,7,13,11,7,10,10,7,12,20,4,7,8,9,9,6,9,8,10,9,11,11,6,3,2,D C,1,1,1,1,1,1,20,1,1,1,1,1,1,1,1
19284164,Jean,1651,06/05/1996,20,0,0,0,0,175,72,2,1,2,1,3,2,4,2,2,3,1,3,5,1,4,13,5,5,8,1,5,13,2,10,10,8,6,3,5,6,10,11,3,8,3,5,5,7,10,13,12,2,6,9,8,13,20,9,7,8,8,7,8,8,16,12,9,11,14,3,8,6,M C,1,1,1,1,1,1,1,1,1,13,20,1,1,1,1
19284187,Hudson,1651,24/01/1996,20,0,0,0,0,180,75,3,1,3,3,2,3,1,1,4,2,1,4,8,11,9,12,9,8,10,5,11,12,8,13,11,12,10,12,10,11,8,11,10,7,8,8,11,11,12,12,12,11,7,10,11,12,20,13,10,10,8,9,10,6,7,12,9,9,10,2,15,7,DM/M C,1,1,1,1,1,1,1,1,11,20,19,1,13,1,12
19284230,Danrlei,1651,11/07/1998,17,0,0,0,0,181,0,3,2,3,3,1,1,3,1,1,4,2,5,6,10,13,13,3,10,4,1,3,7,8,2,8,8,7,4,11,4,6,12,5,8,5,8,4,5,7,13,9,6,5,9,12,13,20,9,6,7,6,5,6,6,14,8,9,12,10,9,12,1,S C,1,1,20,15,1,1,1,1,1,1,1,1,1,1,1
19284295,Érick,1651,01/12/1988,27,0,0,0,0,184,0,3,2,2,2,3,1,4,1,1,1,3,5,6,9,9,13,3,2,7,1,5,13,4,8,10,10,10,8,8,8,13,10,7,10,14,9,8,8,11,13,12,4,8,8,11,13,20,13,7,10,10,2,8,10,15,11,14,11,10,8,13,8,AM C,1,1,1,20,1,1,1,1,1,1,15,1,1,1,1
19284353,Carlinhos,1651,08/07/1993,22,0,0,0,0,190,0,1,1,3,2,2,2,2,3,2,3,2,8,9,8,9,13,7,8,8,7,9,14,4,14,14,5,13,9,7,6,12,9,7,7,9,8,9,10,13,14,14,7,13,5,8,13,20,9,11,10,4,4,8,10,13,11,12,9,11,6,9,5,DM R,1,1,1,1,1,1,10,1,12,20,12,1,10,1,15
19284354,Gustavo,1651,05/07/1999,16,0,0,0,0,192,0,3,1,1,1,1,3,2,1,3,1,2,1,4,2,5,5,3,12,4,1,13,6,1,13,1,8,7,8,5,8,2,13,3,2,3,1,8,5,6,7,6,6,12,8,8,8,20,10,12,8,8,7,8,8,7,14,9,10,11,9,2,4,D C,1,1,1,1,1,1,20,1,1,1,1,1,1,1,1
19284355,Lucas,1651,21/02/1998,18,0,0,0,0,178,0,1,2,2,3,1,3,2,1,2,3,3,7,7,9,9,14,7,3,11,1,8,12,6,7,10,9,8,5,5,8,13,11,5,9,4,11,8,8,12,13,10,5,10,8,6,12,20,7,7,9,7,9,9,9,16,11,12,15,12,1,1,2,AM C,1,1,1,20,1,1,1,1,1,1,15,1,1,1,1
19284356,Luís Fernando,1651,09/11/1997,18,0,0,0,0,181,0,1,3,2,3,1,1,2,4,2,1,2,6,6,9,13,13,6,11,7,2,3,7,9,1,13,9,8,3,10,3,7,9,6,13,7,10,6,6,7,13,11,3,6,8,14,11,20,6,8,8,9,6,9,9,19,10,12,11,11,1,3,2,S ,1,1,20,1,1,1,1,1,1,1,1,1,1,1,1
19284357,Manoel,1651,14/04/1996,20,0,0,0,0,174,0,3,4,1,2,1,1,2,2,4,4,3,6,8,8,3,13,1,7,8,8,10,10,1,15,10,9,7,9,9,11,6,15,9,1,12,8,8,9,9,15,9,9,9,8,9,14,20,8,7,9,8,4,9,9,19,10,12,12,11,5,18,7,D R,1,1,1,1,1,1,1,1,20,1,1,1,1,1,15
19284410,Klenisson,1651,06/05/1995,21,0,0,0,0,181,79,2,2,4,1,2,3,3,2,1,1,2,8,11,12,13,12,8,9,5,5,6,11,13,5,11,10,12,12,12,12,11,11,12,9,9,12,12,13,12,13,12,13,7,11,12,14,20,13,9,10,8,9,8,10,11,12,11,10,13,11,10,10,S ,1,1,20,1,1,1,1,1,1,1,1,1,1,1,1
19284434,Vitinho,1651,18/02/1988,28,0,0,0,0,168,69,1,3,1,3,3,3,3,4,2,3,3,6,6,13,12,13,6,6,9,3,4,4,7,6,13,5,8,5,8,6,13,11,3,13,10,8,7,7,10,13,12,5,1,9,7,13,20,11,4,9,9,1,9,9,11,10,12,12,10,2,8,2,AM C,1,1,1,20,1,1,1,1,1,1,10,1,1,1,1
19284459,Arthur,1651,30/04/1998,18,0,0,0,0,187,0,13,8,10,4,10,9,9,10,8,6,9,4,1,1,3,1,8,1,1,2,3,1,2,3,2,8,3,14,6,4,5,13,8,2,2,1,8,6,5,13,10,5,12,1,9,11,20,4,10,8,8,8,8,8,10,8,12,9,11,1,17,1,GK ,20,1,1,1,1,1,1,1,1,1,1,1,1,1,1
19284460,Deijair,1651,07/08/1998,17,0,0,0,0,196,88,13,12,11,1,12,11,13,13,10,8,11,7,3,1,3,5,9,1,3,3,2,3,1,1,8,10,9,11,5,11,9,14,14,3,5,1,12,5,9,9,13,8,17,1,13,9,20,13,13,10,10,10,6,10,9,12,12,12,9,7,10,7,GK ,20,1,1,1,1,1,1,1,1,1,1,1,1,1,1
19284461,Edimundo,1651,04/01/1999,17,0,0,0,0,185,0,1,2,4,2,1,3,2,3,1,1,2,8,12,13,3,13,6,9,6,7,8,12,2,8,13,8,12,10,10,9,12,13,5,7,4,6,7,10,10,13,14,6,13,10,12,13,20,11,5,9,7,9,3,6,16,11,11,14,9,1,5,2,D/WB R,1,1,1,1,1,1,1,1,20,1,1,1,1,1,19
19284463,Alisson Augusto,1651,15/10/1999,16,0,0,0,0,193,0,3,3,3,3,1,3,3,3,1,2,2,7,11,11,5,14,2,8,6,4,9,9,1,14,9,6,5,9,9,7,9,10,4,5,1,4,7,9,9,14,11,9,14,20,16,10,10,9,10,7,7,6,5,9,7,10,10,11,11,2,9,3,D/WB L,1,1,1,1,1,1,1,20,1,1,1,1,1,19,1
19284464,Jonas,1651,20/02/1998,18,0,0,0,0,183,74,2,3,1,1,3,3,1,2,1,4,1,5,5,2,6,4,1,12,7,4,12,8,1,12,6,9,13,9,7,6,5,14,4,5,1,7,12,7,8,13,12,9,12,9,13,13,20,12,13,9,9,8,5,9,12,10,12,10,11,3,8,8,D C,1,1,1,1,1,1,20,1,1,1,1,1,1,1,1
19284465,Jaques,1651,06/04/1998,18,0,0,0,0,186,0,3,3,4,2,2,1,3,3,1,3,1,3,3,7,4,7,4,12,5,6,12,8,11,11,4,9,8,10,7,11,6,15,9,9,2,7,15,8,9,7,6,9,12,10,11,6,20,6,10,9,4,5,9,9,12,9,11,10,12,4,15,4,D C,1,1,1,1,1,1,20,1,1,1,1,1,1,1,1
19284466,Ceará,1651,18/01/1999,17,0,0,0,0,193,0,2,1,2,2,3,2,1,1,1,2,1,2,1,3,1,7,3,13,6,5,13,7,3,13,6,9,8,9,6,9,6,13,9,5,11,6,13,6,7,13,6,7,10,13,6,8,20,4,9,8,8,7,9,9,14,11,10,10,9,6,11,6,D C,1,1,1,1,1,1,20,1,1,1,1,1,1,1,1
19284467,Eduardo,1651,03/02/1999,17,0,0,0,0,190,0,3,3,1,1,3,3,3,4,2,1,1,3,5,1,4,8,2,10,2,7,14,8,3,14,7,9,6,9,7,10,5,14,9,1,1,4,7,7,8,8,8,8,13,8,11,7,20,5,12,7,9,9,4,7,9,14,11,14,13,10,18,4,D C,1,1,1,1,1,1,20,1,1,1,1,1,1,1,1
19284468,Luís Fernando,1651,06/06/1996,20,0,0,0,0,183,62,3,2,3,1,2,3,1,3,1,1,1,6,8,10,10,11,10,12,12,7,14,12,8,14,11,12,12,12,10,10,10,11,10,3,5,10,14,14,14,13,13,13,11,2,13,13,20,13,13,10,11,10,5,10,15,11,14,10,10,6,12,4,DM/M C,1,1,1,1,1,1,1,1,1,20,17,1,1,1,1
19284469,Clayton,1651,27/02/1999,17,0,0,0,0,171,0,3,1,4,3,1,3,1,3,1,1,2,5,6,8,7,8,6,8,8,5,13,9,9,12,9,12,8,13,10,7,8,13,9,7,8,6,12,13,13,12,10,9,3,10,9,13,20,8,12,9,9,9,9,9,20,13,11,10,10,5,13,7,DM C,1,1,1,1,1,1,1,1,1,20,15,1,1,1,1
19284470,Caio Lago,1651,21/02/1998,18,0,0,0,0,177,0,3,2,1,1,2,1,1,3,3,1,1,3,6,10,10,12,5,13,6,1,2,6,5,4,7,8,10,7,11,4,6,12,3,7,2,10,6,5,7,13,13,6,4,8,14,13,20,12,4,7,8,7,4,8,12,8,11,12,11,3,10,4,S ,1,1,20,1,1,1,1,1,1,1,1,1,1,1,1
19284471,Felipinho,1651,03/02/1998,18,0,0,0,0,177,0,2,2,3,3,1,3,1,1,2,2,2,10,11,12,10,13,5,8,11,10,10,12,6,9,13,10,11,8,6,9,12,12,13,12,5,12,11,11,12,13,13,11,9,20,13,13,6,12,10,6,7,7,4,10,8,11,13,10,11,6,8,7,M/AM LC,1,1,1,15,17,1,1,13,1,10,20,18,1,14,1
19284472,Sebastian,1651,03/10/1998,17,0,0,0,0,176,0,1,2,2,1,2,3,3,3,1,3,3,7,9,13,5,13,7,7,8,7,6,13,12,9,13,9,7,7,7,8,12,14,10,10,9,8,8,8,12,13,13,6,5,20,9,13,10,10,5,9,9,5,9,9,9,10,12,11,8,2,13,2,AM LC,1,1,1,20,18,13,1,1,1,1,15,13,10,1,1
19284473,Max,1651,25/03/1998,18,0,0,0,0,169,63,4,2,3,3,3,1,1,1,2,2,3,10,10,13,11,13,8,8,10,6,8,11,11,7,13,11,11,12,9,8,11,9,11,14,4,13,8,10,11,13,14,8,5,20,12,13,6,11,5,12,9,10,5,10,15,9,11,11,11,7,1,6,AM LC,1,1,10,18,20,1,1,1,1,1,15,14,1,1,1
19284474,Fabrício,1651,31/01/1999,17,0,0,0,0,180,0,3,1,3,1,4,1,2,2,2,1,2,6,6,8,8,10,6,3,8,1,6,10,3,8,9,9,4,6,5,2,12,10,4,9,3,8,5,7,10,13,11,3,7,16,15,13,20,11,7,9,5,7,9,8,7,8,10,11,9,3,13,2,M/AM C,1,1,1,18,1,1,1,1,1,1,20,1,1,1,1
19284475,Cassiano,1651,10/02/1999,17,0,0,0,0,188,0,14,9,8,1,14,13,12,14,9,3,8,3,1,2,1,2,5,1,2,2,1,1,1,1,5,7,5,13,8,8,7,14,8,1,2,1,9,5,6,11,13,5,13,9,9,12,20,2,8,8,9,8,9,8,7,9,11,10,10,5,6,4,GK ,20,1,1,1,1,1,1,1,1,1,1,1,1,1,1
19284476,Thauan,1651,07/01/1999,17,0,0,0,0,180,0,2,3,1,2,1,1,4,2,3,1,3,7,8,10,12,14,7,14,8,2,5,7,7,1,14,9,7,8,9,7,7,14,6,13,1,12,4,7,8,12,10,10,10,8,12,11,20,10,10,7,9,9,5,9,19,10,11,12,8,2,9,6,S ,1,1,20,1,1,1,1,1,1,1,1,1,1,1,1
19284477,Jonatas,1651,11/04/1999,17,0,0,0,0,177,0,3,1,2,1,3,2,3,2,2,3,3,5,7,11,14,14,6,12,8,1,6,8,7,5,14,9,9,8,7,8,5,10,2,13,6,10,5,7,9,14,10,8,9,3,12,12,20,11,8,9,6,3,7,9,15,11,11,14,11,7,4,4,S ,1,1,20,1,12,12,1,1,1,1,1,1,1,1,1
19284478,Jackson,1651,24/04/1999,17,0,0,0,0,185,0,1,2,3,3,3,1,1,1,3,3,2,6,7,13,11,12,6,13,7,5,5,7,4,1,12,9,10,7,7,6,5,8,9,12,8,11,7,6,7,13,10,4,10,9,9,10,20,9,9,8,6,9,5,9,10,11,11,10,12,4,16,7,S ,1,1,20,1,1,1,1,1,1,1,1,1,1,1,1
19284480,Gílson,1651,04/02/1997,19,0,0,0,0,188,0,14,11,10,3,14,14,13,14,5,9,12,2,1,1,3,3,5,1,3,2,3,1,3,2,6,5,5,13,8,14,7,12,4,1,10,1,8,8,7,14,7,8,9,1,15,12,20,5,8,9,9,8,9,8,8,12,12,10,14,3,8,1,GK ,20,1,1,1,1,1,1,1,1,1,1,1,1,1,1
19284481,Caio Santana,1651,19/03/1999,17,0,0,0,0,183,0,5,10,9,5,13,10,8,6,9,7,12,3,3,2,1,1,4,1,2,2,2,1,3,1,4,3,6,12,6,9,6,13,4,1,7,1,7,7,6,11,13,7,9,20,7,12,8,4,6,9,9,9,9,9,7,10,12,15,10,4,10,2,GK ,20,1,1,1,1,1,1,1,1,1,1,1,1,1,1
19284492,John,1651,02/01/1998,18,0,0,0,0,195,0,13,7,6,1,13,9,11,10,6,7,5,2,2,2,1,1,4,1,1,1,1,1,3,1,2,9,7,13,6,10,6,13,4,1,4,2,9,7,6,11,10,7,12,6,9,12,20,4,12,9,5,8,9,9,15,11,11,13,12,1,16,2,GK ,20,1,1,1,1,1,1,1,1,1,1,1,1,1,1
19284493,Cedric,1651,14/02/1998,18,0,0,0,0,170,0,1,2,3,1,4,2,1,1,2,2,3,6,12,12,3,12,3,7,5,6,7,8,1,13,8,8,6,8,3,12,7,11,1,6,8,5,5,7,7,13,13,6,2,8,12,13,20,11,5,8,7,3,8,8,17,10,10,10,11,8,8,2,D/WB R,1,1,1,1,1,1,1,1,20,1,1,1,1,1,18
19284494,Matheus Souza,1651,24/03/1998,18,0,0,0,0,184,0,2,1,3,2,1,3,3,1,1,2,3,7,7,7,8,11,7,12,7,1,12,14,4,12,8,9,7,8,7,7,8,10,6,9,7,6,10,13,12,14,14,7,9,9,13,13,20,12,13,9,5,6,4,9,16,9,11,12,11,3,8,1,D/DM C,1,1,1,1,1,1,20,1,1,18,12,1,1,1,1
19284495,Hebert,1651,28/02/1998,18,0,0,0,0,180,80,3,3,3,3,2,2,1,1,4,2,2,7,8,8,9,10,7,11,9,6,13,11,7,11,10,12,11,13,9,7,7,8,19,8,8,7,11,12,12,12,10,10,10,4,14,11,20,12,12,13,12,9,7,13,13,10,10,9,9,8,5,3,D/DM C,1,1,1,1,1,1,18,1,1,20,13,1,1,1,1
19284496,Thiago,1651,05/08/1997,18,0,0,0,0,177,0,1,1,2,2,1,3,1,3,4,2,2,4,7,12,7,7,5,5,7,1,5,13,1,7,10,8,4,1,3,4,10,10,8,10,9,10,5,7,11,12,13,6,7,8,12,12,20,7,6,8,8,5,8,8,8,12,12,12,11,6,12,5,AM RC,1,1,1,20,1,16,1,1,1,1,15,1,12,1,1
19284497,Weslley,1651,01/10/1998,17,0,0,0,0,183,0,3,3,3,2,3,1,3,3,3,2,3,8,10,12,10,13,8,8,8,7,5,12,1,10,10,9,6,3,7,7,12,15,3,9,10,10,9,9,11,13,13,4,13,4,10,13,20,10,11,6,8,9,5,9,7,8,11,11,13,9,7,5,M/AM C,1,1,1,20,13,14,1,1,1,1,18,1,1,1,1
19284569,Igor,1651,13/07/1995,20,0,0,0,0,173,0,1,2,1,3,1,3,2,1,2,1,1,8,6,5,6,10,6,9,6,7,7,10,2,12,9,9,8,9,10,9,8,14,4,2,1,7,7,10,10,14,10,10,5,17,8,10,20,7,8,8,9,2,6,9,10,10,13,10,11,5,11,6,D/WB L,1,1,1,1,1,1,1,20,1,1,1,1,1,19,1
19284576,Rogério,1651,13/01/1998,18,0,0,5,0,178,71,3,2,2,3,2,3,3,1,3,1,3,8,11,13,7,10,8,9,7,9,12,9,5,10,9,11,11,10,11,12,10,11,13,14,10,12,12,10,12,14,12,10,9,20,10,13,6,13,11,11,9,8,10,7,12,12,10,9,12,9,11,4,D/WB L,1,1,1,1,1,1,1,20,1,1,1,15,1,20,1
19284649,Ewerton,1651,10/08/1997,18,0,0,0,0,184,0,3,2,1,1,2,3,3,1,1,2,2,2,4,13,14,13,7,5,7,1,7,14,3,8,13,6,5,4,7,8,12,14,5,12,3,5,7,8,13,14,10,6,12,7,14,13,20,11,8,9,3,9,7,7,9,9,11,10,10,2,13,2,AM C,1,1,1,20,1,1,1,1,1,1,10,1,1,1,1
19284692,Reynaldo,1651,03/01/1997,19,0,0,0,0,190,0,2,2,2,2,3,3,2,3,2,2,2,6,1,1,5,7,3,13,4,1,13,8,3,13,3,7,12,10,6,5,3,13,4,6,3,5,13,6,8,12,10,8,10,11,9,12,20,8,11,10,8,10,10,10,12,11,9,12,11,6,7,1,D C,1,1,1,1,1,1,20,1,1,1,1,1,1,1,1
19284723,Renan,1651,09/01/1998,18,0,0,0,0,184,80,14,7,11,3,14,10,9,14,5,9,11,4,1,1,3,1,7,1,3,2,3,1,1,2,1,6,10,10,7,8,7,14,5,3,1,1,8,8,7,14,6,8,11,1,12,11,20,5,10,9,5,6,6,9,10,10,12,11,13,9,10,4,GK ,20,1,1,1,1,1,1,1,1,1,1,1,1,1,1
19284724,Nicolas,1651,04/06/1999,17,0,0,0,0,167,0,1,3,3,1,3,1,2,3,3,3,1,10,13,14,11,13,7,13,7,3,6,11,4,7,13,4,13,4,11,8,9,13,4,15,1,13,7,7,9,13,14,9,2,14,17,13,20,6,6,10,7,6,9,9,11,11,10,11,12,2,13,8,AM/S L,1,1,20,1,16,13,1,1,1,1,1,1,1,1,1
19284725,Iago,1651,11/03/1996,20,0,0,0,0,175,73,1,3,2,2,3,2,2,1,2,1,3,7,5,10,11,14,7,7,12,2,7,12,1,6,14,9,9,4,6,5,14,9,9,13,4,6,7,8,12,14,14,8,9,1,12,14,20,8,7,9,9,9,7,9,20,9,10,13,12,9,12,2,AM C,1,1,1,20,1,1,1,1,1,1,10,1,1,1,1
19284871,Lorran,1651,02/05/1995,21,0,0,0,0,176,0,2,3,1,1,2,3,1,3,4,3,4,9,13,13,13,13,7,8,8,5,6,5,9,7,10,5,6,8,12,7,7,12,2,10,14,13,6,7,8,10,10,7,8,5,10,13,20,5,4,9,9,4,9,9,17,14,12,8,11,1,5,8,AM/S RL,1,1,20,13,17,17,1,1,1,1,1,1,1,1,1
19285113,Gabriel Lagoa,1651,22/09/1998,17,0,0,0,0,179,76,2,3,2,2,4,1,3,1,2,1,2,7,7,14,14,14,7,14,8,4,4,8,9,1,14,9,10,6,11,7,5,10,1,13,11,14,3,5,7,14,12,8,9,1,10,12,20,10,8,9,9,9,7,9,15,11,11,13,11,2,12,3,S ,1,1,20,7,7,7,1,1,1,1,1,1,1,1,1
19285120,Silvio,1651,11/02/1994,22,0,0,0,0,177,68,3,3,3,1,2,3,1,2,3,2,3,6,6,11,10,8,4,13,6,1,6,7,1,4,9,7,10,8,8,7,7,8,2,9,8,13,7,6,7,13,10,4,6,10,10,13,20,12,8,9,7,6,9,9,20,13,10,11,13,10,15,7,S ,1,1,20,1,1,1,1,1,1,1,1,1,1,1,1
19285121,Edicleber,1651,30/10/1993,22,0,0,0,0,175,69,2,1,1,2,2,2,3,3,1,3,1,7,7,14,5,11,7,6,9,1,7,10,2,8,14,9,8,8,5,5,13,13,5,13,1,5,6,8,12,14,14,8,9,10,10,14,20,7,5,9,8,9,9,9,15,12,10,11,12,11,3,3,AM C,1,1,1,20,1,1,1,1,1,1,10,1,1,1,1
19285152,Carlos Coppetti,1651,08/07/1994,21,0,0,0,0,183,80,1,3,3,3,1,3,3,1,2,1,2,5,6,5,6,13,7,3,8,3,10,13,5,11,9,9,12,8,6,6,8,13,9,6,9,6,13,8,9,13,13,6,8,10,14,13,20,10,10,9,6,9,5,9,17,11,14,12,11,2,15,7,DM ,1,1,1,1,1,1,1,1,1,20,1,1,1,1,1
19285180,Rafael Martins,1651,06/02/1997,19,0,0,0,0,181,0,1,1,2,1,2,3,1,1,3,1,3,7,4,4,4,12,7,7,10,1,11,12,2,14,12,9,12,8,7,5,8,14,8,7,11,6,11,8,12,10,11,6,11,14,13,12,20,8,9,9,9,4,8,9,14,11,12,11,11,6,10,5,DM ,1,1,1,1,1,1,1,1,1,20,10,1,1,1,1
19285270,Yan,1651,18/04/1991,25,0,0,0,0,194,92,13,10,8,6,13,9,7,13,9,5,7,3,3,2,2,1,6,1,2,1,2,1,3,1,1,9,6,10,5,13,6,13,5,2,1,3,11,7,6,13,9,7,13,10,9,10,20,6,12,9,9,9,9,9,10,12,12,13,11,11,16,5,GK ,20,1,1,1,1,1,1,1,1,1,1,1,1,1,1
19285271,Luiz Eduardo,1651,09/01/1994,22,0,0,0,0,170,0,3,3,2,1,2,1,2,1,1,1,2,7,5,5,6,9,3,8,4,4,9,9,4,14,9,9,8,8,8,8,6,9,9,9,9,6,6,8,9,14,14,8,7,10,13,14,20,13,7,9,6,9,7,9,16,8,15,10,9,4,11,3,D R,1,1,1,1,1,1,1,1,20,1,1,1,1,1,13
19285272,Alex,1651,21/03/1995,21,0,0,0,0,189,0,2,1,1,1,1,1,2,3,2,2,3,7,4,3,4,8,4,14,1,6,10,8,3,13,7,7,7,9,7,9,1,14,8,1,11,6,14,7,7,14,10,8,13,9,11,9,20,5,11,9,8,7,9,9,14,12,11,10,12,4,4,3,D C,1,1,1,1,1,1,20,1,1,1,1,1,1,1,1
19285273,Mario Pierre,1651,28/08/1995,20,0,0,0,0,191,0,3,1,3,2,1,2,4,2,2,2,1,4,6,3,2,8,5,14,1,4,14,6,1,14,5,6,9,9,5,7,3,14,5,6,1,5,8,7,8,8,13,8,14,8,11,12,20,7,12,9,6,9,6,9,13,10,10,10,12,10,3,3,D C,1,1,1,1,1,1,20,1,1,1,1,1,1,1,1
19285274,Bruno,1651,09/08/1994,21,0,0,0,0,186,75,2,2,3,1,1,1,1,3,1,2,1,3,7,9,6,14,7,7,9,2,6,13,5,9,14,8,9,8,9,9,12,11,9,13,11,5,9,9,12,14,12,8,10,10,15,11,20,8,8,9,8,9,9,9,7,11,11,11,12,9,7,5,M/AM C,1,1,1,20,1,1,1,1,1,1,17,1,1,1,1
19285275,William Oliveira,1651,25/02/1992,24,0,0,0,0,182,0,1,1,1,1,2,4,4,1,3,2,3,5,11,12,10,11,8,12,10,6,12,12,7,12,12,12,13,13,12,12,12,12,12,10,10,12,13,13,13,13,12,8,12,10,14,13,20,13,14,13,11,12,11,14,16,12,10,10,11,11,12,9,M C,1,1,1,1,1,1,1,1,1,15,20,1,10,1,1
19285276,Valdeir,1651,13/11/1992,23,0,0,0,0,171,62,1,2,4,3,1,3,3,1,2,3,1,3,7,9,4,14,7,7,9,1,5,11,2,9,12,9,10,2,8,8,10,14,5,11,10,12,7,8,13,11,13,8,7,10,11,14,20,10,6,9,4,6,8,9,10,10,8,10,12,3,9,5,M/AM C,1,1,1,20,1,1,1,1,1,1,20,1,1,1,1
19285278,Rezende,1651,02/01/1995,21,0,0,0,0,170,0,1,2,2,3,2,3,2,2,2,1,2,7,7,8,9,14,6,7,11,3,6,12,5,12,10,8,10,8,6,8,9,14,3,9,5,8,9,9,11,14,12,9,6,20,1,13,10,8,5,9,9,9,6,9,13,9,13,12,8,1,3,6,DM/M C,1,1,1,1,1,1,1,1,1,20,17,1,1,1,1
19285279,Arthur Faria,1651,10/01/1992,24,0,0,0,0,174,70,1,2,2,2,4,1,3,3,2,1,1,6,8,12,8,11,6,4,8,3,4,8,1,3,13,9,8,6,8,6,13,13,8,13,7,8,5,7,11,13,13,7,3,10,15,13,20,6,7,9,7,2,9,9,11,12,10,12,10,4,8,8,M/AM RC,1,1,1,20,13,17,1,1,1,1,17,1,1,1,1
19285280,Gustavo Onofre,1651,19/04/1994,22,0,0,0,0,182,71,1,3,3,1,1,2,2,1,1,1,2,11,13,11,7,10,8,8,8,6,6,8,3,7,9,9,6,2,5,8,6,10,5,9,4,10,6,7,8,12,11,8,6,8,14,12,20,9,6,9,9,9,9,9,7,10,11,11,12,8,1,1,AM/S RL,1,1,17,1,19,20,1,1,1,1,1,1,1,1,1
19285281,Carlos,1651,04/03/1990,26,0,0,0,0,185,0,2,3,3,1,3,2,3,3,2,1,2,9,13,8,5,13,6,3,2,4,7,7,2,8,10,9,9,8,8,8,6,10,3,10,4,6,7,8,8,13,10,8,10,9,10,13,20,7,6,8,7,9,9,9,20,11,11,10,13,1,11,8,D/WB/M/AM R,1,1,1,1,1,17,1,1,20,1,1,1,17,1,19
19285313,Renato Sorriso,1651,21/06/1991,25,0,0,0,0,178,79,4,2,2,2,2,2,1,1,1,3,2,7,8,13,10,13,7,13,8,3,7,9,2,4,13,10,11,2,10,8,10,11,7,13,13,13,7,7,9,13,13,8,3,10,16,13,20,12,6,10,4,6,10,10,18,12,11,13,11,1,5,6,AM/S C,1,1,20,18,1,1,1,1,1,1,10,1,1,1,1
19285377,Vinícius,1651,25/05/1997,19,0,0,0,0,187,0,1,1,3,3,3,3,2,2,3,3,4,4,1,11,12,10,4,12,5,4,4,5,7,1,6,8,9,3,8,2,5,9,8,8,11,12,4,4,5,12,11,5,8,8,2,11,20,5,8,8,7,8,8,8,18,10,10,13,11,3,12,7,S ,1,1,20,1,1,1,1,1,1,1,1,1,1,1,1
19285378,Ramon,1651,19/05/1997,19,0,0,0,0,174,69,1,2,1,3,2,3,3,1,2,3,2,7,6,9,9,12,7,4,11,6,7,13,3,9,12,9,10,1,13,5,14,11,4,11,2,9,7,8,12,10,13,8,6,4,14,14,20,8,5,9,9,9,4,9,8,11,10,12,14,8,15,6,AM C,1,1,1,20,1,1,1,1,1,1,15,1,1,1,1
19285379,Bruno Garcia,1651,09/01/1997,19,0,0,0,0,182,0,3,3,2,1,4,1,2,1,2,2,2,4,8,11,8,13,6,7,4,1,6,8,1,8,9,8,7,7,5,8,7,9,8,8,9,8,6,7,8,13,14,7,9,20,12,14,2,6,7,7,8,7,8,12,7,11,12,13,12,9,8,2,WB/M/AM L,1,1,13,1,17,1,1,15,1,1,1,16,1,20,1
19285381,Gabriel Almeida,1651,12/06/1997,19,0,0,0,0,180,0,2,1,1,1,1,3,3,3,1,2,4,1,2,1,1,5,1,12,2,1,12,2,1,12,1,8,5,7,4,8,1,12,4,1,7,1,9,4,5,12,12,5,6,8,8,12,20,10,7,8,8,8,8,8,7,9,10,10,11,5,5,6,D C,1,1,1,1,1,1,20,1,1,1,1,1,1,1,1
19285382,Johnny,1651,27/02/1998,18,0,0,0,0,182,68,3,3,2,1,3,3,2,4,2,3,1,5,6,7,7,12,6,7,8,5,9,14,1,14,8,6,9,7,7,7,11,13,3,2,9,5,5,7,8,9,10,7,11,8,6,7,20,6,7,7,8,8,4,14,16,14,10,13,11,8,12,4,DM/M RC,1,1,1,1,1,1,15,1,15,17,20,1,1,1,12
19285384,Altair,1651,10/07/1996,19,0,0,0,0,187,0,3,3,1,1,1,1,1,3,3,2,1,9,9,6,9,15,5,9,11,4,10,12,5,15,15,10,11,9,10,10,11,15,7,10,8,10,8,10,10,15,10,5,14,8,12,11,20,8,9,10,7,10,10,10,15,9,13,12,12,8,9,5,DM C,1,1,1,1,1,1,1,1,1,20,15,1,1,1,1
19285721,Lima,1651,09/05/1999,17,0,0,0,0,172,65,1,2,2,2,3,3,3,4,1,4,2,6,8,9,8,10,8,8,8,1,6,8,1,6,13,9,6,3,5,6,9,8,9,13,2,9,4,7,8,13,12,7,5,20,13,12,11,9,5,9,7,9,8,9,10,9,10,14,13,9,6,7,AM RC,1,1,15,20,11,15,1,1,1,1,10,1,1,1,1
19285814,Kennidy,1651,09/09/1999,16,0,0,0,0,180,0,2,2,3,1,3,1,2,2,3,1,1,2,4,1,5,11,4,4,12,3,6,10,4,11,8,7,5,6,4,3,5,13,2,3,5,2,5,6,9,12,11,5,6,7,10,11,20,6,5,5,7,7,7,7,16,11,14,8,11,4,19,4,DM ,1,1,1,1,1,1,1,1,1,20,10,1,1,1,1
19286212,James,1651,15/07/1995,20,0,0,0,0,173,69,2,1,2,1,1,3,1,2,2,3,3,5,8,7,2,13,5,8,5,2,9,9,3,11,8,8,7,9,9,11,9,12,5,7,4,4,8,9,9,14,15,9,6,20,10,10,9,10,5,9,12,9,6,9,10,11,11,11,10,8,1,8,D/WB L,1,1,1,1,1,1,1,20,1,1,1,1,1,17,1
19286215,Arthur,1651,28/01/1997,19,0,0,0,0,194,0,12,5,7,5,12,9,5,12,8,8,7,5,1,1,1,2,8,1,3,2,1,1,1,3,1,8,7,12,5,9,4,7,8,3,8,3,6,5,4,11,13,5,12,8,12,7,20,1,8,8,8,5,8,7,11,10,11,13,11,6,9,2,GK ,20,1,1,1,1,1,1,1,1,1,1,1,1,1,1
19286316,Dedé,1651,18/03/1998,18,0,0,0,0,192,0,3,3,2,2,3,3,1,3,3,1,1,1,1,1,1,5,1,12,1,1,12,5,1,12,2,8,5,7,5,2,3,9,6,1,1,2,8,4,5,10,8,5,12,17,8,9,20,8,10,8,6,4,8,8,13,10,11,14,7,5,14,8,D C,1,1,1,1,1,1,20,1,1,1,1,1,1,1,1
19286317,Guiga,1651,15/12/1998,17,0,0,0,0,175,63,2,3,3,1,2,3,3,3,2,2,3,6,4,7,7,14,6,5,9,1,5,7,4,10,13,5,7,6,8,5,9,14,3,6,3,5,11,7,6,14,12,7,7,7,12,11,20,5,6,8,3,8,8,8,16,10,10,11,10,5,8,6,DM ,1,1,1,3,1,1,1,1,1,20,13,1,1,1,1
19286318,Gustavo Poffo,1651,10/02/1998,18,0,0,0,0,183,0,3,2,2,1,2,1,1,2,1,2,2,4,4,12,12,11,4,12,5,1,2,5,4,1,7,8,5,6,6,3,5,10,1,8,5,11,2,4,5,12,12,5,9,8,14,12,20,4,6,8,4,4,8,8,7,10,14,12,10,11,18,1,S ,1,1,20,1,1,1,1,1,1,1,1,1,1,1,1
19286319,Matheus Camargo,1651,15/02/1997,19,0,0,0,0,180,0,1,3,3,3,4,2,3,3,2,2,1,4,4,12,12,12,1,12,5,3,1,5,6,1,10,8,4,6,7,1,5,7,7,11,11,10,4,4,5,12,12,4,6,20,15,12,7,5,7,8,8,2,8,8,7,11,11,11,13,7,2,6,S ,1,1,20,1,1,1,1,1,1,1,1,1,1,1,1
19286524,Gabriel Medeiros,1651,21/01/1997,19,0,0,0,0,162,0,2,1,1,1,3,1,3,3,4,2,4,7,4,2,5,12,4,7,3,7,9,9,4,8,9,7,9,9,8,6,5,11,2,8,13,6,6,9,9,10,13,9,2,8,13,10,20,9,7,8,6,8,8,8,13,11,11,10,10,4,10,4,D/WB R,1,1,1,1,1,1,1,1,20,1,1,1,1,1,17
19286525,Gustavo,1651,03/02/1997,19,0,0,0,0,172,0,2,3,4,3,3,3,1,4,1,4,1,4,4,6,1,13,2,7,5,6,6,8,1,12,9,5,4,8,5,8,4,10,2,1,11,6,9,7,7,14,14,7,7,20,12,14,8,5,7,8,8,8,8,8,10,12,11,11,11,7,7,3,D/WB L,1,1,1,1,1,1,1,20,1,1,1,1,1,16,1
19286631,Alexandre Tam,1651,30/03/1999,17,0,0,0,0,176,66,1,3,3,1,4,2,1,3,3,2,1,8,6,12,13,12,8,8,7,6,6,14,2,9,13,10,6,4,8,9,14,14,20,15,11,11,6,9,10,13,13,11,7,8,11,13,20,8,10,10,9,6,4,10,17,10,8,10,13,7,14,7,AM C,1,1,1,20,1,1,1,1,1,1,10,1,1,1,1
19286643,Luisinho,1651,21/08/1996,19,0,0,0,0,180,70,3,1,3,1,3,1,1,2,3,2,2,6,4,13,10,13,6,1,9,2,4,11,1,6,9,8,9,7,8,5,13,11,3,9,13,6,7,7,10,10,13,7,9,9,10,13,20,13,6,9,8,9,9,9,11,11,7,12,15,3,9,8,AM C,1,1,1,20,1,1,1,1,1,1,10,1,1,1,1
19286721,Patrick Mota,1651,07/08/1992,23,0,0,0,0,181,77,1,1,1,2,1,2,3,3,2,3,2,6,3,3,7,13,6,6,9,5,9,12,2,13,13,9,5,8,4,9,10,13,3,6,10,5,12,7,10,13,11,7,10,20,7,13,10,7,5,9,9,9,9,9,8,10,11,12,9,4,14,8,DM ,1,1,1,1,1,1,1,1,1,20,10,1,1,1,1
19286727,Betão,1651,19/09/1989,26,0,0,0,0,189,80,2,3,3,1,3,2,2,4,4,1,1,4,4,5,7,8,2,14,8,1,14,9,5,14,6,10,14,10,9,11,5,10,5,5,10,8,10,8,9,14,11,9,13,10,7,13,20,10,14,11,10,10,10,10,8,12,9,9,10,1,12,1,D C,1,1,1,1,1,1,20,1,1,1,1,1,1,1,1
19286736,Dônavan,1651,20/08/1997,18,0,0,0,0,162,58,3,2,2,2,1,2,1,2,1,2,3,8,7,7,13,14,8,8,12,2,5,15,7,9,10,9,6,8,9,9,14,13,5,9,5,10,8,9,13,12,10,9,1,1,13,11,20,9,6,9,9,3,9,9,8,12,10,10,12,8,3,2,AM C,1,1,1,20,1,1,1,1,1,1,10,1,1,1,1
19286838,Lucas França,1651,19/01/1996,20,0,0,0,0,194,83,18,10,10,1,12,10,11,13,12,15,11,1,1,1,1,10,1,9,1,8,5,10,6,6,9,10,10,12,11,10,10,11,11,1,8,1,12,12,11,12,13,10,18,5,11,12,20,12,11,11,8,10,1,1,12,8,11,12,8,9,13,3,GK ,20,1,1,1,1,1,1,1,1,1,1,1,1,1,1
19286840,Marcinho,1651,16/05/1996,20,0,0,0,0,178,71,1,2,3,3,3,1,3,1,2,1,2,7,8,7,5,14,4,9,8,7,10,8,4,14,9,10,9,10,10,10,6,13,8,10,9,7,11,10,10,14,13,10,8,10,10,14,20,8,8,9,10,10,8,10,19,10,11,11,9,3,4,7,D/WB R,1,1,1,1,1,1,1,1,20,1,1,1,1,1,19
19286841,Ribamar,1651,21/05/1997,19,0,0,0,0,184,81,1,2,1,2,1,3,3,3,2,3,1,8,10,13,10,13,8,11,9,7,6,12,12,9,12,16,11,15,10,11,12,13,14,13,9,12,7,14,16,14,13,17,13,20,12,17,9,12,15,10,10,14,10,6,7,13,7,12,10,9,11,10,S ,1,1,20,1,1,1,1,1,1,1,1,1,1,1,1
19286843,Rafael Fachin,1651,11/06/1996,20,0,0,0,0,191,96,12,9,9,10,14,12,9,14,10,10,13,3,2,3,1,4,8,1,1,1,1,3,3,3,3,6,9,12,8,9,8,14,11,3,12,1,13,9,7,13,6,9,15,10,11,13,20,4,11,10,10,10,10,10,20,13,9,9,10,4,11,7,GK ,20,1,1,1,1,1,1,1,1,1,1,1,1,1,1
19286973,Marquinhos Gomes,1651,26/01/1994,22,0,0,0,0,168,60,2,2,3,3,1,2,2,4,2,3,1,6,6,8,4,12,6,6,9,1,7,14,1,8,12,7,7,7,6,7,9,8,4,11,2,4,7,8,12,14,11,7,4,20,5,13,9,9,4,8,4,1,8,8,13,10,12,11,12,8,5,3,AM C,1,1,1,20,1,1,1,1,1,1,15,1,1,1,1
19287039,Mael,1651,26/08/1991,24,0,0,0,0,175,70,3,3,1,3,4,3,3,2,2,1,3,3,6,7,8,12,4,7,7,1,8,12,4,9,14,7,10,8,9,9,7,14,1,13,5,9,8,8,9,14,14,8,6,20,11,14,10,13,7,9,9,9,5,9,8,10,12,11,12,5,9,1,WB/AM LC,1,1,1,20,1,1,1,15,1,1,10,1,1,16,1
19287040,Guilherme Dentão,1651,22/05/1995,21,0,0,0,0,179,0,2,1,2,2,3,1,3,2,3,3,2,8,6,8,8,14,5,8,12,4,6,14,2,10,10,10,7,9,8,10,9,14,6,4,6,4,11,7,11,14,14,9,8,7,8,14,20,9,7,10,10,9,7,10,12,11,11,11,11,8,3,6,DM/M C,1,1,1,1,1,1,1,1,1,18,20,1,1,1,1
19287042,Luiz Miller,1651,05/02/1995,21,0,0,0,0,192,83,11,8,8,1,15,14,9,15,9,9,12,4,1,3,2,1,9,2,1,1,2,2,1,1,5,9,11,8,9,11,8,15,8,2,1,1,12,9,7,12,7,8,16,9,15,11,20,4,13,9,4,1,9,9,20,13,11,13,11,1,14,4,GK ,20,1,1,1,1,1,1,1,1,1,1,1,1,1,1
19287044,Lucas Gomes,1651,18/01/1996,20,0,0,0,0,183,75,2,1,1,1,3,2,1,3,1,2,1,8,8,7,9,14,7,8,13,5,13,12,3,12,10,10,12,9,8,10,8,14,15,8,11,5,12,8,12,14,11,9,9,11,16,10,20,7,7,10,10,10,10,10,12,11,9,9,11,9,13,8,DM ,1,1,1,1,1,1,1,1,1,20,10,1,1,1,1
19287047,Araçoiaba,1651,01/04/1998,18,0,0,0,0,179,0,3,2,3,1,2,2,2,3,1,2,3,6,7,13,13,13,6,13,6,3,2,7,4,1,12,9,11,5,7,5,4,14,9,10,5,13,5,6,7,13,13,5,7,10,6,13,20,4,7,9,9,11,4,9,14,10,11,10,11,7,5,1,S ,1,1,20,1,1,1,1,1,1,1,1,1,1,1,1
19287048,Fábio,1651,31/01/1996,20,0,0,0,0,175,76,1,3,3,1,3,3,1,1,1,1,2,8,8,12,12,13,8,8,12,1,8,13,4,5,12,7,11,8,9,4,9,11,5,10,1,8,7,13,12,14,14,9,9,10,12,13,20,10,6,10,9,12,10,10,10,12,9,10,10,2,10,8,AM C,1,1,1,20,1,1,1,1,1,1,10,1,1,1,1
19287049,Thallyson,1651,24/03/1996,20,0,0,0,0,180,76,2,2,3,2,2,2,2,2,4,2,3,7,5,14,13,14,7,14,5,1,12,8,7,4,9,9,13,12,7,8,3,10,6,8,10,14,6,12,13,14,12,7,7,9,16,11,20,6,12,9,9,11,9,9,14,10,11,11,13,1,4,7,S ,1,1,20,1,1,1,1,1,1,1,1,1,1,1,1
19287050,Kelvenny,1651,27/06/1998,18,0,0,0,0,182,0,3,3,1,2,3,1,3,3,2,2,3,6,5,13,13,13,3,13,6,4,1,7,3,1,11,14,9,13,8,3,5,10,3,11,4,13,4,6,7,11,9,6,8,8,11,10,20,6,12,7,9,9,7,9,14,10,11,13,8,10,4,1,S ,1,1,20,1,1,1,1,1,1,1,1,1,1,1,1
19287051,Wallace,1651,17/07/1997,18,0,0,0,0,180,70,1,2,3,1,3,3,3,3,3,2,2,6,5,13,13,13,6,12,6,6,1,11,2,1,11,9,5,8,7,7,7,12,3,9,1,13,11,6,7,12,12,7,9,10,8,13,20,6,5,12,5,14,9,9,20,14,12,11,12,6,10,5,S ,1,1,20,1,1,1,1,1,1,1,1,1,1,1,1
19287053,Denílson,1651,06/09/1997,18,0,0,0,0,177,0,2,1,3,2,4,4,2,2,1,2,1,5,8,7,2,14,3,9,2,8,9,9,4,9,10,9,9,10,8,12,9,11,5,9,8,7,7,10,10,15,15,5,8,20,9,15,10,7,9,8,9,9,6,9,19,11,11,10,11,1,10,7,D/WB L,1,1,1,1,1,1,1,20,1,1,1,1,1,19,1
19287055,Luiz Fernando,1651,16/10/1996,19,0,0,0,0,178,66,2,1,1,2,2,2,1,1,2,3,3,5,7,7,6,13,7,5,10,6,12,13,4,12,11,10,9,8,7,8,13,13,4,10,7,5,7,8,10,11,13,8,8,9,9,13,20,8,5,9,9,10,8,10,17,10,10,10,11,6,9,7,M C,1,1,1,1,1,1,1,1,1,1,20,1,1,1,1
19287056,Eduardo,1651,25/04/1995,21,0,0,0,0,181,72,1,2,3,3,3,1,2,1,1,2,1,5,8,6,7,9,7,7,4,7,9,10,5,13,9,10,9,9,9,8,8,13,9,7,11,7,13,8,9,13,13,9,9,10,10,13,20,5,7,10,4,3,8,10,10,12,12,10,12,8,13,1,D/WB/DM R,1,1,1,1,1,1,1,1,19,20,10,1,1,1,19
19287057,Rômulo,1651,09/02/1996,20,0,0,0,0,180,81,4,3,3,1,1,2,2,3,3,2,2,6,6,5,5,8,6,13,7,2,12,7,2,13,7,9,10,9,6,7,7,13,9,3,11,6,12,6,8,13,8,8,7,10,10,12,20,13,8,9,9,9,4,9,11,9,11,10,11,2,13,1,D/DM C,1,1,1,1,1,1,20,1,1,19,10,1,1,1,1
19287059,João Basso,1651,13/01/1997,19,0,0,0,0,187,74,3,4,3,2,2,1,3,4,3,2,1,5,6,5,6,10,7,14,7,8,12,10,12,12,10,13,12,13,10,13,7,10,13,5,8,7,13,13,11,10,9,11,14,8,12,10,20,12,13,10,5,6,7,10,14,13,8,11,13,7,16,2,D/DM C,1,1,1,1,1,1,20,1,1,18,10,1,1,1,1
19287064,Vitor Feijão,1651,01/08/1996,19,0,0,0,0,171,0,3,1,2,2,2,2,1,4,1,1,1,5,6,12,14,14,7,14,7,2,7,9,7,6,14,7,9,8,7,7,10,10,6,13,11,10,7,8,9,14,14,8,5,10,13,14,20,6,6,8,5,6,9,9,17,12,10,9,11,10,11,5,AM/S C,1,1,18,20,1,1,1,1,1,1,10,1,1,1,1
19287065,Yan Philippe,1651,22/11/1995,20,0,0,0,0,185,78,3,2,2,3,1,1,1,2,4,2,1,8,6,14,14,14,8,13,9,6,8,9,8,7,9,7,9,5,8,7,5,9,6,10,12,10,6,8,9,14,11,9,10,10,16,13,20,10,10,10,8,9,10,9,7,12,12,10,11,3,8,6,S ,1,1,20,1,1,1,1,1,1,1,1,1,1,1,1
19287066,Guga,1651,30/05/1997,19,0,0,0,0,170,71,1,1,3,1,1,1,3,1,2,2,3,5,8,14,14,14,7,14,8,5,7,8,4,5,12,9,14,5,5,8,6,11,8,11,7,8,8,7,8,12,14,8,3,10,15,14,20,6,10,9,9,9,9,9,20,10,13,11,11,2,7,1,S ,1,1,20,1,1,1,1,1,1,1,1,1,1,1,1
19287067,Paulinho,1651,10/07/1995,20,0,0,0,0,171,70,3,1,2,2,2,2,3,3,1,2,2,11,13,13,8,13,7,7,5,6,4,7,1,3,13,9,7,5,7,4,5,13,8,13,5,8,3,7,8,13,13,7,5,10,16,13,20,9,6,9,9,9,4,9,18,10,9,11,8,9,9,7,AM RL,1,1,13,1,19,20,1,1,1,1,1,1,1,1,1
19287068,Jean,1651,30/11/1990,25,0,0,0,0,179,70,1,2,1,4,2,3,3,1,2,1,2,5,4,7,6,13,5,5,7,1,5,13,2,6,13,8,7,6,8,6,9,13,3,13,1,6,6,7,9,13,10,6,4,20,11,12,9,13,7,8,8,7,8,8,11,10,10,10,12,8,10,1,M/AM C,1,1,1,18,1,1,1,1,1,1,20,1,1,1,1
19287070,Rodrigo,1651,24/02/1997,19,0,0,0,0,184,75,1,3,2,3,2,2,1,2,3,2,2,5,8,7,8,8,6,10,8,1,10,15,4,12,6,9,11,9,5,10,11,15,6,9,12,8,9,9,14,10,9,9,7,3,12,9,20,10,11,9,9,9,6,9,10,11,11,12,11,4,20,8,D/DM C,1,1,1,1,1,1,18,1,1,20,15,1,1,1,1
19287071,Xandão,1651,08/05/1990,26,0,0,0,0,187,83,3,4,1,3,3,1,3,1,2,3,3,3,1,1,4,6,1,12,5,6,13,8,3,11,6,9,10,10,3,6,4,13,9,3,11,6,6,6,8,13,13,8,8,10,13,13,20,13,7,5,6,7,4,9,20,12,10,11,12,1,6,3,D LC,1,1,1,1,1,1,20,19,1,1,1,1,1,1,1
19287072,Chico Bala,1651,23/01/1993,23,0,0,0,0,175,71,4,2,2,3,2,2,3,3,2,1,2,5,4,7,1,6,3,8,6,6,9,9,6,14,9,7,12,9,7,11,7,14,9,7,8,7,8,9,9,14,14,7,6,20,9,13,9,10,6,9,9,3,8,9,9,11,11,10,9,6,8,6,D/WB L,1,1,1,1,1,1,1,20,1,1,1,1,1,19,1
19287073,Anderson Braz,1651,16/06/1987,29,0,0,0,0,180,75,3,3,1,1,1,2,2,2,3,3,2,6,3,5,4,13,6,4,10,5,7,10,1,13,8,9,8,8,7,6,5,13,9,6,3,6,8,7,12,13,11,6,10,8,4,12,20,7,8,7,9,8,9,9,20,12,14,12,9,1,5,2,DM ,1,1,1,1,1,1,1,1,1,20,10,1,1,1,1
19287084,Perotti,1651,22/11/1997,18,0,0,0,0,187,0,3,2,1,3,2,2,2,1,3,2,2,4,5,13,12,12,5,11,5,2,2,5,4,1,12,8,5,5,7,2,2,6,8,12,9,13,6,5,6,13,13,5,13,9,8,13,20,5,9,6,8,8,5,8,12,13,9,11,9,3,12,1,S ,1,1,20,1,1,1,1,1,1,1,1,1,1,1,1
19287095,Pedro Ivo,1651,02/11/1990,25,0,0,0,0,180,0,2,3,2,2,3,2,3,4,1,2,2,7,6,7,5,13,5,7,12,1,9,13,4,13,11,6,13,9,8,9,10,13,5,4,11,7,10,8,11,13,13,8,8,10,10,13,20,13,6,10,10,5,7,10,17,11,14,11,12,7,13,6,DM ,1,1,1,1,1,1,1,1,1,20,10,1,1,1,1
19287104,Heron,1651,12/06/1997,19,0,0,0,0,167,0,1,1,2,3,3,2,2,2,1,3,1,6,6,13,4,13,1,5,11,1,3,12,2,7,13,9,6,4,5,6,13,13,5,13,10,7,7,7,5,13,13,7,1,20,10,13,10,6,4,9,8,9,6,9,17,12,9,9,10,1,9,6,AM C,1,1,1,20,1,1,1,1,1,1,10,1,1,1,1
19287106,Juninho,1651,26/02/1999,17,0,0,0,0,179,68,3,2,2,2,2,1,2,3,3,1,1,7,5,12,13,14,7,9,6,5,7,10,3,4,12,9,8,4,7,8,10,12,5,9,9,7,6,8,13,14,14,8,4,9,15,14,20,10,6,9,9,11,7,8,8,10,9,10,10,5,13,3,AM/S C,1,1,18,20,1,1,1,1,1,1,10,1,1,1,1
19287463,Matheus Marcondele,1651,27/04/1996,20,0,0,0,0,185,0,2,3,3,3,3,2,2,2,3,4,4,7,3,9,9,14,7,7,7,3,6,12,5,9,14,9,10,8,9,6,8,13,6,13,3,12,9,8,11,14,14,8,9,6,5,14,20,7,8,9,9,9,9,9,9,11,13,11,11,4,16,5,M/AM C,1,1,1,20,1,1,1,1,1,1,18,1,1,1,1
19287470,Maycon,1651,27/08/1996,19,0,0,0,0,175,72,2,3,2,3,3,3,2,3,1,3,3,6,4,13,13,13,6,13,5,5,3,7,5,2,9,4,10,6,6,4,6,11,7,9,12,13,7,6,8,13,12,7,8,9,7,11,20,12,9,9,9,5,9,9,10,10,12,12,10,12,12,3,S ,1,1,20,1,1,1,1,1,1,1,1,1,1,1,1
19287778,Iago,1651,23/03/1997,19,0,0,0,0,181,0,3,2,1,2,4,1,1,2,4,1,3,8,11,5,7,13,3,8,6,9,9,11,6,13,11,10,9,11,11,8,8,15,18,3,1,9,9,11,11,14,12,5,8,20,6,14,11,15,9,10,10,4,4,10,12,10,10,12,13,10,12,1,D/WB L,1,1,1,1,1,1,1,20,1,1,1,1,1,19,1
19287972,Mota,1651,23/03/1985,31,0,0,0,0,195,86,14,14,7,1,14,13,11,11,7,8,12,4,3,1,1,6,6,1,2,2,1,1,3,2,2,10,11,15,9,10,8,12,12,3,8,3,12,9,8,12,13,9,15,11,11,10,20,8,11,10,10,10,10,10,10,11,11,10,13,11,10,10,GK ,20,1,1,1,1,1,1,1,1,1,1,1,1,1,1
19288276,Bahia,1651,19/07/1997,18,0,0,0,0,184,0,3,3,2,1,2,1,1,1,2,1,1,3,4,8,8,7,3,12,3,1,1,2,1,1,7,7,4,2,9,4,3,8,2,8,5,10,4,3,4,9,8,3,10,12,12,11,20,8,6,7,5,7,7,6,15,15,10,13,11,10,14,3,S ,1,1,20,1,1,1,1,1,1,1,1,1,1,1,1
19288767,Rodrigão,1651,13/10/1993,22,0,0,0,0,186,88,3,1,1,3,1,3,3,3,1,3,1,7,10,11,13,12,9,14,12,8,10,10,13,8,11,13,13,13,13,12,11,12,4,12,7,14,7,14,14,13,11,14,14,10,12,12,20,13,14,11,7,13,8,5,17,10,14,13,7,1,17,7,S ,1,1,20,1,1,1,1,1,1,1,1,1,1,1,1
19290232,Adalgisio Pitbull,1651,30/10/1989,26,0,0,0,0,176,74,1,4,2,3,1,3,1,1,3,3,1,7,6,10,11,10,7,9,9,5,5,7,12,4,9,11,9,12,10,10,7,10,12,11,7,10,6,10,10,13,14,13,7,13,11,13,20,14,9,9,10,11,4,8,8,11,10,8,9,4,20,5,AM/S R,1,1,18,1,1,20,1,1,1,1,1,1,1,1,1
19290392,Jefferson,1651,03/01/1997,19,0,0,0,0,176,69,1,2,3,2,2,2,2,3,1,3,1,10,11,9,10,12,8,10,11,13,13,13,8,13,11,14,13,13,12,12,11,12,17,10,8,11,12,13,12,12,12,11,13,20,14,12,11,13,14,11,9,10,7,10,12,10,11,10,10,6,6,5,D/WB L,1,1,1,1,1,1,1,20,1,1,1,1,1,16,1
19290393,Léo Sena,1651,31/12/1995,20,0,0,0,0,175,71,2,2,2,4,3,1,2,3,1,1,1,12,12,12,12,13,12,10,11,9,9,14,10,11,13,11,10,12,11,11,12,11,5,11,10,12,12,11,11,11,10,11,10,10,10,11,20,12,11,12,12,11,11,12,8,8,10,9,12,2,16,2,AM C,1,1,1,20,1,1,1,1,8,1,10,1,1,1,1
19290394,Johnathan,1651,04/04/1995,21,0,0,0,0,177,69,3,2,2,1,3,2,1,1,1,2,2,5,9,4,5,14,1,10,8,5,11,11,4,15,10,5,11,11,8,8,9,15,4,8,14,7,11,10,10,15,15,10,9,11,13,15,20,7,9,10,4,7,10,10,19,12,13,10,10,8,5,6,D/WB R,1,1,1,1,1,1,1,1,20,1,1,1,1,1,18
19290396,Gileard,1651,30/05/1996,20,0,0,0,0,179,0,3,3,1,2,2,2,1,3,2,4,2,7,5,13,12,11,7,14,6,7,6,8,5,4,13,8,10,1,13,6,6,10,4,12,6,14,4,7,8,13,11,8,9,9,10,12,20,7,7,9,3,3,9,8,16,13,10,12,10,11,12,1,S ,1,1,20,1,1,1,1,1,1,1,1,1,1,1,1
19290406,Adriel,1651,13/03/1997,19,0,0,0,0,173,0,2,2,1,2,1,2,3,2,1,1,1,6,4,6,6,13,6,3,10,1,7,11,3,8,12,7,4,6,5,7,13,11,3,1,3,6,6,5,9,13,13,7,3,11,15,13,20,8,5,9,9,9,9,9,16,11,10,8,12,4,11,6,M C,1,1,1,1,1,1,1,1,1,1,20,1,1,1,1
19290407,Allan,1651,10/11/1997,18,0,0,0,0,188,0,2,3,3,4,1,1,3,2,1,3,2,3,1,1,6,7,1,11,1,1,13,7,3,13,5,9,9,9,5,6,6,10,3,1,10,6,13,6,7,11,11,7,11,3,9,13,20,4,9,9,9,9,9,8,15,11,9,11,13,8,15,3,D C,1,1,1,1,1,1,20,1,1,1,1,1,1,1,1
19290408,Arlen,1651,30/01/1996,20,0,0,0,0,172,0,2,1,2,4,3,3,1,2,3,1,1,6,3,3,2,12,3,7,1,6,5,6,4,9,8,9,9,9,7,10,8,14,7,1,11,4,5,8,8,8,11,8,5,20,11,12,20,10,6,9,9,5,9,9,17,9,13,12,9,1,10,7,D R,1,1,1,1,1,1,1,13,20,1,1,1,1,1,1
19290410,Felipe Bob,1651,16/03/1995,21,0,0,0,0,186,0,3,3,2,2,3,1,1,1,3,3,2,6,9,12,12,11,6,8,6,4,3,6,4,5,13,6,9,3,7,7,7,8,4,13,12,8,6,7,8,13,7,7,11,9,12,11,20,13,9,7,6,9,8,9,17,12,12,10,11,8,2,2,AM/S RL,1,1,20,13,17,17,1,1,1,1,1,1,1,1,1
19290412,Ygor,1651,01/07/1995,21,0,0,0,0,186,0,4,2,2,3,3,2,3,1,2,2,1,5,5,7,7,13,5,5,7,1,6,9,1,12,13,5,3,7,2,4,9,13,8,6,14,7,9,7,12,12,9,5,11,8,12,12,20,12,10,8,8,5,4,8,13,10,12,10,11,12,3,2,DM/M C,1,1,1,1,1,1,1,1,1,17,20,1,1,1,1
19290413,Jorda,1651,16/01/1995,21,0,0,0,0,178,0,3,2,1,3,3,2,1,3,1,2,4,6,9,13,14,12,7,9,7,1,5,9,6,6,11,5,7,5,11,7,6,12,6,10,7,8,7,8,9,14,10,8,4,2,9,13,20,9,8,9,8,9,9,9,9,12,10,9,11,2,11,1,AM/S RL,1,1,20,13,17,17,1,1,1,1,1,1,1,1,1
19290414,Luiz Henrique,1651,12/06/1997,19,0,0,0,0,171,0,1,1,4,1,2,1,2,2,1,3,1,6,4,8,9,14,6,7,10,2,9,14,7,14,14,9,6,4,6,7,11,12,9,9,6,8,8,9,12,10,13,5,6,5,13,14,20,8,8,9,5,9,9,9,14,12,8,10,12,11,10,6,DM/M C,1,1,1,1,1,1,1,1,1,17,20,1,1,1,1
19290415,Paulo André,1651,21/04/1997,19,0,0,0,0,183,0,13,8,6,6,13,13,10,11,7,9,12,3,2,2,2,2,7,1,2,2,3,1,1,3,1,7,7,7,3,12,6,13,9,3,1,3,10,7,4,10,9,7,10,4,14,7,20,6,9,9,9,9,6,8,8,14,12,15,10,6,13,2,GK ,20,1,1,1,1,1,1,1,1,1,1,1,1,1,1
19290416,Rodrigo Confettura,1651,20/06/1997,19,0,0,0,0,181,0,3,3,4,1,3,1,2,4,2,3,3,7,6,14,14,14,7,9,6,7,4,8,5,7,11,9,6,1,10,5,6,9,4,11,12,9,6,7,9,14,14,8,9,20,14,12,4,7,7,9,9,5,9,9,15,13,10,11,12,10,12,6,AM/S L,1,1,19,1,20,13,1,1,1,1,1,1,1,1,1
19290417,Yago,1651,05/10/1994,21,0,0,0,0,182,0,2,2,1,3,3,4,1,3,3,3,1,6,4,1,4,5,1,13,4,5,13,7,1,13,6,9,4,9,5,10,6,12,6,1,8,5,12,6,7,10,13,7,7,8,12,13,20,4,8,9,9,9,9,9,15,10,10,13,11,7,10,3,D C,1,1,1,1,1,1,20,1,1,1,1,1,1,1,1
19290418,Yan Silva,1651,19/02/1996,20,0,0,0,0,190,0,1,4,2,1,1,1,3,2,3,1,3,7,6,5,4,5,2,9,2,2,11,8,5,14,4,9,9,9,7,7,6,14,6,4,5,7,11,8,8,11,11,8,14,8,8,12,20,7,11,9,7,9,9,9,8,9,8,14,13,7,9,1,D RLC,1,1,1,1,1,1,20,17,17,1,1,1,1,1,1
19290514,Kevin,1651,14/03/2000,16,0,0,0,0,184,0,1,2,2,3,1,1,3,2,3,1,3,6,13,12,4,12,3,6,4,5,8,11,3,12,13,12,4,8,2,5,13,8,8,13,7,5,6,6,6,13,13,1,11,20,15,13,8,12,6,13,8,2,8,8,8,10,13,10,13,7,13,2,D L,1,1,1,1,1,1,1,20,1,1,1,1,1,15,1
19290524,Bruno Lucas,1651,07/07/1996,19,0,0,0,0,179,70,1,2,2,1,2,2,2,3,3,1,2,5,5,7,1,12,3,9,1,7,10,8,1,13,10,5,8,9,9,11,9,12,4,1,13,8,7,9,9,15,12,11,9,2,10,13,20,14,8,8,9,9,9,9,12,10,10,10,12,4,12,4,D/WB R,1,1,1,1,1,1,1,1,20,1,1,1,1,1,18
19290526,Jean Henrique,1651,24/07/1993,22,0,0,0,0,178,70,2,3,3,3,1,3,2,2,3,3,1,6,6,3,6,13,6,6,10,4,9,12,3,13,13,6,11,8,5,6,8,13,3,4,1,6,10,7,10,13,11,7,6,10,11,13,20,13,6,9,7,9,9,9,12,13,10,12,13,8,8,7,DM ,1,1,1,1,1,1,1,1,1,20,10,1,1,1,1
19290527,Léo Baiano,1651,02/10/1992,23,0,0,0,0,180,80,2,1,3,4,3,3,3,3,1,3,2,6,2,7,7,10,6,3,9,3,7,11,4,12,5,1,12,8,7,7,9,13,9,9,3,6,10,8,11,14,14,7,10,10,14,13,20,8,6,9,5,9,9,9,18,13,11,12,10,2,15,5,DM ,1,1,1,1,1,1,1,1,1,20,10,1,1,1,1
19290528,Dalberson,1651,13/01/1997,19,0,0,0,0,187,0,12,10,6,5,13,12,8,13,9,9,8,3,2,1,1,1,8,1,3,3,2,1,2,2,4,9,4,12,5,10,6,13,4,3,2,3,9,7,6,10,12,2,13,11,15,12,20,6,7,9,6,9,5,9,8,11,8,8,11,6,17,6,GK ,20,1,1,1,1,1,1,1,1,1,1,1,1,1,1
19290599,Rafael Bastos,1651,25/04/1993,23,0,0,0,0,182,80,3,2,1,3,3,2,3,1,4,3,1,10,9,13,12,11,7,10,6,3,3,12,11,4,13,11,9,10,12,13,13,9,13,12,6,11,12,11,12,13,11,10,10,12,12,11,20,11,11,10,6,13,10,15,15,12,12,11,11,10,12,10,AM LC,1,1,12,20,19,12,1,1,1,1,1,1,1,1,1
19290600,Igor Bosel,1651,08/09/1992,23,0,0,0,0,185,85,1,2,1,3,1,3,1,3,1,2,3,7,13,12,8,11,7,13,7,10,12,12,8,13,12,12,10,12,9,11,10,11,9,7,5,11,10,12,12,13,10,11,11,8,11,12,20,13,14,11,10,10,9,10,10,10,10,10,11,11,14,10,D R,1,1,1,1,1,1,1,1,20,12,1,1,1,1,10
19290601,Pedrão,1651,22/01/1994,22,0,0,0,0,192,82,2,1,3,2,3,1,2,1,3,2,2,4,1,1,1,7,3,14,1,3,10,6,3,11,5,18,12,9,5,6,5,14,3,1,10,7,14,7,8,10,8,8,16,6,16,10,20,7,14,9,4,1,4,9,13,12,10,10,9,7,8,6,D C,1,1,1,1,1,1,20,1,1,1,1,1,1,1,1
19290602,Rodolfo,1651,16/02/1991,25,0,0,0,0,174,64,1,3,2,1,2,1,3,4,3,3,2,6,3,14,11,13,7,14,8,4,7,9,5,5,9,9,12,6,8,8,8,13,9,9,1,13,8,7,9,14,14,6,9,8,15,14,20,12,5,9,5,9,8,9,11,10,11,11,8,3,5,1,AM/S C,1,1,20,18,1,1,1,1,1,1,1,1,1,1,1
19290603,Marcelinho,1651,02/07/1996,19,0,0,0,0,173,68,3,3,2,1,2,3,2,1,3,3,2,4,10,12,9,9,4,7,6,3,4,11,7,3,9,13,11,12,7,8,8,9,13,15,4,12,8,5,11,15,16,7,5,20,10,14,11,10,5,9,5,10,5,9,8,12,9,8,11,12,12,7,AM RC,1,1,1,20,1,17,1,1,1,1,10,1,1,1,1
19290604,Igor Miranda,1651,01/07/1996,20,0,0,0,0,178,78,1,1,2,1,1,3,2,2,1,1,4,8,11,11,6,14,3,8,6,7,11,7,6,16,11,9,10,9,10,8,10,9,9,9,13,8,8,10,11,12,15,10,9,20,8,12,10,9,7,9,9,3,9,16,12,11,11,11,12,5,8,3,D/WB L,1,1,1,1,13,1,1,20,1,1,10,13,1,17,1
19290840,Euller Viana,1651,21/05/1995,21,0,0,0,0,181,78,3,3,2,1,3,2,1,1,2,2,1,2,5,5,6,10,6,12,8,8,12,10,5,10,8,10,10,12,10,10,8,12,10,6,1,10,10,10,10,12,12,11,12,20,10,12,11,14,12,8,8,8,5,5,10,11,12,14,12,1,8,6,D C,1,1,1,1,1,1,20,1,1,1,1,1,1,1,1
19290841,Ramon,1651,01/01/1992,24,0,0,0,0,179,0,1,2,1,2,1,3,1,1,3,2,3,8,9,10,7,14,7,6,10,4,5,14,3,6,13,10,10,9,14,8,10,13,4,10,13,12,7,9,11,14,14,9,8,3,14,13,20,14,6,10,10,10,4,10,16,11,12,9,11,5,11,8,M/AM C,1,1,1,20,1,1,1,1,1,1,18,1,1,1,1
19290842,Raphael Augusto,1651,18/11/1994,21,0,0,0,0,182,0,1,2,2,3,1,2,1,3,3,2,1,9,6,11,11,11,9,7,11,3,6,13,9,7,11,5,7,6,7,6,9,9,10,10,5,11,6,7,11,13,11,11,11,10,10,13,20,11,9,6,5,10,10,9,10,10,10,10,10,10,10,10,AM C,1,1,1,20,1,1,1,1,1,1,10,1,1,1,1
19290843,Sávio,1651,24/05/1995,21,0,0,0,0,180,70,2,1,3,2,1,2,2,2,4,2,3,6,7,11,9,9,9,9,10,3,6,11,11,7,11,5,7,8,9,11,14,11,15,12,11,11,13,16,11,13,11,9,9,10,10,13,20,13,11,12,5,10,10,10,10,10,5,8,12,3,11,8,AM C,1,1,1,20,1,1,1,1,1,1,1,1,1,1,1
19290853,Bissoli,1651,09/01/1998,18,0,0,0,0,176,68,3,3,2,1,1,1,3,2,1,2,3,6,6,8,8,13,6,1,11,1,7,11,8,7,13,6,8,6,12,7,9,12,5,13,8,9,8,7,11,13,13,7,4,14,11,13,20,7,5,5,9,9,8,9,18,11,10,12,12,5,14,3,M/AM C,1,1,1,20,1,1,1,1,1,1,16,1,1,1,1
19290854,Luizão,1651,20/02/1998,18,0,0,0,0,186,0,1,4,2,1,2,2,4,2,2,3,2,7,3,8,5,7,8,14,4,8,14,9,2,13,6,9,9,10,8,8,7,13,6,4,8,6,9,8,9,14,14,9,8,9,14,14,20,6,11,8,7,6,6,9,11,13,11,13,11,1,6,8,D C,1,1,1,1,1,1,20,1,1,1,1,1,1,1,1
19290856,Oliveira,1651,11/07/1998,17,0,0,0,0,174,0,2,1,3,3,1,1,3,1,2,1,2,4,6,7,6,11,6,4,12,1,8,12,3,13,12,9,7,8,7,8,6,13,9,9,1,7,11,8,11,13,13,8,8,10,9,13,20,7,5,9,9,7,9,9,11,10,8,13,11,8,15,5,DM/M C,1,1,1,12,1,1,1,1,1,20,16,1,1,1,1
19290857,Bruno Dip,1651,17/02/1998,18,0,0,0,0,175,0,2,1,3,1,2,1,3,1,4,3,2,11,13,12,10,12,8,7,12,5,8,12,8,10,13,10,7,8,10,7,12,10,20,13,1,10,6,9,10,12,13,11,8,20,12,13,6,12,9,9,3,10,7,10,8,10,12,10,13,6,11,4,M/AM LC,1,1,10,20,16,1,1,13,1,1,16,15,1,15,1
19290858,Clairton,1651,28/02/1998,18,0,0,0,0,167,0,4,1,1,1,3,3,1,2,3,1,3,12,5,10,10,15,15,7,12,1,8,14,4,8,12,8,9,8,7,9,13,11,8,10,11,12,8,9,13,9,13,9,3,8,12,10,20,9,6,9,9,9,6,9,18,13,12,13,12,12,11,5,M/AM C,1,1,1,20,1,1,1,1,1,1,16,1,1,1,1
19290859,Coutinho,1651,21/02/1997,19,0,0,0,0,197,0,14,10,5,1,9,13,14,14,8,7,8,7,1,3,1,3,9,1,3,2,1,3,3,1,6,9,5,11,8,10,7,14,2,3,9,1,5,8,7,9,14,8,17,1,13,11,20,3,12,9,9,9,7,9,11,12,11,12,14,7,3,3,GK ,20,1,1,1,1,1,1,1,1,1,1,1,1,1,1
19290860,Morais,1651,28/04/1998,18,0,0,0,0,183,0,1,1,2,3,2,3,4,3,1,2,1,1,1,1,2,5,1,13,2,3,7,3,6,12,6,9,7,9,4,8,2,13,9,2,11,6,13,6,7,12,10,7,11,8,12,9,20,9,9,9,9,8,6,9,8,11,10,11,10,7,11,7,D C,1,1,1,1,1,1,20,1,1,1,1,1,1,1,1
19290861,Igor Neves,1651,13/07/1998,17,0,0,0,0,187,75,1,2,2,2,3,2,1,3,3,2,2,4,2,2,1,3,3,13,4,5,12,12,2,12,6,7,13,9,2,8,2,13,3,2,7,3,13,6,7,9,7,7,13,9,13,11,20,5,10,9,9,8,9,9,7,12,14,12,10,11,13,5,D C,1,1,1,1,1,1,20,1,1,1,1,1,1,1,1
19290862,Lucas,1651,15/05/1998,18,0,0,0,0,194,0,13,9,11,1,13,13,7,13,8,6,12,2,1,2,2,1,3,1,3,3,3,1,3,2,4,5,8,11,4,12,6,13,7,1,10,3,9,7,5,9,10,7,15,13,11,11,20,1,9,9,6,7,9,8,15,13,11,10,9,8,3,4,GK ,20,1,1,1,1,1,1,1,1,1,1,1,1,1,1
19290863,Rodrigo,1651,17/06/1998,18,0,0,0,0,187,0,2,2,2,3,1,2,3,3,1,2,1,1,5,2,1,6,1,12,4,2,12,6,1,13,5,4,8,9,4,6,4,12,17,2,10,4,10,5,7,13,11,6,11,9,7,12,20,8,9,9,9,1,9,9,12,12,10,12,9,4,4,8,D C,1,1,1,1,1,1,20,1,1,1,1,1,1,1,1
19290864,Gui Alves,1651,08/09/1998,17,0,0,0,0,181,0,1,3,3,1,1,1,2,3,2,3,1,8,10,8,5,15,5,7,3,3,9,10,5,15,10,6,6,9,7,7,6,8,12,8,11,7,8,9,9,15,14,5,9,6,11,15,20,8,10,7,9,9,8,8,16,13,12,13,11,2,13,6,D/WB L,1,1,1,1,1,1,1,20,1,1,1,1,1,18,1
19290865,Paulo Henrique,1651,26/06/1998,18,0,0,0,0,173,0,2,3,1,4,2,1,1,3,3,3,3,5,10,11,11,12,5,12,3,1,4,10,3,5,10,6,5,6,10,3,10,11,12,14,9,12,1,5,7,11,13,8,9,13,14,13,20,6,5,9,8,9,8,9,7,10,9,13,11,5,12,4,S L,1,1,20,1,15,14,1,1,1,1,1,1,1,1,1
19290866,Alex Nascimento,1651,10/05/1999,17,0,0,0,0,185,0,1,3,1,3,1,2,3,3,1,1,2,7,5,4,2,8,2,10,5,1,14,8,4,14,3,9,12,9,8,6,7,14,2,9,7,3,11,7,6,7,9,8,10,8,14,10,20,5,10,6,7,9,9,9,13,11,11,11,14,5,10,2,D C,1,1,1,1,1,1,20,1,1,1,1,1,1,1,1
19290867,Alex,1651,30/03/1999,17,0,0,0,0,185,0,3,3,1,3,1,2,1,3,1,3,2,7,7,7,8,12,7,7,13,4,6,14,4,9,8,8,5,3,5,8,5,14,4,9,1,8,8,8,11,14,13,8,12,8,15,14,20,8,8,7,9,7,9,9,17,13,11,11,11,5,7,2,AM C,1,1,1,20,1,1,1,1,1,1,15,1,1,1,1
19290868,Amarildo,1651,19/01/1999,17,0,0,0,0,176,0,1,1,3,1,2,1,1,1,2,3,3,6,7,13,13,13,6,7,7,3,4,3,6,2,10,8,10,8,9,6,4,7,20,10,10,13,3,6,8,13,12,7,8,15,10,13,20,12,5,9,9,5,9,9,15,12,11,10,13,3,7,4,S ,1,1,20,1,1,1,1,1,1,1,1,1,1,1,1
19290869,Augusto Galván,1651,25/03/1999,17,0,0,0,0,177,0,2,2,1,1,3,3,2,3,3,2,1,6,11,13,7,13,5,6,13,3,5,12,3,7,14,8,6,7,10,7,13,12,20,14,3,12,3,6,11,11,13,10,8,9,12,12,20,8,8,8,6,7,9,9,19,14,12,11,12,10,7,6,AM C,1,1,1,20,1,1,1,1,1,1,15,1,1,1,1
19290870,Danilo,1651,05/02/1999,17,0,0,0,0,184,0,1,2,3,3,1,2,1,3,2,3,1,5,6,11,11,12,5,12,6,1,3,6,3,1,11,9,12,4,11,6,6,8,12,10,8,11,6,5,7,12,11,6,7,6,14,12,20,11,6,9,8,9,9,8,18,13,11,10,12,8,7,2,S ,1,1,20,1,1,1,1,1,1,1,1,1,1,1,1
19290871,Kau,1651,17/01/1999,17,0,0,0,0,180,0,3,1,3,4,1,2,1,3,1,3,1,5,10,7,8,15,8,8,9,6,7,12,7,13,10,9,7,9,5,7,9,11,1,9,6,7,8,10,10,9,13,10,9,20,10,11,3,7,8,9,9,8,9,9,15,11,10,9,12,2,7,5,D/WB/DM L,1,1,1,1,1,1,1,16,1,16,12,14,1,20,1
19290872,Igor,1651,17/03/1999,17,0,0,0,0,163,0,1,3,2,3,1,3,1,2,2,2,3,6,6,8,6,14,6,6,12,1,6,8,3,7,12,7,9,2,5,5,11,14,3,11,10,10,6,8,11,14,11,7,1,8,9,11,20,7,4,8,8,6,8,8,7,12,13,8,13,1,8,1,AM C,1,1,1,20,1,1,1,1,1,1,15,1,1,1,1
19290873,Kiefer,1651,19/04/1999,17,0,0,0,0,180,0,2,1,1,3,1,2,1,1,3,4,3,4,1,10,12,10,4,12,5,1,1,8,9,1,10,13,11,5,11,5,9,11,8,12,8,12,5,4,5,11,12,9,9,13,15,11,20,2,5,7,8,8,6,8,20,12,12,11,10,10,12,8,S ,1,1,20,1,1,1,1,1,1,1,1,1,1,1,1
19290874,Luan,1651,14/05/1999,17,0,0,0,0,183,0,1,1,2,3,3,1,3,2,1,1,1,6,4,5,4,14,6,6,10,1,8,14,2,14,14,8,10,6,3,8,12,11,8,3,11,6,6,8,11,11,8,7,12,8,8,10,20,7,10,5,8,8,7,8,15,10,9,13,11,2,3,7,DM/M C,1,1,1,1,1,1,1,1,1,20,16,1,1,1,1
19290875,Lucas Augusto,1651,03/02/1999,17,0,0,0,0,184,0,1,1,1,1,1,3,3,3,1,2,2,4,3,7,6,12,5,7,9,5,9,13,3,14,8,7,9,8,6,7,6,14,9,9,8,5,9,8,9,13,8,8,12,8,9,10,20,7,9,7,7,4,9,8,9,12,12,10,10,1,11,4,D/DM C,1,1,1,1,1,1,20,1,1,18,15,1,1,1,1
19290876,Grijo,1651,03/10/1999,16,0,0,0,0,189,75,12,7,6,1,13,12,11,13,6,4,9,5,3,1,2,1,7,1,1,3,3,2,1,3,1,8,3,13,1,9,5,12,7,1,8,3,9,6,5,9,7,6,12,6,13,8,20,2,8,8,8,1,6,7,20,11,11,12,10,9,13,8,GK ,20,1,1,1,1,1,1,1,1,1,1,1,1,1,1
19290877,Rael,1651,14/04/1999,17,0,0,0,0,175,0,2,2,3,2,3,3,1,2,1,3,1,9,13,9,10,13,5,8,8,6,4,8,1,5,12,8,6,7,7,7,9,12,3,12,10,5,7,7,8,13,13,7,8,20,12,13,8,7,5,7,9,6,9,9,17,9,11,13,11,5,16,6,AM/S LC,1,1,20,15,18,1,1,10,1,1,12,15,1,12,1
19290878,Thiago Couto,1651,26/03/1999,17,0,0,0,0,187,0,10,7,6,1,13,11,6,13,9,9,12,6,3,1,1,1,8,1,1,1,3,1,3,1,6,9,5,13,4,9,6,13,20,3,4,2,11,7,5,12,16,7,11,8,11,13,20,1,9,8,9,3,9,7,13,9,9,11,12,4,5,1,GK ,20,1,1,1,1,1,1,1,1,1,1,1,1,1,1
19290879,Walce,1651,02/02/1999,17,0,0,0,0,187,0,2,1,3,1,2,2,2,2,2,4,3,7,5,4,5,9,3,12,5,5,14,9,5,14,8,9,5,9,5,9,7,14,8,9,2,6,8,7,7,13,10,8,12,3,9,11,20,6,10,9,9,9,9,9,13,11,11,11,11,2,12,2,D C,1,1,1,1,1,1,20,1,1,14,11,1,1,1,1
19290880,William,1651,28/02/1999,17,0,0,0,0,173,0,1,1,2,2,4,2,1,1,1,2,2,10,13,13,11,11,11,8,11,2,3,11,4,7,12,7,9,8,8,3,12,9,14,14,10,10,5,7,8,12,13,7,4,1,16,14,20,11,5,9,9,5,8,7,18,12,10,13,9,5,5,2,AM/S R,1,1,16,1,13,20,1,1,1,1,1,1,1,1,1
19290881,Yuri,1651,02/05/1999,17,0,0,0,0,178,0,1,3,3,2,1,1,1,2,3,2,2,6,6,6,9,14,7,7,10,3,8,11,1,13,10,8,8,8,7,6,8,14,1,9,5,8,10,9,7,11,13,6,6,8,10,13,20,7,7,9,8,9,9,9,8,12,10,12,10,10,7,3,DM/M C,1,1,1,1,1,1,1,1,1,20,17,1,1,1,1
19290882,Tiago Jorge,1651,05/08/1999,16,0,0,0,0,182,0,1,2,3,2,3,1,1,2,3,2,4,6,5,13,13,13,4,11,7,3,2,7,5,1,10,9,13,6,5,4,4,11,5,10,1,10,4,6,7,13,10,7,10,8,8,11,20,6,6,9,9,1,6,8,17,12,11,13,12,1,11,3,S ,1,1,20,1,1,1,1,1,1,1,1,1,1,1,1
19290883,Thiago,1651,18/07/1999,16,0,0,0,0,193,0,9,12,6,1,14,14,9,11,4,9,8,3,2,1,1,7,8,1,3,1,1,1,2,2,4,9,6,15,8,8,7,14,9,2,1,1,6,8,7,13,10,8,13,1,15,10,20,5,13,9,9,9,9,6,19,12,10,9,10,10,4,1,GK ,20,1,1,1,1,1,1,1,1,1,1,1,1,1,1
19290884,Tuta,1651,04/07/1999,16,0,0,0,0,180,0,3,1,3,3,2,2,2,1,1,1,3,5,6,7,7,9,4,14,7,4,14,8,6,14,8,9,7,9,5,6,3,14,9,5,10,3,8,7,8,7,9,8,9,8,10,11,20,11,8,9,9,9,7,9,17,13,12,11,13,9,12,5,D RC,1,1,1,1,1,1,20,1,16,1,1,1,1,1,14
19290885,Bottan,1651,14/07/1999,16,0,0,0,0,182,0,9,11,8,1,13,13,8,13,7,9,10,6,2,1,1,4,9,1,2,1,1,1,2,1,1,4,4,10,2,12,6,13,6,2,10,1,10,7,6,10,7,7,6,8,10,10,20,5,7,7,6,9,8,8,10,12,10,11,9,10,11,8,GK ,20,1,1,1,1,1,1,1,1,1,1,1,1,1,1
19290886,Cássio,1651,20/06/1999,17,0,0,0,0,185,0,2,3,3,2,1,3,1,2,2,4,2,7,5,5,8,7,7,7,13,1,7,13,3,13,10,9,5,8,4,9,9,14,9,9,10,5,7,8,12,12,10,8,10,12,10,12,20,7,9,9,6,6,7,9,17,10,10,10,9,10,9,3,DM/M C,1,1,1,1,1,1,1,1,1,20,16,1,1,1,1
19290887,Fabinho,1651,18/11/1999,16,0,0,0,0,176,0,1,1,4,2,2,1,1,3,1,2,3,5,5,11,13,13,5,11,2,1,3,8,6,4,13,5,7,7,9,6,7,9,8,13,9,10,5,6,7,13,9,6,4,10,9,11,20,10,4,8,6,7,8,6,18,14,10,11,10,1,9,8,AM/S C,1,1,20,17,1,1,1,1,1,1,15,1,1,1,1
19290888,Pavaneli,1651,02/11/1999,16,0,0,0,0,183,0,4,1,3,4,2,1,3,1,3,3,1,3,6,6,1,13,1,7,1,6,6,8,1,12,8,6,5,8,4,7,7,9,3,7,8,1,9,7,7,14,14,7,12,11,9,14,20,7,9,5,8,8,4,8,15,12,10,12,11,5,16,1,D/WB R,1,1,1,1,1,1,1,1,20,1,1,1,1,1,16
19290889,Gabriel Sara,1651,26/06/1999,17,0,0,0,0,170,0,1,3,4,2,1,2,1,1,2,2,1,4,6,8,8,12,6,6,14,6,7,11,3,8,14,8,9,5,7,5,8,7,5,13,10,11,8,8,12,8,8,4,7,8,9,7,20,14,6,8,8,6,8,8,9,9,11,10,11,8,10,8,M/AM C,1,1,1,20,1,1,1,1,1,1,16,1,1,1,1
19291032,Felipe,1651,29/01/1994,22,0,0,0,0,183,0,3,1,1,1,1,2,2,3,1,1,3,9,6,15,15,14,9,10,7,2,8,10,8,6,9,10,12,4,14,7,8,14,10,9,10,15,7,6,10,15,13,9,12,1,15,12,20,11,10,8,8,10,5,10,7,13,9,12,9,7,14,5,S ,1,1,20,1,1,1,1,1,1,1,1,1,1,1,1
19291033,Felipe,1651,22/02/1997,19,0,0,0,0,186,0,2,1,2,1,3,2,1,2,1,3,3,7,9,7,4,9,2,8,2,8,9,10,2,15,10,4,6,8,10,8,7,10,7,9,9,7,9,9,10,14,10,9,12,10,10,13,20,15,9,9,9,9,9,9,9,12,11,10,11,4,4,6,D/WB R,1,1,1,1,1,1,1,1,20,14,10,1,12,1,16
19291034,Magrão,1651,10/12/1989,26,0,0,0,0,192,78,2,3,2,2,1,2,3,2,3,1,1,8,4,4,7,7,6,14,6,3,14,9,1,14,4,10,11,10,6,9,4,10,3,5,11,6,13,7,9,13,11,8,11,8,10,11,20,14,9,10,5,4,10,10,17,10,11,13,10,10,10,4,D C,1,1,1,1,1,1,20,1,1,1,1,1,1,1,1
19291146,Alex,1651,04/06/1998,18,0,0,0,0,172,0,2,3,1,2,2,3,2,1,1,1,2,6,8,9,8,10,8,8,15,5,8,14,6,14,10,9,7,9,8,6,6,11,9,2,4,9,9,9,12,10,11,9,6,8,7,8,20,8,7,9,8,9,5,9,16,12,13,13,8,2,7,8,DM/M C,1,1,1,1,1,1,1,1,1,20,16,1,1,1,1
19291147,Caio,1651,11/12/1995,20,0,0,0,0,166,62,1,1,4,3,2,3,1,1,3,4,1,6,6,7,13,13,6,10,6,1,5,7,7,1,11,6,9,8,13,7,4,10,9,11,1,13,5,6,7,13,13,7,2,9,12,13,20,8,9,8,7,7,9,9,18,12,12,10,11,10,11,7,S ,1,1,20,1,1,1,1,1,1,1,1,1,1,1,1
19291148,Darlyson,1651,20/03/1998,18,0,0,0,0,180,0,3,3,3,3,4,2,2,3,1,3,3,6,3,8,7,13,4,2,11,2,1,10,2,7,11,9,4,5,5,6,13,11,5,11,9,10,8,7,11,13,13,6,6,1,7,13,20,13,5,9,6,9,9,9,10,13,9,11,11,10,13,7,AM C,1,1,1,20,1,1,1,1,1,1,15,1,1,1,1
19291149,Diego,1651,17/01/1995,21,0,0,0,0,174,0,3,3,2,3,3,3,3,3,2,2,1,6,5,8,5,13,6,6,8,6,6,7,4,8,11,9,7,8,8,7,10,10,9,11,12,10,8,7,7,13,13,7,6,9,11,13,20,9,4,9,5,5,9,9,20,11,10,10,10,3,6,8,AM C,1,1,1,20,1,1,1,1,1,1,15,1,1,1,1
19291150,Gabriel,1651,01/01/1997,19,0,0,0,0,194,85,12,10,10,9,12,11,9,10,10,10,10,3,1,1,2,8,4,8,1,1,2,9,3,2,9,9,9,10,11,11,9,9,9,8,8,11,12,12,12,8,10,10,12,4,10,10,20,10,12,10,5,8,5,9,15,9,12,13,9,10,13,3,GK ,20,1,1,1,1,1,1,1,1,1,1,1,1,1,1
19291155,Rafael,1651,21/05/1993,23,0,0,0,0,176,0,1,3,1,2,4,1,2,3,3,3,1,7,7,14,14,14,4,14,6,2,7,8,7,5,9,5,12,5,10,6,8,9,2,8,8,11,8,7,8,14,11,3,9,1,4,13,20,7,5,9,9,9,9,9,15,11,8,9,10,11,3,3,S ,1,1,20,1,1,1,1,1,1,1,1,1,1,1,1
19291399,Bahia,1651,14/02/1997,19,0,0,0,0,186,0,1,2,1,2,4,2,4,2,1,1,3,8,6,4,6,9,5,15,5,5,12,9,4,15,8,9,12,10,8,12,3,7,4,1,4,5,14,8,9,12,9,9,10,6,15,13,20,6,12,9,5,1,9,9,20,14,10,11,12,3,7,6,D C,1,1,1,1,1,1,20,1,1,1,1,1,1,1,1
19291400,Gabriel Batista,1651,27/02/1997,19,0,0,0,0,182,0,2,1,3,1,3,4,2,3,2,3,2,6,9,8,7,14,4,9,8,8,8,10,2,13,10,7,11,10,9,8,9,13,3,9,13,8,8,9,9,14,11,9,7,20,11,11,9,8,7,9,9,9,9,9,10,7,12,13,12,11,7,3,D/WB L,1,1,1,1,1,1,1,20,1,1,1,1,1,18,1
19291401,Guilherme,1651,18/06/1997,19,0,0,0,0,167,0,3,3,3,2,2,4,1,3,1,3,1,7,6,9,11,13,7,8,9,2,8,14,7,9,14,9,5,7,7,9,14,12,4,13,13,11,6,8,9,14,14,9,3,1,16,14,20,7,5,5,5,7,4,8,16,11,11,12,11,8,8,7,AM C,1,1,12,20,1,1,1,1,1,1,15,1,1,1,1
19291403,Pedro Vítor,1651,15/05/1997,19,0,0,0,0,183,0,1,4,1,2,2,1,1,3,3,1,3,6,9,5,6,12,8,8,8,5,7,8,6,13,7,9,7,8,10,7,10,11,9,8,10,7,12,9,10,15,11,9,12,7,14,14,20,10,11,9,9,7,8,9,16,11,8,14,12,3,7,7,WB/DM/M RC,1,1,1,1,1,1,1,1,14,20,16,1,12,1,18
19291404,Pedro Henrique,1651,04/09/1996,19,0,0,0,0,183,0,1,3,2,1,2,3,2,4,2,2,3,7,5,6,7,14,5,7,9,1,8,14,1,14,13,9,6,8,4,7,10,14,5,9,5,8,8,8,12,10,12,9,8,10,9,13,20,7,10,9,9,8,6,9,10,12,11,11,8,8,1,8,DM C,1,1,1,1,1,1,12,1,1,20,15,1,1,1,1
19291406,Bruno Mineiro,1651,19/04/1996,20,0,0,0,0,180,0,1,1,3,3,2,1,1,3,1,3,2,7,9,8,5,13,5,9,7,6,8,10,3,13,10,4,11,10,7,10,7,7,9,3,4,8,8,9,9,12,14,9,8,5,12,14,20,14,10,9,9,2,9,9,17,12,11,15,13,6,11,3,D/WB R,1,1,1,1,1,1,1,1,20,1,1,1,1,1,16
19291407,Arlan Olinda,1651,05/08/1996,19,0,0,0,0,182,0,1,1,2,2,3,3,2,2,1,4,2,6,4,14,13,13,7,14,8,1,5,8,8,2,12,8,12,6,8,6,7,8,9,11,12,14,6,7,8,14,13,8,8,9,6,13,20,6,9,9,9,9,3,9,20,11,12,11,11,4,3,4,S ,1,1,20,1,1,1,1,1,1,1,1,1,1,1,1
19291416,Renê Oliveira,1651,03/03/1997,19,0,0,0,0,179,0,2,1,1,1,3,3,3,1,1,2,1,8,8,9,3,12,5,10,5,6,9,10,4,15,11,9,9,10,8,7,10,11,6,9,13,8,11,10,10,15,13,10,8,3,15,12,20,10,8,9,9,3,9,9,18,9,10,13,11,2,7,3,D R,1,1,1,1,1,1,1,1,20,1,1,1,1,1,15
19291421,Thiago Pereira,1651,21/07/1989,26,0,0,0,0,175,0,4,2,2,1,2,1,3,2,2,3,3,8,11,7,8,15,6,10,2,9,11,11,4,14,11,9,12,10,10,10,10,11,1,2,3,9,9,10,10,15,15,10,8,20,15,15,10,9,12,10,8,3,10,10,16,10,9,12,10,6,8,1,D/WB L,1,1,1,1,1,1,1,20,1,1,1,1,1,16,1
19291519,Ewerton,1651,28/12/1996,19,0,0,0,0,194,87,4,1,1,3,2,3,2,2,3,2,3,7,7,9,8,14,7,7,11,1,6,14,5,9,14,9,5,8,6,8,14,13,8,13,5,7,4,8,11,14,12,3,13,9,11,12,20,7,11,9,9,3,9,9,9,11,13,9,12,9,10,8,AM C,1,1,1,20,1,1,1,1,1,1,15,1,1,1,1
19291523,Pernambuco,1651,22/08/1993,22,0,0,0,0,182,0,3,3,1,3,1,2,4,2,4,2,3,7,5,14,14,14,7,14,8,7,7,8,4,5,11,8,10,4,10,6,6,14,1,10,9,14,8,7,8,13,11,8,7,7,16,12,20,8,9,9,9,8,9,9,9,10,11,9,11,12,16,2,S ,1,1,20,1,1,1,1,1,1,1,1,1,1,1,1
19291586,Luanderson,1651,04/05/1993,23,0,0,0,0,187,0,2,4,2,1,3,2,4,2,2,2,3,3,4,4,7,7,1,11,6,6,14,7,7,14,7,7,14,10,9,12,4,14,9,8,4,6,10,8,9,13,11,9,11,9,12,10,20,6,9,10,9,10,10,10,8,11,11,13,11,7,4,2,D C,1,1,1,1,1,1,20,1,1,1,1,1,1,1,1
19291595,Henrique,1651,14/04/1995,21,0,0,0,0,170,0,2,1,3,1,3,2,2,3,3,3,1,4,7,8,8,12,7,7,11,3,8,11,5,9,12,9,5,8,9,7,13,12,7,11,11,7,4,8,12,14,13,8,2,9,9,14,20,9,5,9,9,1,9,9,7,10,12,9,11,9,12,2,AM C,1,1,1,20,1,1,1,1,1,1,15,1,1,1,1
19291601,Matheus,1651,14/01/1996,20,0,0,0,0,181,0,2,2,3,1,2,4,2,3,1,3,1,5,8,5,6,15,3,7,1,8,10,10,4,14,10,8,8,9,7,6,8,10,4,2,13,8,8,9,9,15,11,9,11,20,11,13,6,11,10,8,7,9,6,9,10,10,10,11,10,10,10,5,D/WB L,1,1,1,1,1,1,1,20,1,1,1,1,1,16,1
19291602,Matheus,1651,19/12/1997,18,0,0,0,0,191,82,4,2,1,1,1,4,1,3,2,1,1,1,1,1,1,6,5,12,1,1,13,6,4,10,2,8,12,8,4,5,2,12,1,1,8,4,13,5,6,13,8,5,9,8,12,11,20,3,10,8,5,5,8,8,17,11,11,10,10,7,9,4,D C,1,1,1,1,1,1,20,1,1,1,1,1,1,1,1
19291607,Willian,1651,18/02/1995,21,0,0,0,0,177,0,1,2,2,3,3,3,1,1,3,3,2,3,7,10,13,13,6,13,8,3,4,7,5,3,10,9,13,8,10,7,9,9,7,10,2,8,6,6,8,13,13,7,8,9,15,13,20,7,7,9,9,9,7,9,12,13,9,10,12,5,4,8,S C,1,1,20,15,1,1,1,1,1,1,10,1,1,1,1
19291683,Thiago,1651,14/01/1993,23,0,0,0,0,185,0,13,9,8,1,13,13,9,13,4,7,6,4,2,1,2,3,7,1,2,2,2,1,3,2,3,8,7,10,5,9,6,13,1,1,12,2,10,7,6,13,8,7,10,10,13,12,20,6,7,9,1,9,4,9,8,15,11,13,11,1,11,2,GK ,20,1,1,1,1,1,1,1,1,1,1,1,1,1,1
19291690,Charles,1651,29/07/1993,22,0,0,0,0,188,0,2,3,1,1,2,1,3,2,1,2,1,3,6,13,13,13,6,13,7,6,5,5,4,1,8,4,11,5,12,5,7,11,9,8,10,11,5,6,7,11,8,7,11,10,11,7,20,8,9,9,9,9,4,9,13,9,10,9,11,5,9,4,S ,1,1,20,1,1,1,1,1,1,1,1,1,1,1,1
19291793,Joni,1651,22/04/1999,17,0,0,0,0,173,0,1,4,2,1,1,4,1,4,2,1,3,4,2,13,13,13,6,13,7,1,4,7,3,1,13,9,10,7,6,3,2,13,3,13,11,11,2,6,7,13,13,7,7,4,9,13,20,7,8,9,9,9,9,9,8,14,9,12,12,6,19,2,S ,1,1,20,1,1,1,1,1,1,1,1,1,1,1,1
19291794,Lucas Santos,1651,03/10/1994,21,0,0,0,0,180,0,2,3,3,2,1,3,2,2,3,3,1,9,7,9,8,13,8,9,9,6,10,14,4,15,9,10,9,10,11,9,11,15,10,8,6,10,14,10,9,10,11,7,11,9,7,11,20,8,10,10,8,6,6,10,17,9,11,11,13,10,10,5,DM/M C,1,1,1,1,1,1,12,1,1,20,16,1,1,1,1
19291795,Diego Almeida,1651,24/11/1999,16,0,0,0,0,180,0,3,3,2,1,3,3,1,2,2,3,1,3,5,12,10,13,5,7,7,1,2,11,4,7,13,8,4,7,5,3,10,8,7,13,11,4,3,6,7,13,13,6,8,8,6,13,20,8,5,8,8,8,8,4,10,11,13,10,11,2,13,5,M/AM C,1,1,15,20,1,1,1,1,1,1,16,1,1,1,1
19291796,Emerson,1651,11/07/1997,18,0,0,0,0,179,0,3,1,1,2,3,1,2,3,3,1,3,7,7,13,14,13,7,14,5,4,6,7,8,5,14,9,10,8,13,7,7,12,9,13,5,12,8,6,8,13,13,8,6,1,14,14,20,4,8,8,9,9,5,8,8,11,13,9,11,2,11,7,S ,1,1,20,1,1,1,1,1,1,1,1,1,1,1,1
19291797,Hugo,1651,27/05/1998,18,0,0,0,0,187,0,4,2,1,3,2,2,3,3,1,3,3,7,6,9,9,13,7,6,12,6,6,14,5,8,10,9,6,8,10,3,9,11,9,9,7,8,4,8,9,14,10,8,14,1,6,13,20,13,10,9,9,4,9,9,12,12,11,12,12,5,12,7,M/AM C,1,1,1,20,1,1,1,1,1,1,18,1,1,1,1
19291798,Jackson,1651,23/05/1997,19,0,0,0,0,184,0,4,2,2,3,3,1,1,3,2,2,1,5,3,4,7,8,1,14,2,1,14,6,1,12,5,6,9,8,5,7,4,14,1,1,10,5,14,7,4,14,11,8,7,2,12,12,20,7,10,8,9,6,9,9,11,11,9,11,11,8,15,3,D C,1,1,1,1,1,1,20,1,1,1,1,1,1,1,1
19291799,Lucas,1651,22/05/2000,16,0,0,0,0,189,0,3,3,1,1,3,3,3,1,1,3,1,3,1,3,2,6,1,13,5,5,7,4,4,13,5,8,6,8,1,5,1,13,4,5,9,5,11,5,6,9,10,6,13,12,5,7,20,11,11,8,5,8,8,8,7,8,11,11,9,14,13,2,D C,1,1,1,1,1,1,20,1,1,1,1,1,1,1,1
19291800,Lucas,1651,08/02/1998,18,0,0,0,0,175,0,1,1,3,3,1,3,1,2,2,1,2,7,7,7,7,13,7,7,11,1,12,14,2,14,14,8,11,8,8,4,14,14,3,9,4,8,8,8,10,12,10,5,4,7,10,10,20,8,6,9,7,9,8,9,17,10,12,12,12,13,8,4,DM/M C,1,1,1,1,1,1,1,1,1,20,16,1,1,1,1
19291801,Marcelo Júnior,1651,25/08/1998,17,0,0,0,0,179,0,2,1,1,2,1,2,2,1,2,2,1,5,3,1,2,5,1,13,1,1,13,6,4,11,1,9,10,9,2,6,1,12,9,1,11,5,13,6,7,12,9,7,7,8,12,11,20,10,7,9,9,2,9,9,19,11,12,12,11,3,11,4,D C,1,1,1,1,1,1,20,1,1,1,1,1,1,1,1
19291802,Nícolas,1651,15/05/1998,18,0,0,0,0,177,0,2,2,3,3,3,2,2,1,1,2,3,5,6,8,7,11,1,9,6,8,9,10,2,15,10,8,9,10,8,6,9,12,5,8,9,8,7,9,9,14,12,9,7,9,15,11,20,10,7,9,9,9,9,9,18,11,12,12,10,8,9,7,D/WB R,1,1,1,1,1,1,1,1,20,1,1,1,1,1,16
19291803,Rafael,1651,16/10/1997,18,0,0,0,0,184,0,2,3,4,2,1,2,3,3,3,2,1,4,8,6,6,12,1,8,3,7,8,5,5,14,7,5,5,8,8,6,8,13,5,1,3,7,6,8,8,15,10,8,9,20,12,12,1,8,9,7,8,8,6,8,16,10,10,10,12,5,12,4,D/WB L,1,1,1,1,1,1,1,20,1,1,1,1,1,16,1
19291804,Rodrigo,1651,04/07/1999,16,0,0,0,0,171,0,2,3,3,2,3,3,4,3,3,2,1,6,6,7,7,10,6,6,12,1,8,14,3,14,12,8,12,7,3,6,13,7,4,8,3,5,4,7,10,13,10,7,5,8,10,9,20,6,6,8,8,8,8,8,12,9,10,11,9,6,6,3,DM C,1,1,1,1,1,1,1,1,1,20,15,1,1,1,1
19291866,Lucas Ferreira,1651,20/10/1997,18,0,0,0,0,188,69,13,11,10,1,11,9,9,13,10,5,11,4,3,2,2,1,9,1,1,1,3,2,3,3,6,8,8,15,6,6,7,13,6,2,7,2,11,8,7,13,10,8,13,9,14,12,20,3,10,9,10,9,3,10,18,10,11,11,11,7,6,5,GK ,20,1,1,1,1,1,1,1,1,1,1,1,1,1,1
19292199,Jori,1651,15/03/1996,20,0,0,0,0,190,84,12,8,9,8,12,12,10,12,9,9,9,3,1,1,3,1,5,1,1,1,3,1,1,3,4,3,7,11,5,12,5,12,4,1,10,2,10,6,5,8,13,6,10,10,13,7,20,2,9,9,9,9,7,8,7,10,11,13,13,9,9,6,GK ,20,1,1,1,1,1,1,1,1,1,1,1,1,1,1
19292589,Bruno,1651,09/06/1996,20,0,0,0,0,188,82,3,2,3,2,1,1,3,3,3,2,1,1,1,3,4,6,1,14,6,1,14,6,1,10,6,8,6,8,7,9,3,14,8,1,4,4,11,6,7,11,8,7,13,8,11,9,20,5,10,8,8,8,8,8,20,13,13,11,10,5,14,1,D C,1,1,1,1,1,1,20,1,1,1,1,1,1,1,1
19292590,Iago,1651,16/04/1996,20,0,0,0,0,186,0,13,8,7,1,13,13,9,13,1,9,10,2,1,3,1,3,6,1,2,3,2,1,1,1,3,9,7,14,4,10,6,12,5,3,2,1,6,7,5,12,8,2,8,15,9,7,20,1,8,9,9,2,9,9,10,10,13,10,11,5,4,3,GK ,20,1,1,1,1,1,1,1,1,1,1,1,1,1,1
19292591,Piauí,1651,15/02/1997,19,0,0,0,0,189,82,1,3,1,1,3,1,4,1,2,1,1,4,3,14,14,14,7,10,8,5,3,8,9,1,14,9,7,4,10,7,8,7,9,13,3,14,6,7,8,14,8,8,11,9,8,12,20,7,9,9,5,6,4,9,7,11,11,12,10,9,18,2,S ,1,1,20,1,1,1,1,1,1,1,1,1,1,1,1
19292663,Wellington,1651,19/01/1994,22,0,0,0,0,178,0,1,2,2,2,3,2,3,2,2,2,2,9,7,14,15,13,9,15,10,9,9,7,10,5,15,5,12,10,12,10,7,13,4,13,1,9,10,9,10,12,13,7,6,1,13,12,20,15,11,10,10,9,10,10,8,14,10,10,10,1,16,6,S ,1,1,20,1,1,1,1,1,1,1,1,1,1,1,1
19292687,Bruno,1651,02/12/1997,18,0,0,0,0,173,0,4,3,2,3,1,1,3,4,1,2,1,3,4,6,5,14,2,7,6,7,9,7,2,14,9,8,6,8,7,5,9,7,5,1,7,4,9,9,8,14,9,9,7,8,14,12,20,9,7,8,8,8,8,8,15,10,10,12,12,1,9,8,D/WB R,1,1,1,1,1,1,1,1,20,1,1,1,1,1,17
19292694,Anderson,1651,21/12/1997,18,0,0,0,0,182,73,3,2,1,2,3,2,2,1,2,3,2,9,9,13,10,11,9,15,7,5,7,10,12,4,12,10,9,6,11,10,6,15,8,13,10,15,7,9,10,13,14,7,8,11,13,14,20,8,7,10,9,10,10,10,11,10,12,11,14,8,6,1,S ,1,1,20,1,1,1,1,1,1,1,1,1,1,1,1
19292695,Elivelton,1651,29/06/1997,19,0,0,0,0,179,74,3,2,3,3,2,3,3,3,3,1,3,7,5,7,2,14,2,8,8,8,9,10,4,14,10,9,6,11,8,9,9,11,4,6,9,6,9,10,10,13,13,8,9,20,6,13,10,10,7,9,7,6,9,9,10,12,12,10,11,10,17,4,D/WB L,1,1,1,1,1,1,1,20,1,1,1,1,1,17,1
19292696,Danilo,1651,16/03/1996,20,0,0,0,0,191,86,1,3,1,1,3,1,2,1,3,3,4,3,1,5,1,8,1,9,3,2,14,8,1,14,5,9,7,9,6,8,6,14,4,1,3,5,14,7,8,7,11,8,12,2,6,11,20,9,11,8,5,2,9,9,17,11,10,11,9,9,10,5,D C,1,1,1,1,1,1,20,1,1,1,1,1,1,1,1
19292697,Samuel,1651,22/02/1998,18,0,0,0,0,174,69,2,2,4,1,3,1,3,4,1,1,4,5,5,6,8,13,7,7,9,2,8,9,1,13,14,9,8,8,8,7,10,12,3,2,4,9,10,9,10,14,7,9,9,10,12,9,20,7,7,9,7,9,9,9,14,10,12,14,12,8,10,6,DM/M C,1,1,1,1,1,1,1,1,1,17,20,1,1,1,1
19292698,Rafael Nunes,1651,20/04/1996,20,0,0,0,0,180,0,3,1,3,1,2,1,2,3,3,1,3,5,6,4,2,10,3,7,6,8,7,10,3,13,9,9,10,10,10,10,8,11,3,8,6,7,7,10,10,15,15,10,8,8,11,14,20,6,8,9,9,7,5,9,10,10,13,12,12,5,11,2,D/WB R,1,1,1,1,1,1,1,1,20,1,1,1,1,1,17
19292699,Giuseppe,1651,31/10/1995,20,0,0,0,0,186,80,1,2,2,1,1,3,1,2,1,1,3,3,5,4,6,12,5,7,7,5,11,7,3,12,7,8,9,7,7,4,7,12,4,9,8,5,11,6,9,9,9,7,11,17,12,12,20,12,8,9,6,2,9,9,15,13,10,9,12,1,1,7,D/DM C,1,1,1,1,1,1,17,1,1,20,7,1,1,1,1
19292700,Marcus Vinicius,1651,18/03/1997,19,0,0,0,0,175,70,2,1,2,3,3,2,2,1,1,2,2,8,8,5,10,12,8,8,10,6,8,15,7,10,15,8,9,6,8,10,11,15,6,13,9,12,5,10,13,14,10,6,5,4,5,10,20,8,7,9,6,5,9,8,14,10,12,12,10,10,3,2,M/AM C,1,1,1,17,1,1,1,1,1,1,20,1,1,1,1
19292701,Mario,1651,01/04/1997,19,0,0,0,0,189,82,3,3,2,3,2,1,2,1,2,3,2,6,4,13,13,11,6,13,7,2,4,7,11,2,11,6,13,8,13,6,6,9,9,11,6,10,2,6,7,13,13,7,13,8,10,13,20,6,10,4,9,9,9,9,20,11,12,10,12,4,8,3,S ,1,1,20,1,1,1,1,1,1,1,1,1,1,1,1
19292703,André,1651,21/11/1997,18,0,0,0,0,185,0,2,3,3,2,1,2,4,2,2,2,3,7,4,10,10,13,7,13,7,6,3,8,3,5,13,6,10,6,7,6,7,7,11,13,3,13,6,7,8,13,11,3,11,9,12,13,20,13,8,10,7,6,6,10,10,14,10,10,11,4,7,7,S ,1,1,20,1,1,1,1,1,1,1,1,1,1,1,1
19293154,Valdo,1651,10/02/1992,24,0,0,0,0,180,77,3,2,2,3,3,4,3,2,2,2,2,6,6,8,8,9,5,13,8,7,13,10,8,13,10,13,11,14,12,11,5,11,14,11,11,12,13,14,14,13,12,9,11,13,13,12,20,14,14,12,11,11,6,5,12,12,12,10,14,3,4,3,D C,1,1,1,1,1,1,20,1,1,1,1,1,1,1,1
19293284,Ali Mohamad,1651,12/03/1998,18,0,0,0,0,188,75,1,4,1,3,1,1,1,1,2,3,2,6,4,1,1,5,5,12,1,1,13,5,3,13,6,7,12,9,4,7,1,13,7,1,6,4,10,6,7,10,12,10,10,20,11,12,9,5,9,9,7,8,9,9,14,10,10,10,11,1,6,6,D C,1,1,1,1,1,1,20,1,1,1,1,1,1,1,1
19293287,Rafael Jensen,1651,03/12/1988,27,0,0,0,0,186,0,1,2,1,2,4,3,1,2,3,1,1,2,2,3,3,7,1,10,7,4,12,9,3,11,7,6,9,9,9,9,6,12,10,4,10,7,11,8,9,14,13,9,11,16,6,13,20,8,10,10,9,10,9,10,7,8,12,9,11,1,9,7,D C,1,1,1,1,1,1,20,1,1,1,1,1,1,1,1
19293323,Jeferson Monte Alegre,1651,14/06/1994,22,0,0,0,0,187,0,1,4,1,3,3,3,3,3,2,3,2,6,2,11,13,8,6,13,6,1,6,5,9,3,13,9,7,4,10,7,7,9,1,13,1,9,5,6,7,13,12,5,7,11,9,13,20,5,8,9,7,9,7,9,14,13,10,13,11,4,4,1,S ,1,1,20,1,1,1,1,1,1,1,1,1,1,1,1
19293332,Kaio Christian,1651,18/07/1998,17,0,0,0,0,179,69,3,1,1,1,4,3,1,1,2,3,2,5,3,8,11,13,5,13,4,1,2,3,1,1,12,8,9,7,6,3,2,13,6,12,1,13,2,5,7,13,10,6,3,8,12,12,20,12,7,8,8,2,8,8,7,11,12,10,12,9,5,7,S ,1,1,20,1,1,1,1,1,1,1,1,1,1,1,1
19293340,Cadina,1651,21/01/1997,19,0,0,0,0,171,65,1,1,1,1,2,1,2,2,2,1,1,7,7,8,4,14,7,7,7,1,9,14,4,14,10,8,6,8,7,7,7,14,5,9,3,7,5,8,13,14,10,8,5,6,3,11,20,6,7,9,9,9,6,13,19,10,10,13,11,10,15,6,DM ,1,1,1,1,1,1,1,1,1,20,10,1,1,1,1
19293341,Diego,1651,07/08/1998,17,0,0,0,0,195,0,2,1,3,2,2,1,1,1,3,1,1,6,6,6,8,13,6,2,5,1,5,12,1,6,13,8,8,7,6,3,6,12,4,12,5,7,6,8,11,14,9,7,15,1,5,13,20,7,13,8,5,7,7,8,13,10,11,12,12,9,16,7,AM C,1,1,1,20,1,1,1,1,1,1,15,1,1,1,1
19293342,Judson,1651,19/01/1999,17,0,0,0,0,173,0,4,1,2,2,2,2,2,2,1,1,3,3,3,4,3,12,3,1,12,1,4,6,1,10,9,6,10,5,3,3,6,12,3,7,10,2,12,4,6,12,9,4,4,7,12,11,20,5,3,4,7,7,7,7,18,11,11,9,11,4,1,7,DM ,1,1,1,1,1,1,1,1,1,20,10,1,1,1,1
19293343,Emerson Müller,1651,08/06/1998,18,0,0,0,0,164,64,3,1,2,1,1,2,1,3,3,3,2,6,6,8,8,14,6,6,14,1,5,10,3,7,12,8,5,7,5,7,6,12,7,11,3,8,5,7,9,12,8,6,3,7,13,12,20,4,4,8,7,2,8,8,19,11,14,13,12,8,5,1,AM C,1,1,1,20,1,1,1,1,1,1,15,1,1,1,1
19293344,Matheus Bahia,1651,11/08/1999,16,0,0,0,0,178,0,2,2,1,1,1,2,1,1,1,3,3,7,6,5,5,6,4,8,6,12,9,9,7,15,8,8,7,9,6,9,9,8,1,8,12,4,6,9,9,15,12,4,7,20,15,14,2,11,7,8,8,4,8,8,11,14,14,12,9,4,3,5,D/WB L,1,1,1,1,1,1,1,20,1,1,1,1,1,17,1
19293345,Estigarribia,1651,09/03/1998,18,0,0,0,0,189,78,2,4,2,2,1,1,2,1,3,3,1,1,1,1,2,6,5,13,1,3,13,4,1,13,3,6,7,8,3,5,1,13,7,1,3,4,13,5,7,10,9,6,13,8,14,11,20,11,10,8,8,1,8,8,14,11,9,10,13,1,5,7,D C,1,1,1,1,1,1,20,1,1,1,1,1,1,1,1
19293471,Tharlis,1651,22/11/1997,18,0,0,0,0,180,75,2,3,3,1,3,3,2,1,3,2,3,1,3,4,1,7,2,12,6,5,11,7,2,13,4,8,9,6,4,5,5,12,4,3,9,4,12,5,7,13,11,6,9,7,11,11,20,4,7,8,8,8,4,8,7,13,12,14,10,7,16,5,D C,1,1,1,1,1,1,20,1,1,15,5,1,1,1,1
19293475,Tiepo,1651,08/02/1998,18,0,0,0,0,183,0,7,6,7,1,10,9,10,11,14,8,10,4,3,1,2,1,8,1,3,2,2,3,3,1,5,8,5,12,5,9,6,14,8,1,9,1,11,7,6,8,16,7,12,4,15,10,20,2,10,8,8,1,8,6,12,11,11,11,11,2,13,2,GK ,20,1,1,1,1,1,1,1,1,1,1,1,1,1,1
19293581,Issa,1651,08/04/1997,19,0,0,0,0,183,0,1,1,1,1,3,3,1,2,3,2,3,4,7,7,2,11,2,8,7,5,7,9,3,12,6,3,6,8,8,9,6,7,6,8,4,4,6,8,8,15,12,8,12,20,6,11,7,11,9,8,8,8,7,8,13,12,12,12,12,5,10,8,D/WB L,1,1,1,1,1,1,1,20,1,1,1,1,1,16,1
19293583,Rogério,1651,21/07/1997,18,0,0,0,0,173,0,3,3,3,1,2,4,1,2,3,2,3,5,3,7,7,11,5,4,7,1,4,13,4,5,10,7,4,7,3,5,9,8,8,10,1,5,4,7,11,13,12,3,2,7,11,13,20,7,3,8,8,8,8,8,12,11,12,13,13,10,9,1,AM C,1,1,1,20,1,1,1,1,1,1,15,1,1,1,1
19293584,Diogo Moura,1651,11/01/1998,18,0,0,0,0,185,0,1,2,3,1,4,3,1,1,3,2,1,5,6,13,13,6,1,13,6,1,1,3,7,2,7,8,5,1,6,4,5,7,3,8,4,13,5,5,6,13,10,3,13,7,15,12,20,6,9,8,8,3,8,8,19,13,10,13,11,1,16,4,S ,1,1,20,1,1,1,1,1,1,1,1,1,1,1,1
19293586,Mauricio,1651,27/04/1997,19,0,0,0,0,185,76,1,1,1,2,2,1,4,2,1,2,1,5,2,1,3,5,3,12,4,1,13,5,1,9,5,8,8,6,6,4,3,12,4,1,7,4,12,5,6,10,11,6,12,1,1,12,20,6,7,7,8,5,6,8,15,13,13,11,12,1,11,3,D C,1,1,1,1,1,1,20,1,1,1,1,1,1,1,1
19293668,Leo Dreyer,1651,23/04/1997,19,0,0,0,0,175,68,1,1,1,4,3,1,3,4,3,2,4,7,4,8,8,13,11,6,11,1,6,13,3,6,13,8,8,6,10,5,13,12,3,13,5,6,8,7,10,13,13,7,6,10,7,13,20,12,5,9,6,8,9,9,10,9,11,14,11,8,9,7,AM C,1,1,1,20,1,1,1,1,1,1,15,1,1,1,1
19293669,Jean,1651,10/03/1997,19,0,0,0,0,179,0,2,2,3,2,1,3,3,1,3,1,1,4,6,4,5,12,6,7,8,4,9,14,4,14,8,8,11,7,4,8,6,13,7,5,7,6,6,7,8,14,11,7,9,8,8,12,20,5,6,8,7,6,4,8,7,13,13,9,12,1,13,3,DM ,1,1,1,1,1,1,13,1,1,20,10,1,1,1,1
19293670,Flávio,1651,06/05/1997,19,0,0,0,0,178,0,1,2,3,2,2,1,2,3,3,4,4,5,5,10,13,13,5,13,6,2,5,5,2,1,12,8,8,3,5,1,6,11,8,12,7,10,3,5,6,12,9,1,7,8,7,11,20,5,7,7,7,8,6,8,20,11,10,9,11,1,6,8,S ,1,1,20,1,1,1,1,1,1,1,1,1,1,1,1
19293671,Luiz Eduardo,1651,12/01/1998,18,0,0,0,0,179,0,3,1,3,2,1,3,2,1,1,2,1,4,4,13,13,12,5,13,4,1,5,1,10,1,8,8,5,7,11,4,3,9,2,8,5,11,4,5,6,13,13,6,8,8,14,13,20,4,6,8,8,3,5,8,19,13,14,12,10,10,2,3,S ,1,1,20,1,1,1,1,1,1,1,1,1,1,1,1
19293672,Anderson Geraldina,1651,05/09/1999,16,0,0,0,0,173,0,3,3,3,1,2,2,4,3,3,1,2,3,4,13,8,12,4,7,4,1,4,5,3,1,9,7,5,3,10,6,6,6,5,9,7,9,6,5,6,13,13,4,2,7,12,13,20,5,6,7,8,8,6,8,12,9,12,11,14,9,9,5,S ,1,1,20,1,1,1,1,1,1,1,1,1,1,1,1
19293674,Luan,1651,03/06/1995,21,0,0,0,0,176,72,1,3,2,2,2,3,1,1,2,1,4,4,4,6,6,9,4,3,12,1,3,12,1,3,8,8,2,4,7,4,8,12,8,9,10,7,4,6,10,12,12,5,6,8,8,12,20,5,5,8,8,4,8,8,19,9,11,11,13,3,11,2,AM C,1,1,1,20,1,1,1,1,1,1,15,1,1,1,1
19293729,Marcos,1651,12/03/1997,19,0,0,0,0,180,0,1,2,3,2,2,2,4,4,2,3,2,5,3,1,6,8,6,14,2,2,12,8,5,14,4,8,7,8,8,9,8,13,5,8,11,5,13,5,8,9,11,8,10,1,11,7,20,4,9,8,8,8,8,8,9,11,8,9,12,1,8,2,D/DM C,1,1,1,1,1,1,20,1,1,17,6,1,1,1,1
19293730,Luiz Fernando,1651,11/07/1999,16,0,0,0,0,165,52,2,1,3,4,2,1,3,3,1,1,1,8,10,12,13,13,6,13,7,6,3,13,3,4,12,8,8,7,5,4,13,11,3,12,9,11,3,6,8,13,13,17,2,9,14,12,20,6,2,6,6,9,8,6,10,10,9,12,12,5,9,7,AM/S L,1,1,20,1,18,1,1,1,1,1,1,1,1,1,1
19293731,Benhur,1651,12/01/1997,19,0,0,0,0,190,86,3,3,2,3,4,1,4,4,2,2,1,4,2,12,12,12,4,8,5,1,3,5,6,1,10,8,8,4,10,4,5,9,5,11,1,12,5,4,5,12,10,5,13,8,14,11,20,9,11,8,8,8,8,8,13,10,11,11,12,8,7,2,S ,1,1,20,1,1,1,1,1,1,1,1,1,1,1,1
19293778,Felipe,1651,18/02/1997,19,0,0,0,0,194,0,4,3,8,1,11,8,6,11,7,4,10,4,3,2,1,1,8,1,3,2,3,2,3,3,2,8,3,10,5,11,2,12,4,3,11,1,11,6,5,10,14,6,13,8,12,10,20,2,11,7,6,8,8,7,7,13,10,12,11,13,15,4,GK ,20,1,1,1,1,1,1,1,1,1,1,1,1,1,1
19294005,Matenay,1651,06/04/1995,21,0,0,0,0,170,0,1,2,2,2,2,2,2,2,2,1,3,6,5,3,4,12,5,6,11,1,9,9,1,13,8,9,7,8,2,7,9,13,9,7,9,5,10,7,11,13,13,7,5,8,14,13,20,6,5,9,9,9,9,9,7,11,12,9,11,8,16,2,DM ,1,1,1,1,1,1,1,1,1,20,10,1,1,1,1
19294027,Renatinho,1651,26/02/1989,27,0,0,0,0,175,0,1,3,3,2,1,1,2,3,3,1,2,8,10,9,8,12,6,6,3,4,3,6,1,5,12,6,6,7,5,4,3,5,2,13,5,7,4,5,7,12,12,5,5,20,10,12,9,11,2,8,6,8,8,8,18,9,12,11,13,10,2,3,AM/S LC,1,1,17,15,20,1,1,1,1,1,8,12,1,1,1
19294028,Luiz Felipe,1651,25/09/1996,19,0,0,0,0,189,0,12,8,7,1,13,7,6,13,8,6,7,1,3,3,1,3,3,1,1,3,2,1,1,3,1,5,4,11,4,5,5,13,8,1,3,2,9,6,5,8,9,6,13,15,14,5,20,5,11,8,8,8,7,8,11,12,13,8,11,2,8,7,GK ,20,1,1,1,1,1,1,1,1,1,1,1,1,1,1
19294349,Renan Montanha,1651,28/04/1998,18,0,0,0,0,187,0,2,2,2,2,3,3,3,2,1,1,2,6,1,3,1,5,2,14,6,4,9,8,4,12,2,9,10,9,7,11,3,13,20,3,5,4,8,7,8,14,14,8,9,8,12,14,20,5,10,9,9,7,6,9,20,11,10,10,11,6,2,3,D C,1,1,1,1,1,1,20,1,1,1,1,1,1,1,1
19294449,Dion,1651,08/02/1985,31,0,0,0,0,183,0,2,1,2,3,3,1,1,1,3,3,2,7,7,14,6,14,7,4,14,4,7,9,1,7,10,8,8,7,8,7,14,14,5,9,1,9,7,8,13,14,7,8,10,2,13,12,20,14,8,9,9,1,8,9,17,11,11,14,11,8,8,3,AM C,1,1,1,20,1,1,1,1,1,1,10,1,1,1,1
19294564,Danilo,1651,12/08/1991,24,0,0,0,0,171,68,3,4,1,3,3,3,1,2,3,1,1,11,14,10,7,9,8,5,12,7,8,12,6,10,9,10,9,7,10,9,16,9,10,10,4,11,9,10,13,13,12,9,6,20,10,13,10,15,8,9,10,8,5,9,18,12,11,10,9,2,14,2,D/WB L,1,1,1,1,1,1,1,20,1,1,1,1,1,16,1
19294566,Guilherme,1651,12/05/1994,22,0,0,0,0,177,0,3,1,3,2,1,2,4,1,2,3,1,6,7,14,14,10,6,13,6,2,6,14,6,6,14,6,6,8,10,7,10,14,5,13,6,8,7,8,9,14,14,4,4,8,12,13,20,5,6,9,9,2,9,9,9,8,9,11,12,6,14,3,AM/S C,1,1,18,20,1,1,1,1,1,1,1,1,1,1,1
19294624,Djavan,1651,27/11/1995,20,0,0,0,0,176,69,1,1,2,3,2,1,1,3,3,1,2,10,8,5,6,12,7,12,11,7,12,11,4,12,10,7,13,10,9,10,11,14,14,5,9,12,13,10,12,11,13,9,8,14,10,12,20,15,8,12,5,10,4,9,16,14,11,9,11,1,7,5,DM/M C,1,1,1,1,1,1,1,1,8,20,17,1,1,1,1
19294625,Andrezon,1651,10/11/1994,21,0,0,0,0,190,78,7,5,6,9,8,7,8,6,8,6,5,3,1,2,2,8,5,4,2,1,1,7,2,3,4,8,9,15,9,6,9,7,6,3,12,1,12,10,9,13,16,10,16,9,9,10,20,8,13,8,8,3,8,8,17,10,11,4,11,6,12,2,GK ,20,1,1,1,1,1,1,1,1,1,1,1,1,1,1
19294627,Lukinha,1651,18/03/1996,20,0,0,0,0,180,0,3,2,1,3,3,3,2,2,2,3,2,4,5,9,8,12,2,2,7,2,3,12,2,3,12,9,5,4,4,6,12,9,3,13,11,5,6,6,9,12,11,6,5,14,7,9,20,12,6,9,9,9,9,9,9,12,9,11,9,7,9,1,AM C,1,1,1,20,1,1,1,1,1,1,9,1,1,1,1
19294629,Édson,1651,31/08/1993,22,0,0,0,0,187,76,9,8,12,8,8,5,7,10,12,9,11,3,3,2,2,1,3,1,2,3,1,1,3,3,4,8,9,11,7,11,6,14,8,1,1,1,10,7,5,11,10,7,8,9,13,14,20,2,10,8,8,5,8,8,15,12,9,8,10,1,16,5,GK ,20,1,1,1,1,1,1,1,1,1,1,1,1,1,1
19294630,Nildo,1651,31/03/1993,23,0,0,0,0,188,86,2,1,4,2,3,1,2,2,3,2,4,4,2,1,1,7,4,12,6,1,8,7,5,10,5,9,11,9,7,6,4,13,9,3,9,4,13,6,7,13,9,7,9,10,13,13,20,9,13,9,6,9,9,9,9,10,12,11,12,1,6,1,D C,1,1,1,1,1,1,20,1,1,1,1,1,1,1,1
19294851,Jefferson Baiano,1651,10/05/1995,21,0,0,0,0,187,84,3,3,2,1,1,1,4,3,2,1,1,7,5,13,12,12,5,13,6,3,7,6,3,4,7,6,13,6,11,6,6,13,8,10,10,11,8,7,8,12,12,7,12,9,11,13,20,6,13,10,10,9,10,10,14,11,9,8,13,4,6,2,S ,1,1,20,1,1,1,1,1,1,1,1,1,1,1,1
19294957,Danillo Bala,1651,05/05/1993,23,0,0,0,0,166,60,2,2,1,3,2,1,1,3,1,2,2,7,3,14,14,14,7,5,8,1,5,8,6,1,14,8,9,8,10,8,8,7,1,13,8,12,5,10,10,14,15,12,5,10,11,12,20,10,11,9,9,9,9,8,14,11,9,13,11,1,13,1,S ,1,1,20,1,1,1,1,1,1,1,1,1,1,1,1
19294978,Peu,1651,14/10/1991,24,0,0,0,0,175,70,1,2,1,1,1,2,2,1,2,3,2,7,6,3,8,14,5,7,13,4,11,7,4,10,12,13,9,8,9,10,8,10,3,3,8,9,11,9,12,14,14,10,5,10,10,14,20,12,10,9,9,9,6,9,10,11,13,10,9,5,8,3,DM ,1,1,1,1,1,1,1,1,1,20,10,1,1,1,1
19294979,Denis,1651,27/12/1991,24,0,0,0,0,171,69,1,1,1,1,3,2,2,1,3,1,2,5,5,5,4,8,2,8,4,7,12,8,5,13,6,9,6,9,8,6,5,11,9,9,10,7,8,8,8,14,14,8,6,9,16,13,20,9,10,9,9,1,8,9,18,11,11,10,10,10,6,8,D R,1,1,1,1,1,1,1,1,20,1,1,1,1,1,10
19294981,Rodrigo Poty,1651,07/09/1992,23,0,0,0,0,186,0,2,4,4,1,1,3,1,1,1,3,2,8,11,8,6,14,6,8,7,6,6,7,4,3,14,5,9,7,9,5,8,6,3,13,12,13,6,7,8,13,9,7,14,3,12,13,20,9,11,8,8,5,8,8,9,9,11,13,12,1,9,5,AM/S RL,1,1,18,1,17,20,1,1,1,1,1,1,1,1,1
19294985,Gil Pernambucano,1651,21/06/1986,30,0,0,0,0,180,78,1,2,3,3,3,3,1,2,2,1,1,4,1,8,6,12,7,9,8,1,8,6,1,10,9,14,12,6,8,9,8,9,9,9,12,4,9,8,11,14,13,11,9,9,12,12,20,5,12,9,5,9,9,9,15,12,12,12,11,4,2,2,DM C,1,1,1,1,1,1,15,1,1,20,1,1,1,1,1
19295256,Índio Pernambucano,1651,08/09/1993,22,0,0,0,0,165,65,2,1,2,4,2,3,3,2,3,4,3,10,14,8,3,13,7,2,3,6,7,8,3,8,14,7,6,7,6,8,6,12,4,4,13,6,8,7,8,11,12,3,5,9,3,12,20,10,4,8,8,8,4,8,11,11,8,10,12,1,10,6,D/WB/M R,1,1,1,1,1,1,1,1,18,1,1,1,20,1,18
19295306,Walber,1651,12/06/1997,19,0,0,0,0,186,0,2,2,3,3,1,1,1,2,1,3,2,7,5,3,5,6,3,9,6,5,11,8,3,10,7,9,11,12,10,9,8,11,5,4,7,9,11,7,9,9,8,9,16,9,8,8,20,11,10,9,6,9,9,9,19,10,11,11,13,8,2,8,D C,1,1,1,1,1,1,20,1,1,1,1,1,1,1,1
19295307,João Pedro,1651,19/02/1997,19,0,0,0,0,186,0,2,3,1,2,3,1,1,1,4,3,2,5,1,1,5,11,3,5,10,3,7,13,1,13,6,8,8,7,6,6,12,13,8,6,9,4,5,7,10,13,13,6,10,8,13,12,20,5,7,8,5,8,8,7,11,10,11,10,12,1,15,6,DM ,1,1,1,1,1,1,1,1,1,20,13,1,1,1,1
19295310,Marquinhos,1651,29/01/1997,19,0,0,0,0,176,0,3,2,3,3,2,1,4,3,3,2,1,3,3,6,6,12,4,2,2,1,3,10,3,4,12,8,3,1,5,2,8,12,8,13,2,7,5,5,8,12,9,5,6,16,10,11,20,7,4,8,3,5,7,8,18,9,9,10,9,3,3,4,M/AM C,1,1,1,16,1,1,1,1,1,1,20,1,1,1,1
19295397,Matheus Guedes,1651,03/12/1999,16,0,0,0,0,192,0,3,2,1,2,2,2,2,3,2,3,2,6,5,1,6,7,2,13,4,1,13,7,5,13,5,5,8,9,7,4,1,13,13,1,10,1,13,6,7,7,8,11,14,20,16,6,12,9,11,8,7,8,4,9,18,9,7,14,12,3,2,8,D C,1,1,1,1,1,1,20,1,1,1,1,1,1,1,1
19295410,Willian Chrispim,1651,17/01/1991,25,0,0,0,0,168,69,3,2,2,1,2,2,3,4,3,3,4,6,5,10,13,13,6,13,2,1,6,7,8,1,13,9,11,8,10,7,2,9,2,13,10,13,6,6,7,13,13,10,3,9,14,13,20,7,13,9,9,9,4,9,16,11,10,10,12,7,6,7,S ,1,1,20,1,1,1,1,1,1,1,1,1,1,1,1
19295423,Gio Paraíba,1651,04/06/1997,19,0,0,0,0,173,0,3,1,1,3,3,1,2,3,1,3,1,3,6,13,9,8,5,6,6,2,2,6,6,4,10,7,4,1,7,3,7,13,7,14,7,7,6,6,7,13,10,6,5,20,11,12,8,5,4,8,8,8,8,8,13,12,9,13,9,6,7,3,M/AM/S LC,1,1,16,20,18,1,1,1,1,1,11,17,1,1,1
19296007,Sancler,1651,06/03/1997,19,0,0,0,0,182,0,13,8,6,1,9,11,8,7,8,8,8,3,1,1,1,1,3,1,3,2,3,2,3,1,3,8,4,10,6,5,5,12,4,3,12,2,6,6,4,10,10,6,5,8,12,8,20,1,5,8,6,8,8,8,20,12,10,11,12,4,2,2,GK ,20,1,1,1,1,1,1,1,1,1,1,1,1,1,1
19296008,Índio,1651,31/05/1996,20,0,0,0,0,192,0,2,2,1,2,1,3,3,3,1,3,1,3,1,1,3,6,1,7,1,1,13,6,1,12,4,7,9,8,5,5,2,12,5,1,3,4,6,5,6,10,7,6,14,8,3,6,20,5,12,8,8,2,7,8,18,10,12,9,10,6,10,7,D C,1,1,1,1,1,1,20,1,1,1,1,1,1,1,1
19296014,Fellyppy,1651,25/09/1997,18,0,0,0,0,180,0,3,2,1,3,2,1,4,2,3,2,1,6,6,8,8,7,5,6,9,2,4,10,6,6,9,8,5,2,4,2,7,7,3,8,3,12,9,8,11,9,13,3,11,8,10,13,20,7,8,8,8,8,4,8,16,9,11,11,9,1,17,4,M/AM C,1,1,1,20,1,1,1,1,1,1,20,1,1,1,1
19296015,Bennerick,1651,22/09/1999,16,0,0,0,0,188,0,2,2,2,4,4,2,1,3,2,3,3,5,4,3,2,10,5,13,5,1,7,9,2,13,6,8,6,7,2,5,4,13,4,8,9,3,7,6,9,12,6,6,13,7,7,9,20,5,8,8,4,7,7,8,8,11,12,12,10,5,10,6,D/DM C,1,1,1,1,1,1,20,1,1,20,1,1,1,1,1
19296016,Alessandro,1651,19/02/1997,19,0,0,0,0,179,0,1,2,3,2,3,1,2,3,2,3,2,4,2,12,9,10,4,11,2,2,2,5,4,1,8,8,6,4,8,4,3,2,8,9,9,6,4,4,5,12,12,5,8,11,11,12,20,8,7,8,6,7,6,7,15,13,10,12,12,7,12,1,S ,1,1,20,1,1,1,1,1,1,1,1,1,1,1,1
19296017,Juninho,1651,28/09/1997,18,0,0,0,0,169,0,3,3,1,3,1,1,3,2,2,2,4,6,8,5,4,11,1,7,1,4,8,8,1,13,6,6,7,8,6,7,3,9,7,5,12,3,7,7,8,9,11,7,3,20,11,12,8,12,5,7,7,7,5,7,7,10,10,11,15,7,7,3,D L,1,1,1,1,1,1,1,20,1,1,1,1,1,15,1
19296018,Aranha,1651,04/03/1997,19,0,0,0,0,175,0,1,1,2,2,1,2,3,2,3,2,1,7,5,9,6,11,9,7,9,7,8,10,1,8,14,8,8,7,6,6,8,12,8,1,1,8,6,9,11,11,8,5,8,8,4,9,20,7,8,8,6,1,5,8,12,10,11,11,12,8,12,3,M RC,1,1,1,12,1,13,1,1,9,1,20,1,20,1,5
19296019,Michael Coqueijo,1651,07/04/1998,18,0,0,0,0,178,0,3,2,1,3,3,3,3,3,3,2,3,4,5,7,7,13,4,1,5,2,4,8,4,7,10,6,4,4,6,5,12,11,4,10,10,7,7,7,11,13,11,6,5,1,9,13,20,11,5,6,8,8,3,8,9,11,13,13,11,4,8,5,M/AM C,1,1,1,20,1,1,1,1,1,1,20,1,1,1,1
19296020,Élton,1651,26/11/1997,18,0,0,0,0,182,0,1,1,2,2,3,2,1,1,3,3,1,5,5,10,13,11,5,13,6,1,4,5,6,5,7,8,8,4,8,2,4,12,8,8,11,13,3,5,4,13,13,6,5,2,15,13,20,6,6,8,8,8,8,8,16,12,10,12,11,2,4,3,S ,1,1,20,1,1,1,1,1,1,1,1,1,1,1,1
19296021,Thiago,1651,27/11/1997,18,0,0,0,0,181,0,1,1,3,1,2,3,1,3,1,3,2,4,5,7,5,11,3,4,6,1,2,10,2,5,7,7,3,6,3,2,9,10,4,7,8,6,3,6,10,13,13,5,10,1,14,13,20,6,6,7,5,7,7,6,20,11,10,11,12,9,11,3,AM RC,1,1,1,20,14,15,1,1,1,1,1,1,1,1,1
19296022,Javan,1651,19/10/1997,18,0,0,0,0,173,0,3,2,2,4,4,4,2,3,1,1,2,2,7,4,4,7,1,6,5,5,7,7,2,7,6,8,8,8,3,4,4,12,4,2,1,5,9,7,8,13,13,4,3,20,9,12,8,12,4,8,8,6,8,8,19,11,9,9,10,3,10,5,D/WB L,1,1,1,1,1,1,1,20,1,1,1,1,1,17,1
19296023,Popola,1651,02/03/1997,19,0,0,0,0,178,0,1,3,2,2,1,3,1,1,2,3,2,5,2,8,8,13,5,3,8,2,3,9,3,5,13,8,6,1,12,6,10,11,6,13,9,3,1,7,11,13,12,6,3,20,12,13,7,8,5,8,8,8,8,8,7,11,13,12,12,13,5,6,AM C,1,1,10,20,1,1,1,1,1,1,10,1,1,1,1
19296024,Jackson,1651,20/01/1998,18,0,0,0,0,179,0,2,3,2,2,3,1,3,1,1,1,2,5,5,9,5,11,5,4,2,2,2,8,2,6,10,7,4,6,6,6,5,10,3,9,2,2,6,7,10,14,11,6,7,20,14,12,8,7,7,6,7,2,7,5,14,12,11,11,11,2,4,4,M LC,1,1,1,1,15,1,1,1,1,1,20,16,1,1,1
19296025,Mateus,1651,13/02/1998,18,0,0,0,0,184,0,1,3,2,1,1,1,4,3,1,1,2,4,2,13,10,10,4,13,1,2,2,4,3,1,10,7,5,3,7,4,5,6,7,10,3,13,3,4,5,13,11,5,11,1,8,12,20,3,7,7,7,4,7,7,15,10,10,12,11,4,12,1,S ,1,1,20,1,1,1,1,1,1,1,1,1,1,1,1
19296026,Bruno,1651,11/09/1998,17,0,0,0,0,189,0,1,3,3,3,1,3,1,2,1,2,1,1,1,7,11,10,2,8,3,1,1,3,1,1,10,7,5,4,3,3,1,6,3,12,10,5,1,2,3,11,9,3,8,12,14,11,20,4,6,7,7,4,4,7,8,10,11,10,11,6,10,8,S ,1,1,20,10,1,1,1,1,1,1,1,1,1,1,1
19296027,Léo,1651,17/06/1998,18,0,0,0,0,177,0,2,3,3,3,1,2,3,1,1,1,2,4,1,12,13,11,4,11,4,1,4,4,8,2,6,6,6,5,9,2,3,7,1,6,1,9,4,4,5,13,9,5,4,16,11,9,20,6,5,7,7,7,7,7,14,11,12,12,10,4,4,4,S ,1,1,20,1,1,1,1,1,1,1,1,1,1,1,1
19296089,Thiaguinho,1651,19/10/1990,25,0,0,0,0,174,0,1,2,4,3,2,2,2,3,1,2,3,5,7,7,6,12,6,6,2,6,8,5,3,10,8,9,9,6,6,5,7,10,9,8,8,7,7,7,8,13,13,7,4,20,15,13,9,13,8,9,9,8,9,9,13,11,9,13,9,5,11,2,D/WB/M L,1,1,1,1,1,1,1,20,1,1,1,16,1,20,1
19296454,Abner,1651,29/08/1995,20,0,0,0,0,176,62,3,3,3,2,3,1,3,2,1,4,2,7,7,9,9,14,7,7,14,2,7,14,5,7,9,9,9,6,9,7,12,12,3,9,4,5,7,9,10,14,12,9,8,9,9,12,20,8,6,9,9,9,9,9,16,10,14,12,11,7,20,5,M/AM C,1,1,10,20,1,1,1,1,1,1,17,1,1,1,1
19296458,Gabriel Galhardo,1651,06/02/1994,22,0,0,0,0,170,65,3,2,2,2,4,3,3,2,1,1,1,7,7,7,8,9,5,7,7,7,11,12,1,14,10,5,9,8,8,7,11,11,5,9,10,7,9,8,12,14,9,14,5,18,9,13,20,7,6,9,9,9,9,9,16,12,9,13,12,6,11,4,DM ,1,1,1,1,1,1,1,1,1,20,10,1,1,1,1
19296470,Luciano,1651,03/07/1992,23,0,0,0,0,172,68,1,2,2,1,1,2,1,2,1,2,3,3,7,11,14,14,5,9,8,4,5,8,8,8,14,4,8,8,7,8,13,13,9,13,12,11,6,8,9,13,11,8,4,20,15,11,10,7,7,9,7,6,9,9,14,9,13,11,9,2,10,5,AM/S C,1,1,16,20,1,1,1,1,1,1,10,1,1,1,1
19296713,Matheus,1651,11/04/1998,18,0,0,0,0,181,0,3,1,1,2,1,1,1,1,3,2,1,7,8,14,11,13,6,14,6,5,5,8,1,4,10,3,10,3,7,8,5,7,5,9,6,12,6,7,8,14,14,8,6,1,12,14,20,8,8,9,9,4,9,7,9,13,10,10,11,6,9,7,S ,1,1,20,1,1,1,1,1,1,1,1,1,1,1,1
19296714,Allan Vencato,1651,16/04/1996,20,0,0,0,0,171,68,2,2,1,2,3,2,2,2,3,2,2,12,14,14,8,11,10,5,8,5,7,6,6,8,13,9,6,4,8,6,6,7,8,9,9,6,5,8,12,14,10,8,3,20,9,11,1,8,5,9,8,9,7,9,10,12,10,12,10,12,5,8,M L,1,1,1,1,13,1,1,1,1,1,10,20,1,1,1
19296715,Vinicius,1651,09/02/1996,20,0,0,0,0,186,85,2,1,1,2,3,3,3,1,2,3,2,1,1,3,3,6,2,11,3,3,12,6,3,9,2,9,5,8,6,7,3,12,4,1,8,3,12,5,6,12,11,6,11,8,13,12,20,4,8,9,5,5,6,9,13,11,10,12,13,9,10,7,D C,1,1,1,1,1,1,20,1,1,1,1,1,1,1,1
19296716,Douglas Tomazi,1651,21/01/1996,20,0,0,0,0,191,91,3,2,2,2,2,3,1,1,2,1,2,5,3,1,7,8,2,10,1,1,10,8,4,14,4,7,8,9,8,7,7,14,3,1,2,5,14,7,8,10,10,8,11,2,15,11,20,5,11,9,9,8,3,9,10,11,12,10,9,10,4,3,D C,1,1,1,1,1,1,20,1,1,1,1,1,1,1,1
19296717,Obina,1651,01/04/1996,20,0,0,0,0,175,71,2,1,2,3,4,4,1,2,2,4,3,4,4,2,7,13,6,5,7,1,9,13,1,13,13,5,13,8,5,7,8,13,9,8,12,3,11,7,6,13,12,12,6,11,15,13,20,8,6,9,9,9,9,9,7,12,11,10,10,10,3,6,DM ,1,1,1,1,1,1,1,1,1,20,1,1,1,1,1
19296718,Caprini,1651,11/11/1997,18,0,0,0,0,167,66,4,3,1,1,2,3,2,2,3,1,3,8,10,11,14,13,8,13,5,6,5,10,7,3,13,12,6,6,13,10,6,14,2,12,9,7,7,8,10,13,6,10,5,16,14,7,20,9,6,10,6,10,10,10,11,14,10,11,11,1,12,8,S ,1,1,20,13,13,13,1,1,1,1,1,1,1,1,1
19296883,Thiago Valle,1651,25/02/1998,18,0,0,0,0,198,0,12,6,7,9,12,11,9,12,9,9,10,4,2,3,2,1,8,1,3,2,2,1,2,1,2,9,6,14,3,4,5,11,9,2,8,2,8,6,5,10,14,6,14,8,10,10,20,3,10,9,8,5,9,7,20,12,10,10,12,9,17,3,GK ,20,1,1,1,1,1,1,1,1,1,1,1,1,1,1
19296884,Filipinho,1651,30/09/1996,19,0,0,0,0,170,67,4,1,1,1,1,4,3,1,2,1,3,6,8,13,6,12,6,6,8,4,6,12,4,5,13,9,4,5,7,7,13,6,10,13,6,8,6,8,11,13,13,8,3,10,14,13,20,10,4,9,6,4,9,9,20,10,11,10,10,1,12,5,AM LC,1,1,10,20,17,1,1,1,1,1,1,1,1,1,1
19296885,João Victor,1651,17/07/1998,17,0,0,0,0,188,0,1,1,3,2,1,3,2,2,2,2,3,8,6,5,7,8,4,11,6,4,7,8,4,13,8,9,10,10,9,10,5,15,15,9,7,8,13,8,9,12,11,9,10,8,10,11,20,10,10,9,6,1,3,9,8,12,11,11,12,5,9,8,D C,1,1,1,1,1,1,20,1,1,1,1,1,1,1,1
19296886,João Figueiredo,1651,27/05/1996,20,0,0,0,0,184,0,3,2,2,3,1,3,1,3,1,1,3,4,4,13,9,11,7,12,9,4,3,11,6,2,10,9,11,8,10,5,8,13,5,9,8,8,10,7,9,14,14,8,8,8,9,14,20,10,10,9,8,2,9,9,12,12,10,9,12,6,10,6,S ,1,1,20,13,1,1,1,1,1,1,1,1,1,1,1
19296887,Thalis,1651,19/03/1996,20,0,0,0,0,181,0,3,1,2,1,4,2,2,3,3,2,2,8,7,9,9,13,13,7,11,2,7,13,4,5,13,10,11,7,8,11,11,9,10,15,6,10,6,11,12,12,12,5,9,9,10,12,20,8,10,10,6,10,10,10,8,10,9,12,12,7,14,6,M/AM C,1,1,1,20,1,1,1,1,1,1,17,1,1,1,1
19296888,Luis Guilherme,1651,07/06/1996,20,0,0,0,0,179,0,1,2,3,2,2,1,4,1,2,3,3,7,4,14,14,14,5,10,8,5,5,6,6,2,12,9,11,8,9,6,8,12,9,11,1,14,6,7,8,13,10,8,8,10,10,10,20,7,9,9,6,9,8,9,16,13,11,11,9,1,7,7,S ,1,1,20,1,1,1,1,1,1,1,1,1,1,1,1
19296889,Matheus Roldan,1651,20/03/1996,20,0,0,0,0,165,0,3,3,2,2,1,2,3,2,1,4,1,7,7,7,9,14,7,7,14,1,7,11,4,13,11,8,11,8,5,7,11,14,9,10,11,11,10,10,10,12,11,8,1,10,12,13,20,5,7,9,9,9,9,9,18,12,11,10,12,11,15,4,DM/M C,1,1,10,13,1,1,1,1,1,17,20,1,1,1,1
19296890,David Müller,1651,25/01/1997,19,0,0,0,0,180,0,3,4,3,1,3,3,2,3,2,1,3,3,6,2,1,7,1,8,1,2,13,5,3,13,6,9,11,9,5,7,3,13,9,1,12,6,13,6,7,13,13,7,9,8,10,13,20,4,7,9,9,9,12,9,18,11,10,10,11,3,6,2,D C,1,1,1,1,1,1,20,1,1,1,1,1,1,1,1
19296891,Vinícius,1651,15/02/1999,17,0,0,0,0,189,0,1,2,1,1,3,4,1,3,3,3,1,7,5,14,11,14,7,9,8,7,5,7,4,7,12,9,7,6,5,6,7,13,5,12,2,9,4,8,9,11,12,8,14,20,11,12,10,10,7,9,9,9,9,7,19,11,10,12,12,7,4,3,AM/S RC,1,1,17,20,13,17,1,1,1,1,1,1,1,1,1
19296892,Alerrandro,1651,12/01/2000,16,0,0,0,0,180,0,3,1,1,1,3,1,2,1,2,1,2,5,7,13,9,12,6,13,7,6,3,8,10,1,9,8,7,8,9,3,4,6,9,11,11,9,9,6,8,11,10,6,8,15,10,10,20,11,10,8,7,9,5,9,10,11,13,12,12,10,20,6,S ,1,1,20,1,1,1,1,1,1,1,1,1,1,1,1
19296893,Hélio Júnior,1651,25/01/2000,16,0,0,0,0,167,0,2,1,4,2,3,3,1,2,2,2,4,7,5,7,3,12,5,7,6,7,9,4,5,15,9,8,7,9,9,9,6,10,2,4,11,6,6,9,9,15,12,5,4,20,10,15,6,9,7,8,8,8,6,8,8,11,11,12,10,4,8,6,D/WB L,1,1,1,1,1,1,1,20,1,1,1,1,1,17,1
19296894,Wandrew,1651,24/05/2000,16,0,0,0,0,181,78,2,3,2,1,1,3,3,3,1,3,3,5,6,5,8,13,6,10,11,1,7,10,6,10,8,9,8,8,4,7,12,6,19,9,8,4,9,8,11,13,9,8,11,20,11,10,12,10,11,8,7,9,9,9,20,12,11,10,10,6,12,6,DM/M C,1,1,1,1,1,1,1,1,1,20,17,1,1,1,1
19296895,Matheus Stockl,1651,14/03/2000,16,0,0,0,0,177,0,1,2,3,1,1,2,1,3,4,3,1,6,7,1,3,9,4,10,2,2,13,9,1,14,6,9,8,9,5,5,8,13,7,4,6,4,6,7,9,12,13,8,10,6,16,13,20,7,9,9,5,9,5,9,20,12,10,11,10,4,12,7,D C,1,1,1,1,1,1,20,1,1,13,10,1,1,1,1
19296896,Igor Reis,1651,27/03/1999,17,0,0,0,0,176,0,1,2,2,1,3,1,1,2,2,2,2,9,13,14,13,14,5,13,6,1,4,5,5,1,13,8,9,4,7,7,5,12,19,13,10,12,4,6,7,7,11,7,4,9,13,10,20,8,6,8,7,1,7,8,14,11,14,11,13,7,5,3,AM/S L,1,1,20,1,17,10,1,1,1,1,1,1,1,1,1
19296897,Marquinhos,1651,23/10/1999,16,0,0,0,0,179,0,3,3,1,1,1,2,1,2,3,2,3,6,6,11,10,9,6,8,11,6,5,11,11,7,10,9,5,8,11,9,10,11,12,11,8,9,7,8,8,10,11,10,9,10,12,11,20,12,9,10,9,10,9,7,19,11,10,12,10,6,15,4,AM C,1,1,13,20,1,1,1,1,1,1,1,1,1,1,1
19296898,Matheus Mendes,1651,10/03/1999,17,0,0,0,0,190,0,11,9,6,1,12,12,10,12,7,6,8,5,2,1,1,5,7,1,3,1,3,1,3,3,5,9,7,12,6,12,5,12,16,2,1,3,3,6,5,6,13,6,13,8,4,11,20,2,8,9,9,9,9,6,15,13,11,11,12,11,5,2,GK ,20,1,1,1,1,1,1,1,1,1,1,1,1,1,1
19297044,Felipe Costa,1651,22/06/1994,22,0,0,0,0,174,0,2,4,2,3,4,4,2,2,4,1,1,5,1,2,2,9,2,8,3,6,9,7,2,13,8,8,12,9,8,7,8,13,1,4,4,6,12,8,9,14,14,7,3,10,9,14,20,14,6,9,5,9,9,14,17,9,11,13,12,4,16,6,D RC,1,1,1,1,1,1,17,1,20,13,1,1,1,1,1
19297048,Dogão,1651,20/09/1988,27,0,0,0,0,184,80,1,2,1,3,3,2,3,3,3,2,1,6,4,1,1,7,3,11,6,3,10,5,4,12,4,9,10,6,7,11,4,13,9,4,13,6,13,6,7,13,13,12,7,9,13,10,20,8,12,9,8,5,9,9,19,12,12,10,11,4,2,1,D C,1,1,1,1,1,1,20,1,1,1,1,1,1,1,1
19297051,Gabriel Miotti,1651,26/02/1994,22,0,0,0,0,188,78,13,9,9,1,13,13,10,8,9,7,4,7,3,1,3,4,9,1,3,3,3,1,4,3,6,9,9,10,7,8,6,13,2,2,13,3,12,7,5,12,12,7,13,9,16,13,20,1,10,9,9,7,9,9,13,14,12,12,12,3,11,1,GK ,20,1,1,1,1,1,1,1,1,1,1,1,1,1,1
19297052,Bruno Lima,1651,28/06/1995,21,0,0,0,0,181,0,2,2,2,3,1,2,3,3,3,4,3,3,3,2,1,7,2,12,5,1,13,7,3,11,6,7,8,9,6,8,3,13,9,2,12,6,12,4,7,13,10,7,10,10,15,13,20,12,7,9,9,7,9,9,14,12,11,11,12,5,12,8,D C,1,1,1,1,1,1,20,1,1,1,1,1,1,1,1
19297053,Lucas Xavier,1651,26/07/1994,21,0,0,0,0,170,60,3,2,1,2,1,2,2,3,2,2,2,7,3,13,13,11,6,12,8,1,7,8,10,4,13,10,13,6,12,8,6,12,6,13,11,13,3,7,8,13,13,6,3,14,6,13,20,6,9,10,10,10,4,10,10,11,12,11,13,1,15,3,S ,1,1,20,1,1,1,1,1,1,1,1,1,1,1,1
19297054,Adriel,1651,22/05/1997,19,0,0,0,0,184,0,4,3,4,3,3,1,3,3,3,3,3,3,1,3,3,3,1,13,2,2,12,5,3,11,1,9,11,9,7,7,6,13,2,3,12,4,10,6,7,13,9,7,11,8,10,9,20,5,8,9,8,9,9,9,13,10,10,12,11,3,13,2,D C,1,1,1,1,1,1,20,1,1,1,1,1,1,1,1
19297055,Bruno,1651,16/11/1997,18,0,0,0,0,173,0,1,2,1,2,1,3,1,3,2,1,3,6,6,8,8,13,6,4,7,2,7,13,2,7,13,2,7,3,5,3,10,9,3,13,4,6,6,8,10,13,13,8,7,8,15,13,20,7,5,8,7,9,9,9,19,9,14,12,9,3,8,6,M/AM C,1,1,1,20,1,1,1,1,1,1,17,1,1,1,1
19297056,Douglas,1651,18/06/1996,20,0,0,0,0,187,0,2,1,1,2,2,3,3,1,3,1,1,6,6,8,6,13,6,6,10,5,7,9,3,8,12,9,5,7,10,8,9,8,4,12,7,8,6,8,11,13,12,8,10,8,14,13,20,8,10,9,9,9,9,9,10,11,11,10,11,3,14,1,M/AM C,1,1,1,17,1,1,1,1,1,1,20,1,1,1,1
19297057,Eduardo,1651,02/04/1994,22,0,0,0,0,186,78,1,1,3,1,1,3,2,2,2,1,2,1,2,7,1,9,1,14,5,6,13,8,1,14,4,8,6,9,7,7,7,14,1,1,1,7,13,7,7,9,13,8,13,10,15,11,20,6,11,9,6,5,9,9,15,10,10,12,11,4,5,5,D RC,1,1,1,1,1,1,20,1,16,1,1,1,1,1,10
19297058,Gelson,1651,18/04/1996,20,0,0,0,0,177,0,2,1,1,2,1,1,3,1,4,3,3,8,8,2,2,9,3,8,8,8,10,10,6,14,10,9,10,9,8,8,10,13,9,6,9,6,10,10,10,15,14,10,8,20,13,14,10,8,7,9,7,9,9,9,9,11,13,11,12,3,1,8,D/WB L,1,1,1,1,1,1,1,20,1,1,1,1,1,17,1
19297059,Guilherme,1651,21/11/1997,18,0,0,0,0,171,60,1,1,1,2,1,3,3,1,3,1,2,4,5,6,5,12,2,7,2,6,7,6,2,13,8,6,5,8,8,6,6,9,3,8,4,5,7,8,8,14,14,8,6,7,7,14,20,7,8,7,7,8,8,8,17,12,12,11,12,8,7,5,D/WB R,1,1,1,1,1,1,1,1,20,1,1,1,1,1,17
19297060,Gustavo,1651,21/01/1996,20,0,0,0,0,179,0,1,3,2,3,1,1,1,1,2,1,1,6,5,3,8,13,6,6,7,1,7,14,3,12,10,8,7,7,8,5,8,14,8,8,1,2,8,8,7,10,12,8,8,10,6,14,20,5,5,8,8,5,8,8,16,13,9,9,11,1,4,2,DM/M C,1,1,1,1,1,1,1,1,1,20,17,1,1,1,1
19297061,Henrique,1651,13/08/1994,21,0,0,0,0,186,0,2,2,1,1,2,3,3,3,4,2,1,6,2,7,8,12,2,6,11,1,7,11,6,8,13,9,4,6,8,7,13,11,7,13,8,11,8,7,12,12,9,7,13,10,15,9,20,9,9,9,2,9,6,9,13,12,10,11,10,9,17,8,M/AM C,1,1,1,20,1,1,1,1,1,1,18,1,1,1,1
19297062,Igor,1651,12/09/1996,19,0,0,0,0,189,0,3,2,3,1,1,3,1,4,2,1,3,4,6,2,6,8,6,13,6,1,7,8,2,13,7,9,4,9,6,6,3,13,5,6,3,5,11,6,7,9,13,7,13,8,16,12,20,7,10,8,8,9,9,9,8,10,10,11,8,3,8,3,D/DM C,1,1,1,1,1,1,20,1,1,17,7,1,1,1,1
19297063,Jefferson,1651,09/02/1998,18,0,0,0,0,186,0,2,3,1,1,4,2,3,1,1,2,2,4,5,7,10,13,5,7,7,3,2,8,4,5,13,3,4,4,4,4,8,10,8,13,10,8,4,6,6,13,13,6,12,1,13,13,20,7,10,8,7,8,8,8,8,13,12,12,9,10,12,3,AM C,1,1,13,20,1,1,1,1,1,1,1,1,1,1,1
19297064,Lucas Santos,1651,02/05/1997,19,0,0,0,0,193,0,4,3,3,3,3,3,3,2,1,3,1,1,4,1,1,6,1,13,1,5,13,6,1,13,3,8,13,8,3,6,3,13,4,8,13,3,13,5,6,12,10,6,10,1,15,9,20,3,9,8,7,7,8,8,17,10,9,12,14,11,1,7,D C,1,1,1,1,1,1,20,1,1,1,1,1,1,1,1
19297093,Evandro,1651,13/01/1993,23,0,0,0,0,178,67,2,3,3,2,1,1,3,3,3,2,2,7,6,10,9,9,7,7,11,4,11,10,5,13,9,7,9,9,9,9,13,13,10,9,10,9,9,9,13,12,12,9,5,9,13,12,20,8,7,10,9,10,10,10,8,11,12,10,11,1,12,6,DM/M C,1,1,1,1,1,1,1,1,1,17,20,1,1,1,1
19297103,André Sousa,1651,20/02/1992,24,0,0,0,0,179,0,3,3,3,1,2,4,1,3,2,2,1,6,3,8,7,13,6,6,13,3,7,10,4,7,9,9,10,3,7,5,8,13,9,9,4,11,8,8,12,13,13,8,4,5,13,13,20,7,5,9,7,9,6,9,7,9,11,9,14,3,5,7,M/AM C,1,1,1,17,1,1,1,1,1,1,20,1,1,1,1
19297104,Juninho,1651,30/01/1995,21,0,0,0,0,181,74,1,3,3,3,3,2,1,2,1,1,3,7,6,9,9,14,7,7,13,5,6,11,1,9,14,9,9,8,10,6,11,13,6,13,6,9,4,9,10,8,8,9,10,8,15,12,20,10,9,7,9,3,9,9,18,9,9,11,12,3,16,8,M/AM C,1,1,1,20,1,1,1,1,1,1,17,1,1,1,1
19297181,Washington,1651,16/11/1986,29,0,0,0,0,183,82,4,3,3,2,1,4,1,2,4,3,2,9,7,9,10,14,9,9,10,8,12,14,6,14,14,10,11,10,10,10,12,14,9,11,5,10,14,11,12,14,14,11,11,11,11,14,20,8,10,11,10,1,10,11,16,13,12,11,11,8,8,4,DM/M C,1,1,1,1,1,1,1,1,1,20,19,1,1,1,1
19298161,Hugo,1651,19/05/1997,19,0,0,0,0,183,0,3,2,3,1,1,4,3,3,3,2,3,5,2,3,3,9,1,13,6,6,12,8,5,15,7,9,8,9,6,8,8,10,8,1,7,8,15,8,9,13,11,9,12,9,13,11,20,7,9,8,8,5,9,9,10,13,9,11,11,3,10,1,D C,1,1,1,1,1,1,20,1,1,1,1,1,1,1,1
19298222,Gabriel Lacerda,1651,20/03/1999,17,0,0,0,0,187,74,1,1,1,1,3,2,1,1,1,1,1,1,1,1,1,5,1,12,2,1,12,5,1,11,4,6,9,7,2,5,4,12,8,1,9,3,12,4,5,12,11,5,12,8,11,12,20,4,9,8,8,6,8,8,15,12,7,11,10,10,12,5,D C,1,1,1,1,1,1,20,1,1,1,1,1,1,1,1
19298223,Gabriel Afonso,1651,25/03/1999,17,0,0,0,0,186,0,2,4,3,3,2,2,3,2,1,1,3,4,6,6,3,13,1,5,3,6,6,5,10,12,9,8,4,8,8,10,6,14,8,3,6,3,6,8,8,14,10,8,14,7,15,14,20,5,9,7,8,8,8,8,9,13,12,12,11,11,12,8,D/WB R,1,1,1,1,1,1,1,1,20,1,1,1,1,1,17
19298224,Alan Guimarães,1651,08/03/2000,16,0,0,0,0,184,0,3,3,3,1,2,2,2,1,1,3,2,11,12,12,11,12,6,3,11,6,6,13,4,7,13,1,7,4,7,3,10,13,12,14,9,8,6,7,12,12,12,7,11,12,4,12,20,8,6,5,9,9,9,9,12,13,11,10,11,7,14,6,AM C,1,1,1,20,1,1,1,1,1,1,10,1,1,1,1
19298225,Caio Cézar,1651,06/06/1999,17,0,0,0,0,183,0,1,4,1,3,1,1,1,3,3,3,2,2,3,5,7,12,3,3,11,1,1,6,1,5,12,7,2,4,3,2,12,8,4,13,9,3,4,5,9,12,9,2,6,7,14,8,20,12,8,7,7,7,3,7,19,11,9,14,10,1,8,5,AM C,1,1,1,20,1,1,1,1,1,1,15,1,1,1,1
19298354,Tom,1651,03/06/1997,19,0,0,0,0,194,0,4,2,3,4,2,2,3,1,3,2,3,8,8,5,6,10,8,8,13,2,8,12,6,13,15,8,9,8,9,7,13,9,7,7,3,8,11,9,11,10,13,9,13,9,15,13,20,8,13,8,8,4,9,9,11,12,11,9,10,1,7,1,DM ,1,1,1,1,1,1,1,1,1,20,10,1,1,1,1
19298366,Rafael Ribeiro,1651,18/01/1996,20,0,0,0,0,190,81,1,1,1,2,3,2,3,3,1,3,2,5,3,3,3,8,1,14,3,4,9,7,3,14,3,9,8,9,6,11,5,14,5,1,1,7,10,6,8,13,10,8,16,3,8,9,20,7,10,8,9,9,5,9,17,11,11,8,9,8,16,8,D C,1,1,1,1,1,1,20,1,1,1,1,1,1,1,1
19298367,Cal,1651,14/03/1996,20,0,0,0,0,180,72,1,2,1,1,2,3,1,1,1,1,3,6,6,6,7,13,5,6,10,2,8,13,3,13,13,9,6,8,5,5,8,13,4,2,6,6,12,7,11,13,13,7,7,16,6,13,20,6,7,9,6,8,9,9,19,11,13,12,9,9,13,5,DM ,1,1,1,1,1,1,1,1,1,20,10,1,1,1,1
19298368,Odilávio,1651,23/07/1996,19,0,0,0,0,180,72,15,10,7,1,14,9,10,8,9,8,15,4,2,2,1,4,7,1,2,1,1,4,1,2,2,6,8,13,6,6,8,15,5,1,13,2,11,9,8,11,13,9,9,1,10,14,20,4,8,9,9,7,9,9,12,10,11,11,11,10,7,3,GK ,20,1,7,1,1,1,1,1,1,1,1,1,1,1,1
19298509,Fábio Júnior,1651,05/07/1999,16,0,0,0,0,182,0,12,7,4,1,10,12,6,12,7,3,4,1,1,1,3,1,2,1,1,3,2,1,2,2,1,4,2,11,4,5,3,10,7,1,6,1,5,4,3,9,8,1,6,6,12,10,20,1,5,7,7,7,7,3,17,9,10,12,10,1,5,8,GK ,20,1,1,1,1,1,1,1,1,1,1,1,1,1,1
19298510,Luiz Alberto,1651,19/11/1997,18,0,0,0,0,186,0,1,1,2,4,1,1,3,2,1,1,1,4,2,1,2,5,1,13,3,1,7,3,1,13,2,8,9,7,5,11,1,13,4,2,11,2,12,5,6,10,10,2,7,4,10,13,20,5,8,8,8,1,8,8,16,10,12,12,11,4,10,2,D C,1,1,1,1,1,1,20,1,1,1,1,1,1,1,1
19298511,Anderson Luiz,1651,17/05/1997,19,0,0,0,0,173,0,1,4,2,2,1,2,2,1,1,1,2,5,3,6,2,8,1,6,1,4,8,5,2,10,8,8,6,6,7,7,2,14,8,5,9,6,6,7,7,14,10,7,6,8,14,11,20,7,6,8,8,4,8,8,13,9,9,10,10,8,13,2,D/WB R,1,1,1,1,1,1,1,1,20,1,1,1,1,1,20
19298512,João Manoel,1651,02/01/1993,23,0,0,0,0,201,93,5,10,9,1,12,4,4,10,5,7,12,3,3,2,3,1,3,1,2,3,1,1,2,2,1,8,5,13,5,12,4,12,6,3,7,1,9,5,4,10,14,5,16,2,13,6,20,4,12,8,7,8,8,8,10,11,11,10,10,3,20,1,GK ,20,1,1,1,1,1,1,1,1,1,1,1,1,1,1
19298513,Dudu,1651,06/07/1997,18,0,0,0,0,168,65,1,1,3,3,1,1,2,3,2,2,1,6,8,9,5,13,5,3,7,6,4,8,2,5,10,8,11,7,4,7,11,8,8,8,5,7,2,7,9,12,9,6,5,20,13,11,8,11,5,8,8,8,8,8,19,9,12,12,12,12,13,3,M/AM LC,1,1,1,15,20,1,1,1,1,1,1,20,1,1,1
19298570,Diogo Peixoto,1651,03/03/1988,28,0,0,0,0,170,67,2,1,2,1,2,1,3,3,3,3,1,5,9,6,7,12,7,4,9,5,9,11,4,9,14,9,6,8,8,9,9,11,9,1,9,9,8,8,13,14,14,8,7,9,15,14,20,10,10,9,7,9,9,9,18,11,11,10,12,5,6,8,M RC,1,1,1,1,1,1,1,1,1,12,20,1,20,1,1
19298704,Douglas,1651,28/04/1998,18,0,0,0,0,185,0,7,10,3,8,12,12,4,6,8,6,9,3,1,1,3,1,2,1,3,1,2,1,2,3,2,7,5,12,3,8,4,12,3,2,7,3,6,5,4,12,10,1,8,7,12,8,20,1,5,7,1,8,6,8,14,11,12,12,10,8,13,5,GK ,20,1,1,1,1,1,1,1,1,1,1,1,1,1,1
19298708,Tales,1651,09/12/1997,18,0,0,0,0,183,70,1,3,1,3,2,3,3,3,2,1,2,7,9,9,14,12,4,6,9,5,5,9,5,8,12,8,9,7,6,4,9,11,2,9,3,8,5,8,9,7,8,8,12,20,6,8,14,11,5,8,8,8,7,8,14,13,9,11,10,5,9,4,AM RC,1,1,15,20,12,17,1,1,1,1,1,1,1,1,1
19298753,Gédson,1651,14/03/1998,18,0,0,0,0,183,0,1,2,1,2,4,3,3,1,2,4,3,3,1,1,4,6,2,14,4,1,11,2,3,10,1,6,7,4,5,4,5,11,7,1,11,4,10,5,4,11,10,6,7,5,7,11,20,4,9,4,7,3,5,7,17,10,10,9,10,5,12,5,D RC,1,1,1,1,1,1,20,1,15,1,1,1,1,1,1
19298808,Júnior Assis,1651,21/01/1998,18,0,0,0,0,185,0,3,3,1,1,3,2,1,1,3,2,3,1,1,10,8,12,1,5,4,1,1,9,5,3,12,6,5,3,6,1,8,7,1,13,4,8,4,4,6,12,10,4,10,8,14,11,20,10,6,7,3,3,6,7,15,12,10,10,10,5,18,2,AM/S C,1,1,16,20,1,1,1,1,1,1,1,1,1,1,1
19298957,Obede,1651,23/04/1997,19,0,0,0,0,184,0,1,3,2,3,2,2,2,1,3,2,1,1,1,1,4,5,1,6,1,1,7,4,3,12,4,7,4,7,4,8,1,12,1,2,11,3,10,4,5,12,12,5,6,7,13,12,20,9,8,8,8,8,8,8,7,11,10,12,10,8,5,5,D C,1,1,1,1,1,1,20,1,1,1,1,1,1,1,1
19299087,Jefinho,1651,23/02/1989,27,0,0,0,0,180,74,1,1,3,3,2,2,4,3,2,1,2,6,2,11,13,10,6,13,2,1,5,4,4,4,13,4,13,7,10,7,5,11,9,13,11,11,6,4,7,13,13,7,7,18,9,13,20,6,9,9,7,9,9,9,8,10,11,12,10,8,11,3,S ,1,1,20,1,1,1,1,1,1,1,1,1,1,1,1
19299235,Izael,1651,06/03/1997,19,0,0,0,0,187,0,3,2,2,2,1,2,2,2,1,1,1,3,1,1,6,6,6,13,5,4,13,6,2,10,6,9,11,9,4,10,6,12,12,3,10,4,10,6,8,13,11,7,11,8,7,9,20,12,10,9,9,6,9,9,19,13,9,12,9,3,5,2,D C,1,1,1,1,1,1,20,1,1,1,1,1,1,1,1
19299248,Tininho,1651,02/11/1992,23,0,0,0,0,164,0,3,2,2,1,1,1,2,1,2,3,1,5,9,13,8,13,6,4,7,6,6,8,6,6,13,9,9,6,10,8,9,9,9,13,1,8,6,8,12,13,13,8,4,20,13,13,9,8,4,9,6,9,9,9,7,12,14,10,13,4,5,7,M/AM L,1,1,1,1,19,1,1,1,1,1,1,20,1,1,1
19299262,Escarabajal,1651,06/04/1996,20,0,0,0,0,176,72,4,2,3,1,2,2,3,3,2,1,1,4,4,1,5,8,3,4,4,1,5,7,3,11,7,8,7,7,3,6,8,12,4,3,2,2,7,6,9,12,12,10,6,8,14,12,20,4,5,8,5,8,8,8,7,9,11,12,13,1,10,3,DM ,1,1,1,1,1,1,1,1,1,20,10,1,1,1,1
19299263,Vitor,1651,29/10/1997,18,0,0,0,0,187,81,4,1,1,1,1,1,3,2,2,3,1,6,7,10,11,11,5,11,8,10,4,9,10,4,11,9,11,10,9,9,8,10,1,10,1,12,7,10,11,12,12,11,13,7,14,12,20,11,12,10,11,4,10,6,17,9,12,10,10,4,9,8,S ,1,1,20,1,1,1,1,1,1,1,1,1,1,1,1
19299296,Guilherme Puhl,1651,18/04/1999,17,0,0,0,0,185,0,2,1,3,3,2,3,1,1,3,1,1,2,1,5,1,6,1,13,5,1,13,6,4,13,3,8,6,7,2,10,1,7,1,4,6,2,13,5,6,13,10,6,8,7,8,10,20,7,6,7,7,8,8,8,13,10,12,15,9,6,8,3,D C,1,1,1,1,1,1,20,1,1,1,1,1,1,1,1
19299297,Rhainer,1651,06/07/1998,17,0,0,0,0,180,72,2,1,3,3,1,2,2,4,2,3,3,5,3,13,13,13,5,12,3,1,5,6,3,5,10,8,12,3,8,3,6,6,3,10,4,6,2,5,6,13,13,10,9,1,15,13,20,5,8,8,8,8,8,8,18,8,13,12,10,4,13,3,S ,1,1,20,1,1,1,1,1,1,1,1,1,1,1,1
19299341,Victor Sousa,1651,05/07/1994,21,0,0,0,0,183,0,3,2,2,1,1,2,2,3,2,1,2,6,6,3,2,8,4,9,2,6,8,8,4,12,9,8,10,7,8,9,5,11,2,6,11,6,7,7,9,14,13,9,11,20,10,14,5,6,11,8,5,6,8,8,16,10,14,11,13,8,9,3,D L,1,1,1,1,1,1,12,20,1,1,1,1,1,15,1
19299378,Matheus Velasque,1651,23/02/1997,19,0,0,0,0,191,0,3,2,3,1,3,2,2,2,1,1,3,2,1,1,1,4,1,12,1,1,10,4,1,11,4,8,10,5,5,2,1,11,7,3,9,3,10,4,5,12,12,5,11,11,12,12,20,8,7,8,8,8,4,8,11,9,11,10,10,12,6,4,D C,1,1,1,1,1,1,20,13,1,1,1,1,1,9,1
19299380,Thomas,1651,22/06/1996,20,0,0,0,0,190,0,1,2,3,2,1,1,1,2,3,1,3,5,4,10,8,13,5,2,12,3,5,9,2,6,13,4,5,7,5,5,13,7,3,13,5,5,4,6,7,13,8,6,12,10,13,9,20,6,10,8,8,8,8,8,17,12,12,9,12,6,6,3,AM C,1,1,1,20,1,1,1,1,1,1,10,1,1,1,1
19299604,Vitor,1651,28/04/1997,19,0,0,0,0,179,0,1,1,3,2,1,3,1,1,1,3,4,5,6,2,3,12,6,8,8,1,8,10,3,14,8,8,9,4,5,4,8,8,3,8,1,6,11,8,11,13,11,7,9,7,12,11,20,12,7,8,8,8,8,9,8,12,11,11,12,11,8,1,DM C,1,1,1,1,1,1,15,1,1,20,7,1,1,1,1
19299605,Rodrigo,1651,07/08/1998,17,0,0,0,0,176,0,3,2,2,2,2,3,2,1,3,3,2,4,5,12,9,10,4,12,5,4,1,5,8,1,9,8,10,6,11,5,5,6,4,10,8,4,2,4,5,12,12,5,5,10,10,12,20,9,4,7,8,8,7,8,15,9,11,12,11,1,7,6,S ,1,1,20,1,1,1,1,1,1,1,1,1,1,1,1
19299606,João Henrique,1651,29/06/1993,23,0,0,0,0,175,71,2,1,1,3,1,2,3,3,1,2,2,7,8,14,8,11,6,7,8,5,7,9,2,7,7,7,7,8,8,8,7,7,6,7,1,11,6,8,9,14,14,13,7,20,10,14,10,9,8,9,5,4,8,9,7,10,12,13,11,1,8,7,AM LC,1,1,15,16,20,1,1,1,1,1,10,13,1,1,1
19299607,Eduardo,1651,10/03/1998,18,0,0,0,0,179,0,11,12,7,1,12,12,4,12,8,8,6,1,2,3,3,1,5,1,3,2,2,1,1,1,1,8,4,9,1,6,4,12,8,1,4,2,6,5,4,9,14,6,4,1,13,10,20,4,6,8,8,3,8,7,11,13,10,11,13,13,2,2,GK ,20,1,1,1,1,1,1,1,1,1,1,1,1,1,1
19299688,Jeferson,1651,29/07/1998,17,0,0,0,0,185,0,2,2,3,1,2,2,3,1,2,1,2,1,4,1,4,11,4,4,12,1,6,11,2,11,10,6,5,6,1,6,7,13,7,5,5,3,8,5,7,11,7,5,10,7,14,6,20,10,6,7,7,5,7,7,19,11,10,12,10,8,11,2,DM ,1,1,1,1,1,1,1,1,1,20,10,1,1,1,1
19299689,Léo,1651,13/07/1994,21,0,0,0,0,173,68,1,2,1,1,3,3,1,1,2,2,1,6,4,8,7,10,6,6,5,1,5,10,6,6,13,9,4,8,7,7,13,8,6,13,9,9,8,7,12,13,13,14,5,9,9,13,20,10,4,9,9,1,9,9,15,10,10,10,12,6,16,8,AM C,1,1,1,20,1,1,1,1,1,1,15,1,1,1,1
19299690,Rafael Tufa,1651,21/02/1992,24,0,0,0,0,178,74,1,4,3,1,2,4,1,3,3,4,3,6,1,4,7,10,6,6,10,6,7,13,1,13,13,9,10,8,7,6,6,12,4,8,11,6,8,7,11,13,13,11,7,10,13,13,20,10,6,9,13,9,9,8,7,13,9,10,9,6,14,4,DM ,1,1,1,1,1,1,1,1,1,20,10,1,1,1,1
19299692,Felipe Merlo,1651,13/08/1994,21,0,0,0,0,185,0,3,2,3,1,1,3,2,3,3,3,1,8,9,6,3,12,8,8,5,2,7,12,4,13,10,9,6,9,8,8,8,15,5,9,4,8,14,10,13,9,9,10,13,20,12,8,9,9,8,9,6,2,8,9,13,12,10,11,10,2,17,3,D/DM L,1,1,1,1,1,1,1,17,1,20,8,1,1,12,1
19299832,Yan,1651,01/02/1998,18,0,0,0,0,166,0,2,1,2,3,2,4,1,1,2,2,1,5,5,4,1,8,1,8,1,3,9,8,1,11,4,8,9,8,5,6,4,14,8,1,3,4,9,7,7,12,10,7,6,20,13,9,4,11,7,8,8,5,8,7,18,9,9,9,14,9,16,7,D LC,1,1,1,1,1,1,17,20,1,1,1,1,1,13,1
19299835,Ayran,1651,21/02/1997,19,0,0,0,0,168,0,3,2,1,2,2,2,1,2,1,3,1,3,5,8,3,15,6,9,5,8,9,6,7,15,10,8,10,9,10,11,6,8,2,5,9,8,10,10,10,15,10,10,4,1,8,12,20,8,6,8,8,8,8,8,7,12,13,12,10,1,12,1,D/WB R,1,1,1,1,1,1,1,1,20,1,1,1,1,1,17
19299836,Renan,1651,15/05/1996,20,0,0,0,0,189,0,1,1,2,2,1,3,1,2,3,2,1,4,2,12,12,12,4,12,5,1,1,5,9,1,11,8,11,6,12,5,4,9,7,12,9,9,4,4,6,12,9,1,9,3,11,11,20,11,9,8,8,8,4,8,20,8,12,11,12,4,9,8,S ,1,1,20,1,1,1,1,1,1,1,1,1,1,1,1
19300032,Elsinho,1651,10/04/1991,25,0,0,0,0,190,76,3,2,3,2,1,2,2,1,1,2,2,8,5,7,9,11,8,8,14,7,10,14,3,14,14,8,11,9,9,6,6,14,4,4,7,8,9,9,11,14,11,9,14,8,16,13,20,8,9,10,7,10,10,10,17,13,11,13,10,8,9,3,DM ,1,1,1,1,1,1,10,1,1,20,10,1,1,1,1
19300090,Lucas Maia,1651,23/02/1993,23,0,0,0,0,190,80,2,2,1,2,2,3,1,2,3,3,1,7,6,3,8,11,3,12,5,8,12,10,7,11,7,9,10,10,10,11,9,9,9,5,2,9,11,9,10,10,12,10,15,20,13,9,10,7,14,3,6,9,9,9,18,11,10,12,10,11,10,2,D C,1,1,1,1,1,1,20,13,1,1,1,1,1,1,1
19300108,Willian Pacheco,1651,28/03/1992,24,0,0,0,0,197,86,3,1,2,3,1,2,2,3,2,3,1,3,3,2,3,7,5,12,6,1,10,7,1,9,6,9,7,8,5,10,5,9,3,8,10,5,12,5,7,12,10,6,15,18,9,9,20,12,9,9,6,9,9,9,12,12,12,10,11,6,12,3,D C,1,1,1,1,1,1,20,1,1,15,10,1,1,1,1
19301264,David Luis,1651,17/06/1995,21,0,0,0,0,195,0,3,3,2,2,3,1,3,4,3,4,2,11,14,5,4,12,6,6,3,16,12,12,6,11,8,9,11,12,11,14,9,8,5,2,8,12,15,12,9,13,14,11,14,20,9,14,10,7,12,12,5,5,7,10,18,13,9,9,10,7,3,8,D/WB L,1,1,1,1,1,1,1,20,1,1,1,1,1,16,1
19301385,Levi,1651,21/08/1996,19,0,0,0,0,179,0,3,4,1,1,1,1,3,1,3,1,3,7,7,8,4,14,7,7,13,7,8,14,2,14,14,9,12,8,5,6,10,14,5,3,8,7,11,8,12,14,13,8,4,3,2,13,20,8,6,8,9,9,9,9,7,11,11,10,12,3,18,3,DM ,1,1,1,1,1,1,1,1,1,20,10,1,1,1,1
19301388,Judvan,1651,02/08/1991,24,0,0,0,0,176,72,2,2,1,2,1,3,1,3,2,2,3,8,6,5,8,14,8,8,7,3,10,11,4,13,14,9,11,7,9,10,11,14,2,1,7,8,12,9,12,14,14,9,9,10,14,14,20,8,9,10,10,6,10,10,10,10,13,9,11,5,12,1,DM ,1,1,1,1,1,1,1,1,1,20,12,1,1,1,1
19301564,Safirinha,1651,17/03/1995,21,0,0,0,0,185,72,1,3,3,1,2,1,1,2,3,2,1,4,9,12,12,10,5,11,8,3,4,9,10,4,10,13,11,12,9,11,8,8,13,11,5,12,7,9,12,14,11,8,12,13,12,12,20,11,11,9,8,10,8,12,10,14,10,10,11,11,11,7,S ,1,1,20,12,12,12,1,1,1,1,1,1,1,1,1
19301643,Mykaell,1651,13/03/1997,19,0,0,0,0,198,0,4,3,1,1,1,3,2,2,2,3,3,4,6,7,7,9,6,6,7,2,8,13,4,13,13,6,9,7,8,4,8,13,9,9,3,7,9,7,12,13,10,2,13,4,10,12,20,7,11,9,6,5,9,9,10,10,10,10,13,5,16,1,DM C,1,1,1,1,1,1,1,1,1,20,15,1,1,1,1
19301644,Caio Carioca,1651,02/02/1999,17,0,0,0,0,167,0,2,1,3,2,2,1,4,1,3,1,1,4,4,7,1,13,1,8,4,5,7,6,1,12,9,8,6,6,8,8,7,12,8,8,1,6,6,8,8,15,14,4,5,5,8,15,20,12,5,8,5,8,8,8,18,11,10,11,11,2,8,8,D R,1,1,1,1,1,1,1,1,20,1,1,1,1,1,15
19301645,Gabriel Novaes,1651,05/04/1999,17,0,0,0,0,185,0,1,1,2,1,1,3,1,3,3,3,3,4,5,11,11,12,4,10,10,1,3,9,10,1,10,8,9,6,12,3,5,7,8,9,4,11,3,4,5,11,10,11,7,8,13,12,20,3,7,8,6,8,7,8,7,8,10,10,12,5,1,7,S ,1,1,20,1,1,1,1,1,1,1,1,1,1,1,1
19301646,Rafael,1651,12/05/1999,17,0,0,0,0,185,0,2,1,1,1,2,3,4,2,3,1,2,5,3,7,7,13,5,4,13,1,5,12,1,7,10,8,7,3,10,5,11,12,8,10,5,4,7,7,10,13,11,4,10,8,8,10,20,5,7,8,6,6,8,8,13,11,11,10,11,5,1,3,AM C,1,1,1,20,1,1,1,1,1,1,15,1,1,1,1
19301647,Valber,1651,06/07/1998,17,0,0,0,0,188,0,1,1,2,1,1,2,3,3,4,2,3,3,7,13,9,13,6,10,7,1,3,7,5,4,10,4,8,4,10,5,7,6,6,10,6,13,6,6,7,13,11,4,8,8,6,11,20,6,10,8,9,9,8,8,11,12,10,12,12,9,9,4,S ,1,1,20,1,1,1,1,1,1,1,1,1,1,1,1
19301812,Marcelinho,1651,05/03/1990,26,0,0,0,0,177,0,2,3,2,3,3,1,2,2,3,1,2,6,4,11,13,13,6,12,7,1,3,7,8,2,10,9,6,3,13,7,7,12,6,10,3,11,7,6,8,13,10,7,5,9,14,13,20,12,6,9,4,9,9,9,15,11,11,11,13,2,6,3,S ,1,1,20,1,1,1,1,1,1,1,1,1,1,1,1
19301914,Wesley,1651,12/07/1999,16,0,0,0,0,175,0,2,2,4,1,2,1,3,1,4,3,2,5,5,7,13,13,5,13,6,3,2,6,4,1,12,8,7,2,6,4,4,4,8,12,1,13,6,5,6,13,13,6,4,8,11,13,20,6,5,7,6,8,8,8,8,11,12,10,12,6,14,3,S ,1,1,20,1,1,1,1,1,1,1,1,1,1,1,1
19302146,Vinícius Júnior,1651,12/07/2000,15,0,0,0,0,182,0,2,3,3,2,2,1,1,3,2,1,2,7,10,11,12,14,7,10,11,7,7,6,7,1,12,5,9,8,11,9,9,14,14,13,1,10,5,7,9,12,10,9,12,10,11,12,20,9,7,9,5,9,9,6,12,11,12,13,11,1,15,2,AM/S L,1,1,20,1,19,1,1,1,1,1,1,1,1,1,1
19302153,Cleiton,1651,09/12/1986,29,0,0,0,0,179,76,3,2,1,2,3,3,3,2,3,1,3,7,5,9,7,13,7,7,13,1,7,13,6,8,13,10,8,4,8,8,13,10,10,13,5,11,9,8,12,13,13,11,7,10,12,13,20,13,8,10,10,6,10,10,20,11,11,8,9,5,10,5,AM C,1,1,1,20,1,1,1,1,1,1,15,1,1,1,1
19302263,Gilmar,1651,04/07/1993,22,0,0,0,0,180,70,3,2,2,2,1,3,1,1,3,1,2,11,10,10,3,11,9,10,7,7,12,10,7,11,11,9,9,8,9,8,12,9,9,9,12,8,14,11,12,12,12,14,8,20,13,10,10,12,11,9,8,3,9,12,15,14,12,9,11,3,7,6,D L,1,1,1,1,5,1,1,20,1,1,1,14,1,12,1
19302327,Léo,1651,01/05/1998,18,0,0,0,0,180,76,1,3,3,2,2,2,2,3,3,3,2,7,8,6,7,13,8,8,13,3,9,14,1,14,10,6,6,9,5,6,14,14,3,7,10,9,8,9,10,14,14,9,7,9,12,14,20,8,9,10,10,3,10,10,7,10,12,11,10,1,5,4,DM C,1,1,1,1,1,1,1,1,1,20,15,1,1,1,1
19302434,Jean Carlos,1651,02/07/1993,23,0,0,0,0,175,71,2,2,3,2,1,3,1,2,3,2,1,7,6,14,14,14,7,14,3,3,7,7,6,1,11,3,13,3,7,8,3,12,5,10,3,14,8,7,8,14,12,7,7,10,13,12,20,5,7,9,9,9,9,9,12,8,9,9,11,3,9,3,S ,1,1,20,1,1,1,1,1,1,1,1,1,1,1,1
19302456,Douglas Luiz,1651,09/05/1998,18,0,0,0,0,178,65,2,2,2,3,1,2,1,1,1,3,1,9,7,6,10,15,10,8,12,2,11,15,7,14,15,11,14,10,12,6,13,14,14,11,9,7,15,11,13,11,13,10,6,11,17,10,20,9,9,10,9,10,11,11,18,11,11,9,14,3,11,1,DM ,1,1,1,1,1,1,1,1,1,20,12,1,10,1,1
19302470,André Luiz,1651,13/03/2000,16,0,0,0,0,192,0,9,9,6,5,13,13,10,12,8,9,10,5,2,3,2,2,8,1,3,2,2,1,3,1,6,7,6,8,3,9,6,13,7,1,1,2,6,7,6,11,9,7,11,10,12,13,20,4,12,9,9,9,5,9,8,11,12,9,9,9,4,6,GK ,20,1,1,1,1,1,1,1,1,1,1,1,1,1,1
19302471,Vinícius Otávio,1651,26/01/2000,16,0,0,0,0,186,0,10,9,10,3,9,7,10,14,4,4,10,1,3,3,2,2,5,1,3,2,2,3,2,3,2,8,6,10,4,8,6,14,20,1,9,2,10,7,6,11,10,7,14,2,14,12,20,3,10,8,8,8,8,8,16,8,9,10,11,6,7,4,GK ,20,1,1,1,1,1,1,1,1,1,1,1,1,1,1
19302472,Geovani,1651,18/02/2000,16,0,0,0,0,181,0,1,1,3,3,2,4,3,1,3,2,2,5,1,1,3,4,4,13,5,4,12,11,2,13,4,9,10,9,6,11,4,12,13,1,9,6,12,6,12,9,11,7,8,9,13,9,20,8,9,12,4,9,6,9,8,12,12,12,11,11,8,1,D C,1,1,1,1,1,1,20,1,1,1,1,1,1,1,1
19302473,Leandro Spadacio,1651,17/02/2000,16,0,0,0,0,188,0,1,2,1,1,3,1,3,1,1,1,2,8,10,12,11,11,6,8,5,3,5,10,3,7,12,7,8,3,6,7,11,9,9,14,1,6,3,7,8,13,12,7,10,20,14,13,8,12,7,9,5,9,9,8,9,13,11,10,9,1,8,5,AM/S L,1,1,18,1,20,14,1,1,1,1,1,1,1,1,1
19302474,Matheus Miranda,1651,19/01/2000,16,0,0,0,0,190,0,3,1,1,1,3,3,2,1,2,3,2,2,4,1,4,7,1,13,2,4,13,6,5,12,6,6,11,9,5,6,5,13,3,2,4,2,13,6,8,13,10,7,13,1,11,12,20,12,10,7,9,5,5,9,12,14,10,10,12,3,14,1,D C,1,1,1,1,1,1,20,1,1,1,1,1,1,1,1
19302476,Paulo Henrique,1651,15/07/2000,15,0,0,0,0,182,0,3,3,3,1,1,1,2,4,2,3,1,3,6,11,12,10,4,11,7,4,5,7,3,1,11,5,7,7,7,4,7,13,13,9,3,8,1,5,11,12,10,6,11,20,15,12,8,6,6,8,8,2,8,7,15,11,10,12,13,5,5,6,S ,1,1,20,13,13,1,1,1,1,1,1,1,1,1,1
19302544,Rildo,1651,03/01/1997,19,0,0,0,0,181,77,3,1,2,2,3,1,1,2,1,1,3,1,1,1,4,6,1,13,3,1,12,6,1,13,5,8,7,8,6,8,3,13,8,1,9,5,8,5,6,11,11,6,10,10,6,13,20,7,7,8,8,8,5,8,17,8,10,13,10,1,9,6,D C,1,1,1,1,1,1,20,1,1,1,1,1,1,1,1
19302562,Vinicius Locatelli,1651,23/03/1998,18,0,0,0,0,177,0,1,3,2,3,3,3,2,1,3,1,1,4,5,6,8,12,5,5,8,1,5,13,1,11,13,8,7,3,7,2,6,13,3,3,3,7,6,7,9,13,9,3,7,7,14,8,20,6,5,5,8,4,8,8,12,11,12,13,13,9,11,7,DM/M C,1,1,1,10,1,1,8,1,1,18,20,1,1,1,1
19302563,Régis,1651,16/01/1998,18,0,0,0,0,182,0,4,3,1,3,1,1,3,1,4,4,2,3,3,13,13,9,4,13,5,1,4,5,6,1,11,7,8,3,6,4,5,9,3,11,11,13,4,4,5,13,8,4,6,3,14,9,20,8,7,7,6,7,6,5,20,12,11,11,12,6,4,2,S ,1,1,20,1,1,1,1,1,1,1,1,1,1,1,1
19302564,Igor,1651,12/02/1999,17,0,0,0,0,181,0,4,6,8,1,10,10,9,11,5,7,9,2,2,3,2,1,6,1,1,3,1,1,3,1,1,7,1,12,3,8,2,11,5,1,2,3,4,3,2,10,13,4,6,12,11,9,20,1,5,7,4,6,7,7,13,11,13,11,11,2,3,3,GK ,20,1,1,1,1,1,1,1,1,1,1,1,1,1,1
19302607,Christian,1651,01/06/1999,17,0,0,0,0,183,0,1,2,3,3,1,3,2,1,1,1,1,3,1,1,2,5,1,13,1,2,9,6,3,13,4,8,11,8,5,6,1,13,7,2,11,2,12,5,6,12,10,6,10,7,15,11,20,5,6,8,7,4,8,8,16,14,12,13,11,4,1,5,D C,1,1,1,1,1,1,20,1,1,1,1,1,1,1,1
19302794,Wellington Maciel,1651,30/04/1999,17,0,0,0,0,175,0,1,1,3,4,4,3,1,3,4,1,2,6,5,8,7,9,6,6,14,2,5,14,3,9,14,6,7,7,8,4,12,5,3,13,7,7,7,8,11,7,11,3,9,1,10,10,20,11,5,8,8,7,5,8,12,12,12,11,9,9,1,2,M/AM C,1,1,1,17,1,1,1,1,1,13,20,1,1,1,1
19302795,Ferrugem,1651,17/03/1999,17,0,0,0,0,182,0,2,3,4,3,1,2,1,3,1,3,2,2,1,1,1,6,1,9,1,2,12,6,1,13,5,8,6,8,5,5,3,13,5,1,2,5,11,5,7,10,9,6,11,8,9,9,20,12,6,7,8,3,8,8,13,10,9,11,11,2,5,7,D C,1,1,1,1,1,1,20,1,1,1,1,1,1,1,1
19302796,Vitinho,1651,10/03/1999,17,0,0,0,0,189,0,1,3,3,3,3,2,2,4,4,3,2,5,4,7,4,8,5,5,9,2,5,10,1,7,13,8,3,3,6,5,11,4,5,13,11,4,2,6,11,13,11,6,13,16,10,11,20,6,9,8,5,8,7,8,10,13,10,12,10,3,7,1,M/AM C,1,1,1,18,1,1,1,1,1,1,20,1,1,1,1
19302797,Índio,1651,21/03/1999,17,0,0,0,0,178,0,2,2,3,2,2,2,3,1,3,1,1,2,1,6,6,7,4,4,7,4,4,13,3,6,12,7,3,6,4,4,11,5,7,12,2,5,6,6,11,13,12,5,7,8,8,13,20,6,4,7,7,6,3,7,16,11,12,8,10,4,6,3,AM C,1,1,1,20,1,1,1,1,1,1,15,1,1,1,1
19302798,Fernando,1651,01/03/1999,17,0,0,0,0,179,0,1,2,3,1,1,2,3,3,3,2,2,8,6,10,9,15,8,8,9,5,3,12,6,8,11,9,10,8,10,6,15,15,9,9,1,8,6,9,6,14,9,9,11,1,15,9,20,11,6,9,9,9,9,9,8,10,13,12,10,3,12,5,AM C,1,1,1,20,1,1,1,1,1,1,15,1,1,1,1
19302799,Matheus Teixeira,1651,08/03/1999,17,0,0,0,0,187,0,13,7,7,1,11,11,10,13,8,8,10,4,3,3,1,3,8,1,1,3,3,2,3,2,1,8,3,14,3,12,5,13,8,3,5,3,6,6,5,11,7,6,8,8,10,10,20,3,9,8,8,8,7,6,10,10,13,12,10,5,14,5,GK ,20,1,1,1,1,1,1,1,1,1,1,1,1,1,1
19302912,Patrick Souza,1651,28/02/2000,16,0,0,0,0,183,0,3,3,2,2,3,1,3,1,1,3,1,5,4,6,4,7,3,10,5,2,13,7,1,13,5,9,4,9,7,6,6,13,7,1,10,3,12,6,7,13,12,5,10,13,9,13,20,7,6,6,7,1,9,9,8,13,10,11,8,12,13,6,D C,1,1,1,1,1,1,20,1,1,1,1,1,1,1,1
19302913,Wesley,1651,13/03/2000,16,0,0,0,0,174,0,2,2,2,4,3,1,3,2,3,2,2,7,9,8,5,14,7,7,3,5,8,9,2,14,9,9,7,8,8,7,9,10,5,1,11,7,8,8,9,14,11,8,4,8,10,11,20,13,6,9,7,9,5,9,17,12,10,11,10,2,5,7,D/WB/DM R,1,1,1,1,1,1,1,1,20,16,10,1,1,1,19
19302914,Kazu,1651,18/03/2000,16,0,0,0,0,168,0,2,1,1,1,3,3,3,1,2,1,2,7,8,7,7,7,2,8,7,3,9,9,5,14,9,9,5,9,5,7,9,11,6,9,10,6,6,9,9,11,14,9,6,20,12,14,9,6,7,8,6,1,6,9,19,10,13,12,10,4,12,3,D/WB L,1,1,1,1,1,1,1,20,1,1,1,1,1,19,1
19302916,Hélio,1651,25/04/2000,16,0,0,0,0,177,0,2,3,1,2,2,3,3,1,2,2,3,6,6,13,10,13,6,6,10,1,5,12,2,6,11,9,8,8,6,7,12,10,9,11,3,10,4,7,12,13,13,7,3,9,10,13,20,7,7,9,9,9,8,9,12,13,10,10,12,2,7,5,AM C,1,1,1,20,1,1,1,1,1,1,10,1,1,1,1
19302917,Brenner,1651,16/01/2000,16,0,0,0,0,178,0,3,1,2,2,2,3,2,1,3,2,1,6,7,13,13,13,4,13,7,1,4,7,6,1,13,9,7,8,9,7,2,10,5,13,1,13,3,6,7,13,10,7,5,8,12,12,20,5,5,9,4,8,9,8,20,9,13,13,12,3,11,1,S ,1,1,20,1,1,1,1,1,1,1,1,1,1,1,1
19302918,Victor Bobsin,1651,12/01/2000,16,0,0,0,0,179,0,1,3,1,1,1,1,2,2,1,1,2,4,6,7,7,8,5,6,7,3,6,8,3,12,13,3,11,8,7,6,13,13,8,4,4,3,11,7,10,12,9,7,9,8,13,12,20,5,7,7,9,5,3,9,12,11,9,10,12,10,8,1,DM ,1,1,1,1,1,1,1,1,1,20,10,1,1,1,1
19302919,Leonardo Chu,1651,06/04/2000,16,0,0,0,0,184,0,2,1,2,1,1,1,3,1,3,2,2,6,6,13,13,12,6,13,7,4,5,7,5,1,9,9,6,7,10,4,2,5,9,9,6,13,5,6,7,13,12,4,9,10,13,13,20,8,9,7,4,9,9,6,7,10,11,11,10,10,10,6,S ,1,1,20,1,1,1,1,1,1,1,1,1,1,1,1
19302920,Rafael Barros,1651,24/11/1991,24,0,0,0,0,187,0,2,1,2,3,3,1,3,3,1,2,2,6,4,11,13,13,6,10,4,1,6,3,9,1,13,9,8,8,11,6,6,12,9,13,11,13,7,6,7,13,13,7,9,9,9,13,20,10,8,9,9,7,7,9,9,11,11,10,11,7,5,4,S ,1,1,20,1,1,1,1,1,1,1,1,1,1,1,1
19302928,Careca,1651,26/08/1995,20,0,0,0,0,172,0,3,4,1,2,2,2,3,2,3,3,1,4,3,12,10,14,7,7,9,3,3,14,3,6,13,9,9,6,7,5,14,12,6,12,10,5,6,8,13,14,10,8,3,20,5,11,10,8,6,9,5,4,4,9,11,10,10,8,11,6,4,3,AM C,1,1,1,20,1,1,1,1,1,1,10,1,1,1,1
19303006,Levy,1651,19/12/1995,20,0,0,0,0,182,79,3,3,1,1,1,1,2,2,2,1,2,7,6,4,5,7,2,13,6,3,14,8,1,14,2,4,13,9,6,7,5,13,8,9,7,3,13,7,8,14,14,8,7,9,14,13,20,12,10,9,9,3,6,9,18,12,13,14,10,8,12,3,D C,1,1,1,1,1,1,20,1,1,1,1,1,1,1,1
19303007,Kessi,1651,26/10/1994,21,0,0,0,0,179,72,1,3,1,2,2,4,3,2,1,3,2,7,8,4,6,12,8,5,8,2,9,11,7,14,9,10,7,8,8,8,9,14,3,10,13,9,11,9,11,14,14,8,7,20,12,14,9,8,10,10,10,5,10,10,16,9,11,11,13,8,11,4,DM C,1,1,1,1,1,1,1,1,1,20,15,1,1,1,1
19303008,Dudé,1651,05/06/1996,20,0,0,0,0,181,74,3,1,4,1,3,1,2,1,1,3,3,8,6,10,10,14,8,8,14,2,5,14,8,10,11,10,6,4,12,4,13,14,3,10,2,9,8,9,10,14,14,9,7,7,7,14,20,7,7,10,10,10,9,10,17,12,10,10,10,3,8,2,M C,1,1,1,15,1,1,1,1,1,1,20,1,1,1,1
19303009,Gaspar,1651,26/10/1995,20,0,0,0,0,178,72,1,2,3,3,3,2,2,2,2,3,1,4,6,7,4,11,6,7,12,5,9,14,4,12,14,9,9,8,8,8,7,14,3,9,9,8,6,8,11,14,14,8,5,8,4,14,20,8,8,8,6,9,4,9,16,10,12,12,12,9,8,8,DM C,1,1,1,1,1,1,1,1,1,20,15,1,1,1,1
19303010,Edjaílson,1651,09/10/1992,23,0,0,0,0,182,79,1,2,2,3,1,2,1,4,1,3,2,11,13,14,9,12,8,4,9,8,6,10,5,7,9,10,11,6,11,9,8,10,6,10,12,9,8,9,9,14,14,9,9,10,14,14,20,7,8,10,3,1,6,10,14,10,11,12,13,13,7,7,AM L,1,1,1,1,20,1,1,1,1,1,1,15,1,1,1
19303011,Jaílton,1651,13/01/1988,28,0,0,0,0,183,79,3,2,2,1,4,1,1,3,2,3,3,7,5,10,10,14,8,3,14,5,9,11,7,8,13,8,9,6,10,9,13,11,5,12,11,13,9,9,12,14,14,9,10,1,13,14,20,12,11,10,3,9,8,10,15,11,12,8,11,7,15,4,AM C,1,1,1,20,1,1,1,1,1,1,15,1,1,1,1
19303012,Lessinho,1651,22/09/1995,20,0,0,0,0,178,80,2,2,1,1,2,2,3,3,1,2,3,10,14,13,10,14,8,9,7,7,8,7,5,7,14,10,6,3,8,9,9,14,7,13,8,10,6,9,10,14,11,9,8,12,10,13,20,11,6,10,8,8,7,9,7,11,9,12,12,1,1,5,AM RL,1,1,15,1,20,20,1,1,1,1,1,1,1,1,1
19303047,Elias,1651,17/09/1993,22,0,0,0,0,169,62,2,3,4,2,1,1,3,2,1,1,2,12,14,14,14,12,9,11,10,5,8,9,6,7,12,7,10,5,9,10,10,10,10,11,2,14,8,9,10,14,14,10,7,11,6,14,20,7,6,10,5,1,8,10,9,10,12,10,11,3,16,8,AM/S R,1,1,19,1,1,20,1,1,1,1,1,1,1,1,1
19303226,Marcelo Henrique,1651,06/04/1993,23,0,0,0,0,179,0,2,1,3,2,1,3,2,1,2,4,1,3,7,5,5,12,1,7,5,1,9,7,3,13,7,8,8,8,6,12,5,8,1,8,10,6,6,7,8,14,10,6,9,9,13,12,20,13,8,8,8,6,8,8,14,13,12,10,12,6,9,1,D R,1,1,1,1,1,1,1,1,20,1,1,1,1,1,10
19303283,Jó Boy,1651,19/06/1989,27,0,0,0,0,169,62,1,2,4,1,2,1,3,1,3,1,2,13,15,11,12,11,8,10,9,6,8,10,8,7,10,6,6,3,7,5,6,6,9,7,4,15,7,6,5,14,12,10,12,10,12,11,20,12,8,8,9,8,4,5,7,13,9,6,6,5,17,8,AM L,1,1,15,8,20,12,1,1,1,1,1,1,1,1,1
19303284,Damião,1651,23/03/1995,21,0,0,0,0,179,0,1,1,1,2,2,1,1,2,1,2,2,5,5,5,4,13,5,5,11,4,6,8,1,7,12,8,3,6,5,4,10,9,4,12,9,4,5,7,10,12,11,4,7,8,14,13,20,6,4,8,7,8,6,8,16,11,13,8,12,7,5,4,AM C,1,1,1,20,1,1,1,1,1,1,15,1,1,1,1
19303285,Amaral,1651,26/05/1995,21,0,0,0,0,175,71,1,2,3,3,3,1,3,1,2,1,3,5,2,4,5,9,3,6,3,4,7,6,1,12,7,7,6,6,4,4,6,8,3,7,8,3,10,6,7,14,13,5,9,8,8,13,20,11,5,7,6,7,7,7,20,13,11,12,11,10,13,5,D/WB R,1,1,1,1,1,1,1,1,20,1,1,1,1,1,18
19303590,Jerfeson,1651,03/08/1995,20,0,0,0,0,186,0,3,3,3,2,3,1,3,1,3,2,3,1,4,1,4,6,1,13,1,1,12,4,1,12,4,8,6,8,5,3,5,13,4,1,6,4,10,5,6,10,12,6,10,4,7,12,20,3,9,8,8,8,8,8,20,10,13,11,10,4,18,7,D C,1,1,1,1,1,1,20,1,1,1,1,1,1,1,1
19303723,Robson Júnior,1651,06/04/1993,23,0,0,0,0,187,83,3,2,2,1,2,3,2,2,3,1,2,6,2,3,3,6,2,14,1,4,14,6,2,14,1,7,13,9,8,8,5,13,9,1,13,7,12,7,8,11,11,8,11,10,10,11,20,8,8,9,9,8,9,9,17,12,11,10,10,3,2,8,D C,1,1,1,1,1,1,20,1,1,1,1,1,1,1,1
19303733,Yago,1651,26/05/1997,19,0,0,0,0,183,78,2,2,2,3,1,3,1,2,3,3,1,12,14,14,11,14,8,11,9,5,6,9,7,3,14,8,6,6,11,9,10,11,15,15,7,12,7,9,10,15,15,10,6,20,10,14,11,8,10,10,10,10,10,10,19,14,10,10,10,6,1,4,AM/S R,1,1,20,1,13,19,1,10,1,1,1,1,1,10,1
19303768,Caio Emerson,1651,18/02/1999,17,0,0,0,0,169,64,3,2,3,1,2,1,2,1,2,3,3,8,10,11,10,11,6,8,12,6,1,10,4,6,11,8,8,4,9,2,11,7,13,14,1,5,3,7,10,12,13,9,10,20,14,13,13,11,7,9,6,10,10,9,15,10,10,13,10,7,12,5,AM/S R,1,1,18,1,14,20,1,1,1,1,1,1,1,1,1
19303780,Matheus Santana,1651,19/02/1998,18,0,0,0,0,169,0,3,1,1,3,1,4,3,3,4,3,1,5,3,10,11,9,5,1,6,1,3,11,3,4,13,8,7,3,7,5,9,9,3,13,2,6,4,7,10,13,13,6,5,8,13,13,20,7,3,7,6,7,5,8,8,13,11,11,13,14,11,5,AM C,1,1,1,20,1,1,1,1,1,1,10,1,1,1,1
19303818,Léo,1651,31/03/1998,18,0,0,0,0,185,76,3,2,3,3,3,1,3,1,2,3,3,4,2,1,1,6,1,13,1,2,13,6,1,9,1,8,11,8,4,6,5,13,8,1,9,3,4,5,6,12,10,4,12,8,9,11,20,7,9,8,8,8,8,8,16,13,13,12,9,1,7,2,D C,1,1,1,1,1,1,20,1,1,1,1,1,1,1,1
19303819,Wallace,1651,26/05/2000,16,0,0,0,0,175,0,2,2,2,1,3,2,1,3,2,3,2,3,6,13,13,13,5,10,4,2,3,7,5,3,12,5,5,5,9,5,5,13,2,12,2,13,3,5,7,13,9,6,5,1,11,11,20,6,5,8,8,8,8,7,11,12,10,11,10,10,5,7,S C,1,1,20,15,1,1,1,1,1,1,5,1,1,1,1
19303820,Lucas Rosa,1651,03/04/2000,16,0,0,0,0,174,0,3,3,3,3,1,3,1,2,4,3,2,7,12,12,3,10,5,6,5,1,7,11,2,10,11,8,4,8,6,8,5,11,2,3,9,5,5,6,11,11,9,6,5,8,5,13,20,11,5,6,8,8,8,7,8,12,10,11,9,8,14,8,D R,1,1,1,1,1,1,1,1,20,1,1,1,1,1,15
19303821,Vitão,1651,02/02/2000,16,0,0,0,0,185,65,3,2,2,2,3,1,3,2,2,4,4,4,6,2,4,6,1,13,6,1,13,7,1,13,6,7,5,9,7,12,6,13,2,1,6,4,9,6,7,11,11,8,12,9,9,10,20,7,7,9,7,8,8,12,19,9,11,11,10,6,15,7,D C,1,1,1,1,1,1,20,9,13,10,1,1,1,6,8
19303839,Cata,1651,21/01/1999,17,0,0,0,0,171,68,1,2,1,2,1,1,1,1,3,4,2,5,7,5,1,9,2,6,2,3,4,7,2,10,7,7,8,7,6,6,2,7,7,6,11,4,5,6,6,12,15,5,6,8,13,13,20,5,5,5,6,7,6,7,11,9,11,11,12,11,7,7,D/WB R,1,1,5,1,1,7,1,11,20,1,1,1,8,9,17
19303840,Alisson,1651,22/04/1999,17,0,0,0,0,169,0,1,1,3,3,1,2,3,2,3,3,2,4,6,3,5,13,5,2,5,4,5,9,1,11,8,7,6,6,3,4,6,9,7,7,9,3,5,6,7,13,12,6,5,3,13,14,20,8,5,6,7,7,6,7,15,12,12,12,13,3,9,4,D RC,1,1,3,8,1,1,1,1,20,5,15,1,1,1,15
19303841,Luis,1651,14/09/1999,16,0,0,0,0,182,0,1,3,3,3,1,2,4,3,3,2,3,6,1,2,2,7,1,14,1,3,6,6,2,12,5,8,9,8,5,7,1,12,8,3,11,1,7,6,7,14,14,7,11,5,4,14,20,6,7,8,8,8,8,8,7,10,10,13,10,4,1,3,D C,1,1,1,1,1,1,20,1,1,1,1,1,1,1,1
19303842,Ned,1651,10/08/1999,16,0,0,0,0,167,0,1,2,3,2,2,1,1,3,4,2,2,6,6,2,5,13,5,4,8,6,7,12,1,13,9,7,10,7,3,9,4,14,2,7,2,4,12,8,10,12,8,14,4,20,13,11,8,6,8,6,8,4,7,13,10,10,11,9,10,9,3,4,DM ,1,1,1,6,7,1,1,11,1,20,10,9,1,10,1
19303843,Péri,1651,04/05/1999,17,0,0,0,0,175,0,3,2,2,2,1,1,3,2,3,3,2,4,4,13,9,12,1,1,6,2,3,7,1,3,12,7,3,1,3,1,10,10,6,12,9,8,2,5,6,12,10,3,6,1,9,13,20,6,4,4,5,2,7,7,9,13,14,10,10,6,11,1,AM C,1,1,15,20,1,1,1,1,1,1,10,1,1,1,1
19303924,Coutinho,1651,01/06/2000,16,0,0,0,0,183,0,1,3,2,2,3,3,3,2,2,3,1,4,6,9,8,13,4,12,7,1,1,7,1,1,8,7,7,2,5,2,6,6,7,8,9,7,2,5,6,14,9,6,6,2,10,12,20,11,8,6,7,4,7,6,8,11,11,9,10,13,5,7,S C,1,1,20,15,1,1,1,1,1,1,7,1,1,1,1
19303925,Mauricio,1651,02/01/2000,16,0,0,0,0,172,0,2,2,1,2,1,2,1,4,1,2,2,1,3,1,5,11,1,6,2,3,6,6,4,12,7,7,5,6,2,5,4,13,4,7,5,1,8,6,10,13,11,4,5,9,14,10,20,6,7,7,7,7,6,7,13,11,13,10,10,1,12,4,D/DM C,1,1,1,1,1,1,17,1,7,20,1,1,1,1,1
19303926,Victor Hugo,1651,04/03/1999,17,0,0,0,0,182,0,4,7,4,1,14,11,8,14,8,8,7,4,1,2,3,1,8,1,2,3,2,1,1,1,4,8,8,15,3,10,6,9,7,3,11,3,4,7,5,14,9,7,8,1,10,12,20,1,9,8,8,5,7,7,10,15,12,12,13,1,16,2,GK ,20,1,1,1,1,1,1,1,1,1,1,1,1,1,1
19303927,Luan,1651,21/04/2000,16,0,0,0,0,185,0,3,3,2,2,2,3,3,1,2,2,2,4,1,6,6,11,2,4,4,4,3,9,3,6,6,7,3,5,6,1,13,7,4,6,11,11,1,6,11,13,10,5,7,2,7,13,20,7,6,6,7,7,7,7,12,14,10,12,11,1,5,5,AM C,1,1,1,20,1,1,1,1,1,1,15,1,1,1,1
19303928,Dudu,1651,31/03/1998,18,0,0,0,0,196,0,3,3,1,4,3,2,3,1,3,3,1,4,4,4,6,12,4,4,8,2,2,9,3,6,12,6,8,6,5,1,7,9,4,13,9,6,5,6,10,12,12,5,14,7,10,12,20,7,11,8,8,8,5,8,16,12,13,11,11,1,8,6,AM C,1,1,1,20,1,1,1,1,1,1,15,1,1,1,1
19303929,Diego,1651,23/09/1998,17,0,0,0,0,180,0,4,2,2,4,2,4,2,2,3,2,3,1,1,3,1,5,1,13,2,1,13,5,1,13,4,7,8,7,5,6,1,13,3,1,9,3,8,4,5,5,11,5,5,13,10,8,20,5,5,4,7,7,7,7,7,11,10,10,12,7,9,4,D C,1,1,1,1,1,1,20,1,1,1,1,1,1,1,1
19303930,Diogo,1651,07/04/2000,16,0,0,0,0,169,0,1,2,3,2,1,3,3,2,2,1,3,4,1,4,4,9,4,3,13,1,5,11,4,11,13,7,3,4,5,3,11,11,7,7,4,4,11,6,9,10,11,5,2,12,14,11,20,5,6,7,5,3,5,7,9,9,14,11,11,5,6,7,DM ,1,1,1,1,1,1,1,1,1,20,10,1,1,1,1
19303931,Vitinho,1651,10/11/1999,16,0,0,0,0,187,0,1,2,3,2,2,1,1,3,2,2,3,10,14,8,4,11,8,6,4,6,6,8,1,8,7,8,5,7,8,8,8,14,5,8,1,3,8,7,8,14,9,6,9,4,7,11,20,4,8,8,8,8,8,12,11,12,11,11,12,2,6,5,D/WB/M L,1,1,1,10,15,1,1,16,1,1,6,18,1,20,1
19303932,Vinicius Rayan,1651,31/05/2000,16,0,0,0,0,175,0,1,1,2,1,3,1,2,3,2,3,1,3,1,9,12,11,3,12,1,1,1,2,5,1,10,6,9,5,7,1,4,5,1,11,3,7,1,3,4,11,8,4,6,8,6,10,20,2,6,7,7,7,7,6,18,11,11,9,11,5,10,4,S ,1,1,20,1,1,1,1,1,1,1,1,1,1,1,1
19304095,Marlyson,1651,17/12/1997,18,0,0,0,0,187,0,1,3,1,1,3,1,2,3,1,2,3,5,4,10,13,9,5,13,6,1,3,6,6,2,4,8,10,5,5,6,3,8,3,8,9,8,3,5,6,11,10,6,11,16,12,13,20,8,8,8,8,8,8,7,9,9,10,11,12,6,9,8,S ,1,1,20,1,1,1,1,1,1,1,1,1,1,1,1
19304199,Julio Gruba,1651,17/01/1996,20,0,0,0,0,174,76,3,3,3,3,1,1,3,3,1,2,2,3,6,6,6,7,6,6,7,5,8,11,1,14,7,8,8,7,6,7,4,14,3,5,11,6,4,3,8,10,7,7,8,7,8,9,20,8,5,8,8,8,4,8,13,11,13,13,10,1,6,4,D/DM R,1,1,1,1,1,1,1,1,17,20,8,1,1,1,15
19304200,Zé Victor,1651,17/01/1996,20,0,0,0,0,179,79,3,2,1,1,3,2,2,3,4,3,2,5,8,8,4,12,7,7,6,4,8,9,3,13,9,3,6,8,5,9,9,12,9,9,5,6,8,8,9,14,13,10,9,9,10,10,20,5,11,9,5,9,8,9,13,14,9,12,11,6,12,7,D/DM R,1,1,1,1,1,1,1,1,17,20,8,1,1,1,15
19304315,Lucão,1651,15/02/1997,19,0,0,0,0,195,0,12,7,6,7,10,6,7,12,7,7,4,5,3,2,1,2,7,1,1,1,1,1,3,2,1,5,3,11,2,6,3,12,4,1,6,2,8,4,3,11,8,1,12,7,11,6,20,3,11,7,7,5,7,7,20,10,11,11,10,6,14,5,GK ,20,1,1,1,1,1,1,1,1,1,1,1,1,1,1
19304316,Dudu,1651,03/04/1996,20,0,0,0,0,187,0,1,2,2,2,3,3,2,1,1,2,1,1,1,2,4,4,2,9,5,3,13,6,1,13,4,7,9,8,6,3,3,13,5,1,5,3,11,5,6,9,9,6,9,11,9,7,20,7,7,7,8,2,8,8,13,11,11,12,11,5,8,3,D C,1,1,1,1,1,1,20,1,11,1,1,1,1,1,6
19304317,João William,1651,11/06/1996,20,0,0,0,0,186,80,3,1,3,1,2,3,1,1,1,1,1,1,1,1,1,5,1,9,1,1,11,4,4,12,4,8,9,2,5,6,2,11,8,7,12,4,12,4,5,11,12,7,11,8,13,11,20,5,10,7,8,8,8,8,7,12,11,11,13,1,1,8,D C,1,1,1,1,1,1,20,1,1,1,1,1,1,1,1
19304378,Marco,1651,07/01/1999,17,0,0,0,0,171,0,2,3,3,1,1,4,3,1,1,3,2,1,5,2,3,9,1,6,1,2,2,4,1,8,7,7,9,7,6,4,4,8,5,5,3,2,6,6,6,14,14,6,5,16,12,14,20,6,5,7,7,7,7,7,18,11,10,10,12,5,15,6,D/WB R,1,1,1,1,1,1,1,1,20,1,1,1,1,1,16
19304379,Chico,1651,17/04/1997,19,0,0,0,0,179,0,3,1,2,2,2,3,2,2,3,3,3,11,13,8,6,8,8,6,4,6,5,8,3,8,9,7,9,7,3,4,7,6,6,6,12,3,8,7,8,14,12,7,9,20,15,11,8,6,6,8,8,8,8,8,14,11,13,11,11,10,14,4,D/WB/M L,1,1,1,9,12,1,1,16,1,1,6,17,1,20,1
19304543,Rhuan,1651,12/06/1998,18,0,0,0,0,192,0,1,1,1,3,3,4,1,3,3,3,3,1,1,1,2,2,1,12,1,1,11,3,1,12,3,6,9,5,4,2,1,12,1,1,9,3,12,3,4,5,7,2,14,4,11,5,20,4,11,7,6,7,7,7,14,12,10,12,11,1,6,1,D C,1,1,1,1,1,1,20,1,1,1,1,1,1,1,1
19304669,Bruno,1651,05/02/1996,20,0,0,0,0,185,80,2,1,2,2,1,2,2,1,1,3,2,9,14,7,2,13,5,6,6,6,6,7,1,11,8,7,6,7,7,5,6,9,8,4,7,6,3,7,7,13,11,9,13,20,12,10,1,9,11,8,8,8,8,8,14,11,11,13,11,1,5,3,D/WB L,1,1,1,1,1,1,1,17,1,1,1,15,1,20,1
19304671,Ruan,1651,23/10/1997,18,0,0,0,0,170,64,1,3,1,1,4,1,1,3,2,2,1,6,8,14,8,14,6,1,8,3,6,14,1,8,10,8,3,6,8,7,9,6,8,9,6,3,7,7,8,12,7,7,5,9,9,7,20,9,4,8,8,3,8,8,20,9,12,11,10,5,8,1,AM RC,1,1,1,20,1,17,1,1,8,1,15,1,12,1,10
19305042,Mikael,1651,06/04/1993,23,0,0,0,0,180,73,1,1,1,2,3,1,2,2,3,3,3,6,7,12,9,10,7,2,10,1,5,10,4,7,13,10,9,4,7,7,13,12,6,13,13,12,6,8,12,13,13,8,10,10,6,13,20,8,8,10,10,9,10,10,11,11,13,13,13,5,1,4,AM C,1,1,1,20,1,1,1,1,1,1,10,1,1,1,1
19305043,Daniel,1651,25/11/1991,24,0,0,0,0,175,69,4,1,3,1,3,2,1,3,2,1,1,7,8,8,6,7,7,7,8,4,8,12,3,14,9,8,12,8,8,11,6,13,3,8,8,7,14,8,11,14,11,8,8,10,14,13,20,7,7,9,9,9,9,9,11,9,8,13,8,10,9,3,DM R,1,1,1,1,1,1,1,1,15,20,10,1,1,1,15
19305175,Pedro Henrique,1651,24/05/1999,17,0,0,0,0,160,0,2,3,1,3,4,3,2,3,3,4,2,3,4,13,13,12,6,5,10,3,4,13,5,7,10,9,4,3,5,6,7,13,9,10,10,12,5,7,10,13,13,7,1,8,16,13,20,6,4,9,9,9,8,9,8,10,12,11,12,10,10,1,AM C,1,1,1,20,1,1,1,1,1,1,10,1,1,1,1
19305177,Renan,1651,26/02/1999,17,0,0,0,0,180,0,3,2,3,2,3,2,1,3,3,2,1,7,6,4,8,12,7,7,12,2,7,12,3,12,8,9,12,8,5,5,9,13,9,9,5,4,9,8,8,14,11,8,6,9,10,9,20,9,9,9,4,1,9,9,9,10,13,12,12,4,1,8,DM ,1,1,1,1,1,1,1,1,1,20,10,1,1,1,1
19305179,Jonathan Braz,1651,14/01/1999,17,0,0,0,0,189,75,14,9,8,8,12,10,11,11,12,9,10,5,6,8,7,10,4,10,5,7,6,9,7,7,9,10,12,12,10,9,10,9,9,5,8,4,8,12,11,12,13,12,14,7,11,11,20,12,13,10,5,9,6,5,15,11,10,8,10,9,11,3,GK ,20,1,1,1,1,1,1,1,1,1,1,1,1,1,1
19305263,Charles,1651,19/06/1996,20,0,0,0,0,187,0,2,1,2,1,2,2,1,1,3,3,3,8,6,6,8,13,8,13,8,5,10,11,4,14,14,3,13,9,6,6,13,14,9,8,12,7,11,9,13,7,12,8,12,11,17,11,20,8,13,9,10,10,10,10,14,11,12,12,13,1,14,5,DM ,1,1,1,1,1,1,1,1,1,20,10,1,1,1,1
19305267,Lucas Rex,1651,20/11/1994,21,0,0,0,0,190,84,3,3,1,4,3,1,1,3,2,1,3,3,4,3,6,7,3,12,6,8,14,9,3,14,8,10,11,10,9,10,5,14,9,6,11,5,14,8,9,11,8,9,13,10,12,8,20,6,10,10,6,9,5,10,12,10,10,10,14,5,14,1,D C,1,1,1,1,1,1,20,1,1,1,1,1,1,1,1
19305272,Machado,1651,20/01/1996,20,0,0,0,0,174,61,4,1,2,3,2,1,1,2,3,3,2,9,8,9,7,13,9,8,15,4,9,15,2,14,15,10,12,9,10,9,13,15,9,10,9,8,15,10,13,11,13,5,10,11,17,15,20,8,7,10,5,10,10,10,20,10,10,12,10,10,9,8,DM ,1,1,1,1,1,1,1,1,1,20,10,1,1,1,1
19305373,Mateus Lima,1651,24/04/1997,19,0,0,0,0,172,0,3,3,1,3,1,3,1,3,3,2,1,3,5,6,8,13,7,7,10,5,9,14,4,13,11,9,9,2,6,6,14,12,3,7,9,8,7,8,11,6,12,8,5,8,9,10,20,14,6,9,7,9,7,8,13,13,10,11,11,2,18,3,M C,1,1,1,1,1,1,1,1,1,1,20,1,1,1,1
19305697,Marcos,1651,08/04/1997,19,0,0,0,0,181,74,13,10,5,1,13,12,8,13,9,7,11,7,2,2,3,1,9,1,3,2,1,1,2,1,3,8,5,12,6,6,6,13,7,1,5,2,11,7,5,11,8,7,9,6,12,13,20,1,7,9,9,9,9,9,14,11,11,11,9,9,10,4,GK ,20,1,1,1,1,1,1,1,1,1,1,1,1,1,1
19305714,Genesis,1651,03/01/1991,25,0,0,0,0,180,70,4,2,2,1,1,2,1,1,1,3,3,6,4,13,13,13,6,13,7,3,6,6,7,5,12,9,10,2,8,7,7,7,5,12,4,11,5,6,8,13,13,9,9,10,10,13,20,12,7,9,9,8,8,9,14,11,10,10,11,9,13,6,S ,1,1,20,1,1,1,1,1,1,1,1,1,1,1,1
19305759,Lucas,1651,19/12/1997,18,0,0,0,0,193,0,9,11,9,9,14,11,10,14,9,6,10,5,3,3,3,1,9,1,2,2,2,1,3,3,4,9,6,14,5,12,7,13,5,2,10,1,9,8,7,7,13,7,13,9,9,5,20,4,11,9,5,3,9,8,7,11,12,14,10,4,13,5,GK ,20,1,1,1,1,1,1,1,1,1,1,1,1,1,1
19305760,Fábio Sousa,1651,30/01/1996,20,0,0,0,0,181,0,2,1,2,2,3,2,2,3,3,2,1,2,6,4,3,9,1,14,3,3,14,9,5,14,7,3,11,10,6,11,6,14,4,4,9,5,14,8,9,12,11,9,7,6,14,14,20,6,9,9,10,6,10,10,11,10,12,9,13,6,7,8,D C,1,1,1,1,1,1,20,1,1,1,1,1,1,1,1
19305761,Laylson,1651,08/02/1997,19,0,0,0,0,181,0,2,1,1,3,2,3,1,1,1,2,1,8,9,10,8,13,8,8,8,8,6,9,4,10,14,10,10,9,8,9,7,11,10,13,8,9,8,9,10,11,14,9,7,20,7,14,10,6,9,10,9,10,4,10,20,13,11,13,14,3,14,4,D/AM LC,1,1,1,20,1,1,1,18,1,1,15,10,1,15,1
19305762,Leonel,1651,02/09/1997,18,0,0,0,0,179,0,1,3,3,2,3,2,2,2,3,2,3,8,5,14,14,13,6,14,5,3,6,9,8,2,11,7,9,6,13,8,7,12,8,10,1,12,7,8,10,14,14,9,7,9,13,14,20,7,8,10,10,10,10,10,18,12,13,12,10,2,13,1,S ,1,1,20,1,12,12,1,1,1,1,1,1,1,1,1
19305763,Darlisson,1651,31/03/2000,16,0,0,0,0,177,0,3,1,1,1,2,3,1,2,3,2,1,4,4,7,13,12,3,11,5,1,3,5,7,1,7,7,3,5,9,1,6,4,2,7,11,6,4,4,6,13,13,5,5,7,7,13,20,4,6,7,7,1,7,7,8,13,13,12,13,9,18,8,S ,1,1,20,1,12,12,1,1,1,1,1,1,1,1,1
19305764,Dudu,1651,10/04/1999,17,0,0,0,0,186,0,3,3,3,3,2,3,2,3,1,3,2,2,3,5,11,10,4,12,5,3,4,7,8,4,5,8,10,11,10,9,8,8,12,3,9,8,10,11,11,10,10,8,13,20,11,11,9,11,12,10,4,9,7,6,11,12,11,8,12,11,10,9,S ,1,1,20,1,1,1,1,1,1,1,1,1,1,1,1
19305767,Hugo,1651,29/08/1997,18,0,0,0,0,169,0,1,3,1,1,2,2,3,2,2,2,1,8,5,10,10,12,8,3,14,3,7,9,1,10,8,9,8,5,6,9,10,11,9,9,9,12,7,9,14,15,13,5,5,20,12,15,9,9,6,9,9,9,4,9,10,11,11,10,10,9,10,3,AM C,1,1,1,20,1,1,1,1,1,1,15,1,1,1,1
19305921,Jean,1651,25/06/1999,17,0,0,0,0,160,0,3,2,1,1,1,2,3,1,3,3,1,5,5,8,13,9,5,7,6,1,1,10,5,6,13,8,4,2,6,4,8,11,7,13,1,10,2,6,7,13,13,6,1,2,12,13,20,11,3,7,8,4,8,7,7,12,11,15,11,5,12,1,AM C,1,1,15,20,1,1,1,1,1,1,10,1,1,1,1
19305959,Murillo Batista,1651,31/01/1997,19,0,0,0,0,180,0,2,2,1,4,1,3,2,3,1,3,1,5,3,1,6,7,2,14,3,6,9,8,2,14,5,9,8,9,5,8,7,14,3,4,13,5,14,7,8,11,14,5,7,20,15,14,10,5,8,9,9,9,9,9,17,13,12,13,8,8,10,6,D C,1,1,1,1,1,1,20,1,1,1,1,1,1,1,1
19305972,Victor Souza,1651,31/08/1992,23,0,0,0,0,191,84,14,12,9,1,14,9,10,11,10,9,10,3,2,1,2,4,4,1,1,3,3,2,1,2,3,10,8,12,9,10,8,14,6,3,10,2,14,9,6,10,8,9,12,10,9,11,20,5,10,10,8,8,7,10,9,11,10,13,10,4,11,3,GK ,20,1,1,1,1,1,1,1,1,1,1,1,1,1,1
19306009,Arthur César,1651,07/01/1997,19,0,0,0,0,179,0,2,4,1,2,1,3,2,3,1,3,3,6,5,15,5,12,2,7,2,7,7,8,2,13,8,9,7,9,4,6,8,14,4,15,9,5,8,8,8,14,13,4,8,10,15,14,20,10,7,9,7,6,9,9,10,12,9,12,13,11,5,7,D R,1,1,1,1,1,1,1,1,20,1,1,1,1,1,10
19306010,Matheus Oliveira,1651,28/09/1997,18,0,0,0,0,180,0,3,2,2,2,1,3,1,3,1,2,3,8,8,10,10,12,8,3,7,5,5,12,5,9,13,9,10,9,10,9,14,14,19,14,11,13,5,9,11,14,11,8,9,9,16,13,20,14,7,10,10,7,7,10,19,11,11,11,10,8,1,4,AM C,1,1,1,20,1,1,1,1,1,1,10,1,1,1,1
19306011,Emerson Barbosa,1651,18/08/1998,17,0,0,0,0,177,0,3,2,1,2,1,2,1,3,1,1,1,6,9,9,4,13,2,10,9,9,9,8,6,13,11,6,9,11,6,9,11,14,7,7,4,4,10,11,11,13,13,9,9,20,14,15,10,8,8,10,10,10,5,10,9,10,11,8,10,8,13,4,D/WB L,1,1,1,1,1,1,1,20,1,1,1,1,1,19,1
19306296,Marquinhos,1651,29/03/1994,22,0,0,0,0,177,71,3,1,3,1,2,2,2,3,2,1,3,8,12,9,7,14,6,5,6,5,3,5,6,9,11,9,10,8,9,6,9,10,4,10,14,8,9,9,4,14,13,9,5,20,15,14,9,7,7,9,6,9,8,9,10,11,9,11,12,7,4,6,D/WB/M/AM L,1,1,1,1,17,1,1,20,1,1,1,17,1,19,1
19306524,Arthur,1651,09/02/1997,19,0,0,0,0,189,0,2,3,3,3,1,2,2,3,3,1,1,2,5,11,11,12,2,12,6,2,4,5,4,1,10,1,10,1,8,5,4,10,8,11,11,11,4,5,7,12,12,6,7,8,10,12,20,11,7,9,9,9,9,8,17,11,11,10,12,1,12,6,S ,1,1,20,1,1,1,1,1,1,1,1,1,1,1,1
19306549,Gabriel Lima,1651,27/10/1996,19,0,0,0,0,181,73,3,1,1,1,3,2,1,2,2,3,3,6,6,13,13,13,6,10,6,1,3,7,9,2,11,9,9,7,12,7,7,10,1,11,10,7,6,6,7,13,13,4,8,8,12,13,20,10,6,9,4,6,5,9,15,10,13,13,9,10,7,1,S ,1,1,20,1,1,1,1,1,1,1,1,1,1,1,1
19306633,Tarcísio,1651,11/04/1994,22,0,0,0,0,181,74,2,3,2,3,2,1,2,1,1,1,1,11,14,10,14,12,8,11,4,5,7,9,9,7,11,10,11,5,8,9,10,11,7,10,11,12,8,8,10,14,13,5,7,9,16,14,20,6,8,10,7,10,7,10,15,11,11,9,11,9,15,3,S RL,1,1,20,1,15,15,1,1,1,1,1,1,1,1,1
19306634,Ivanzinho,1651,14/04/1990,26,0,0,0,0,182,73,1,3,2,1,3,2,3,3,3,2,1,7,7,10,6,13,7,3,6,7,7,9,5,6,13,6,9,9,11,8,9,13,5,13,11,9,8,8,12,13,13,8,10,20,14,13,10,8,7,10,7,5,10,10,18,12,11,11,11,5,5,6,AM LC,1,1,1,20,18,1,1,10,1,1,15,13,1,10,1
19306635,Diego Renato,1651,25/12/1988,27,0,0,0,0,184,79,1,3,3,1,1,2,2,1,3,1,3,7,10,11,13,13,7,13,7,6,7,9,6,7,10,5,9,6,8,8,6,12,7,10,12,8,6,8,9,13,11,8,7,9,9,12,20,13,8,10,10,8,10,10,19,12,9,11,11,1,12,2,S RL,1,1,20,13,15,15,1,1,1,1,12,1,1,1,1
19306636,Lucão,1651,24/04/1994,22,0,0,0,0,191,92,4,2,3,2,2,3,1,1,1,2,2,7,5,10,13,13,5,13,6,7,5,8,3,3,13,5,8,7,6,8,3,7,8,13,7,13,7,7,8,13,10,8,13,10,17,12,20,13,13,9,10,2,6,10,11,11,9,10,11,3,17,5,S ,1,1,20,1,1,1,1,1,1,1,1,1,1,1,1
19306724,Miguel,1651,13/01/2000,16,0,0,0,0,175,0,1,1,3,1,1,1,3,3,1,2,2,6,8,4,4,12,2,7,7,7,7,9,2,9,9,8,9,9,5,6,8,12,8,8,7,6,6,8,8,13,15,8,8,20,12,15,9,5,7,8,6,5,8,8,13,12,10,11,9,12,11,8,D L,1,1,1,1,1,1,1,20,1,1,1,1,1,15,1
19306725,Matheus Henrique,1651,02/05/2000,16,0,0,0,0,159,0,3,3,3,3,1,2,4,3,3,1,1,6,6,8,8,12,6,4,11,1,2,9,3,8,13,8,8,5,4,7,14,5,3,12,6,9,3,8,11,14,14,8,1,1,9,14,20,12,4,8,7,1,8,8,7,10,10,11,11,1,9,3,M/AM C,1,1,1,20,1,1,1,1,1,1,17,1,1,1,1
19306726,Jardel,1651,18/05/2000,16,0,0,0,0,174,0,2,3,1,2,3,3,2,2,3,2,3,6,6,2,3,9,3,7,1,2,3,11,3,8,5,8,10,5,4,9,6,14,3,3,4,3,14,6,6,14,11,7,9,8,6,10,20,5,7,7,8,1,6,8,17,10,11,11,13,1,4,6,,1,20,1,1,1,1,1,1,1,1,1,1,1,1,1
19306728,Elói,1651,26/06/1998,18,0,0,0,0,184,0,2,2,2,3,1,1,3,1,2,3,1,6,7,10,9,14,8,9,10,2,6,14,5,9,10,10,7,3,10,9,9,14,4,9,9,9,10,9,10,14,13,10,12,9,13,13,20,8,7,10,10,5,7,10,16,10,9,11,12,2,4,3,AM C,1,1,12,20,1,1,1,1,1,1,15,1,1,1,1
19306729,Zé Gabriel,1651,16/04/2000,16,0,0,0,0,175,0,1,2,4,3,1,1,1,4,2,3,4,5,1,13,13,13,5,11,6,1,2,6,3,1,13,7,8,5,6,6,2,7,8,13,2,11,5,5,6,13,8,5,3,8,6,11,20,11,8,8,8,8,5,8,19,12,13,12,12,1,1,4,S ,1,1,20,1,1,1,1,1,1,1,1,1,1,1,1
19306730,Weverton Souza,1651,15/06/1999,17,0,0,0,0,176,0,1,1,3,1,3,2,2,1,2,1,1,3,2,5,1,10,1,6,4,2,3,7,2,9,6,7,4,7,6,5,6,13,7,4,1,5,6,6,7,10,10,6,9,8,9,12,20,11,7,7,7,6,7,6,11,11,10,8,14,10,10,5,D R,1,1,1,1,1,1,1,1,20,1,1,1,1,1,15
19306731,Tonys,1651,16/04/1998,18,0,0,0,0,170,0,1,1,3,3,1,1,1,3,2,2,2,6,6,8,5,13,6,3,9,1,6,13,1,8,13,9,7,8,7,4,12,13,9,13,7,11,8,7,12,13,10,7,2,11,16,11,20,12,4,8,9,4,6,9,16,11,12,11,10,7,9,5,AM C,1,1,1,20,1,1,1,1,1,1,15,1,1,1,1
19306798,Alesson,1651,16/02/1999,17,0,0,0,0,165,0,3,2,2,1,1,2,3,2,3,3,3,7,6,13,11,15,7,7,10,7,7,13,5,8,14,8,8,8,7,6,10,8,2,13,9,8,7,9,9,15,15,7,2,4,10,14,20,10,7,9,9,9,9,9,13,11,11,11,11,4,12,2,AM C,1,1,1,20,1,1,1,1,1,1,10,1,1,1,1
19306799,Jhony,1651,19/02/1997,19,0,0,0,0,178,84,4,2,2,3,3,1,1,4,1,2,3,8,6,5,6,9,6,14,6,3,13,8,4,14,8,10,11,10,4,12,6,14,9,9,8,8,14,8,9,13,13,9,8,9,17,10,20,6,10,10,10,10,10,10,11,11,10,12,12,6,4,8,D C,1,1,1,1,1,1,20,1,1,1,1,1,1,1,1
19306802,Hugo,1651,15/07/1997,18,0,0,0,0,189,81,10,10,7,1,11,12,9,14,8,7,9,7,2,3,2,8,10,1,2,2,1,2,3,3,8,10,6,12,7,10,7,14,3,2,8,2,13,9,6,10,16,9,8,9,13,9,20,2,10,9,10,8,8,10,10,13,11,11,13,8,1,3,GK ,20,1,1,1,1,1,1,1,1,1,1,1,1,1,1
19306805,Allexson,1651,17/02/1998,18,0,0,0,0,171,66,1,3,1,1,1,1,1,3,3,3,3,8,8,10,8,9,8,7,9,7,5,12,1,5,14,9,10,9,7,9,8,12,4,12,8,8,9,9,12,15,15,9,6,2,12,15,20,8,7,9,9,1,9,9,10,11,14,11,9,12,8,6,AM C,1,1,1,20,1,1,1,1,1,1,10,1,1,1,1
19306930,Bruno Soares,1651,08/04/1999,17,0,0,0,0,180,70,2,1,2,1,3,2,2,3,2,1,1,6,8,12,12,12,6,10,11,4,4,11,12,6,12,9,12,8,12,3,12,6,11,14,3,13,3,6,8,12,13,12,10,10,15,13,20,7,10,12,9,8,9,9,12,10,13,12,10,1,10,5,S ,1,1,20,1,13,12,1,1,1,1,1,1,1,1,1
19306932,Serginho,1651,21/01/2000,16,0,0,0,0,179,0,2,1,1,1,2,3,2,2,1,1,2,10,12,11,9,11,7,4,11,3,1,6,4,4,11,11,5,6,10,5,11,10,11,14,9,10,2,9,6,12,12,5,5,8,12,12,20,10,4,8,8,8,8,8,18,12,13,11,11,2,4,5,AM RL,1,1,12,14,18,20,1,1,1,1,1,1,1,1,1
19306933,Carlo,1651,14/08/1997,18,0,0,0,0,173,0,2,1,2,2,2,1,3,2,1,3,1,7,5,6,6,10,5,8,2,7,8,9,4,13,6,3,9,9,8,7,5,10,8,8,4,6,6,8,8,13,12,8,3,20,8,15,9,9,7,8,7,7,8,8,7,11,10,8,10,7,2,8,D L,1,1,1,1,1,1,1,20,1,1,1,1,1,13,1
19306934,Diego Riechelmann,1651,19/10/1999,16,0,0,0,0,192,0,13,14,9,1,12,13,12,13,10,9,8,5,3,1,3,6,10,1,1,3,2,3,2,2,1,7,5,15,8,9,8,13,10,2,3,2,7,9,7,12,7,8,13,9,15,9,20,4,11,10,10,10,8,9,14,12,11,9,11,1,11,2,GK ,20,1,1,1,1,1,1,1,1,1,1,1,1,1,1
19306935,Lucas Minele,1651,15/02/1999,17,0,0,0,0,175,0,3,3,2,2,3,3,1,2,2,2,1,7,14,13,8,12,3,8,14,7,10,12,3,9,9,9,8,9,5,8,6,13,9,9,8,6,7,8,8,13,14,10,8,10,12,14,20,13,7,9,9,7,5,9,19,12,14,11,13,8,11,4,D R,1,1,1,1,1,1,1,1,20,1,1,1,10,1,15
19306936,Zé Gabriel,1651,21/01/1999,17,0,0,0,0,190,0,1,3,2,3,2,3,1,1,1,1,3,5,5,12,12,13,5,13,3,2,5,6,3,1,11,6,6,7,5,5,7,11,2,14,5,11,2,5,7,13,8,6,12,20,9,12,6,11,10,8,8,8,7,8,20,9,11,9,10,3,17,5,S ,1,1,20,1,13,11,1,1,1,1,1,1,1,1,1
19306937,Felipe,1651,06/01/1999,17,0,0,0,0,177,0,3,2,1,3,1,1,3,2,3,3,4,3,2,3,7,13,5,3,7,3,7,13,3,7,13,8,8,1,5,6,13,9,9,8,10,7,2,6,10,10,12,6,6,8,14,13,20,6,7,8,8,8,8,8,17,11,10,12,8,1,6,7,M C,1,1,1,13,1,1,1,1,1,1,20,1,1,1,1
19306938,Michel,1651,06/03/1999,17,0,0,0,0,184,0,3,2,1,2,1,3,3,3,2,3,1,3,2,4,5,5,5,12,3,1,11,4,1,11,5,6,10,12,3,8,1,13,8,1,10,3,10,5,3,13,10,6,12,8,12,9,20,8,9,8,8,11,5,8,8,11,11,12,11,8,5,4,D C,1,11,1,1,1,1,20,1,1,1,1,1,1,1,1
19306939,Vinicius,1651,11/02/1999,17,0,0,0,0,172,68,3,3,3,1,2,1,2,1,3,2,2,7,9,10,11,12,4,12,5,1,2,5,3,4,12,12,10,6,10,5,6,5,17,13,10,7,1,4,6,12,12,5,11,20,14,12,11,7,4,8,4,8,5,8,19,11,14,13,9,2,19,4,S ,1,1,20,1,14,11,1,1,1,1,1,1,1,1,1
19306944,Iago Oliveira,1651,01/03/2000,16,0,0,0,0,180,70,2,2,3,1,3,2,3,2,3,1,1,5,12,13,10,12,6,8,12,4,6,13,4,12,13,10,12,8,11,12,13,12,14,14,11,13,8,7,11,9,10,7,7,10,7,12,20,7,7,13,8,9,5,8,13,10,9,12,14,1,13,7,DM/M C,1,1,1,12,1,1,1,1,1,18,20,1,1,1,1
19306945,Arthur Gazze,1651,12/04/2000,16,0,0,0,0,190,83,11,6,9,1,14,14,13,12,8,7,11,3,3,3,3,5,5,1,2,1,1,1,3,1,3,7,4,11,4,7,6,13,11,3,2,1,7,7,6,13,9,7,14,8,11,10,20,4,11,4,8,8,6,8,20,10,13,10,12,7,8,5,GK ,20,1,1,1,1,1,1,1,1,1,1,1,1,1,1
19306946,Rodrigo Nestor,1651,09/03/2000,16,0,0,0,0,190,0,3,3,1,2,2,1,1,4,2,2,2,11,10,12,9,11,11,5,12,3,7,11,2,7,11,9,8,8,11,7,12,12,10,13,2,11,8,4,8,11,11,9,12,9,9,12,20,8,9,7,9,3,9,9,18,10,12,11,14,8,8,3,DM/M C,1,1,1,12,1,1,1,1,1,18,20,1,1,1,1
19306963,Leonardo Sulzbach,1651,01/01/2000,16,0,0,0,0,183,0,11,7,4,1,10,12,9,12,7,8,12,1,3,2,3,1,6,1,3,3,3,1,2,3,3,8,3,14,3,10,4,11,8,1,1,3,8,5,4,12,15,5,7,7,8,10,20,1,5,8,1,8,8,8,13,11,11,11,12,8,5,5,GK ,20,1,1,1,1,1,1,1,1,1,1,1,1,1,1
19306964,Gabriel,1651,07/07/1998,17,0,0,0,0,189,0,1,1,1,3,2,2,4,1,2,3,2,5,5,11,10,13,6,13,4,3,2,6,5,1,9,9,4,6,10,4,7,11,4,13,11,12,5,6,7,13,13,7,12,6,9,13,20,8,11,9,5,4,9,8,14,10,13,11,11,6,8,3,S ,1,1,20,1,1,1,1,1,1,1,1,1,1,1,1
19307054,Gauto,1651,25/08/1997,18,0,0,0,0,176,0,2,3,3,3,3,1,1,3,2,2,2,6,8,12,8,14,5,6,8,4,6,13,6,8,14,8,7,2,5,5,7,8,3,13,6,3,4,8,11,14,14,8,8,1,15,13,20,6,6,8,8,8,8,8,10,11,12,14,13,5,11,7,AM RC,1,1,1,20,1,15,1,1,1,1,10,1,12,1,1
19307225,Eduardo Sousa,1651,26/01/1990,26,0,0,0,0,187,0,2,3,2,1,3,4,1,1,3,1,3,3,1,1,1,6,1,12,1,1,13,6,1,13,6,9,11,9,6,9,1,13,1,8,11,6,13,5,8,12,12,7,12,1,11,13,20,11,13,9,5,8,8,9,7,11,11,11,12,5,4,7,D C,1,1,1,1,1,1,20,1,1,1,1,1,1,1,1
19307355,Pachu,1651,26/02/1996,20,0,0,0,0,186,77,2,3,2,3,2,2,3,4,2,1,3,11,15,12,12,11,9,11,12,3,8,10,8,7,12,13,11,10,12,10,11,12,10,12,7,12,8,10,11,12,9,11,12,13,12,12,20,9,12,12,8,10,8,10,20,11,9,12,12,3,16,5,S L,1,1,20,1,15,13,1,1,1,1,1,1,1,1,1
19307356,Rhuan,1651,25/01/2000,16,0,0,0,0,181,0,1,3,2,2,1,1,2,2,2,1,2,7,11,12,11,13,5,10,6,5,2,7,3,1,12,8,8,2,5,2,7,13,8,10,9,8,4,5,7,12,13,5,7,9,12,13,20,6,8,8,8,8,8,13,16,12,10,13,11,1,7,5,S ,1,1,20,1,14,13,1,1,1,1,1,1,1,1,1
19307358,Mateus,1651,22/06/1999,17,0,0,0,0,175,65,4,1,1,3,1,2,1,2,3,2,1,8,13,10,12,13,6,13,5,1,3,12,6,1,11,3,6,6,13,6,12,8,2,9,11,12,6,6,8,13,12,7,7,20,13,11,1,6,5,9,8,6,9,8,13,9,9,12,11,11,10,1,S L,1,1,20,1,15,13,1,1,1,1,1,1,1,1,1
19307359,Kanú,1651,07/03/1997,19,0,0,0,0,190,0,1,1,4,2,2,2,3,3,2,3,2,3,5,10,4,12,1,14,8,5,13,12,2,14,12,5,9,10,6,8,13,14,2,3,8,5,14,8,10,12,11,6,13,10,10,13,20,6,13,10,6,5,9,10,12,11,14,12,11,2,9,7,D C,1,1,1,1,1,1,20,1,1,12,1,1,1,1,1
19307360,Alison,1651,26/01/1997,19,0,0,0,0,188,0,2,3,1,1,1,2,2,4,2,1,1,6,5,12,10,6,6,7,11,4,5,12,1,8,12,5,7,5,7,6,12,13,7,10,9,4,7,7,11,12,11,11,7,12,9,12,20,13,8,9,9,9,3,9,11,12,12,12,12,12,10,6,AM C,1,1,1,20,1,1,1,1,1,1,14,1,1,1,1
19307361,Paulo Vitor,1651,24/06/1999,17,0,0,0,0,170,0,2,2,2,2,2,1,2,2,2,1,3,5,7,11,10,12,8,6,10,4,5,10,5,6,11,12,10,5,9,3,11,10,8,14,6,9,3,6,9,11,12,10,5,9,10,12,20,12,6,9,6,6,4,7,12,12,10,13,12,2,1,4,AM/S RL,1,1,18,1,20,15,1,1,1,1,1,1,1,1,1
19307362,Robinho,1651,07/03/1999,17,0,0,0,0,164,59,1,1,4,3,1,1,1,1,1,2,1,9,12,12,10,11,5,5,8,5,2,11,6,1,12,8,8,7,8,4,11,6,8,14,1,3,4,6,7,12,14,6,2,9,12,12,20,8,5,8,8,8,8,8,12,11,12,9,9,11,11,4,AM/S RL,1,1,16,14,20,16,1,1,1,1,1,1,1,1,1
19307363,Denilson,1651,17/03/2000,16,0,0,0,0,188,0,2,3,2,3,4,3,1,2,1,4,2,6,8,13,8,13,6,6,8,1,3,13,3,7,12,4,4,3,4,3,9,11,9,14,5,8,6,7,12,11,13,7,13,9,12,12,20,8,7,9,7,9,9,9,18,14,12,12,13,1,19,8,AM C,1,1,1,20,14,14,1,1,1,1,1,1,1,1,1
19307364,Gustavo Schutz,1651,01/01/1999,17,0,0,0,0,177,67,1,1,2,4,3,3,1,1,1,3,1,9,13,10,10,11,7,13,4,1,4,7,10,2,10,12,9,6,11,8,7,11,4,9,1,7,5,6,8,13,13,12,7,20,15,12,8,8,6,9,9,5,9,9,12,10,12,13,12,9,14,3,S L,1,1,20,1,15,12,1,1,1,1,1,1,1,1,1
19307366,Willian Henrique,1651,06/01/2000,16,0,0,0,0,180,0,3,4,3,2,2,2,2,2,1,3,1,11,13,8,8,13,6,5,6,5,1,5,4,6,12,8,6,5,9,3,6,13,8,12,1,7,5,6,7,13,9,6,7,20,11,12,8,8,7,8,8,8,8,8,9,12,12,12,9,1,12,3,AM RL,1,1,14,1,20,18,1,1,1,1,1,1,1,1,1
19307367,Rafael Resende,1651,05/03/2000,16,0,0,0,0,169,0,1,2,1,1,3,1,1,2,3,3,2,3,2,7,5,11,5,6,12,1,6,12,1,12,13,9,5,8,7,8,12,13,4,9,2,8,7,7,11,10,10,3,1,20,9,13,9,11,5,9,9,5,5,9,8,12,10,12,11,2,16,5,M C,1,1,1,1,1,1,1,1,1,13,20,1,1,1,1
19308145,Gabriel Kazu,1651,09/06/1999,17,0,0,0,0,167,62,2,2,3,3,1,1,4,2,2,3,3,6,6,2,6,13,6,6,12,4,8,11,4,13,13,7,6,8,6,5,9,13,5,9,1,1,12,7,12,13,10,7,2,8,16,8,20,9,9,9,7,8,9,9,7,11,9,13,14,13,18,5,DM ,1,1,1,1,1,1,1,1,1,20,10,1,1,1,1
19308300,Márcio,1651,06/05/1994,22,0,0,0,0,191,0,3,1,3,1,2,3,3,1,2,2,2,2,1,5,1,6,1,13,3,1,12,5,1,7,1,8,8,8,4,9,5,13,2,1,12,5,10,5,6,11,9,6,15,8,12,10,20,3,8,8,8,8,6,8,15,10,11,12,10,10,13,3,D C,1,1,1,1,1,1,20,1,1,1,1,1,1,1,1
19308307,Tiago Orobó,1651,28/10/1993,22,0,0,0,0,188,75,3,4,1,1,3,4,1,2,3,3,1,10,15,9,11,13,9,15,11,4,9,11,6,10,15,10,13,14,10,5,10,15,10,13,7,8,10,12,8,7,8,10,17,17,8,9,20,12,12,10,10,8,4,10,15,13,11,11,11,3,4,8,AM LC,1,1,15,15,20,1,1,1,1,1,1,8,1,1,1
19308309,Ronan,1651,14/01/1995,21,0,0,0,0,168,0,3,2,2,1,2,2,2,3,2,2,1,7,7,14,14,14,7,14,8,5,7,8,5,3,13,9,12,8,9,8,8,11,5,12,7,14,6,7,8,12,13,8,1,9,9,14,20,10,7,9,9,9,6,9,17,10,11,9,12,6,5,1,S ,1,1,20,1,1,1,1,1,1,1,1,1,1,1,1
19308310,Andson Alagoano,1651,01/07/1992,24,0,0,0,0,182,78,2,2,3,1,2,3,2,3,2,3,1,2,2,4,2,7,1,13,2,3,13,4,5,13,6,9,11,9,7,8,2,13,5,1,13,6,8,6,7,11,12,7,9,10,13,13,20,10,11,9,9,7,7,9,16,13,12,12,10,2,9,7,D C,1,1,1,1,1,1,20,1,1,1,1,1,1,1,1
19308311,Augusto,1651,10/04/1991,25,0,0,0,0,183,0,1,2,2,1,3,3,1,1,3,3,3,10,13,12,8,14,8,8,8,8,8,9,3,7,12,9,11,3,7,9,10,10,10,10,5,9,7,9,10,12,14,10,6,6,8,14,20,15,8,10,5,10,10,10,8,11,9,13,10,2,3,7,AM R,1,1,15,1,1,20,1,1,1,1,1,1,8,1,1
19308312,Tcharlles,1651,12/01/1992,24,0,0,0,0,175,68,3,2,3,3,3,1,3,2,3,1,3,8,11,13,5,13,10,5,8,5,4,13,6,7,11,9,8,5,9,7,7,11,6,11,12,8,6,7,12,13,13,6,3,20,11,13,10,8,9,9,5,6,7,9,12,10,10,11,12,7,6,3,AM LC,1,1,8,20,20,1,1,1,1,1,1,10,1,1,1
19309070,Fábio Moura,1651,03/06/1997,19,0,0,0,0,170,58,3,1,2,3,1,1,3,2,3,3,1,3,5,5,3,9,4,14,6,1,10,9,2,13,8,5,10,9,8,13,5,14,5,9,7,7,7,7,9,14,14,8,5,10,14,14,20,6,7,8,9,9,9,9,10,10,11,8,9,10,2,1,D C,1,1,1,1,1,1,20,1,13,15,10,1,1,1,1
19309071,Vitor,1651,15/04/1999,17,0,0,0,0,178,0,9,9,9,4,11,12,4,9,7,7,7,2,2,3,2,1,6,1,2,2,1,1,2,3,1,4,4,9,4,7,3,7,7,1,4,1,10,4,3,10,14,4,8,7,7,10,20,1,4,7,7,7,6,6,8,11,10,13,12,9,13,5,GK ,20,1,1,1,1,1,1,1,1,1,1,1,1,1,1
19309072,Renan Gomes,1651,08/01/1999,17,0,0,0,0,185,0,1,3,1,1,2,2,2,1,2,2,2,2,1,1,1,5,5,10,1,1,13,3,1,12,3,8,7,8,2,5,1,12,8,1,4,2,11,4,6,12,11,5,12,1,9,12,20,6,8,8,8,8,8,6,17,10,11,12,8,1,14,3,D C,1,1,1,1,1,1,20,1,1,1,1,1,1,1,1
19309073,Charles,1651,16/03/1998,18,0,0,0,0,182,0,3,1,1,4,3,3,2,2,2,3,3,6,7,7,2,11,4,9,7,8,9,10,5,13,8,9,10,10,7,10,7,15,9,5,2,8,6,9,9,14,11,9,11,9,10,13,20,6,8,9,5,9,6,9,10,14,12,12,10,2,11,2,D R,1,1,1,1,1,1,1,1,20,1,1,1,1,1,13
19309074,Pedrinho,1651,07/08/2000,15,0,0,0,0,184,0,3,1,3,4,2,1,3,1,2,3,2,1,3,3,4,12,3,1,10,3,1,11,1,3,12,7,5,3,2,1,12,2,7,13,8,4,2,5,10,12,12,4,5,6,12,11,20,6,6,7,7,7,4,7,8,13,11,10,14,8,3,3,AM C,1,1,1,20,1,1,1,1,1,1,15,1,1,1,1
19309075,Wellington,1651,01/07/1997,19,0,0,0,0,176,64,3,2,2,1,3,3,3,3,2,2,1,6,6,8,8,12,7,6,9,4,8,9,5,8,15,8,5,3,6,8,11,10,8,13,8,8,7,8,12,14,12,7,4,1,14,13,20,6,4,8,8,5,8,8,19,11,11,14,12,4,8,5,AM C,1,1,1,20,1,1,1,1,1,1,15,1,1,1,1
19310571,Daniel,1651,17/10/1998,17,0,0,0,0,173,0,2,2,3,3,1,2,3,3,2,2,1,7,7,10,11,14,12,14,8,4,4,14,6,7,10,9,11,8,7,6,10,11,9,11,11,10,8,8,9,14,13,11,8,20,8,10,12,8,8,9,9,9,9,8,11,9,10,13,11,4,11,3,AM/S C,1,1,18,20,1,1,1,1,1,1,1,1,1,1,1
19310726,Lucas Machado,1651,04/06/1997,19,0,0,0,0,176,60,2,2,1,2,1,3,1,2,2,1,2,4,9,11,12,10,4,8,6,3,4,10,9,2,11,12,10,9,10,8,8,8,13,9,4,13,6,8,10,14,11,12,9,10,11,13,20,9,7,10,3,12,8,13,10,12,8,10,9,12,11,6,S RL,1,1,20,1,15,15,1,1,1,1,1,1,1,1,1
19310727,Diego Carioca,1651,27/01/1997,19,0,0,0,0,187,79,3,2,2,1,1,2,2,1,1,2,2,2,5,9,11,11,4,13,6,3,3,10,7,4,9,13,9,11,6,8,6,7,12,6,5,12,6,8,9,12,8,6,13,8,13,10,20,11,14,10,5,8,7,7,19,12,10,9,10,6,11,4,S ,1,1,20,1,1,1,1,1,1,1,1,1,1,1,1
19310728,Rômulo,1651,10/01/1996,20,0,0,0,0,182,79,1,3,1,3,2,3,4,1,1,3,2,6,6,10,7,11,13,11,10,4,11,12,11,11,13,13,9,11,13,10,9,12,15,7,13,9,11,12,13,12,9,8,11,10,13,12,20,11,12,13,6,12,7,12,11,15,11,13,13,10,11,6,DM/M C,1,1,1,1,1,1,10,1,1,20,17,1,1,1,1
19310729,Paulo Henrique,1651,25/07/1996,19,0,0,0,0,175,74,2,3,1,2,1,3,2,2,3,1,2,4,11,10,6,9,6,6,4,5,11,10,4,12,9,13,10,10,9,9,7,10,1,5,6,9,11,12,11,13,9,11,8,9,13,12,20,11,10,8,6,12,7,13,7,11,11,12,9,5,3,1,DM ,1,1,1,1,1,1,1,1,14,20,1,1,1,1,1
19310730,Djhonattan,1651,13/06/1998,18,0,0,0,0,189,85,9,7,7,3,13,12,9,13,8,4,7,1,1,3,1,2,6,1,3,3,1,1,1,2,4,9,4,12,5,8,6,13,4,1,3,2,5,7,5,10,13,7,8,5,15,12,20,2,10,9,9,9,4,9,8,9,9,10,13,5,9,4,GK ,20,1,1,1,1,1,1,1,1,1,1,1,1,1,1
19310731,Júlio Cesar,1651,17/01/1996,20,0,0,0,0,187,75,3,1,2,3,3,3,2,3,2,3,2,6,4,4,1,5,4,9,6,1,13,7,1,11,1,6,8,9,7,9,3,13,1,5,9,5,12,6,7,13,10,7,13,5,10,8,20,5,10,8,9,9,4,9,16,9,13,11,12,8,8,4,D C,1,1,1,1,1,1,20,1,1,1,1,1,1,1,1
19311116,Bruno José,1651,31/03/1998,18,0,0,0,0,172,0,1,3,3,2,1,3,3,2,3,2,3,11,13,13,9,8,7,8,5,7,7,9,5,4,12,7,7,7,5,6,9,9,9,8,9,5,8,8,9,14,14,8,5,10,10,14,20,14,6,9,7,4,8,9,11,11,11,9,12,2,12,3,M R,1,1,13,1,1,13,1,1,12,1,1,1,20,1,14
19311117,João Pedro,1651,08/11/1997,18,0,0,0,0,170,0,3,3,1,2,2,2,2,3,2,1,1,6,6,5,7,13,6,4,8,1,7,12,6,9,13,9,7,4,5,6,13,13,9,6,9,7,6,7,10,13,13,7,1,10,7,13,20,6,4,9,9,4,9,9,17,13,12,13,12,4,5,5,M C,1,1,1,1,1,1,1,1,1,13,20,1,1,1,1
19311118,Ariel,1651,04/04/1996,20,0,0,0,0,171,0,2,2,2,4,3,1,2,3,1,1,3,9,13,13,5,13,7,7,4,7,7,9,3,8,13,10,11,7,10,8,8,6,17,9,6,7,4,8,12,13,13,8,2,10,10,13,20,13,5,10,5,10,10,10,11,11,9,9,12,11,3,5,M R,1,1,1,1,1,13,1,1,1,1,1,1,20,1,1
19311119,Valdemir,1651,13/03/1997,19,0,0,0,0,176,0,1,2,4,2,2,2,2,2,4,1,2,7,8,10,13,11,8,9,10,3,7,14,9,13,10,7,10,9,9,4,10,14,16,10,9,9,11,9,12,13,12,9,9,8,10,14,20,8,7,10,10,7,10,10,10,12,10,9,11,7,9,5,DM ,1,1,13,13,1,1,1,1,1,20,13,1,1,1,1
19311120,Pedro Lucas,1651,05/09/1998,17,0,0,0,0,182,0,2,2,3,2,2,3,2,3,2,3,1,4,2,13,13,10,6,13,6,4,3,6,7,4,9,7,7,8,13,7,7,7,14,9,9,10,2,6,7,12,9,7,10,8,10,9,20,7,7,9,9,1,3,9,11,11,11,10,11,9,8,7,S ,1,1,20,1,1,1,1,1,1,1,1,1,1,1,1
19311153,Lucas Frigeri,1651,15/06/1989,27,0,0,0,0,194,88,14,8,12,1,14,14,10,14,1,10,11,5,3,3,1,4,8,1,1,1,2,1,2,2,3,6,10,12,8,10,8,14,7,3,13,1,11,9,8,12,11,9,13,6,15,13,20,4,10,10,10,6,10,10,20,12,11,13,13,11,10,8,GK ,20,1,1,1,1,1,1,1,1,1,1,1,1,1,1
19311306,Lucas Silva,1651,16/01/1996,20,0,0,0,0,194,86,1,3,3,4,3,2,2,2,2,2,2,7,9,4,5,10,8,12,7,1,12,10,5,12,9,10,13,11,8,11,6,15,8,4,6,7,13,9,10,12,12,9,14,3,13,12,20,13,13,10,10,10,4,10,17,13,10,11,11,1,15,8,D C,1,1,1,1,1,1,20,1,1,1,1,1,1,1,1
19311307,Raul,1651,11/07/1996,19,0,0,0,0,177,73,2,1,1,2,2,2,3,2,2,3,2,10,10,11,10,12,10,7,11,8,11,12,10,10,12,11,11,10,12,8,10,10,2,13,4,11,10,11,12,13,14,13,7,10,12,13,20,12,8,12,8,10,4,12,18,11,11,11,12,8,2,6,DM/M C,1,1,1,13,1,12,1,1,1,18,20,1,14,1,1
19311308,Rondinele,1651,16/03/1997,19,0,0,0,0,173,64,2,3,4,1,1,1,1,1,1,1,3,11,13,5,2,13,7,6,4,1,7,8,2,8,9,8,7,8,8,8,8,13,9,9,3,7,5,7,3,12,13,12,5,9,12,12,20,10,4,9,9,9,6,8,20,12,11,10,13,8,17,3,D/WB/M R,1,1,1,1,1,15,1,1,20,1,1,1,16,1,18
19311309,Herbert,1651,10/11/1999,16,0,0,0,0,170,0,3,1,1,3,1,3,1,2,2,3,1,5,4,7,7,13,5,5,8,1,6,11,1,7,12,8,9,7,4,2,13,10,6,12,4,7,3,7,11,13,11,2,4,8,11,11,20,6,3,6,8,8,7,8,17,13,13,10,13,2,1,5,M/AM C,1,1,1,20,1,1,1,1,1,1,18,1,1,1,1
19311310,Fabrício,1651,08/07/1999,16,0,0,0,0,177,0,2,2,2,2,2,3,1,2,3,1,3,5,2,1,5,7,1,14,1,2,8,7,3,8,3,8,9,8,4,5,2,11,3,4,9,2,14,6,7,13,8,7,8,7,8,8,20,6,6,7,8,8,8,8,10,12,14,10,8,2,11,8,D C,1,1,1,1,1,1,20,1,1,1,1,1,1,1,1
19311312,Emerson Santos,1651,03/08/1996,19,0,0,0,0,170,57,3,1,3,2,3,4,2,2,1,4,3,8,8,8,6,14,8,8,10,4,9,11,2,14,10,4,9,9,8,5,14,14,10,3,12,8,10,9,13,13,13,10,2,10,12,13,20,12,8,10,10,10,4,10,14,11,11,11,11,9,9,5,DM/M C,1,1,1,14,1,1,1,1,1,18,20,1,1,1,1
19311313,Franklin,1651,25/01/1998,18,0,0,0,0,170,65,2,3,2,2,2,3,4,3,2,2,4,8,13,11,10,9,6,13,7,6,5,7,2,4,11,9,9,5,8,2,4,8,3,9,3,10,5,7,8,12,13,12,4,10,13,12,20,10,4,9,9,9,4,9,9,12,10,10,10,1,15,3,AM/S L,1,1,18,1,20,12,1,1,1,1,1,1,1,1,1
19311314,Diego,1651,28/09/1995,20,0,0,0,0,191,93,14,10,9,3,10,14,10,14,4,9,11,4,3,3,3,1,8,1,1,3,2,3,2,1,5,10,7,14,9,10,4,14,15,3,5,1,10,9,6,11,14,4,16,8,13,12,20,2,11,10,10,6,10,10,7,10,10,11,13,5,20,8,GK ,20,1,1,1,1,1,1,1,1,1,1,1,1,1,1
19311315,Rafinha,1651,04/03/1997,19,0,0,0,0,175,73,4,1,1,1,2,1,3,1,1,2,2,9,14,14,10,14,8,8,7,8,6,11,1,7,13,10,9,2,7,9,7,13,15,12,2,9,9,9,10,14,11,9,7,9,16,13,20,14,6,10,10,10,10,10,20,10,13,9,10,10,17,7,AM RC,1,1,11,17,1,20,1,1,1,1,13,1,14,1,1
19311395,Juninho Capixaba,1651,06/07/1997,18,0,0,0,0,176,63,2,3,3,1,3,2,3,3,3,2,2,10,10,11,7,12,8,8,10,11,10,12,7,10,12,10,10,10,12,9,10,9,14,12,9,11,10,11,12,14,14,13,7,20,13,13,5,13,5,12,10,9,9,11,11,12,12,15,12,6,9,7,D/WB L,1,1,1,1,1,1,1,20,1,1,1,1,1,18,1
19311396,Mayron,1651,18/11/1996,19,0,0,0,0,170,67,3,3,3,2,1,2,2,4,3,3,2,10,11,12,16,12,8,10,12,7,10,13,9,10,13,3,8,3,8,10,12,11,9,10,5,11,12,11,9,13,14,13,5,20,12,13,3,12,6,10,9,2,5,10,19,10,11,13,11,7,9,5,M/AM C,1,1,14,20,12,13,1,1,1,1,18,1,1,1,1
19311398,Marco Antonio,1651,01/10/1997,18,0,0,0,0,173,0,1,3,4,3,1,1,2,1,2,2,1,4,7,8,8,13,3,5,8,2,6,12,1,7,9,8,8,3,8,7,13,10,8,8,5,8,6,7,10,14,14,7,8,8,6,14,20,6,4,8,8,8,6,8,19,9,10,10,11,1,16,7,M/AM C,1,1,1,20,12,13,1,1,1,1,18,1,1,1,1
19311399,Douglas,1651,13/12/1998,17,0,0,0,0,165,60,3,1,3,2,2,3,2,3,3,2,1,8,10,10,12,12,4,12,5,3,4,5,3,3,12,8,11,6,8,4,6,12,8,13,10,4,3,2,6,11,12,11,2,20,11,12,16,9,3,8,4,8,8,7,20,12,10,10,10,10,6,5,S RL,1,1,20,1,15,15,1,1,1,1,1,1,1,1,1
19311400,Lucas Mesquita,1651,04/04/1999,17,0,0,0,0,182,0,1,3,3,3,3,2,1,2,1,3,1,5,2,12,13,13,5,13,6,4,3,6,4,1,12,8,11,5,7,2,4,10,17,12,10,13,6,4,6,12,8,6,7,20,8,10,10,7,8,8,8,1,8,8,18,10,11,11,10,8,7,4,S ,1,1,20,1,1,1,1,1,1,1,1,1,1,1,1
19311402,Yuri,1651,07/01/1998,18,0,0,0,0,183,0,4,2,1,3,3,2,1,4,3,1,3,2,4,11,13,12,5,13,6,5,1,6,9,1,10,8,10,3,11,2,2,12,8,10,9,7,6,5,6,13,11,3,11,2,9,13,20,10,8,8,7,8,8,8,18,12,11,8,11,1,11,2,S ,1,1,20,1,1,1,1,1,1,1,1,1,1,1,1
19311404,Júnior Brumado,1651,15/05/1999,17,0,0,0,0,177,0,2,1,3,1,3,3,3,1,3,2,3,5,4,10,13,13,5,13,3,2,2,6,8,1,12,8,9,6,13,1,5,8,8,12,2,7,3,5,6,13,11,6,9,1,13,13,20,9,5,8,8,8,5,8,14,11,9,13,13,8,14,3,S ,1,1,20,1,1,1,1,1,1,1,1,1,1,1,1
19311405,Davi Miranda,1651,19/05/1999,17,0,0,0,0,177,0,2,2,2,2,1,1,3,2,2,2,2,3,10,10,3,12,1,6,1,5,7,7,1,12,7,8,5,8,4,6,6,13,20,8,7,4,6,6,6,13,12,6,8,9,10,13,20,9,6,5,8,8,8,8,13,11,8,11,11,1,4,1,D/WB R,1,1,1,1,1,1,1,1,20,1,1,1,1,1,18
19311406,Vinícius,1651,10/03/1999,17,0,0,0,0,186,0,1,3,2,1,2,2,2,2,1,4,1,5,1,1,3,6,1,11,1,5,7,5,3,12,2,8,7,8,5,6,5,12,7,6,3,2,12,5,6,11,10,5,13,13,12,12,20,11,10,8,8,8,8,8,20,10,12,12,12,5,13,1,D C,1,1,1,1,1,1,20,1,1,1,1,1,1,1,1
19311407,Alex Moura,1651,07/03/1997,19,0,0,0,0,187,0,3,2,1,2,3,2,2,1,3,3,3,6,5,13,13,9,6,13,7,3,5,7,5,4,11,9,10,4,9,7,7,7,7,11,7,13,7,6,7,13,12,6,7,9,16,11,20,6,9,9,9,9,9,9,18,11,9,10,11,7,13,5,S ,1,1,20,1,1,1,1,1,1,1,1,1,1,1,1
19311521,Jhemerson,1651,27/01/1997,19,0,0,0,0,175,65,1,1,1,3,3,3,2,1,1,2,1,9,9,12,9,12,8,7,9,3,7,11,9,7,12,11,12,10,11,8,11,8,14,15,4,12,8,10,11,13,14,12,6,3,13,13,20,11,4,13,6,9,4,15,14,10,12,13,10,1,13,4,AM/S R,1,1,18,10,12,20,1,1,8,5,8,7,14,1,10
19311522,Kaio,1651,24/03/1997,19,0,0,0,0,186,0,1,3,1,2,1,3,1,1,2,1,2,9,7,12,11,15,9,4,11,5,7,13,7,11,16,9,11,6,16,9,9,7,2,13,11,11,6,10,11,9,12,7,10,1,7,11,20,11,10,8,7,7,9,9,10,12,8,11,12,7,13,3,M/AM C,1,1,1,20,12,12,1,1,1,1,18,1,1,1,1
19311523,Wayni,1651,21/04/1996,20,0,0,0,0,178,0,1,2,1,3,1,1,2,3,1,1,2,5,2,13,13,12,3,13,6,1,5,6,5,1,8,8,10,3,8,5,5,10,4,8,6,10,4,5,6,13,12,4,5,8,13,13,20,8,7,8,8,8,8,8,14,11,10,11,11,8,15,7,S ,1,1,20,1,1,1,1,1,1,1,1,1,1,1,1
19311524,Andrey,1651,22/05/1997,19,0,0,0,0,177,0,3,3,1,3,2,3,2,2,2,3,3,10,9,10,9,11,7,8,11,8,12,11,7,12,11,12,11,12,9,8,11,8,2,12,5,12,12,12,12,13,14,9,9,5,13,13,20,12,11,12,11,9,9,13,15,10,10,11,11,13,10,3,DM/M C,1,1,1,10,1,1,1,1,1,18,20,1,1,1,1
19311525,Ruan,1651,19/01/1999,17,0,0,0,0,177,0,2,3,3,2,2,3,4,2,3,1,3,7,9,8,10,10,5,12,4,4,2,2,6,4,11,5,7,7,10,3,7,6,8,11,10,8,6,5,7,13,13,6,9,13,9,13,20,7,7,6,6,8,8,8,17,11,11,12,14,8,8,2,S R,1,1,20,1,14,15,1,1,1,1,1,1,1,1,1
19311527,Luciano,1651,16/02/1998,18,0,0,0,0,180,0,1,1,4,1,3,2,2,2,3,1,2,5,5,11,13,13,5,10,6,2,3,5,5,1,9,8,12,3,10,4,4,9,1,9,10,12,4,5,7,12,9,6,10,8,14,11,20,12,7,8,6,2,8,6,18,9,13,12,11,8,9,7,S ,1,1,20,1,1,1,1,1,1,1,1,1,1,1,1
19311528,Igor Luíz,1651,14/03/2000,16,0,0,0,0,184,0,4,2,3,3,2,1,2,1,3,3,3,2,1,1,1,5,1,13,4,1,11,6,1,11,1,6,6,8,2,3,1,13,17,1,1,2,13,5,6,13,10,6,11,8,10,12,20,5,7,8,7,8,6,8,8,12,9,11,13,1,6,4,D C,1,1,1,1,1,1,20,1,1,1,1,1,1,1,1
19311529,Luan Gabriel,1651,05/08/2000,15,0,0,0,0,174,0,3,1,1,2,1,1,1,2,1,3,1,6,4,13,8,13,6,13,7,1,5,7,1,6,13,3,8,4,7,5,5,12,5,13,6,13,6,6,8,13,13,2,6,8,15,13,20,5,6,9,9,9,7,8,13,11,12,12,11,9,11,7,S ,1,1,20,1,11,12,1,1,1,1,1,1,1,1,1
19311530,Lucão,1651,06/04/2000,16,0,0,0,0,181,0,3,2,4,1,2,2,3,2,1,1,2,6,7,12,8,13,6,6,8,6,7,13,5,7,12,9,7,8,7,6,13,12,9,12,11,8,4,8,11,13,12,4,8,7,16,13,20,7,5,9,7,9,7,9,12,11,11,12,9,1,16,6,AM C,1,1,1,20,12,12,1,1,1,1,15,1,1,1,1
19311531,Vinícius Brenner,1651,07/01/1999,17,0,0,0,0,187,0,3,1,3,2,3,2,1,3,1,1,1,6,6,8,8,14,6,6,6,2,2,11,3,8,13,4,5,7,4,7,14,12,4,12,7,4,3,8,11,14,13,7,8,20,11,13,2,7,9,5,6,8,8,8,20,13,12,9,13,3,8,3,AM C,1,1,1,20,11,10,1,1,1,1,15,1,1,1,1
19311532,Neyverson,1651,05/08/1999,16,0,0,0,0,178,0,3,1,1,1,1,2,1,2,2,1,1,5,3,7,7,12,5,4,7,4,4,13,5,7,8,1,8,7,8,4,12,6,3,8,6,4,2,7,10,13,13,7,8,8,10,13,20,7,7,8,6,5,8,8,16,14,8,9,10,10,5,7,AM C,1,1,1,20,10,12,1,1,1,1,15,1,1,1,1
19311533,Gabriel Coelho,1651,25/05/1999,17,0,0,0,0,184,0,2,3,3,3,1,1,3,3,3,3,1,2,1,5,2,4,3,11,5,1,12,7,1,11,5,8,7,8,2,8,6,13,2,6,10,3,10,5,7,13,12,6,8,1,8,12,20,3,9,7,6,8,6,8,14,14,10,11,10,3,16,8,D C,1,1,1,1,1,1,20,1,1,13,1,1,1,1,1
19311534,Jorginho,1651,08/06/1999,17,0,0,0,0,189,0,3,1,3,2,1,3,1,3,3,2,3,1,1,1,3,6,4,13,1,1,11,6,1,11,4,8,10,4,3,3,1,13,8,1,4,3,13,5,6,12,8,6,12,20,9,11,8,3,9,5,8,8,7,8,15,11,12,11,11,1,9,1,D C,1,1,1,1,1,1,20,1,1,1,1,1,1,1,1
19311535,Luan,1651,26/02/1999,17,0,0,0,0,185,0,3,1,1,3,4,2,4,3,3,3,2,7,11,11,9,13,5,13,6,5,3,6,1,6,11,8,5,7,5,4,7,7,5,11,2,8,5,6,5,12,12,5,9,20,6,12,17,6,9,6,8,8,8,7,15,10,10,13,10,6,15,8,AM/S L,1,1,18,1,20,10,1,1,1,1,1,1,1,1,1
19311536,Rafael,1651,27/06/1999,17,0,0,0,0,175,0,3,3,1,2,1,2,1,3,3,3,3,6,7,14,8,14,3,4,8,4,3,11,5,8,14,6,7,7,11,3,12,6,8,13,10,8,4,8,12,14,11,7,7,1,11,10,20,13,6,8,8,8,5,8,17,11,12,10,12,8,12,5,AM C,1,1,1,20,13,12,1,1,1,1,15,1,1,1,1
19311537,Matheus João,1651,22/01/1999,17,0,0,0,0,176,0,1,3,2,3,4,3,1,1,3,2,1,6,4,10,12,12,6,14,7,3,5,6,7,1,13,6,7,7,11,7,5,8,6,12,6,12,5,6,7,13,9,7,8,8,8,11,20,9,6,4,8,8,4,8,20,9,13,11,9,7,8,7,S ,1,1,20,1,1,1,1,1,1,1,1,1,1,1,1
19311538,Wesley,1651,08/06/1999,17,0,0,0,0,174,0,3,4,3,1,3,3,2,1,2,2,1,5,2,7,7,12,5,5,12,1,5,13,1,10,7,8,4,7,7,7,10,13,8,8,3,5,3,6,6,12,13,6,8,1,13,13,20,7,6,8,8,8,8,8,12,12,14,12,11,2,14,1,DM/M C,1,1,1,15,1,1,1,1,1,18,20,1,1,1,1
19311541,Neto,1651,16/07/1998,17,0,0,0,0,187,78,9,9,10,2,11,13,9,12,9,9,10,3,3,3,3,3,7,1,2,2,1,1,1,2,4,9,5,15,3,11,6,12,9,2,7,2,6,7,6,9,13,7,13,10,13,5,20,1,10,9,9,5,9,9,18,13,11,12,13,2,10,5,GK ,20,1,1,1,1,1,1,1,1,1,1,1,1,1,1
19311818,Miguel,1651,22/02/2000,16,0,0,0,0,190,0,1,3,3,2,1,3,4,1,1,1,3,4,3,4,3,6,5,13,2,1,9,6,1,13,2,7,8,6,7,5,4,13,15,8,9,5,13,6,7,13,12,7,11,8,4,13,20,7,9,5,7,9,6,9,10,10,9,13,10,7,8,1,D C,1,1,1,1,1,1,20,1,1,1,1,1,1,1,1
19311819,Weverson,1651,05/07/2000,15,0,0,0,0,175,0,4,2,3,1,1,3,1,1,4,2,2,2,7,8,4,13,4,9,8,8,7,9,4,13,10,9,6,9,3,6,9,12,3,9,2,4,9,9,9,15,15,8,8,20,7,15,7,10,7,5,9,9,9,7,7,13,9,9,11,10,6,8,D/WB L,1,1,1,1,1,1,1,20,1,1,1,1,1,18,1
19311963,Mateus Norton,1651,19/07/1997,18,0,0,0,0,193,0,1,1,1,3,1,1,2,2,2,2,1,6,4,4,7,13,5,6,12,1,7,10,6,12,12,9,8,8,7,5,12,13,8,4,11,6,8,7,11,13,9,7,10,16,9,11,20,7,10,9,6,9,5,9,13,11,13,10,10,7,11,8,DM ,1,1,1,1,1,1,1,1,1,20,10,1,1,1,1
19312804,Caio,1651,16/04/1999,17,0,0,0,0,170,63,3,2,4,2,3,2,3,3,2,1,2,8,9,8,3,15,3,9,8,7,10,10,3,15,10,9,8,10,8,11,10,11,17,9,12,4,10,10,10,10,13,10,7,20,13,11,9,11,8,7,9,5,7,9,10,9,11,12,9,1,11,3,D/WB L,1,1,1,1,1,1,1,20,1,1,1,1,1,19,1
19312806,Patrick,1651,06/05/1999,17,0,0,0,0,174,65,1,1,1,3,3,2,2,4,2,1,2,4,5,14,14,14,7,14,8,5,7,8,4,4,13,9,9,7,11,7,8,13,16,12,10,11,13,7,8,13,11,8,7,9,11,12,20,6,6,13,9,12,9,9,8,13,12,13,10,12,7,3,S ,1,1,20,1,1,1,1,1,1,1,1,1,1,1,1
19312810,Fabrício,1651,23/07/1997,18,0,0,0,0,185,0,3,2,3,3,4,1,1,4,1,2,2,5,5,11,12,12,1,12,6,5,3,6,5,1,11,3,8,6,9,5,6,7,4,12,5,12,1,5,6,10,12,6,9,16,11,12,20,11,7,9,5,4,9,9,13,12,9,14,11,12,15,5,S ,1,1,20,1,1,1,1,1,1,1,1,1,1,1,1
19312829,Maílton,1651,31/05/1998,18,0,0,0,0,172,0,1,2,1,1,2,3,3,3,3,3,3,4,8,8,6,8,1,4,7,3,8,9,1,14,8,9,7,8,7,10,5,11,4,9,9,4,5,5,9,14,11,8,3,8,14,12,20,14,6,9,8,9,9,12,13,12,9,10,13,4,6,8,D/WB R,1,1,10,1,1,11,1,1,20,1,1,1,13,1,17
19312830,Magno,1651,15/02/1997,19,0,0,0,0,176,0,1,1,2,1,4,1,3,2,4,2,3,5,3,9,13,13,5,13,6,3,2,6,6,2,13,3,6,5,7,3,3,9,1,13,12,13,6,5,6,13,12,6,6,8,10,13,20,6,6,7,8,1,7,8,12,11,10,13,13,11,16,4,S ,1,1,20,1,1,1,1,1,1,1,1,1,1,1,1
19312831,Léo Passos,1651,13/03/1999,17,0,0,0,0,179,0,2,3,1,3,1,2,1,2,3,2,4,6,3,13,8,13,6,13,7,5,4,7,5,2,10,7,6,5,10,7,5,9,17,10,10,9,4,6,7,13,13,7,3,8,12,13,20,6,8,9,6,9,9,9,17,10,12,11,11,5,16,6,S ,1,1,20,1,1,1,1,1,1,1,1,1,1,1,1
19312832,Alan,1651,19/03/1998,18,0,0,0,0,188,0,2,1,3,1,2,3,3,1,3,3,1,5,3,13,13,12,5,13,6,2,3,6,5,3,11,8,8,1,8,4,4,5,8,11,6,8,3,5,6,13,7,6,7,8,8,10,20,7,9,8,8,1,8,8,14,9,14,12,8,6,10,5,S ,1,1,20,1,1,1,1,1,1,1,1,1,1,1,1
19312833,Marcelo,1651,30/06/1998,18,0,0,0,0,189,0,2,1,1,1,1,1,4,3,3,2,1,5,3,13,13,13,3,8,2,1,4,5,7,1,12,8,6,4,11,4,6,6,4,12,6,7,3,5,6,12,8,6,10,11,14,8,20,6,9,8,8,8,8,6,20,10,12,9,10,2,18,7,S ,1,1,20,1,1,1,1,1,1,1,1,1,1,1,1
19312834,Wesley,1651,30/03/1999,17,0,0,0,0,170,0,1,1,1,2,3,3,1,3,3,1,4,4,4,6,6,13,4,3,12,1,2,10,1,6,10,5,6,2,6,3,11,10,4,10,9,7,1,6,10,12,13,5,1,8,9,13,20,5,3,7,7,4,7,7,13,11,8,12,12,7,5,6,AM C,1,1,1,20,1,1,1,1,1,1,15,1,1,1,1
19312836,Airton,1651,02/02/1999,17,0,0,0,0,176,0,3,2,2,3,1,1,2,3,1,3,3,3,3,5,5,12,3,1,7,1,1,11,1,5,12,7,5,5,3,4,12,7,5,13,1,7,2,5,10,12,12,4,8,5,8,12,20,7,5,7,7,7,7,7,9,13,9,12,12,7,10,7,AM C,1,1,1,20,1,1,1,1,1,1,15,1,1,1,1
19313166,Vinicius Guará,1651,05/08/1997,18,0,0,0,0,191,0,2,2,1,1,1,4,2,1,2,1,2,1,1,1,1,4,1,7,1,4,6,5,1,11,1,5,9,8,5,5,1,12,8,1,11,3,12,4,5,12,6,5,14,20,11,11,8,5,8,7,8,7,8,8,18,10,12,13,11,7,3,2,D C,1,1,1,1,1,1,20,1,1,1,1,1,1,1,1
19313167,Igor Heinen,1651,28/08/1997,18,0,0,0,0,176,0,1,2,3,1,2,1,3,3,1,3,4,5,6,8,6,9,5,8,6,6,8,10,4,9,10,4,8,6,8,5,9,15,8,5,2,5,9,8,11,11,11,9,7,6,7,11,20,10,6,7,7,8,5,11,8,12,14,11,9,1,7,6,DM C,1,1,1,1,1,1,15,1,1,20,12,1,1,1,1
19313168,Bruno,1651,26/11/1997,18,0,0,0,0,187,0,2,3,1,1,2,4,1,1,2,1,3,6,6,6,3,13,1,7,2,6,8,8,1,14,8,4,8,8,5,8,7,14,4,8,11,5,7,7,12,14,11,7,10,20,8,14,1,7,8,7,8,8,7,8,13,13,9,9,10,8,1,3,D L,1,1,1,1,1,1,7,20,1,1,1,1,1,15,1
19313169,Japa,1651,19/08/1997,18,0,0,0,0,185,0,1,1,2,3,3,1,2,1,2,1,2,5,6,9,10,10,5,10,8,1,4,8,5,4,10,5,11,13,10,8,8,9,5,7,12,10,7,8,13,11,11,9,13,7,9,11,20,10,11,7,8,7,6,8,14,11,11,12,12,1,2,1,S ,1,1,20,1,1,1,1,1,1,1,1,1,1,1,1
19313170,Busanello,1651,20/10/1998,17,0,0,0,0,177,0,2,2,1,3,1,1,1,1,2,2,1,4,5,6,1,10,1,6,6,6,5,8,1,10,7,8,7,8,6,10,8,6,8,5,2,3,6,8,9,14,14,8,7,20,13,13,9,13,7,7,8,8,8,8,8,13,10,11,11,8,10,4,D/WB L,1,1,1,1,1,1,10,20,1,1,1,1,1,17,1
19313171,Ronei,1651,22/02/1998,18,0,0,0,0,175,0,2,1,1,2,1,2,1,4,3,2,2,6,7,9,6,14,5,8,6,1,9,12,5,9,12,12,9,13,8,9,7,9,3,8,2,6,10,7,13,11,11,7,7,9,8,11,20,9,8,7,13,8,8,8,14,14,12,11,12,4,10,1,DM ,1,1,1,1,1,1,1,1,1,20,10,1,1,1,1
19313172,Luquinhas,1651,11/07/1998,17,0,0,0,0,190,0,1,3,3,3,3,2,1,2,2,2,2,5,1,3,5,10,5,5,7,1,7,12,1,13,7,4,5,4,7,3,7,13,8,8,9,6,5,4,9,12,10,6,14,20,8,12,9,6,8,8,8,8,8,13,19,11,10,11,12,9,4,6,DM ,1,1,8,12,1,1,1,1,1,20,14,1,1,1,1
19313397,Léo Ribeiro,1651,14/02/2000,16,0,0,0,0,185,0,3,3,2,1,3,3,1,1,2,1,2,3,7,3,1,9,1,6,3,5,6,7,3,9,7,5,5,7,6,7,6,12,7,2,6,5,6,6,6,13,11,6,12,8,9,10,20,8,9,5,7,7,7,7,17,12,14,10,11,4,7,7,D R,1,1,1,1,1,1,1,1,20,1,1,1,1,1,15
19313398,Gétulio,1651,10/06/1997,19,0,0,0,0,180,0,1,3,1,1,3,3,2,3,2,3,1,1,2,13,13,12,5,13,6,3,2,6,10,2,9,5,11,7,13,1,3,8,4,9,10,5,4,5,6,12,10,2,10,16,14,12,20,3,6,8,8,8,8,8,11,11,10,12,10,7,3,6,S ,1,1,20,1,1,1,1,1,1,1,1,1,1,1,1
19313592,Lucas Vinicius,1651,10/02/1996,20,0,0,0,0,178,0,3,2,3,1,1,2,3,2,3,3,1,5,7,8,6,9,6,8,8,1,8,8,3,8,8,12,12,12,10,10,8,15,6,9,7,7,13,13,12,12,11,9,5,20,10,12,9,6,8,9,13,9,8,9,20,10,11,12,11,10,6,6,DM ,1,1,1,1,1,1,1,1,1,20,12,1,1,1,1
19313593,Matheus,1651,01/10/1998,17,0,0,0,0,179,0,1,1,3,2,3,1,3,2,3,1,3,5,2,13,13,13,5,10,6,5,2,6,9,1,13,8,6,3,11,5,6,5,2,13,6,10,4,5,6,13,13,6,7,5,6,13,20,4,6,8,8,8,8,8,19,11,13,10,11,4,13,2,S ,1,1,20,1,1,1,1,1,1,1,1,1,1,1,1
19313594,Lucas Bessa,1651,17/11/1999,16,0,0,0,0,169,0,3,2,2,2,2,3,3,1,2,3,2,3,6,7,6,10,6,6,5,1,7,9,2,13,11,7,7,7,2,6,6,14,6,8,11,1,8,8,11,14,9,7,3,13,11,9,20,7,4,4,5,8,3,8,10,9,10,10,11,5,10,3,DM ,1,1,1,1,1,1,1,1,1,20,10,1,1,1,1
19313595,José Natanael,1651,11/03/2000,16,0,0,0,0,179,0,3,2,3,3,2,3,1,2,3,3,1,2,4,5,5,12,4,3,6,1,7,5,1,12,7,7,8,6,2,6,6,13,5,7,2,1,5,6,11,9,9,2,8,2,7,11,20,6,7,7,5,7,7,7,14,13,10,12,13,1,14,5,DM ,1,1,1,1,1,1,1,1,13,20,10,1,1,1,8
19313596,Marko Pollo,1651,27/02/1997,19,0,0,0,0,184,77,3,3,1,1,1,1,3,2,1,3,2,4,4,12,12,12,4,12,1,1,4,2,9,4,9,6,5,2,10,4,1,12,6,10,10,12,3,4,5,12,12,5,11,7,9,12,20,6,8,8,7,5,7,8,9,12,11,9,12,7,5,7,S ,1,1,20,1,1,1,1,1,1,1,1,1,1,1,1
19313597,Nilsinho,1651,16/09/1998,17,0,0,0,0,175,67,4,1,3,3,3,2,2,4,3,3,2,4,4,4,6,12,5,1,9,3,3,11,2,6,10,5,6,6,4,4,12,8,4,11,9,8,4,5,2,12,12,12,5,8,11,12,20,5,4,6,8,8,8,8,11,12,10,13,10,1,15,3,M/AM C,1,1,1,17,1,1,1,1,1,1,20,1,1,1,1
19313733,Madalena,1651,02/03/1998,18,0,0,0,0,176,0,1,1,3,1,2,1,2,2,1,3,2,1,4,13,13,13,5,10,6,1,3,6,6,1,8,6,4,7,6,6,5,8,7,8,7,11,2,5,6,13,11,6,7,8,12,13,20,10,5,8,8,8,8,6,16,9,13,10,13,6,3,3,S ,1,1,20,10,1,1,1,1,1,1,1,1,1,1,1
19313734,Vitor,1651,01/07/1999,17,0,0,0,0,185,0,11,8,6,1,11,9,8,8,8,8,6,1,2,2,2,1,6,1,1,3,1,1,1,3,1,8,5,13,1,8,3,11,5,1,1,3,10,4,3,8,10,4,10,16,11,11,20,1,6,8,4,8,3,7,11,10,10,14,11,7,10,2,GK ,20,1,1,1,1,1,1,1,1,1,1,1,1,1,1
19313735,Victor Malaquias,1651,12/02/1998,18,0,0,0,0,182,0,2,3,3,1,3,2,1,1,1,1,2,3,2,6,4,11,5,3,4,1,7,13,4,13,7,8,7,7,7,7,5,10,2,6,9,5,7,6,8,13,7,6,8,8,11,8,20,12,6,8,8,1,8,12,18,11,12,12,12,5,3,2,D/DM R,1,1,1,1,1,1,1,1,16,20,8,1,13,1,15
19313736,Lucas Kuhn,1651,14/04/1999,17,0,0,0,0,179,0,2,2,2,3,3,3,3,3,2,4,2,4,1,1,5,13,4,3,5,2,5,13,2,11,12,7,8,6,2,3,9,13,2,7,10,4,9,6,9,12,8,1,9,3,8,8,20,8,4,6,7,1,7,7,14,10,13,12,8,3,5,1,DM ,1,1,1,1,1,1,1,1,1,20,10,1,1,1,1
19313737,Felipe,1651,08/01/1999,17,0,0,0,0,185,0,3,2,1,4,2,1,2,4,3,3,1,5,3,5,5,7,2,13,4,4,13,7,2,13,5,6,8,5,4,3,2,9,1,4,4,5,10,5,7,13,10,7,12,20,9,9,6,10,8,8,8,8,8,13,14,11,11,11,10,1,1,6,D LC,1,1,1,1,1,1,20,16,1,1,1,1,1,11,1
19313976,Janderson,1651,26/02/1999,17,0,0,0,0,188,0,1,2,3,3,1,3,1,3,2,1,3,4,3,8,7,12,4,10,5,1,3,5,2,3,12,5,11,4,10,1,4,4,3,13,10,9,5,4,6,12,12,5,11,7,10,12,20,10,6,8,7,8,8,8,14,13,9,13,10,9,12,5,S ,1,1,20,7,1,1,1,1,1,1,1,1,1,1,1
19315474,Julian,1651,08/03/1999,17,0,0,0,0,164,0,1,2,1,2,3,3,1,4,2,4,3,7,7,9,8,14,5,7,9,3,6,12,5,8,13,9,7,7,5,8,13,14,6,12,10,6,4,8,12,14,12,5,1,12,10,14,20,8,6,5,7,9,8,9,14,10,12,9,14,7,18,2,AM C,1,1,1,20,1,1,1,1,1,1,15,1,1,1,1
19315482,Joãozinho,1651,02/02/1994,22,0,0,0,0,176,68,3,2,2,1,4,1,2,2,3,3,1,11,14,14,14,13,9,10,5,4,8,10,5,5,14,10,6,4,11,9,9,12,12,13,13,8,8,9,10,14,13,12,6,20,14,13,11,13,7,10,8,10,8,10,11,13,10,9,11,12,10,8,AM/S L,1,1,18,1,20,1,1,1,1,1,1,15,1,1,1
19315483,Geovani,1651,06/05/1992,24,0,0,0,0,170,63,3,3,2,3,1,2,3,1,2,3,3,6,10,14,5,10,8,8,8,5,8,10,8,9,14,3,12,6,8,6,8,14,2,13,4,10,9,9,9,14,13,5,3,20,10,14,10,7,9,10,10,10,5,10,14,11,13,11,10,7,11,2,AM LC,1,1,12,20,20,1,1,1,1,1,15,15,1,1,1
19316133,Dida,1651,14/11/1997,18,0,0,0,0,194,0,14,13,10,1,13,12,11,13,6,10,13,4,2,2,1,4,8,1,2,2,3,1,4,3,6,5,10,15,9,7,8,14,11,2,1,2,13,9,8,10,14,6,12,13,14,9,20,6,13,10,4,10,8,10,12,9,13,11,10,9,5,2,GK ,20,1,1,1,1,1,1,1,1,1,1,1,1,1,1
19316672,Pablo Pardal,1651,21/04/1999,17,0,0,0,0,170,62,3,1,4,1,1,3,2,1,1,3,2,6,8,13,8,13,6,6,8,1,5,12,1,5,13,4,7,8,4,6,10,13,15,13,10,8,4,7,11,13,11,7,3,10,8,12,20,11,5,9,9,9,9,9,11,9,9,10,9,7,19,3,M/AM RC,1,1,1,20,1,18,1,1,1,1,16,1,15,1,1
19317126,Thonny Anderson,1651,27/12/1997,18,0,0,0,0,186,67,1,3,2,2,2,2,2,3,1,3,1,7,9,11,12,12,9,10,10,7,8,11,10,8,12,9,11,10,12,11,10,10,20,12,8,12,7,12,12,12,13,12,12,20,11,12,12,12,11,10,8,10,7,20,10,10,12,12,13,1,7,8,AM/S L,1,1,20,14,19,1,10,12,1,12,13,14,1,13,1
19317139,Guilherme Romão,1651,01/10/1997,18,0,0,0,0,179,0,3,1,2,2,3,3,3,3,3,2,2,7,8,6,1,14,3,8,4,7,9,9,7,12,9,9,10,9,8,10,8,13,9,9,2,7,8,4,8,14,14,8,6,20,16,14,10,7,8,9,9,9,9,9,14,10,12,10,10,3,11,1,D/WB L,1,1,1,1,1,1,1,20,1,1,1,1,1,18,1
19317341,Hugo Borges,1651,01/01/1998,18,0,0,0,0,186,0,1,4,3,2,2,3,3,2,3,2,2,6,8,10,13,13,7,13,8,3,6,8,6,1,13,7,13,9,6,7,4,13,10,13,10,13,6,7,8,13,11,8,7,8,11,12,20,12,10,10,10,4,6,10,7,12,13,10,11,8,12,7,S ,1,1,20,1,1,1,1,1,1,1,1,1,1,1,1
19317859,Biro Biro,1651,04/07/1992,23,0,0,0,0,173,0,2,2,1,3,3,1,3,3,3,3,1,13,15,8,10,10,8,11,8,9,9,8,9,5,7,15,6,9,13,8,6,7,2,9,6,14,7,8,12,14,12,8,8,6,11,10,20,11,7,8,6,8,4,8,11,9,11,6,7,6,7,4,AM R,1,1,15,1,1,20,1,1,1,1,1,1,7,1,1
19317910,Yuri,1651,12/06/1998,18,0,0,0,0,185,0,2,2,3,2,3,1,1,3,3,1,3,7,5,14,14,14,5,14,6,6,2,8,6,4,11,9,6,6,6,5,8,6,17,10,10,12,5,7,8,14,11,3,8,14,15,13,20,8,8,9,9,2,9,9,15,10,9,9,12,9,12,6,S ,1,1,20,1,1,1,1,1,1,1,1,1,1,1,1
19317939,Bala,1651,01/12/1997,18,0,0,0,0,165,63,1,1,3,4,2,3,3,2,3,4,2,7,6,13,11,13,7,13,8,1,5,8,2,2,12,6,11,8,9,7,8,10,13,12,5,13,7,11,12,12,12,8,4,15,14,11,20,8,8,9,8,11,4,10,10,9,12,9,12,1,1,3,S ,1,1,20,1,1,1,1,1,1,1,1,1,1,1,1
19317983,Marcinho,1651,16/05/1995,21,0,0,0,0,162,59,3,4,1,1,3,1,3,3,3,2,1,9,8,12,13,15,9,3,7,6,7,15,6,8,15,10,11,6,7,10,9,13,8,13,10,14,6,10,10,15,15,10,1,1,11,15,20,9,7,10,4,10,9,10,11,11,11,9,11,7,16,3,AM C,1,1,1,20,1,1,1,1,1,1,10,1,1,1,1
19317989,Marcos,1651,12/04/1997,19,0,0,0,0,189,0,1,2,3,3,1,2,3,3,3,1,4,2,2,1,4,8,2,10,6,6,14,8,5,14,5,9,10,9,7,9,3,14,1,2,13,5,10,7,8,12,13,8,11,2,13,14,20,8,12,9,4,4,6,9,17,12,14,12,10,8,11,4,D C,1,1,1,1,1,1,20,1,1,1,1,1,1,1,1
19318420,Luan,1651,10/06/1997,19,0,0,0,0,189,0,6,12,5,1,14,12,11,14,9,9,14,1,1,3,1,5,4,1,2,3,3,2,2,2,1,6,5,13,5,5,7,14,4,2,13,1,7,8,6,11,14,8,10,9,10,13,20,2,11,9,9,4,9,9,16,12,10,12,7,6,2,3,GK ,20,1,1,1,1,1,1,1,1,1,1,1,1,1,1
19318421,Lucas Amorim,1651,12/05/1997,19,0,0,0,0,178,0,2,1,3,1,1,2,1,3,1,1,4,6,2,12,13,13,6,13,4,1,4,7,7,4,13,9,12,7,13,5,4,13,1,13,6,13,5,6,7,13,13,7,7,2,9,13,20,7,6,8,3,9,9,9,13,13,9,13,12,10,13,4,S ,1,1,20,1,1,1,1,1,1,1,1,1,1,1,1
19319066,Ramon,1651,19/05/1999,17,0,0,0,0,189,0,2,3,2,1,3,3,1,3,2,2,3,2,4,6,4,12,1,7,1,6,5,8,5,11,7,9,7,9,7,4,7,13,9,5,11,3,8,7,7,13,13,7,12,20,8,13,9,9,11,9,7,9,9,9,18,14,13,11,9,10,15,2,D L,1,1,1,1,1,1,1,20,1,1,1,1,1,15,1
19319190,Carlão,1651,31/12/1985,30,0,0,0,0,190,87,14,9,9,1,13,12,12,14,10,6,8,4,1,3,2,2,7,1,3,1,1,1,1,1,4,10,11,9,8,12,8,12,6,2,10,3,14,9,8,12,11,8,16,10,11,11,20,8,12,10,4,10,10,9,8,10,11,9,12,7,7,5,GK ,20,1,1,1,1,1,1,1,1,1,1,1,1,1,1
19319191,Tiago Souza,1651,22/02/1992,24,0,0,0,0,184,74,1,2,2,2,3,2,2,1,1,1,3,8,5,14,13,14,7,14,9,1,7,9,7,6,13,3,12,5,8,8,9,9,2,13,12,14,8,8,8,14,10,9,7,9,14,12,20,14,10,5,8,4,10,10,12,9,10,10,10,8,6,6,S ,1,1,20,1,1,1,1,1,1,1,1,1,1,1,1
19319192,Diego Góis,1651,29/10/1992,23,0,0,0,0,186,80,2,1,1,2,1,3,1,2,1,3,2,7,7,4,8,14,7,7,14,7,9,14,3,9,14,9,8,3,10,8,9,14,9,13,10,13,9,8,13,13,10,5,13,11,7,11,20,10,10,9,9,4,8,9,15,9,9,13,12,4,7,5,M C,1,1,1,15,1,1,1,1,1,1,20,1,1,1,1
19319193,Marcelo,1651,10/01/1995,21,0,0,0,0,183,76,1,2,3,3,2,3,3,3,2,3,1,8,6,7,1,6,6,12,3,3,14,7,1,14,8,9,14,10,9,7,2,14,3,1,12,8,11,8,9,12,12,9,9,4,11,13,20,6,10,10,7,8,6,10,11,11,12,13,13,10,18,2,D C,1,1,1,1,1,1,20,1,1,1,1,1,1,1,1
19319194,Naldo,1651,29/12/1998,17,0,0,0,0,183,0,11,9,8,1,13,9,9,13,8,6,12,3,3,3,1,5,5,1,1,3,2,1,2,1,1,4,3,14,4,4,5,6,6,3,5,2,12,6,4,7,15,6,9,17,14,3,20,1,8,8,8,8,8,8,19,9,9,10,13,4,12,4,GK ,20,1,1,1,1,1,1,1,1,1,1,1,1,1,1
19319288,Felix,1651,07/07/1996,19,0,0,0,0,181,70,1,3,1,1,2,3,1,3,1,2,4,8,7,8,9,12,5,10,7,9,7,11,8,12,10,9,9,6,10,15,9,9,3,5,5,7,9,11,11,12,13,9,10,20,11,13,2,12,10,9,9,9,9,9,8,10,11,12,11,5,10,2,D/WB L,1,1,1,1,1,1,1,20,1,1,1,1,1,17,1
19319304,Anderson Tasca,1651,27/02/1994,22,0,0,0,0,175,75,4,2,3,2,2,1,2,2,1,3,3,7,7,6,4,12,5,8,7,7,9,7,6,9,9,7,8,9,9,9,7,14,2,9,1,7,9,9,9,14,14,9,7,20,9,12,10,10,9,9,9,9,9,9,20,11,14,10,13,1,4,8,D/WB L,1,1,1,1,1,1,1,20,1,1,1,1,1,17,1
19319305,Lucas Tocantins,1651,25/07/1994,21,0,0,0,0,180,72,3,2,2,2,2,2,3,2,1,3,2,7,4,11,10,14,7,14,8,1,6,8,7,1,12,7,14,8,10,7,8,11,4,11,10,14,7,7,8,14,14,8,9,3,15,14,20,7,8,9,9,9,5,9,12,12,10,11,14,6,20,8,S ,1,1,20,1,1,1,1,1,1,1,1,1,1,1,1
19319320,Rodrigão,1651,11/09/1995,20,0,0,0,0,191,94,2,3,2,3,2,3,1,2,1,2,1,6,3,8,5,11,4,12,9,4,10,11,4,11,8,10,9,11,11,10,8,16,2,3,10,9,12,10,11,9,10,11,14,5,12,10,20,8,12,10,10,7,10,10,11,11,9,13,9,5,3,1,D C,1,1,1,1,1,1,20,1,1,1,1,1,1,1,1
19319321,Lucas Índio,1651,12/04/1997,19,0,0,0,0,185,0,1,1,2,3,2,2,2,1,2,1,2,6,7,13,9,11,6,8,6,2,4,8,5,1,8,9,9,8,6,5,6,13,12,6,10,13,9,6,8,10,9,7,13,8,14,10,20,12,9,9,5,9,9,9,12,11,11,12,11,6,15,5,S ,1,1,20,10,1,1,1,1,1,1,1,1,1,1,1
19319322,João Moura,1651,19/02/1998,18,0,0,0,0,189,0,1,2,3,4,2,3,1,2,2,2,1,3,1,1,5,2,6,13,5,2,13,5,4,13,6,7,11,9,6,10,3,13,8,1,7,5,4,6,7,10,13,7,13,9,16,13,20,9,10,9,1,9,9,9,15,13,12,11,11,10,11,3,D C,1,1,1,1,1,1,20,1,1,1,1,1,1,1,1
19319366,Thiago Souza,1651,18/03/1997,19,0,0,0,0,177,58,1,1,1,2,2,2,3,1,3,3,3,10,8,9,9,9,10,10,11,6,10,10,8,11,11,10,11,11,9,12,9,11,10,8,8,7,11,13,11,12,12,10,9,7,12,11,20,13,11,10,7,10,8,10,11,10,9,12,12,10,10,5,DM/M C,1,1,1,1,1,1,1,1,1,20,19,1,1,1,1
19319367,Marcio,1651,18/08/1998,17,0,0,0,0,175,0,3,3,3,3,3,2,2,4,1,2,1,8,9,10,10,11,9,8,10,7,10,12,10,11,11,10,12,10,11,10,11,10,10,9,9,10,11,12,13,11,13,9,8,8,11,12,20,12,8,9,9,8,8,12,14,13,9,10,12,5,5,3,DM/M C,1,1,1,14,1,1,1,1,1,19,20,1,1,1,1
19319368,Vander,1651,13/09/1998,17,0,0,0,0,176,69,1,1,3,2,1,3,2,2,1,1,3,7,8,10,10,10,8,6,7,7,7,9,8,8,10,10,10,10,9,9,10,10,11,12,6,11,9,10,11,10,11,12,6,20,13,11,10,12,6,10,8,10,6,12,13,12,9,10,10,5,11,3,M/AM C,1,1,1,20,1,1,1,1,1,14,19,1,1,1,1
19319369,João Luiz,1651,16/02/1999,17,0,0,0,0,172,0,2,1,1,3,1,1,3,1,4,2,3,5,8,11,10,10,6,7,8,6,5,9,9,6,10,10,11,11,11,11,9,9,9,12,7,11,6,9,10,11,12,9,7,8,11,11,20,11,8,9,7,8,7,11,16,12,10,8,13,1,10,5,AM/S RL,1,1,20,1,19,18,1,1,1,1,1,1,1,1,1
19319370,Gustavo Rissi,1651,04/02/1998,18,0,0,0,0,182,72,1,3,2,3,3,1,1,3,2,1,3,6,5,8,2,8,9,11,6,7,10,10,6,11,4,9,10,12,13,11,8,10,10,1,7,9,11,9,10,10,11,11,11,7,9,11,20,12,9,9,9,9,8,9,8,12,11,9,12,5,3,5,D C,1,1,1,1,1,1,20,1,1,1,1,1,1,1,1
19319371,Natan,1651,13/01/1999,17,0,0,0,0,174,0,2,1,2,2,2,1,2,2,1,3,2,6,4,5,8,13,6,6,7,3,9,9,6,11,10,5,8,8,9,10,8,11,2,9,6,6,9,10,11,9,10,9,7,8,10,10,20,10,9,7,8,8,10,9,11,10,12,9,12,5,13,7,DM/M C,1,1,1,1,1,1,1,1,1,20,19,1,1,1,1
19319372,Lucas Soares,1651,04/05/1998,18,0,0,0,0,174,64,1,2,3,2,3,2,1,2,2,1,2,7,7,10,14,10,7,10,7,5,5,8,4,2,12,9,6,7,11,6,8,10,9,9,11,9,3,7,8,14,12,8,8,3,7,14,20,13,7,9,9,9,9,9,14,12,9,12,12,12,1,8,S ,1,1,20,1,1,1,1,1,1,1,1,1,1,1,1
19319373,Marco Antônio,1651,15/07/2000,15,0,0,0,0,182,75,2,1,1,1,2,1,1,2,2,3,1,6,6,8,8,13,6,6,9,3,5,11,9,7,10,6,6,5,5,7,11,13,9,9,11,4,5,8,12,10,7,8,10,14,12,9,20,12,8,8,7,9,7,7,7,11,14,12,10,3,17,5,M/AM C,1,1,1,20,1,1,1,1,1,1,19,1,1,1,1
19319448,Robinho,1651,28/12/1993,22,0,0,0,0,173,71,2,3,3,3,3,2,1,3,1,1,1,11,9,14,7,11,10,5,8,2,5,12,7,6,13,13,11,8,12,10,12,7,13,14,4,12,8,9,11,12,14,13,6,20,11,13,11,10,6,12,4,9,9,11,9,12,9,10,10,12,14,3,AM LC,1,1,1,20,15,12,1,1,1,1,1,1,1,1,1
19319449,Zé Victor,1651,02/07/1998,18,0,0,0,0,194,78,1,1,3,2,1,1,4,3,2,4,1,1,3,3,1,5,6,6,4,1,10,7,1,13,1,9,10,9,5,5,3,12,5,4,6,4,11,6,3,13,10,3,15,5,10,12,20,4,12,8,9,2,6,9,18,12,11,9,10,10,16,8,D C,1,1,1,1,1,1,20,1,1,1,1,1,1,1,1
19319450,Felipe,1651,04/05/1999,17,0,0,0,0,177,70,2,3,1,2,3,2,3,2,4,2,1,5,11,11,4,9,3,8,4,5,9,10,4,8,10,13,9,8,11,10,6,10,12,9,4,8,10,11,11,14,11,9,9,20,12,13,8,9,8,12,6,10,4,11,10,13,10,10,11,9,13,3,D/WB L,1,1,1,1,1,1,1,20,1,1,1,13,1,17,1
19319451,Welton,1651,22/11/1998,17,0,0,0,0,174,71,4,3,3,3,3,2,1,1,2,1,2,3,4,7,5,9,3,8,4,2,9,12,4,11,11,12,9,11,8,9,9,10,10,4,10,7,10,12,11,12,8,11,7,15,11,11,20,9,11,10,8,8,3,7,9,11,7,10,8,11,9,9,DM ,1,1,1,1,1,1,1,1,1,20,1,1,1,1,1
19319452,Romenigue,1651,05/03/1997,19,0,0,0,0,171,68,3,2,3,2,3,3,3,2,3,1,1,8,7,11,6,10,10,4,5,3,4,11,7,4,11,8,11,9,12,10,10,9,13,8,5,9,6,11,8,12,12,12,5,11,10,12,20,9,7,12,4,11,4,9,9,13,10,10,11,12,11,4,AM C,1,1,1,20,1,1,1,1,1,1,13,1,1,1,1
19319453,Casagrande,1651,12/05/1999,17,0,0,0,0,186,74,1,2,1,1,3,3,3,3,3,1,3,1,2,3,1,6,1,11,5,1,12,6,5,13,1,8,11,8,3,7,2,13,8,5,11,3,13,5,6,10,3,4,12,7,10,10,20,7,12,8,8,8,3,8,18,10,12,12,10,1,12,4,D C,1,1,1,1,1,1,20,1,1,1,1,1,1,1,1
19319454,Anderson,1651,16/07/1998,17,0,0,0,0,169,64,1,3,2,2,3,4,2,2,2,1,2,10,13,13,8,13,5,3,6,5,5,6,1,3,13,8,3,5,4,5,6,13,2,13,10,4,5,6,7,11,10,12,4,9,9,11,20,6,3,6,8,4,5,8,18,11,11,9,14,10,6,8,AM L,1,1,13,1,20,1,1,1,1,1,1,1,1,1,1
19319455,Léo,1651,08/01/1998,18,0,0,0,0,180,81,2,1,2,1,2,2,1,2,3,1,3,5,4,7,13,13,5,13,5,1,5,6,11,1,13,8,7,2,13,3,6,11,4,13,2,7,4,5,6,13,13,6,9,10,14,13,20,6,6,8,8,8,8,8,11,10,12,10,13,12,15,2,S ,1,1,20,1,1,1,1,1,1,1,1,1,1,1,1
19319456,Quaresma,1651,22/08/1996,19,0,0,0,0,181,77,1,1,4,2,1,3,3,1,3,3,3,7,8,11,8,14,7,7,5,3,7,14,2,9,9,5,8,8,7,8,9,12,9,9,1,9,8,8,9,14,11,8,8,20,13,13,10,6,9,8,9,1,7,14,18,11,12,10,13,6,8,5,D/AM LC,1,1,1,20,1,1,1,17,1,1,1,1,1,13,1
19319488,Maurílio,1651,03/09/1997,18,0,0,0,0,174,0,3,3,3,1,3,3,1,2,3,1,2,7,7,4,8,13,7,7,14,2,7,14,4,13,14,4,11,5,6,7,12,12,2,6,6,7,12,8,9,14,12,8,4,1,14,13,20,5,8,9,6,9,9,9,7,11,10,10,9,14,9,7,DM ,1,1,1,1,1,1,1,1,1,20,10,1,1,1,1
19319490,Juninho,1651,06/04/1998,18,0,0,0,0,174,0,1,2,3,2,2,1,3,2,3,1,2,6,7,10,13,13,6,13,7,1,5,4,6,5,11,9,8,5,13,2,7,13,3,11,4,13,6,8,7,12,12,7,4,4,12,12,20,7,5,9,9,6,5,8,15,12,14,13,11,4,7,7,S ,1,1,20,10,10,10,1,1,1,1,1,1,1,1,1
19319554,João Paulo,1651,07/09/1997,18,0,0,0,0,176,0,3,3,1,2,2,3,2,1,3,3,1,5,5,7,7,13,3,5,7,1,5,11,2,6,11,8,3,5,5,5,9,8,3,11,5,4,4,7,9,13,12,6,3,9,12,11,20,10,3,8,8,8,8,8,11,13,11,9,10,1,15,6,AM C,1,1,1,20,1,1,1,1,1,1,15,1,1,1,1
19319656,Jean Martim,1651,14/04/1999,17,0,0,0,0,185,0,3,2,2,2,2,1,2,3,1,1,2,3,5,7,7,10,5,2,12,5,4,9,2,5,8,8,7,6,4,6,13,11,2,8,2,3,2,7,9,13,12,6,12,9,9,12,20,5,6,2,8,8,6,8,14,13,10,11,12,9,5,6,AM C,3,1,5,20,1,1,1,1,1,9,15,1,1,1,1
19319657,Caio,1651,20/10/1997,18,0,0,0,0,183,0,3,2,3,2,2,1,1,3,1,2,3,3,2,13,13,13,5,11,5,1,4,6,9,1,8,8,9,3,12,3,4,10,5,8,10,6,1,5,6,12,9,6,7,1,12,9,20,8,9,8,8,4,8,8,14,9,10,14,13,7,10,2,S ,1,1,20,1,1,1,1,1,1,1,1,1,1,1,1
19319658,José Leonardo,1651,05/03/1999,17,0,0,0,0,170,56,1,2,1,3,2,3,1,3,3,3,3,5,5,7,7,11,4,5,5,1,4,13,1,7,13,5,7,1,5,1,8,6,8,13,2,7,7,7,11,13,10,12,4,8,12,12,20,7,1,7,8,8,5,8,9,11,10,12,12,6,9,4,AM C,1,1,1,20,1,1,1,1,1,1,15,1,1,1,1
19319659,Pedro Wagner,1651,18/07/1998,17,0,0,0,0,179,0,3,2,2,2,3,2,2,3,2,4,3,3,5,7,7,12,5,3,9,3,1,10,3,4,7,8,5,1,5,6,8,12,8,8,6,3,3,6,8,13,10,4,3,8,9,12,20,5,5,8,6,8,8,8,12,12,11,10,11,3,13,2,AM C,1,1,1,20,1,1,1,1,1,1,15,1,1,1,1
19319720,Lucas Halter,1651,02/05/2000,16,0,0,0,0,188,0,3,1,1,2,2,2,3,1,3,3,3,3,3,5,5,9,6,14,2,7,13,9,3,14,8,6,11,10,9,12,6,11,14,6,2,1,13,8,9,14,10,9,11,9,14,13,20,7,11,7,10,10,7,10,13,14,11,10,10,8,15,3,D C,1,1,1,1,1,1,20,1,1,1,1,1,1,1,1
19319755,Carlos Júnior,1651,09/07/1988,27,0,0,0,0,169,69,1,4,2,3,2,3,1,3,3,1,1,6,2,13,13,13,6,13,7,5,5,5,7,1,10,9,11,5,7,6,4,9,9,10,7,13,6,6,8,13,13,7,6,10,14,13,20,12,6,9,9,9,4,9,8,11,9,13,10,1,7,6,S ,1,1,20,1,1,1,1,1,1,1,1,1,1,1,1
19320102,Esaú,1651,11/01/1999,17,0,0,0,0,194,0,9,11,9,1,14,10,8,12,9,9,8,5,1,3,3,7,9,1,1,2,3,3,2,3,2,9,5,12,7,9,7,14,3,1,1,3,8,8,7,13,9,4,14,8,11,13,20,5,13,8,7,9,9,7,11,12,9,11,12,12,17,1,GK ,20,1,1,1,1,1,1,1,1,1,1,1,1,1,1
19320103,Maranhão,1651,29/10/1998,17,0,0,0,0,176,0,2,2,3,4,2,1,2,2,1,1,2,9,9,11,6,14,4,8,8,9,10,11,6,15,11,9,9,10,9,8,6,12,9,1,3,8,10,10,10,13,13,10,7,10,15,13,20,11,9,9,4,7,9,9,7,10,9,11,10,4,18,4,D/WB R,1,1,1,1,1,1,1,1,20,1,1,1,1,1,18
19320104,Samuel,1651,14/02/1997,19,0,0,0,0,188,0,4,2,2,1,2,1,1,1,1,3,2,4,2,4,1,8,2,13,1,4,11,8,2,12,5,8,11,9,8,8,2,8,9,5,9,6,13,7,5,12,11,7,7,20,14,11,6,13,12,9,8,9,9,9,19,11,14,10,12,9,10,8,D C,1,1,1,1,1,1,20,1,1,1,1,1,1,1,1
19320105,Arlan,1651,02/01/1998,18,0,0,0,0,191,0,3,3,3,2,1,2,2,4,1,1,1,1,5,1,3,6,2,13,5,1,7,6,4,13,5,8,9,8,6,5,5,12,8,1,5,1,13,5,6,13,7,6,15,8,3,8,20,9,8,4,8,8,8,7,8,12,12,11,11,13,11,6,D C,1,1,1,1,1,1,20,1,1,1,1,1,1,1,1
19320106,William,1651,20/08/1998,17,0,0,0,0,190,78,1,4,1,2,1,3,2,1,2,1,1,7,4,5,7,10,8,13,8,1,13,12,1,13,8,8,13,9,9,6,8,11,5,2,3,8,12,9,13,14,12,9,15,5,13,12,20,8,12,10,10,10,6,10,10,10,10,10,13,3,12,3,DM C,1,1,1,1,1,1,15,1,1,20,1,1,1,1,1
19320107,Filipe Castro,1651,26/01/1999,17,0,0,0,0,171,0,3,4,3,2,3,3,3,3,2,3,1,5,6,10,7,11,5,5,7,1,3,13,3,7,13,8,9,7,3,3,13,11,5,13,6,3,3,7,8,13,13,7,6,8,10,13,20,6,4,7,6,6,6,7,12,10,11,8,12,3,12,2,AM C,1,1,1,20,12,12,1,1,1,1,13,1,1,1,1
19320108,Clemer,1651,19/06/1997,19,0,0,0,0,183,0,3,1,3,2,2,1,2,1,4,2,2,7,9,12,11,10,5,12,6,3,4,4,8,1,7,5,5,7,9,4,6,11,1,8,12,7,4,5,7,13,12,5,9,20,9,11,8,10,6,8,7,8,6,8,19,12,13,9,12,12,15,1,AM/S R,1,1,20,1,14,18,1,1,1,1,1,1,1,1,1
19320109,Brunão,1651,24/06/1998,18,0,0,0,0,188,0,3,2,2,3,1,1,1,1,1,3,4,4,3,7,9,12,4,12,5,1,2,5,4,1,7,8,9,3,12,1,1,11,3,8,8,10,4,4,5,11,10,8,10,8,13,10,20,10,10,8,8,8,8,8,20,12,11,9,12,1,12,7,S ,1,1,20,1,1,1,1,1,1,1,1,1,1,1,1
19320111,Luíz,1651,17/02/1998,18,0,0,0,0,197,0,7,7,5,1,13,13,6,13,7,8,10,2,2,3,2,5,4,1,1,1,2,1,1,1,1,7,7,13,2,5,5,13,5,3,11,1,6,6,5,12,12,3,14,12,15,10,20,3,12,8,3,8,8,8,11,10,12,12,11,1,8,5,GK ,20,1,1,1,1,1,1,1,1,1,1,1,1,1,1
19320112,Hygor,1651,02/09/1997,18,0,0,0,0,185,66,3,3,4,3,2,2,3,1,1,1,3,4,2,5,3,5,6,8,7,5,9,12,1,13,8,8,9,7,5,4,8,14,4,8,9,6,9,7,8,11,13,9,13,8,11,13,20,4,8,8,6,3,8,8,18,13,10,12,10,9,16,1,D/DM C,1,1,1,1,1,1,18,1,12,20,1,1,1,1,13
19320113,Ramon,1651,11/03/2000,16,0,0,0,0,181,0,2,1,2,2,2,1,3,2,1,3,3,1,1,1,2,5,1,11,1,1,12,4,1,10,3,8,12,7,1,4,1,12,8,4,2,1,12,4,5,12,11,5,6,7,7,8,20,3,6,8,8,8,6,8,17,9,11,13,14,4,14,6,D C,1,1,1,1,1,1,20,1,1,1,1,1,1,1,1
19320114,Gleydson,1651,07/03/1998,18,0,0,0,0,176,0,2,3,2,1,2,1,1,4,1,1,1,5,7,7,3,9,5,5,7,1,3,10,3,7,13,8,5,7,5,7,10,13,8,13,7,6,4,7,12,13,13,7,8,8,8,13,20,9,6,6,2,8,8,8,11,12,12,11,8,5,10,3,AM C,1,1,1,20,12,12,1,1,1,1,1,1,1,1,1
19320119,Lucas Arcanjo,1651,08/08/1998,17,0,0,0,0,193,0,11,11,8,4,12,12,7,12,9,9,12,3,2,3,1,4,5,1,2,1,2,1,3,3,1,3,3,13,4,8,5,12,18,2,5,1,8,6,5,10,11,6,11,8,13,9,20,2,9,9,9,6,6,9,17,11,10,10,12,2,9,4,GK ,20,1,1,1,1,1,1,1,1,1,1,1,1,1,1
19320120,Flávio,1651,12/07/1998,17,0,0,0,0,175,0,2,3,2,3,1,2,2,1,1,2,2,6,3,14,14,14,6,14,7,5,3,6,8,1,11,7,10,7,13,6,7,12,3,10,10,10,6,6,7,12,9,7,4,2,11,10,20,7,8,8,8,8,8,5,7,10,8,9,10,14,12,7,S ,1,1,20,1,1,1,1,1,1,1,1,1,1,1,1
19320121,Gabriel,1651,17/01/1999,17,0,0,0,0,180,0,3,2,1,3,2,3,2,3,3,1,2,6,1,1,3,8,6,14,6,1,14,7,5,14,7,5,13,9,7,11,3,14,1,3,4,5,14,7,8,6,11,8,6,1,8,8,20,13,8,6,4,9,9,9,12,9,10,13,12,7,18,7,D C,1,1,1,1,1,1,20,1,1,1,1,1,1,1,1
19320122,Farinha,1651,28/08/1998,17,0,0,0,0,163,0,3,3,4,3,3,2,1,1,1,1,2,7,9,10,8,10,8,10,10,7,11,11,9,10,11,9,10,9,8,7,9,8,2,9,8,10,10,11,11,12,11,8,4,7,13,12,20,11,8,9,4,1,9,14,7,10,11,10,8,1,19,3,DM/M C,1,1,1,13,1,1,1,1,1,18,20,1,1,1,1
19320123,Wellisson,1651,01/03/1999,17,0,0,0,0,175,0,1,1,1,1,2,4,3,2,1,4,2,6,11,11,5,9,1,8,4,7,9,9,5,14,8,8,8,9,8,6,8,7,6,8,4,6,10,8,8,13,13,8,9,6,11,13,20,7,7,7,8,5,8,8,8,13,12,9,14,7,15,2,D/WB R,1,1,1,1,1,1,1,1,20,1,1,1,1,1,18
19320254,Caio Santos,1651,13/08/1997,18,0,0,0,0,192,0,2,1,3,1,1,3,3,1,3,1,1,5,2,1,3,8,3,13,5,1,11,6,1,13,6,9,10,9,8,4,5,13,9,1,10,2,13,6,8,13,11,8,12,20,7,11,6,7,10,9,7,9,9,9,15,11,12,12,7,1,16,6,D C,1,1,1,1,1,1,20,12,1,12,10,1,1,10,1
19320255,Gabriel,1651,16/07/1997,18,0,0,0,0,193,0,2,1,3,2,1,3,2,4,2,3,3,1,1,1,1,6,1,13,4,1,13,6,1,13,2,8,6,8,6,5,1,13,7,3,5,3,13,5,5,13,10,6,14,1,15,11,20,10,10,7,8,8,8,8,15,9,11,8,12,12,9,8,D C,1,1,1,1,1,1,20,1,1,1,1,1,1,1,1
19320256,Matheus Silva,1651,02/05/2000,16,0,0,0,0,183,0,1,1,2,3,2,2,4,2,1,3,1,1,4,6,7,12,4,3,7,1,2,11,3,6,11,5,6,6,11,3,7,13,8,12,11,3,2,7,10,13,12,2,4,15,4,11,20,7,9,2,8,8,8,6,12,12,11,11,10,11,18,7,M/AM C,1,1,1,20,1,1,1,1,1,1,16,1,1,1,1
19320257,Renan Oliveira,1651,08/05/1997,19,0,0,0,0,183,78,2,2,2,3,2,4,4,2,3,1,3,7,5,11,14,14,7,14,6,3,6,8,4,1,14,9,10,4,7,8,6,7,1,13,10,13,5,7,3,14,14,6,8,20,14,14,5,5,10,9,6,7,9,9,16,9,13,12,11,1,3,2,S ,1,1,20,1,1,1,1,1,1,1,1,1,1,1,1
19320258,Samuel,1651,23/12/1999,16,0,0,0,0,172,0,3,3,2,2,2,3,1,4,3,1,2,5,5,7,6,13,5,5,4,5,2,8,3,5,12,8,3,7,4,6,11,9,4,12,11,7,6,7,11,13,11,6,4,13,12,10,20,13,3,5,8,8,8,4,11,10,12,10,13,1,1,6,M/AM C,1,1,1,20,1,1,1,1,1,1,16,1,1,1,1
19320259,Wesley Santos,1651,07/01/1997,19,0,0,0,0,178,0,3,2,2,2,3,3,1,3,3,3,3,3,2,13,13,13,6,13,7,1,6,7,7,1,12,9,9,8,9,4,4,10,4,12,2,7,4,4,7,13,13,7,5,20,7,13,8,9,6,9,9,6,8,9,10,12,10,12,11,10,1,8,S ,1,1,20,1,1,1,1,1,1,1,1,1,1,1,1
19320538,Palhinha,1651,15/09/1988,27,0,0,0,0,178,70,1,2,2,3,3,1,1,2,1,3,3,14,13,12,12,8,14,7,13,6,7,13,13,7,12,7,9,10,10,9,13,11,1,8,12,11,11,9,9,11,12,11,8,10,12,11,20,12,7,10,7,11,8,8,8,12,10,11,10,2,15,2,M/AM C,1,1,1,20,1,1,1,1,1,1,18,1,1,1,1
19320540,Rhuann,1651,07/04/1995,21,0,0,0,0,183,77,1,1,2,2,2,1,3,3,3,3,4,6,3,13,13,13,5,12,7,6,5,7,3,5,13,7,7,8,8,7,5,6,9,13,13,5,5,6,7,13,13,7,12,10,11,13,20,7,12,9,9,8,9,9,20,9,10,12,11,8,12,2,S ,1,1,20,1,1,1,1,1,1,1,1,1,1,1,1
19320543,Jadson,1651,22/03/1993,23,0,0,0,0,189,79,1,1,2,2,1,1,2,3,3,3,1,6,3,1,1,6,5,14,5,4,14,8,2,14,7,9,10,9,8,8,6,14,7,2,3,4,14,7,8,14,12,8,8,8,15,12,20,5,9,9,7,5,9,9,10,8,11,11,11,11,7,1,D C,1,1,1,1,1,1,20,1,1,1,1,1,1,1,1
19320662,Cláudio,1651,15/04/1993,23,0,0,0,0,180,0,2,3,1,3,3,2,3,3,2,2,1,8,4,7,3,9,4,15,2,5,11,10,1,13,7,10,15,11,10,12,6,14,10,1,9,9,11,9,10,15,13,10,7,9,11,11,20,7,8,10,6,8,4,10,17,9,12,10,11,2,10,8,D C,1,1,1,1,1,1,20,1,1,1,1,1,1,1,1
19320665,Edvaldo Rambo,1651,02/06/1987,29,0,0,0,0,187,0,3,3,1,3,3,1,4,1,1,2,2,6,6,4,7,9,5,3,8,5,8,13,4,13,11,9,8,7,6,6,10,13,5,2,10,4,10,7,12,13,8,7,7,8,15,9,20,7,9,9,7,6,6,9,7,11,12,11,11,9,6,7,DM C,1,1,1,1,1,1,1,1,1,20,15,1,1,1,1
19320666,Deysinho,1651,05/12/1991,24,0,0,0,0,166,60,1,1,3,1,3,3,4,2,4,2,3,8,11,12,10,9,7,8,9,6,7,9,7,5,13,10,8,4,7,8,10,13,2,13,12,8,8,8,8,13,13,8,1,10,16,13,20,13,6,10,8,7,10,10,7,9,9,12,10,2,18,4,AM RC,1,1,15,18,1,20,1,1,1,1,12,1,15,1,1
19320667,Júnior Murici,1651,05/05/1992,24,0,0,0,0,178,79,3,3,1,4,3,2,1,2,1,2,1,2,6,2,4,13,6,6,12,3,13,13,1,8,13,9,9,8,7,7,13,11,9,6,9,8,8,7,6,12,13,7,4,9,12,13,20,11,5,9,9,9,9,9,13,12,11,12,13,1,12,4,M C,1,1,1,1,1,1,1,1,1,1,20,1,1,1,1
19320726,Xandy,1651,30/07/1993,22,0,0,0,0,188,80,2,3,3,1,3,3,1,2,1,3,1,1,1,4,2,4,1,13,1,4,13,3,4,13,1,8,8,8,5,5,4,13,8,1,2,5,12,5,6,11,13,6,7,8,8,13,20,9,10,8,5,8,8,8,19,11,13,12,10,7,10,8,D C,1,1,1,1,1,1,20,1,1,1,1,1,1,1,1
19320727,Augusto,1651,02/08/1996,19,0,0,0,0,188,78,3,4,3,1,2,3,2,3,2,1,3,6,2,9,13,10,3,12,7,2,2,7,10,3,11,9,12,8,13,6,7,8,5,11,2,11,7,6,7,13,12,7,12,8,9,13,20,6,13,9,6,9,9,8,15,11,11,12,9,8,11,8,S ,1,1,20,1,1,1,1,1,1,1,1,1,1,1,1
19320728,Albert,1651,30/11/1994,21,0,0,0,0,180,70,1,3,2,2,3,1,3,3,1,1,1,4,5,6,1,13,2,7,1,3,8,8,2,14,8,8,7,4,7,7,6,9,1,8,9,6,4,7,8,9,14,7,11,8,15,14,20,12,6,8,8,7,8,8,9,10,10,11,10,13,12,2,D R,1,1,1,1,1,1,1,1,20,1,1,1,1,1,15
19320729,Caio Breno,1651,16/02/1994,22,0,0,0,0,178,0,1,3,2,1,1,2,2,2,3,3,4,2,5,7,7,13,6,6,6,2,6,13,4,8,13,9,9,8,8,8,13,10,5,2,11,8,9,7,12,13,11,7,7,9,6,12,20,11,5,9,8,4,8,9,18,11,9,12,10,10,4,1,M C,1,1,1,1,1,1,1,1,1,15,20,1,1,1,1
19320730,Fabinho,1651,06/01/1993,23,0,0,0,0,174,74,1,1,2,2,3,2,1,2,1,2,3,6,4,13,13,7,6,9,6,1,5,4,8,1,11,9,9,8,7,6,3,13,1,11,12,11,5,6,7,13,11,7,7,16,8,13,20,8,9,9,8,9,9,9,11,10,11,10,13,5,10,1,S ,1,1,20,1,1,1,1,1,1,1,1,1,1,1,1
19320731,Léo Brum,1651,03/09/1995,20,0,0,0,0,173,69,1,1,3,3,3,2,2,3,2,2,2,5,5,8,1,9,3,9,7,8,10,8,4,15,10,9,7,9,8,10,7,12,6,9,9,8,7,9,9,15,13,9,8,10,12,14,20,10,8,9,9,9,8,9,16,12,12,11,13,6,10,2,D R,1,1,1,1,1,1,1,1,20,1,1,1,1,1,15
19320732,Daniel Alves,1651,11/05/1989,27,0,0,0,0,175,77,3,1,4,1,2,3,3,3,1,3,3,5,5,4,4,10,4,2,9,3,8,10,3,12,12,7,7,7,7,6,8,9,8,6,10,7,9,7,11,13,13,6,6,9,11,13,20,12,4,8,8,4,8,8,14,10,12,11,9,4,15,5,M C,1,1,1,1,1,1,1,1,1,15,20,1,1,1,1
19320733,Queiroz,1651,06/06/1990,26,0,0,0,0,174,74,2,2,3,1,1,3,3,1,2,2,2,3,2,4,5,6,5,4,6,1,9,13,4,13,9,6,10,7,7,6,6,13,8,7,11,5,12,7,10,13,9,6,4,9,12,8,20,6,4,8,8,8,8,8,18,11,12,12,10,2,7,5,DM/M C,1,1,1,1,1,1,1,1,1,20,18,1,1,1,1
19320734,Drey,1651,04/07/1991,24,0,0,0,0,177,70,1,2,1,1,2,1,1,1,2,1,3,5,7,4,4,13,1,7,4,4,6,8,3,11,9,8,6,8,7,5,5,13,5,7,10,4,8,7,8,14,14,7,5,20,15,13,9,13,7,7,8,8,8,8,13,12,10,9,14,9,16,5,D L,1,1,1,1,1,1,1,20,1,1,1,1,1,15,1
19320735,Tiago Índio,1651,02/06/1995,21,0,0,0,0,175,70,3,3,3,2,1,2,3,2,3,3,3,9,13,5,5,10,7,5,4,5,6,7,1,11,7,5,7,7,5,10,7,11,8,8,14,6,5,6,7,13,12,5,3,20,14,13,9,7,5,8,8,8,8,8,8,12,9,13,13,3,7,6,D/WB L,1,1,1,1,13,1,1,20,1,1,1,15,1,18,1
19320736,Davi,1651,27/03/1996,20,0,0,0,0,195,80,13,9,10,8,13,13,9,10,8,7,7,2,2,1,3,1,4,1,1,2,2,1,3,1,4,8,5,9,4,7,5,13,2,1,13,1,11,6,5,11,12,3,12,1,15,12,20,2,11,7,8,8,8,8,12,12,8,12,14,2,3,8,GK ,20,1,1,1,1,1,1,1,1,1,1,1,1,1,1
19320738,Matheus Tenório,1651,23/01/1999,17,0,0,0,0,177,70,1,2,3,3,1,2,2,1,1,1,3,4,5,8,8,9,5,6,7,2,7,13,1,8,13,9,4,8,5,2,13,10,3,13,9,10,7,7,10,13,13,7,4,9,9,13,20,11,6,9,4,5,9,9,15,10,11,10,9,2,11,3,M/AM C,1,1,1,18,1,1,1,1,1,1,20,1,1,1,1
19320815,Helerson,1651,28/10/1997,18,0,0,0,0,185,75,2,1,2,2,2,1,1,4,3,2,3,5,5,2,7,10,2,15,5,5,12,7,5,15,14,10,9,11,5,10,7,15,9,13,6,4,12,5,9,13,14,10,11,20,15,13,11,10,9,10,3,10,10,10,19,12,9,11,12,7,10,4,D C,1,1,1,1,1,1,20,1,1,1,1,1,1,1,1
19320831,Emerson Guioto,1651,04/10/1993,22,0,0,0,0,187,0,1,2,3,2,3,1,3,3,1,3,3,1,4,4,3,11,2,1,9,1,5,7,2,11,7,8,7,6,5,5,6,12,8,5,10,4,9,5,7,12,12,4,8,8,15,12,20,3,8,8,8,6,8,8,19,12,8,11,12,5,8,4,DM ,1,1,1,1,1,1,1,1,1,20,10,1,1,1,1
19320835,Lucas Carvalho,1651,01/04/1996,20,0,0,0,0,182,75,1,1,2,2,1,3,1,3,1,1,2,4,3,12,8,12,4,12,5,1,1,1,6,1,12,7,8,3,12,5,2,11,2,13,7,10,2,4,5,12,12,5,8,9,13,12,20,7,7,8,5,8,8,8,18,7,10,9,11,4,12,2,S ,1,1,20,1,1,1,1,1,1,1,1,1,1,1,1
19320836,Yago,1651,22/05/1994,22,0,0,0,0,181,76,1,3,4,2,2,1,2,2,3,2,1,6,5,6,4,11,3,8,1,7,7,8,4,13,7,7,7,9,8,11,5,12,8,4,7,7,6,8,8,15,8,8,9,9,7,11,20,7,8,8,8,3,8,8,18,8,10,12,8,2,14,7,D R,1,1,1,1,1,1,1,1,20,1,1,1,1,1,1
19320837,Caio,1651,17/02/1998,18,0,0,0,0,172,0,1,3,2,1,2,3,2,1,3,2,2,2,2,6,4,13,3,3,11,2,8,11,4,6,13,8,6,7,8,5,11,12,2,8,11,6,3,7,9,13,10,2,4,9,12,11,20,5,5,8,6,8,8,8,7,10,12,10,11,3,18,7,M C,1,1,1,1,1,1,1,1,1,1,20,1,1,1,1
19321527,Gilmar Alagoano,1651,03/01/1982,34,0,0,0,0,190,86,3,2,3,1,1,1,1,4,4,3,2,6,3,14,10,12,5,14,4,4,6,7,3,2,9,5,9,5,8,7,6,7,8,8,6,14,7,6,7,7,8,7,13,8,12,8,20,12,11,8,5,3,6,8,10,10,10,14,11,11,7,1,S ,1,1,20,1,1,1,1,1,1,1,1,1,1,1,1
19322365,Fabrício,1651,03/06/1998,18,0,0,0,0,183,78,2,3,2,3,2,3,2,3,2,3,2,9,7,5,10,13,8,9,11,6,11,15,3,12,10,10,13,10,9,10,11,13,11,10,2,9,14,10,14,8,11,7,13,9,11,9,20,9,10,10,6,10,8,10,10,9,11,11,10,9,3,4,DM ,1,1,1,1,1,1,1,1,1,20,10,1,1,1,1
19322546,Junio,1651,27/02/1997,19,0,0,0,0,187,0,2,1,1,2,3,1,1,3,4,3,3,8,8,8,3,14,4,9,8,8,10,10,6,14,10,8,7,10,7,7,10,13,8,9,10,7,7,5,9,14,12,10,9,10,11,12,20,14,8,9,8,10,3,10,12,13,14,11,8,1,10,7,D/WB R,1,1,1,1,1,1,1,1,20,1,1,1,1,1,19
19323250,Estevão,1651,21/01/1999,17,0,0,0,0,183,0,3,1,2,3,2,3,2,4,2,3,2,6,8,14,14,14,2,12,8,7,6,8,4,2,14,8,5,6,11,3,7,14,6,13,6,12,5,7,8,13,11,8,8,3,15,12,20,8,8,9,9,9,9,9,17,13,11,9,9,6,14,5,S ,1,1,20,1,1,1,1,1,1,1,1,1,1,1,1
19323257,Thiago Accioli,1651,28/11/1991,24,0,0,0,0,173,66,1,2,3,1,2,3,3,3,3,3,4,8,5,8,10,12,4,7,13,7,8,10,5,7,11,6,9,9,6,8,13,12,10,10,10,11,8,9,12,14,14,8,7,20,13,14,10,7,6,10,8,10,10,10,9,12,10,12,10,7,8,8,AM C,1,1,1,20,1,1,1,1,1,1,10,1,1,1,1
19323266,Alberico,1651,01/06/1990,26,0,0,0,0,176,70,3,2,4,2,2,4,2,3,3,3,3,10,4,12,11,13,14,7,10,4,5,14,5,8,9,5,7,6,14,6,7,11,9,9,11,11,8,8,13,14,13,8,9,20,11,14,3,14,6,9,9,3,7,9,7,9,9,13,11,1,11,1,AM C,1,1,1,20,1,1,1,1,1,1,10,1,1,1,1
19323267,Robinho,1651,28/02/1988,28,0,0,0,0,175,72,1,3,2,1,4,3,2,2,2,3,2,7,9,13,6,13,5,4,9,7,7,9,5,9,13,6,9,9,6,8,9,12,3,13,14,9,8,8,10,13,13,8,8,10,10,13,20,11,5,10,7,9,10,10,18,15,12,13,11,1,12,6,M/AM RC,1,1,1,16,1,20,1,1,1,1,16,1,1,1,1
19323484,Renan,1651,12/06/1998,18,0,0,0,0,177,0,1,1,2,3,3,3,3,3,1,2,4,9,11,8,7,7,7,7,5,7,7,9,5,13,9,2,9,8,8,8,7,13,3,3,2,8,8,8,9,14,10,8,6,1,12,11,20,10,7,8,4,8,5,8,13,8,12,9,8,9,14,6,D/WB R,1,1,1,1,1,1,1,1,17,1,1,1,15,1,20
19323511,Vini,1651,09/08/1999,16,0,0,0,0,182,0,1,1,1,4,1,2,3,3,1,1,3,2,2,4,5,5,2,4,10,1,5,6,3,11,10,5,9,5,5,3,6,12,5,7,8,4,11,6,9,10,13,5,7,7,11,13,20,5,8,7,4,7,4,7,14,13,11,12,13,1,12,7,DM ,1,1,1,1,1,1,1,1,1,20,10,1,1,1,1
19323520,Gabriel,1651,23/01/2000,16,0,0,0,0,187,0,4,1,2,2,3,3,1,4,1,1,1,4,3,13,13,11,4,13,5,2,1,5,5,1,13,6,5,6,10,5,5,6,7,13,9,11,3,4,5,12,11,5,8,2,14,11,20,3,10,4,7,7,7,7,18,10,11,12,11,3,5,1,S ,1,1,20,1,1,1,1,1,1,1,1,1,1,1,1
19323620,Jackinha,1651,11/10/1991,24,0,0,0,0,176,69,3,1,4,3,1,4,3,3,3,2,2,1,4,2,2,13,1,9,4,8,14,9,1,14,9,4,10,10,8,11,8,12,2,10,9,7,10,9,9,14,14,9,4,20,10,14,10,12,10,10,5,10,6,10,11,9,13,11,12,7,17,4,D L,1,1,1,1,1,1,1,20,1,1,1,1,1,1,1
19323720,Daniel Bonassa,1651,01/06/2000,16,0,0,0,0,174,68,4,1,3,3,1,2,4,2,2,3,1,1,4,3,5,13,3,4,13,1,5,12,2,10,13,7,3,6,5,1,6,13,2,7,10,4,4,6,9,13,7,5,3,10,8,10,20,5,6,7,7,1,7,3,20,10,10,12,12,6,1,5,DM C,1,1,1,1,1,1,1,1,1,20,15,1,1,1,1
19323722,Barbosa,1651,12/01/1999,17,0,0,0,0,187,0,1,3,1,2,2,1,2,2,3,2,2,5,1,3,5,2,1,6,5,1,8,6,2,13,4,8,6,5,3,7,5,13,8,1,8,4,13,5,6,11,11,6,9,1,11,8,20,5,7,6,8,8,3,8,20,12,11,12,8,1,13,1,D C,1,1,1,1,1,1,20,1,1,1,1,1,1,1,1
19323742,Eduardo Person,1651,24/01/1997,19,0,0,0,0,194,0,2,3,4,2,3,3,4,1,4,3,1,6,4,8,6,11,6,4,11,1,4,8,4,5,11,4,4,7,5,4,9,12,7,10,6,8,8,7,10,13,10,7,11,8,10,8,20,5,12,8,4,1,8,8,15,11,9,11,11,1,8,6,AM C,1,1,1,20,1,1,1,1,1,1,15,1,1,1,1
19323751,Toni Galego,1651,22/06/1987,29,0,0,0,0,184,79,1,2,3,1,3,3,2,3,1,3,1,5,6,13,12,13,6,6,10,1,6,11,4,5,13,9,7,2,12,7,10,12,4,13,10,12,7,7,11,13,10,7,6,10,8,10,20,13,6,9,6,9,7,9,10,13,8,9,10,7,12,7,AM C,1,1,1,20,1,1,1,1,1,1,1,1,1,1,1
19323752,Raphael Barrios,1651,16/06/1988,28,0,0,0,0,193,92,14,10,7,1,12,11,11,13,5,7,12,5,3,2,3,1,8,1,3,2,3,1,2,3,5,9,10,9,8,9,7,9,6,1,8,3,12,8,5,11,7,8,15,10,10,12,20,7,10,9,9,9,9,9,7,11,13,13,10,4,10,7,GK ,20,1,1,1,1,1,1,1,1,1,1,1,1,1,1
19323758,Rodrigo Andrade,1651,04/06/1997,19,0,0,0,0,174,75,1,2,2,3,1,3,1,1,3,2,2,7,6,8,8,13,7,7,9,1,9,13,3,9,11,8,5,9,7,4,11,13,9,10,13,8,10,8,12,13,11,8,5,16,11,11,20,8,6,9,10,10,9,10,10,14,13,11,11,2,8,2,DM/M C,1,1,1,1,1,1,1,1,1,20,18,1,1,1,1
19323759,Andrelino,1651,21/06/1995,21,0,0,0,0,175,76,3,3,1,1,2,3,3,2,1,2,3,2,5,8,5,13,2,9,5,8,10,10,2,9,10,5,10,10,8,7,8,14,9,3,12,8,7,10,10,14,11,12,7,20,13,12,10,9,10,9,9,1,7,9,10,8,9,11,9,4,11,7,D/WB L,1,1,1,1,1,1,1,20,1,1,1,1,1,17,1
19323760,Búfalo,1651,16/01/1995,21,0,0,0,0,165,74,3,3,3,3,2,3,3,2,2,3,3,6,4,7,8,15,7,8,12,5,10,15,1,7,14,9,5,7,6,8,15,14,4,7,8,11,7,9,11,13,13,9,3,1,14,13,20,9,8,9,5,9,9,9,18,10,12,11,13,3,17,8,M C,1,1,1,1,1,1,1,1,1,1,20,1,1,1,1
19323764,Fernandinho,1651,19/07/1997,18,0,0,0,0,174,70,3,2,1,3,3,1,4,1,2,3,1,9,14,12,11,14,7,14,9,7,5,9,3,7,11,7,9,8,9,8,6,13,5,10,9,11,7,8,9,14,9,9,8,10,9,12,20,7,6,8,8,1,4,9,12,13,10,9,9,8,11,5,AM/S L,1,1,19,1,20,1,1,1,1,1,1,1,1,1,1
19323765,Breno,1651,17/07/1995,20,0,0,0,0,184,72,2,1,2,4,1,1,3,3,2,3,2,7,4,4,2,8,2,12,5,5,10,8,7,14,7,9,10,9,8,12,4,14,9,4,11,5,14,7,8,10,12,9,12,10,7,9,20,5,10,9,9,4,9,8,18,12,11,12,13,7,14,3,D C,1,1,1,1,1,1,20,1,1,1,1,1,1,1,1
19323793,Telo,1651,21/03/1993,23,0,0,0,0,173,67,2,2,1,3,2,3,1,2,2,2,3,6,6,6,4,11,4,7,3,6,8,8,1,13,8,8,7,8,5,11,4,8,8,8,6,6,9,7,7,14,13,13,7,9,13,12,20,7,5,8,4,4,7,8,20,14,10,13,10,12,12,2,D/WB R,1,1,1,1,1,1,1,1,20,1,1,1,1,1,18
19324165,Roger,1651,01/03/1996,20,0,0,0,0,180,74,2,3,1,2,2,2,2,2,4,3,2,7,11,10,6,11,4,5,5,1,4,5,1,5,8,7,4,1,5,5,6,6,7,8,3,5,4,5,6,12,8,5,5,20,9,10,6,7,7,7,7,3,6,7,14,12,10,11,12,10,13,2,AM RL,1,1,13,1,20,17,1,1,1,1,1,1,1,1,1
19324166,Patrick,1651,05/06/1997,19,0,0,0,0,170,66,3,3,1,1,2,3,2,3,2,1,1,4,7,8,5,13,1,5,5,4,8,9,6,14,10,9,8,9,7,11,9,15,1,8,5,7,10,9,9,15,12,9,6,20,13,11,10,8,8,9,3,9,8,9,9,11,12,10,9,6,12,7,D/WB L,1,1,1,1,1,1,1,20,1,1,1,1,1,18,1
19324170,Lausen,1651,23/05/1995,21,0,0,0,0,171,65,2,2,1,2,2,1,3,2,3,3,3,6,5,14,14,12,7,14,8,6,6,8,9,2,12,9,11,4,10,8,7,11,9,11,2,7,8,7,8,14,14,7,5,9,13,14,20,7,10,9,7,9,9,9,8,8,12,11,10,1,13,5,S ,1,1,20,1,1,1,1,1,1,1,1,1,1,1,1
19324879,Murillo,1651,16/06/1999,17,0,0,0,0,187,0,3,2,2,2,3,2,2,3,1,2,2,5,3,12,12,13,7,13,8,1,5,8,1,5,9,9,12,3,6,6,8,8,8,9,5,13,6,7,8,13,13,5,13,9,11,13,20,9,9,10,9,2,5,10,15,7,10,13,8,11,17,3,S ,1,1,20,1,1,1,1,1,1,1,1,1,1,1,1
19324882,Márcio,1651,14/01/1993,23,0,0,0,0,188,73,2,3,2,2,3,3,1,1,1,1,1,4,6,1,2,8,1,13,7,4,13,3,4,13,3,4,10,10,8,10,7,13,10,4,10,5,13,7,8,11,12,11,15,11,15,11,20,9,11,10,9,10,5,10,17,13,13,12,13,12,12,5,D C,1,1,1,1,1,1,20,1,1,1,1,1,1,1,1
19324928,João Paulo,1651,17/03/1997,19,0,0,0,0,183,0,3,1,2,2,1,1,3,1,2,3,1,5,9,9,6,15,1,8,2,9,7,10,6,13,11,5,12,10,10,8,7,13,2,10,9,7,11,10,10,15,14,10,11,20,11,12,10,8,8,10,10,3,4,10,8,9,12,13,12,7,13,2,D/WB L,1,1,1,1,1,1,1,20,1,1,1,1,1,18,1
19324929,Manoel Neto,1651,06/05/1996,20,0,0,0,0,196,89,2,1,4,2,2,1,3,2,2,1,3,8,9,8,9,12,6,10,3,9,9,11,7,14,10,10,12,11,10,12,10,8,19,10,14,9,8,10,10,15,11,5,17,20,13,13,10,8,13,10,10,10,9,10,8,13,10,11,10,6,13,1,D/WB L,1,1,1,1,1,1,1,20,1,1,1,1,1,18,1
19324930,Erick,1651,10/12/1997,18,0,0,0,0,173,65,2,1,2,2,3,3,1,2,2,1,1,9,14,14,10,11,8,9,9,8,6,6,4,6,12,4,10,6,9,10,10,10,4,11,1,10,6,9,10,12,14,10,6,20,13,14,10,9,6,8,9,2,9,10,18,13,11,12,12,1,5,5,M/AM R,1,1,12,1,1,20,1,1,1,1,1,1,17,1,1
19324933,Gerônimo Lopes,1651,28/01/1997,19,0,0,0,0,183,75,3,1,1,3,2,2,1,2,1,1,2,7,6,13,13,12,7,13,8,1,5,7,10,4,13,10,7,9,11,7,5,6,2,13,3,13,7,7,8,13,11,8,10,9,15,13,20,8,9,10,10,5,10,9,17,11,11,11,10,5,2,2,S ,1,1,20,1,1,1,1,1,1,1,1,1,1,1,1
19324934,Lucas Silva,1651,28/05/1997,19,0,0,0,0,196,0,13,7,8,1,13,13,10,13,9,6,11,3,1,2,2,4,6,1,1,1,3,1,3,3,1,8,5,13,6,11,7,13,14,3,7,2,8,8,7,12,13,8,12,4,8,7,20,5,12,10,4,1,7,10,8,12,12,10,12,8,13,3,GK ,20,1,1,1,1,1,1,1,1,1,1,1,1,1,1
19324935,Thawan,1651,13/01/1997,19,0,0,0,0,185,76,3,3,2,2,2,1,1,3,3,2,3,4,3,5,5,9,2,14,5,2,14,8,1,14,5,10,12,10,7,7,6,14,5,1,12,5,14,8,4,13,10,9,12,10,17,11,20,9,8,10,7,10,8,10,18,11,11,11,10,6,7,5,D C,1,1,1,1,1,1,20,1,1,1,1,1,1,1,1
19324936,Eduardo,1651,05/08/1996,19,0,0,0,0,175,68,2,2,4,1,2,1,1,3,2,1,2,3,5,5,7,13,1,8,5,5,9,11,5,15,10,9,9,11,7,11,8,14,1,5,3,5,7,10,10,12,11,10,7,20,17,13,10,9,7,9,10,1,8,10,16,13,11,10,9,1,15,5,D/WB L,1,1,1,1,1,1,1,20,1,1,1,1,1,18,1
19324937,Gabriel Leite,1651,14/06/1996,20,0,0,0,0,191,83,1,3,3,1,1,2,1,2,3,3,2,6,5,8,11,13,7,3,13,1,5,9,5,3,13,10,10,8,6,3,13,13,10,13,4,10,7,8,12,13,13,7,14,9,12,13,20,8,10,9,8,5,10,10,15,12,10,12,9,5,8,3,AM C,1,1,1,20,1,1,1,1,1,1,10,1,1,1,1
19324939,Isllandson,1651,04/09/1999,16,0,0,0,0,178,0,3,2,1,2,3,3,2,4,3,2,2,6,8,4,3,12,8,8,10,4,9,12,7,15,10,7,8,8,9,9,8,13,5,9,7,7,12,9,14,15,10,9,10,1,11,13,20,9,9,9,9,9,7,9,9,11,11,12,10,8,9,8,D/DM C,1,1,1,1,1,1,18,1,1,20,10,1,1,1,1
19324940,Halef Pitbull,1651,20/08/1994,21,0,0,0,0,186,78,1,2,13,1,1,3,4,2,1,2,1,9,7,14,13,14,9,14,7,9,9,10,6,5,12,10,9,10,12,8,10,10,9,11,1,11,6,9,11,13,13,8,11,18,11,14,20,10,8,12,6,6,7,11,9,12,12,10,12,8,16,6,S ,1,1,20,1,1,1,1,1,1,1,1,1,1,1,1
19325045,Emerson,1651,14/01/1999,17,0,0,0,0,181,79,3,1,3,2,3,1,1,3,1,1,1,8,12,9,5,16,5,10,5,4,10,8,5,15,12,10,8,11,6,8,10,12,8,10,4,10,10,11,11,15,11,11,8,11,10,12,20,15,10,10,5,9,10,10,10,9,13,12,11,5,11,1,D/WB R,1,1,1,1,1,1,1,1,20,1,1,1,1,1,18
19325046,Raí,1651,23/01/1997,19,0,0,0,0,170,64,3,3,3,1,1,3,1,2,3,2,3,8,8,14,11,14,8,8,12,6,6,10,1,9,14,10,6,6,6,7,14,10,19,13,13,13,8,9,11,13,14,9,4,9,10,14,20,14,6,10,4,10,7,10,13,10,12,10,12,13,10,8,AM C,1,1,1,20,1,1,1,1,1,1,10,1,1,1,1
19325088,Eduardo,1651,20/05/1999,17,0,0,0,0,180,0,1,1,3,2,1,3,3,2,3,1,3,6,4,9,13,13,3,13,7,1,3,7,9,1,11,9,7,7,11,6,6,10,5,11,7,11,6,6,8,13,13,4,5,9,11,13,20,12,7,9,9,6,3,9,14,12,11,12,10,6,5,3,S ,1,1,20,1,1,1,1,1,1,1,1,1,1,1,1
19325128,Erick,1651,26/03/1997,19,0,0,0,0,192,87,13,6,13,9,12,12,7,11,7,8,10,7,3,1,3,3,9,1,3,1,3,1,2,1,2,9,7,13,7,9,6,13,4,2,1,2,12,7,5,11,9,7,14,4,11,9,20,1,11,9,7,9,8,8,19,12,11,11,10,1,4,4,GK ,20,1,1,1,1,1,1,1,1,1,1,1,1,1,1
19325129,Felipe Bernardo,1651,07/01/1998,18,0,0,0,0,173,65,1,1,1,1,3,3,1,3,4,3,1,7,11,8,7,11,6,6,5,6,2,6,6,7,13,4,5,4,7,7,8,11,8,13,5,7,7,3,6,13,12,6,1,9,9,12,20,11,4,7,6,9,9,9,9,10,12,11,13,4,13,5,D/M/AM R,1,1,1,10,1,16,1,1,20,1,1,1,18,1,12
19325130,Marlon,1651,24/02/1997,19,0,0,0,0,183,72,3,1,2,2,1,1,3,2,3,2,3,4,3,1,1,5,1,14,5,3,13,7,1,13,2,8,11,8,4,9,4,14,3,4,1,4,13,6,7,7,10,7,8,9,10,11,20,6,8,7,8,6,6,7,7,10,12,11,10,8,13,5,D C,1,1,1,1,1,1,20,1,1,1,1,1,1,1,1
19325131,Renan Paschoalino,1651,18/04/1997,19,0,0,0,0,180,0,3,2,2,1,2,1,1,3,3,2,3,5,4,4,5,14,6,6,11,3,6,14,5,12,13,6,9,7,7,6,10,6,8,8,1,8,7,8,11,14,10,7,6,20,12,11,9,6,8,7,8,8,8,8,7,11,10,13,12,5,8,6,M C,1,1,1,1,1,1,1,1,1,15,20,1,1,1,1
19325352,Wesley Ximenes,1651,23/03/1996,20,0,0,0,0,174,60,1,2,3,1,3,2,2,2,1,1,2,6,6,5,13,12,6,6,10,4,6,12,5,3,14,7,7,6,10,6,13,11,8,13,7,6,5,8,12,13,10,3,6,8,13,13,20,9,4,7,7,8,5,8,14,10,12,10,13,6,5,4,AM C,1,1,1,20,1,1,1,1,1,1,8,1,1,1,1
19325353,Eduardo,1651,28/09/1996,19,0,0,0,0,186,71,4,1,2,4,1,2,3,2,3,3,3,6,9,8,4,12,2,7,1,8,10,10,2,15,10,9,7,10,9,7,7,10,6,9,3,7,8,9,9,15,12,7,10,10,9,13,20,9,9,9,8,3,5,9,16,13,10,13,12,5,9,3,D/WB R,1,1,1,1,1,1,1,1,20,1,1,1,1,1,16
19325354,Matheus Jesus,1651,23/05/1997,19,0,0,0,0,189,83,13,7,5,9,13,6,5,10,9,8,10,7,1,3,1,2,9,1,1,3,3,1,1,3,1,5,8,14,2,10,6,13,6,2,13,2,13,7,6,10,13,6,9,10,10,13,20,1,8,9,9,8,9,9,20,13,10,9,11,9,8,2,GK ,20,1,1,1,1,1,1,1,1,1,1,1,1,1,1
19325372,Jhonata,1651,04/07/2000,15,0,0,0,0,184,0,1,1,2,2,2,3,3,4,2,1,3,2,6,5,5,12,5,5,1,5,7,7,1,13,7,8,5,7,2,6,7,13,3,8,11,3,8,6,7,9,12,6,11,9,11,12,20,12,6,5,8,3,7,8,12,11,10,11,9,12,10,7,D/WB/DM R,1,1,1,1,1,1,1,1,20,16,8,1,5,1,16
19325373,Fessin,1651,04/01/1999,17,0,0,0,0,164,0,2,1,3,1,1,3,1,1,4,3,3,8,12,9,6,15,7,6,9,6,7,9,3,6,10,7,5,5,6,8,9,15,8,4,4,8,6,9,13,10,13,7,6,4,9,11,20,9,5,1,8,8,8,8,9,10,11,12,13,10,15,8,M RC,1,1,1,8,1,12,1,1,1,1,20,1,20,1,1
19325374,Leozinho,1651,23/11/1997,18,0,0,0,0,181,0,1,2,1,3,2,3,1,3,3,1,2,5,6,5,7,13,5,12,6,1,2,6,3,1,8,8,6,7,5,6,6,6,7,8,6,12,2,5,7,12,11,2,8,8,8,13,20,11,7,5,8,4,5,8,14,11,10,11,10,10,7,8,AM/S C,1,1,20,16,1,10,1,1,1,1,1,1,1,1,1
19325375,Jardel Parelhas,1651,10/09/1996,19,0,0,0,0,181,0,1,1,1,3,3,2,1,2,1,3,3,5,4,6,2,9,5,4,4,5,5,8,2,10,9,8,4,3,6,7,8,13,4,5,5,2,11,7,10,13,11,6,6,11,9,13,20,6,6,8,7,8,6,8,12,13,11,11,10,2,10,7,DM RC,1,1,1,1,1,1,1,1,15,20,15,1,1,1,12
19325376,Dalberto,1651,15/09/1994,21,0,0,0,0,179,75,2,3,2,2,4,3,1,2,1,2,2,6,8,10,7,14,6,11,5,2,5,7,1,1,11,8,6,1,6,7,9,6,8,10,12,10,7,6,8,14,12,7,5,20,14,13,7,6,8,8,8,6,8,8,13,13,11,13,12,5,6,8,S C,1,1,20,15,14,10,1,1,1,1,1,1,1,1,1
19325377,John Lennon,1651,05/01/1992,24,0,0,0,0,180,73,3,2,2,2,3,3,1,3,3,2,1,6,4,10,13,13,6,13,5,4,6,6,4,2,10,6,12,6,12,7,7,11,9,10,11,12,6,6,8,13,9,7,8,1,10,10,20,12,6,9,7,6,5,9,13,10,10,10,12,9,6,5,S ,1,1,20,1,1,1,1,1,1,1,1,1,1,1,1
19325404,Everton,1651,21/02/1994,22,0,0,0,0,177,72,3,4,4,3,3,3,3,1,3,2,3,3,5,8,1,13,1,5,4,7,10,10,3,15,8,7,6,9,8,11,9,13,9,1,12,8,9,9,8,15,10,7,5,10,9,14,20,9,8,9,9,9,6,9,12,11,11,11,9,10,15,4,D/WB R,1,1,1,1,1,1,1,1,20,1,1,1,1,1,20
19325405,Marcos Júnior,1651,13/05/1995,21,0,0,0,0,172,68,1,3,3,3,2,1,3,2,2,2,3,6,8,9,9,13,6,8,13,1,11,7,2,12,12,9,8,9,10,8,11,14,9,9,3,9,13,9,13,10,11,9,3,13,13,12,20,9,8,9,8,1,9,9,17,9,12,9,11,10,10,2,DM/M C,1,1,1,1,1,1,1,1,1,20,16,1,1,1,1
19325406,Denilson,1651,07/03/1998,18,0,0,0,0,174,0,3,3,2,3,3,1,1,4,4,1,2,5,2,9,13,13,4,13,6,1,2,3,10,3,9,8,8,2,13,5,5,12,8,9,7,11,2,5,6,13,13,2,4,8,7,13,20,6,10,7,5,2,8,8,18,11,10,10,11,9,15,1,S ,1,1,20,1,1,1,1,1,1,1,1,1,1,1,1
2001403,Adriano,1651,17/02/1982,34,48,27,0,0,190,101,1,1,1,1,1,1,1,1,1,1,1,10,12,13,15,15,17,16,16,5,6,12,19,8,15,11,13,15,14,7,11,12,6,14,12,13,5,12,7,9,7,18,17,20,1,9,7,5,19,8,5,15,20,4,2,7,7,5,3,10,11,16,S ,1,1,20,1,1,1,1,1,1,1,1,1,1,1,1
20015085,Lennon,1651,02/01/1991,25,0,0,0,0,183,78,2,2,3,1,1,2,1,2,1,1,2,6,4,7,2,11,3,6,5,3,10,8,2,13,13,16,9,8,3,5,10,11,3,8,6,6,11,7,10,12,12,9,9,10,11,13,20,13,11,9,13,8,5,9,13,9,12,10,12,10,10,2,DM/M C,1,1,1,1,1,1,13,1,1,20,17,1,1,1,1
20015090,Le Petit,1651,02/11/1989,26,0,0,0,0,183,80,3,2,3,1,1,1,3,2,1,3,2,10,11,8,7,10,11,7,6,9,9,12,8,10,12,10,9,10,8,12,11,9,5,8,6,11,10,11,12,12,12,10,11,20,11,11,6,13,11,9,4,9,4,9,14,12,10,13,14,1,8,7,M LC,1,1,1,1,1,1,1,1,1,15,20,15,1,1,1
20015100,Geison,1651,16/07/1986,29,0,0,0,0,178,78,4,1,4,3,3,1,1,2,1,3,2,8,9,13,10,12,9,4,10,7,5,12,6,6,11,7,9,6,10,10,10,8,9,12,6,10,7,9,7,12,15,11,7,7,15,11,20,12,8,9,9,9,8,9,16,12,14,12,12,8,3,4,M/AM RC,1,1,10,20,13,20,1,1,1,1,10,7,17,1,1
20016292,Adriano de Lima,1651,30/07/1981,34,0,0,0,0,176,65,3,1,3,2,2,2,3,3,3,1,3,7,11,10,8,14,4,6,7,6,3,10,5,7,12,6,9,3,5,6,7,12,3,11,5,8,4,8,11,12,9,8,7,7,10,9,20,7,6,8,8,8,6,8,9,12,10,11,11,9,13,3,M/AM RC,1,1,1,20,13,20,1,1,1,1,13,10,17,1,1
2001642,Clodoaldo,1651,28/12/1978,37,0,0,0,0,160,59,1,3,1,2,2,1,2,3,3,1,1,11,11,12,11,12,12,8,8,2,3,12,15,2,12,6,13,7,11,11,12,12,9,14,5,12,6,6,8,11,14,17,1,20,10,10,10,10,2,11,11,13,9,12,6,11,5,10,7,4,14,14,AM/S C,1,1,20,18,14,13,1,1,1,1,5,10,6,1,1
20028730,Halili Nagime,1651,15/03/1993,23,0,0,0,0,178,72,2,1,1,1,1,2,4,3,2,2,1,4,4,12,12,12,4,12,5,1,3,2,2,2,10,8,9,6,9,5,5,9,3,11,10,12,5,4,5,12,11,5,6,20,11,12,9,10,6,8,3,1,8,8,10,10,13,11,9,4,8,6,S ,1,1,20,1,1,1,1,1,1,1,1,1,1,1,1
20028943,Pedro Mendes,1651,13/05/1990,26,0,0,0,0,183,79,1,1,3,4,3,2,2,1,2,1,1,9,8,12,11,10,11,10,9,7,6,8,9,5,12,10,9,8,11,11,9,8,11,14,6,12,8,10,11,11,12,11,10,10,10,12,20,11,11,9,9,9,6,13,17,11,10,11,12,10,10,4,S ,1,1,20,1,10,1,1,1,1,1,1,7,1,1,1
20028944,Paulo Mendes,1651,13/05/1990,26,0,0,0,0,183,78,3,3,1,3,3,3,3,3,1,3,1,11,11,12,7,11,10,6,8,5,6,11,7,7,11,9,8,6,10,10,11,9,11,14,7,11,8,13,12,11,12,10,10,7,11,11,20,12,9,9,7,9,6,9,17,11,10,11,12,10,10,4,AM RLC,1,1,1,20,20,20,1,1,1,1,10,13,13,1,1
20030372,Rubens,1651,12/10/1989,26,0,0,0,0,188,79,3,1,3,1,2,1,2,3,1,3,3,6,4,6,7,12,6,6,10,2,10,13,3,10,13,9,9,8,8,8,10,10,4,9,4,7,8,8,10,13,10,8,12,12,14,9,20,9,9,9,9,7,9,9,11,11,10,13,10,11,13,3,DM/M C,1,1,1,1,1,1,1,1,1,17,20,1,1,1,1
20030485,Rafael Alves,1651,18/01/1985,31,0,0,0,0,191,91,1,3,3,3,2,4,1,3,1,3,3,9,7,8,7,9,13,14,13,8,10,10,6,11,8,9,9,12,10,11,10,11,13,6,8,8,11,8,9,8,7,10,14,10,12,9,20,12,16,14,6,10,9,9,20,16,6,10,14,11,11,7,D C,1,1,1,1,1,1,20,1,1,10,1,1,1,1,1
20030550,Netinho,1651,04/11/1993,22,0,0,0,0,164,63,2,4,2,1,2,2,1,1,3,3,1,12,11,12,7,9,13,5,13,3,7,12,9,5,12,6,11,5,10,11,13,10,1,18,8,11,8,11,10,13,14,7,4,6,10,11,20,10,4,9,9,9,9,9,17,10,11,10,8,10,14,5,M/AM RLC,1,1,1,17,17,17,1,1,10,1,20,7,17,1,10
20031468,Oliver,1651,29/08/1992,23,0,0,0,0,178,71,3,2,1,2,3,1,3,3,2,2,1,8,7,13,9,10,11,8,12,8,8,9,8,7,12,11,12,9,11,13,11,11,10,13,7,10,8,10,9,13,11,10,7,10,10,12,20,10,9,10,5,6,8,9,16,17,8,11,10,8,12,4,AM/S RL,1,1,19,7,20,17,1,1,1,1,1,10,7,1,1
20031903,Ronaldo Vieira,1651,10/08/1990,25,0,0,0,0,181,79,2,1,4,2,3,2,3,2,2,3,3,12,10,13,10,10,12,8,11,1,7,13,12,8,13,3,10,6,9,8,12,8,9,16,8,7,8,10,10,10,12,10,8,3,16,9,20,13,12,5,6,4,9,9,7,12,9,11,9,9,13,7,DM/M C,1,1,1,1,1,1,7,1,1,20,18,1,1,1,1
20035014,Lucas,1651,01/11/1991,24,0,0,0,0,188,87,1,3,3,2,2,2,2,3,2,2,1,10,12,12,12,6,7,8,6,1,5,7,4,4,10,8,7,4,8,5,5,12,9,11,11,10,5,6,7,12,10,11,11,7,15,12,20,12,12,9,8,9,4,9,15,12,12,11,8,13,14,2,AM/S L,1,1,20,1,20,10,1,1,1,1,1,13,7,1,1
20041860,Luiz Fernando,1651,23/06/1997,19,0,0,0,0,176,73,2,1,2,1,1,3,3,1,2,3,1,6,2,10,13,13,6,13,7,3,4,7,4,1,10,9,5,6,5,5,6,13,9,16,10,13,4,6,7,13,12,9,6,7,6,12,20,5,8,9,2,5,9,9,9,10,9,10,12,7,15,5,S ,1,1,20,1,1,1,1,1,1,1,1,1,1,1,1
20041861,Romulo,1651,26/08/1996,19,0,0,0,0,171,73,3,1,2,1,1,3,3,1,1,2,1,6,2,12,11,13,2,13,7,1,6,7,1,2,11,9,11,6,5,7,3,11,2,11,11,9,6,6,7,13,13,11,6,7,8,13,20,4,8,9,4,9,9,9,8,11,9,9,12,1,9,6,S ,1,1,20,1,1,1,1,1,1,1,1,1,1,1,1
20042130,Kaka,1651,25/06/1991,25,0,0,0,0,183,75,3,1,2,3,3,3,1,3,3,3,3,6,8,10,7,9,6,6,8,4,6,11,4,8,11,9,8,8,6,8,10,8,9,14,8,8,7,8,12,13,11,7,9,7,13,13,20,9,9,9,6,3,8,9,10,9,11,12,10,9,19,8,AM C,1,1,1,20,13,13,1,1,1,1,13,7,7,1,1
20044694,Victor Souto,1651,07/01/1993,23,0,0,0,0,181,71,2,2,3,4,3,2,3,1,4,1,4,9,7,7,8,14,13,7,14,3,9,12,17,14,12,5,10,8,9,9,10,14,3,3,12,8,8,8,11,13,9,8,10,7,11,12,20,7,9,9,9,9,8,9,20,10,12,12,11,1,5,6,DM/M C,1,1,1,1,1,1,1,1,1,20,20,1,1,1,1
20500583,Frederico Moojen,1651,25/02/1983,33,0,0,0,0,181,0,2,3,2,2,2,1,3,1,3,2,2,4,8,14,14,14,7,10,8,1,7,8,8,1,12,5,14,7,11,7,7,11,9,11,10,14,6,7,8,13,10,8,6,3,16,9,20,6,9,9,7,5,9,9,13,10,10,10,12,6,4,4,S ,1,1,20,1,1,1,1,1,1,1,1,1,1,1,1
20501639,Renan Dias,1651,21/08/1987,28,0,0,0,0,181,0,2,1,3,2,2,3,3,1,3,3,4,9,8,11,8,11,9,9,9,4,7,9,2,7,8,7,11,11,10,8,11,11,9,10,11,11,9,9,13,11,8,9,11,8,8,9,20,11,13,14,6,9,8,8,15,11,10,13,12,4,10,2,M C,1,1,1,10,1,1,1,1,1,1,20,10,1,1,1
2100114,Rivaldo,1651,25/08/1985,30,0,0,0,0,181,75,4,1,1,1,1,2,1,1,2,1,2,11,11,12,12,11,12,10,11,10,12,13,13,12,11,12,13,13,12,10,11,11,16,14,6,13,11,11,11,13,14,10,11,20,15,14,8,13,9,10,12,12,9,18,11,13,11,13,12,9,13,10,M LC,1,1,9,14,13,1,1,12,1,15,20,19,1,14,1
2100185,Diego Alves,1651,24/06/1985,31,8,0,3,0,187,83,11,12,14,8,12,13,16,19,11,13,13,10,3,2,2,10,13,7,1,3,2,12,3,1,11,12,15,13,17,16,8,14,17,6,15,3,12,11,12,11,17,10,13,20,13,11,8,12,13,12,8,15,14,13,14,14,13,15,14,12,12,15,GK ,20,1,1,1,1,1,1,1,1,1,1,1,1,1,1
2100325,Willian,1651,19/11/1986,29,0,0,0,0,170,73,3,3,3,1,2,1,4,3,3,2,1,14,13,15,12,14,12,11,13,4,7,12,12,10,15,12,12,13,11,11,12,10,16,14,10,14,8,12,13,15,14,10,8,8,15,15,20,13,9,10,7,11,4,12,6,10,11,12,12,8,12,8,AM/S L,1,1,20,1,19,13,1,1,1,1,1,1,1,1,1
2100326,Caio,1651,29/05/1986,30,0,0,0,0,186,85,1,2,2,3,3,2,2,1,1,3,1,15,12,15,13,16,16,9,17,6,3,14,12,6,15,6,13,6,13,12,13,13,10,16,7,13,5,12,6,12,12,13,12,16,11,12,20,12,11,8,6,8,6,10,5,8,10,11,9,10,13,6,AM LC,1,1,13,20,16,12,1,1,1,2,15,9,8,1,1
2100328,Pedro Ken,1651,20/03/1987,29,0,0,1,0,182,79,2,1,1,1,2,2,2,2,2,1,1,11,11,11,11,13,10,7,13,7,9,12,12,12,14,14,12,10,13,9,12,13,8,12,13,12,13,14,12,12,13,12,10,8,13,12,20,13,11,13,12,13,10,14,6,11,12,12,15,8,15,5,DM/M C,1,1,1,13,1,13,1,1,7,17,20,10,13,1,5
2100330,Bruno Mezenga,1651,08/08/1988,27,0,0,0,0,183,78,1,3,1,2,1,2,1,1,3,3,1,8,9,13,12,14,12,14,13,5,6,13,12,8,14,9,12,10,13,12,10,12,11,13,7,11,10,12,10,12,12,13,13,20,11,11,10,8,13,12,8,12,7,15,6,9,17,9,12,10,12,10,AM/S RLC,1,1,20,18,16,16,10,1,1,1,1,1,1,1,1
2100332,Edu Amparo,1651,01/08/1986,29,0,0,2,0,171,70,3,1,2,3,1,3,3,2,2,1,3,6,11,12,11,13,7,1,12,5,8,12,6,9,13,10,8,13,9,7,12,11,16,13,9,12,11,8,13,13,11,12,6,9,14,13,20,12,5,14,6,10,8,10,7,11,10,16,10,10,10,7,M/AM C,1,1,1,20,1,1,1,1,1,1,18,1,1,1,1
2100337,Marcelo Soares,1651,09/03/1982,34,0,0,0,0,181,78,1,1,3,3,3,2,2,1,2,1,3,2,9,10,10,9,2,12,7,3,5,9,8,2,10,10,11,10,11,11,10,6,10,10,4,12,7,11,11,12,10,11,11,12,13,12,20,13,12,12,16,10,7,10,9,12,10,10,10,2,1,8,S ,1,1,20,1,1,1,1,1,1,1,1,1,1,1,1
2100692,Geninho,1651,25/05/1984,32,0,0,0,0,179,69,1,3,3,1,1,1,2,1,1,1,3,4,4,11,8,11,2,6,11,1,5,9,5,5,12,7,4,2,11,5,10,7,13,14,9,11,6,12,13,13,12,10,10,8,10,13,20,13,10,11,9,11,9,9,8,11,10,10,10,1,4,3,M/AM/S C,1,1,16,20,1,1,1,1,1,1,16,1,1,1,1
2100693,Fabiano Oliveira,1651,06/03/1987,29,0,0,7,0,182,78,2,3,2,1,3,3,2,2,1,1,1,6,9,14,13,10,7,11,11,7,3,10,14,7,14,14,11,12,11,9,13,11,11,12,8,11,6,8,11,12,12,14,12,6,14,13,20,10,14,9,8,13,7,12,13,15,14,11,13,12,12,11,AM/S R,1,1,20,1,10,18,1,1,1,1,1,1,1,1,1
2101662,Thiago Corrêa,1651,07/04/1982,34,0,0,0,0,170,67,1,1,1,1,1,3,1,1,1,1,1,10,11,11,10,12,11,4,10,5,8,10,7,6,13,4,12,6,10,11,12,9,12,13,4,12,7,10,9,11,12,14,5,10,13,10,20,12,6,12,3,10,9,11,12,8,11,7,13,8,7,3,AM C,1,1,1,20,1,12,1,1,1,1,15,1,9,1,1
2102062,Marcelo Oliveira,1651,05/09/1981,34,0,0,0,0,185,79,3,1,3,2,1,1,3,2,3,1,2,6,7,6,8,8,12,15,12,12,13,13,8,14,9,15,11,12,12,11,8,12,13,8,15,7,14,13,12,9,7,15,14,7,14,9,20,11,14,13,16,14,5,4,14,12,14,14,13,6,8,6,D C,1,14,1,1,1,1,20,1,1,1,1,1,1,1,1
2102133,Carlão,1651,19/01/1986,30,0,0,0,0,183,73,4,2,3,3,3,4,2,3,2,3,2,4,7,9,5,11,8,14,7,7,15,11,8,14,8,15,12,14,11,11,5,10,13,8,13,4,14,14,10,11,11,14,12,20,11,12,10,13,14,12,15,13,15,12,13,14,13,15,14,10,10,8,D LC,1,10,1,1,1,1,20,17,1,14,8,1,1,12,1
2102135,Fábio Ferreira,1651,04/10/1984,31,0,0,0,0,187,80,2,2,1,3,1,1,3,1,4,4,2,5,6,5,9,9,10,13,3,2,13,11,6,13,10,12,14,13,13,12,10,13,12,10,12,11,14,13,13,13,14,13,14,7,14,13,20,15,14,11,16,12,5,7,9,13,13,13,11,6,11,12,D C,1,11,1,1,1,1,20,1,1,1,1,1,1,3,1
2102136,Johnny,1651,19/02/1987,29,0,0,0,0,182,75,1,3,3,2,2,2,1,3,2,3,1,2,6,13,13,13,6,13,7,3,6,6,6,1,13,7,9,2,10,6,5,11,6,13,5,13,4,6,7,13,13,4,10,7,2,12,20,8,7,9,6,4,7,9,18,10,12,10,10,4,7,8,S ,1,1,20,1,1,1,1,1,1,1,1,1,1,1,1
2102137,Marcelo Godri,1651,20/02/1987,29,0,0,0,0,184,0,1,3,4,2,4,1,3,3,2,3,1,6,6,9,6,8,8,10,6,7,12,9,8,12,9,12,10,13,10,11,10,10,13,10,9,6,11,10,11,12,12,11,10,10,12,12,20,11,12,12,13,10,7,12,11,8,11,11,13,7,12,8,D/DM C,1,1,1,10,1,1,20,1,9,19,15,1,1,1,5
2102218,Elias,1651,29/10/1983,32,0,0,0,0,179,83,1,3,2,3,2,2,3,3,3,3,2,11,6,9,8,12,11,12,9,10,14,9,8,15,11,11,13,10,9,9,10,13,8,10,10,14,12,11,13,12,11,14,11,7,14,12,20,14,12,12,14,6,10,9,11,11,12,9,11,8,11,2,DM/M C,1,1,1,1,1,1,1,1,1,17,20,1,1,1,1
2102245,Ricardinho,1651,06/11/1982,33,0,0,0,0,180,75,2,1,2,2,2,2,3,3,1,1,3,10,11,13,7,11,12,6,10,10,9,10,10,10,12,16,7,8,5,7,8,9,2,10,7,8,6,6,8,12,12,8,5,20,11,12,1,7,8,12,8,12,4,8,7,10,12,8,7,4,7,8,D/WB/M/AM LC,1,1,13,16,17,1,1,20,1,1,1,17,1,16,1
2102248,Osmar,1651,12/12/1984,31,0,0,0,0,187,71,1,3,3,3,1,2,2,1,1,2,2,8,10,9,7,8,8,13,8,5,14,13,6,12,9,10,11,13,10,12,7,14,13,9,12,9,11,12,11,11,8,17,16,10,15,8,20,7,16,11,8,10,15,16,10,10,10,13,10,3,15,4,DM/M RC,1,1,1,1,1,1,1,1,1,20,17,1,15,1,15
2102300,Danilinho,1651,11/03/1987,29,0,0,6,1,167,61,2,3,2,1,2,1,3,2,2,1,1,11,12,15,9,13,11,6,11,11,6,13,12,5,15,9,13,16,10,14,13,13,8,15,7,15,8,12,13,12,12,10,5,12,10,13,20,13,11,12,8,12,10,14,13,8,13,9,4,12,10,12,AM RC,1,1,15,20,8,16,1,1,1,1,15,1,1,1,1
2102379,Dida,1651,03/02/1984,32,0,0,0,0,193,93,12,10,10,5,12,10,11,11,10,10,10,2,3,2,3,3,4,2,1,3,3,3,5,2,5,4,12,14,11,14,7,12,15,1,13,3,12,11,10,8,11,15,16,9,14,7,20,10,17,10,7,10,10,10,10,10,11,8,10,7,9,1,GK ,20,1,1,1,1,1,1,1,1,1,1,1,1,1,1
2102406,Fabio Lopes,1651,24/05/1985,31,0,0,0,0,181,0,1,3,2,2,3,1,1,3,4,3,2,9,10,11,9,10,9,6,9,9,6,11,9,7,11,11,9,11,9,8,10,9,12,12,5,11,8,11,13,14,12,9,9,20,13,13,7,11,8,12,8,13,7,16,7,10,5,12,9,9,6,7,M/AM/S LC,1,1,17,15,20,1,1,1,1,1,13,18,1,1,1
2102439,Borebi,1651,08/08/1984,31,0,0,0,0,175,74,3,1,2,2,3,2,1,3,3,3,3,7,8,11,12,11,6,7,10,6,6,9,10,5,10,7,10,8,9,11,9,10,14,11,7,11,9,12,12,13,14,12,7,11,11,14,20,12,9,12,7,12,9,6,17,12,8,16,9,6,11,12,S ,1,1,20,1,1,1,1,1,1,1,1,1,1,1,1
2102451,Durval,1651,11/07/1980,35,1,0,0,0,184,82,3,3,4,2,2,2,1,4,1,3,2,1,6,10,8,11,12,13,11,8,14,12,13,14,12,14,15,15,12,13,9,13,16,11,17,10,14,14,14,9,9,8,12,20,15,10,12,14,13,16,12,15,7,10,11,13,15,14,19,14,14,6,D C,1,14,1,1,1,1,20,13,1,1,1,1,1,1,1
2102456,Edson Rocha,1651,12/03/1982,34,0,0,0,0,189,81,3,1,3,1,1,2,3,3,1,1,1,1,4,6,9,7,10,15,10,4,12,7,9,12,6,14,11,14,9,11,6,9,13,8,13,7,11,12,12,10,9,12,15,8,15,10,20,12,13,14,14,12,7,6,13,13,8,12,13,7,8,11,D C,1,11,1,1,1,1,20,1,1,1,1,1,1,1,1
21024805,Adam,1651,22/12/1991,24,0,0,0,0,178,73,1,2,2,3,3,3,2,2,3,3,3,8,4,9,9,12,8,8,10,1,10,13,3,15,10,1,10,6,6,5,8,10,3,8,6,8,12,7,11,11,10,12,9,10,8,11,20,13,9,9,6,9,7,9,14,11,9,9,10,3,5,3,DM ,1,1,1,1,1,1,1,1,1,20,12,1,1,1,1
2102527,Sandro Silva,1651,29/04/1984,32,0,0,0,0,186,76,2,2,4,3,1,1,2,1,2,2,3,5,9,12,9,9,7,9,10,9,11,10,10,11,8,16,12,16,10,8,10,11,12,12,9,11,11,15,14,12,13,12,11,7,14,12,20,14,12,11,12,10,10,13,9,12,8,10,14,13,15,11,DM/M C,1,1,1,1,1,1,1,1,11,20,18,1,14,1,13
2102598,Aloísio,1651,22/05/1985,31,0,0,0,0,179,75,3,2,1,3,1,1,3,2,3,3,1,13,12,12,10,13,12,7,12,11,7,13,17,7,12,11,9,12,11,9,13,10,11,13,5,12,8,11,11,12,12,9,7,20,12,12,7,10,8,12,10,12,5,16,11,13,10,14,14,13,12,11,D/WB/M/AM LC,1,1,1,20,19,1,1,17,1,7,15,16,1,18,1
2102604,Gustavo,1651,06/10/1982,33,0,0,0,0,184,78,2,3,3,2,1,2,3,1,2,3,1,7,2,2,2,8,5,14,2,4,10,8,3,10,7,9,13,9,7,12,3,14,1,5,6,6,14,7,8,9,8,8,13,10,9,11,20,10,8,9,9,9,5,9,17,11,10,11,13,4,12,7,D C,1,1,1,1,1,1,20,1,1,1,1,1,1,1,1
2102606,Ernâni,1651,16/07/1984,31,0,0,0,0,185,70,3,2,2,2,2,2,2,2,1,3,2,8,9,11,6,8,12,5,11,6,9,8,4,7,8,10,10,9,8,9,7,10,13,2,4,7,7,7,10,15,12,3,11,20,6,15,7,11,8,11,6,4,15,12,14,13,12,12,10,9,3,2,D/WB/DM LC,1,1,1,1,1,1,1,20,1,18,15,10,1,16,1
2102607,Tiago Alagoano,1651,04/10/1985,30,0,0,0,0,182,77,1,3,1,1,3,3,2,1,1,3,3,6,6,7,8,13,6,6,5,1,9,10,3,13,9,9,10,8,8,7,9,13,5,4,8,7,12,8,12,13,11,13,12,9,16,13,20,13,11,9,9,4,8,9,16,9,12,10,14,8,14,6,DM/M C,1,1,1,1,1,1,1,1,1,20,17,1,1,1,1
21026987,Hugo,1651,14/05/1989,27,0,0,0,0,175,67,3,3,2,3,1,1,1,2,3,3,1,6,8,13,13,13,7,12,9,5,6,9,8,3,13,8,9,9,10,9,5,13,4,13,12,13,8,7,6,13,13,9,5,10,13,13,20,9,6,10,8,6,10,9,7,10,10,11,13,1,13,2,AM/S R,1,1,20,1,1,17,1,1,1,1,1,1,1,1,1
2102749,Daniel Rezende,1651,17/03/1983,33,0,0,0,0,179,70,3,4,1,3,1,1,3,3,3,1,3,7,9,9,10,9,11,11,12,6,12,10,6,12,9,15,11,15,10,11,8,12,14,7,13,10,12,13,12,11,10,13,11,7,16,10,20,13,10,14,15,10,10,10,19,12,12,12,13,12,13,10,DM/M C,1,1,1,1,1,1,1,1,1,20,17,1,1,1,1
2102815,Leandro Santos,1651,30/06/1984,32,0,0,0,0,193,92,14,11,11,5,13,10,8,14,8,10,9,7,2,1,1,8,10,1,2,1,1,1,2,2,6,7,10,15,9,12,8,14,12,1,8,1,10,9,8,13,10,8,17,11,13,12,20,8,12,12,7,10,10,10,20,11,10,9,11,12,18,7,GK ,20,1,1,1,1,1,1,1,1,1,1,1,1,1,1
2102816,Jackson,1651,02/03/1984,32,0,0,0,0,175,72,3,2,3,2,3,3,3,2,1,3,1,5,12,12,3,9,5,8,7,6,10,12,11,11,10,13,10,12,9,11,9,10,13,11,12,7,11,12,13,12,10,8,7,2,12,12,20,10,10,13,7,14,7,12,11,11,12,12,12,8,12,7,D/WB R,1,1,1,1,1,1,1,1,20,1,1,1,1,1,17
2102820,Leonardo,1651,04/08/1985,30,0,0,1,0,171,69,2,3,4,3,3,1,1,3,2,2,2,10,12,13,8,13,10,6,10,14,10,11,8,10,13,12,13,12,11,10,12,12,12,14,10,12,10,11,16,14,13,10,5,20,10,14,5,13,10,11,7,10,16,8,12,16,16,13,16,14,14,9,D/WB/M L,1,1,1,1,5,1,1,20,1,1,1,17,1,18,1
2102827,Silas,1651,08/03/1985,31,0,0,0,0,179,71,2,2,1,3,2,1,3,2,1,3,1,12,11,12,11,11,11,10,10,5,5,11,10,6,12,6,9,8,10,8,11,10,10,11,7,10,10,11,9,11,11,11,8,10,12,11,20,12,10,11,5,9,6,10,10,10,8,8,14,14,8,10,M/AM C,1,1,7,20,8,13,1,1,1,5,18,4,9,1,1
2102830,Valdo,1651,22/11/1980,35,0,0,0,0,192,82,3,2,3,1,2,1,1,1,2,3,4,5,7,15,12,14,10,13,11,4,7,10,11,6,14,8,13,8,8,10,10,10,12,15,5,10,11,11,15,9,12,14,15,3,14,10,20,15,16,12,8,15,10,10,11,12,11,9,8,1,9,6,S ,1,1,20,1,1,1,1,1,1,1,1,1,1,1,1
2102876,Ari,1651,11/12/1985,30,0,0,0,0,180,82,3,1,3,3,2,3,4,2,3,2,2,10,11,12,13,16,12,8,13,8,8,13,13,8,16,9,13,12,13,11,14,16,13,12,8,13,9,12,9,14,14,15,10,13,11,13,20,12,13,8,14,12,7,8,16,12,10,12,9,16,15,8,S ,1,1,20,7,7,13,1,1,1,1,1,1,5,1,1
2102883,Anderson,1651,15/11/1981,34,0,0,0,0,179,72,3,3,1,4,1,3,1,2,3,2,3,7,6,13,13,13,5,13,8,3,7,6,7,6,13,10,11,14,9,7,7,13,10,13,4,13,7,4,8,13,12,7,10,9,17,13,20,7,10,9,10,6,5,10,7,9,12,10,11,12,6,4,S ,1,1,20,1,1,1,1,1,1,1,1,1,1,1,1
2103165,Fellype Gabriel,1651,06/12/1985,30,0,0,4,1,176,73,1,2,2,2,3,1,2,3,2,3,3,9,9,15,13,14,11,12,12,9,13,15,12,8,14,5,13,11,8,12,13,11,13,15,10,11,8,15,13,14,14,8,7,20,12,14,12,10,8,12,10,12,13,16,7,10,12,10,15,10,12,8,M/AM RLC,1,1,1,20,19,17,1,1,1,1,19,10,1,1,1
2103194,Adriano Alves,1651,01/07/1985,31,0,0,0,0,185,78,3,3,2,2,2,1,3,4,2,3,2,7,7,10,8,9,10,13,10,5,13,10,5,13,9,13,12,13,9,11,9,10,11,8,12,10,12,14,13,12,12,13,13,8,14,12,20,14,13,13,10,2,9,10,13,12,10,13,13,13,14,11,D/DM C,1,12,1,1,1,1,20,1,1,18,13,1,1,1,1
2103209,Walter,1651,10/05/1984,32,0,0,0,0,190,90,3,1,3,2,2,1,1,1,1,2,2,6,7,8,6,10,7,11,7,7,12,8,7,12,10,14,12,12,10,12,9,12,12,9,11,10,12,11,12,10,10,15,14,8,14,10,20,13,16,10,15,12,5,13,10,12,13,13,12,9,8,10,D/DM/M C,1,12,1,1,1,1,20,1,1,18,16,1,1,1,1
2103241,Marcos Aurelio,1651,10/02/1984,32,0,0,0,0,167,66,1,3,2,2,2,2,4,1,3,1,2,7,11,14,12,13,14,9,12,5,7,12,15,7,14,14,14,14,10,11,12,12,15,15,11,13,7,10,12,13,13,9,7,14,13,12,20,12,9,13,8,15,11,10,11,16,7,14,14,14,12,7,AM/S R,1,1,20,14,12,18,1,1,1,1,1,1,1,1,1
2103265,Júlio César,1651,19/01/1983,33,0,0,0,0,165,65,1,1,3,3,1,4,3,3,1,3,4,4,12,12,5,11,1,10,3,3,8,12,8,10,11,12,7,10,7,10,8,9,8,11,9,8,9,10,11,15,15,9,3,20,12,13,7,13,7,14,7,14,8,9,11,10,13,10,9,10,3,7,M/AM LC,1,1,1,1,20,1,1,13,1,1,15,16,1,15,1
2103269,Paulão,1651,08/07/1985,30,0,0,0,0,185,85,2,3,3,4,3,1,2,2,1,2,3,2,1,4,3,7,1,14,7,2,13,5,6,12,4,10,12,10,6,12,5,9,12,1,11,7,13,7,8,12,11,15,12,1,12,12,20,13,15,10,3,4,8,10,14,11,11,12,12,4,6,8,D C,1,1,1,1,1,1,20,1,1,1,1,1,1,1,1
2103290,André Luiz,1651,02/07/1985,31,0,0,0,0,173,68,2,4,3,2,2,2,3,3,2,1,3,9,9,11,8,11,8,5,8,11,7,11,7,9,12,13,9,12,9,8,9,9,14,13,8,12,8,10,13,13,12,12,7,20,13,13,8,12,9,10,6,10,12,12,13,12,11,10,11,9,9,8,D/WB/M L,1,1,1,10,12,1,1,18,1,1,5,17,1,20,1
2103294,Makelele,1651,26/02/1985,31,0,0,0,0,171,66,2,2,3,4,1,2,4,3,2,1,3,7,8,10,6,11,5,8,8,10,11,11,9,11,11,13,12,14,12,13,10,12,13,12,7,11,13,13,14,14,12,8,7,10,16,15,20,13,8,14,12,13,6,13,12,11,10,11,13,14,12,10,DM/M C,1,1,1,1,1,11,1,1,7,18,20,1,12,1,10
2103298,Everton Santos,1651,14/10/1986,29,0,0,0,0,176,68,1,1,3,2,2,2,1,3,2,2,3,9,11,12,10,13,11,10,12,5,5,11,12,6,13,10,11,12,11,11,12,11,13,11,8,12,5,11,11,14,14,15,8,12,12,14,20,10,6,11,7,10,8,12,9,14,11,12,12,10,13,7,M/AM RC,1,1,10,15,12,20,1,1,1,1,1,10,18,1,1
2103345,Fabinho Capixaba,1651,27/11/1983,32,0,0,0,0,179,75,3,2,1,2,3,3,3,3,1,1,2,6,9,10,6,10,9,9,8,12,8,10,8,9,10,13,10,12,8,8,9,8,11,11,7,10,8,12,11,12,12,10,9,9,13,12,20,12,9,9,8,11,6,11,14,13,13,11,15,15,14,10,D/WB R,1,1,1,1,1,12,1,1,18,10,10,1,12,1,20
2103355,Émerson,1651,22/07/1983,32,0,0,0,0,185,79,3,2,1,1,2,1,2,1,2,3,2,3,6,8,9,8,13,13,12,2,12,10,12,10,8,12,10,13,9,10,7,10,11,9,12,8,12,12,11,11,10,11,12,9,14,11,20,11,12,13,10,10,8,11,12,13,10,13,13,8,8,13,D C,1,12,1,1,1,1,20,1,1,15,5,1,1,1,1
2103504,Jeci,1651,22/04/1980,36,0,0,0,0,184,77,3,1,3,1,1,1,3,3,3,2,3,2,5,5,4,11,2,12,4,4,11,9,8,10,9,14,12,12,11,11,8,12,12,10,15,6,11,13,11,9,10,11,11,9,13,8,20,11,12,13,13,13,7,10,9,11,12,10,16,16,16,8,D C,1,18,1,1,1,1,20,1,1,1,1,1,1,1,1
2103513,Alex Silva,1651,09/06/1980,36,0,0,0,0,170,64,1,3,1,2,2,3,4,3,3,1,3,5,6,7,6,11,2,9,5,9,12,11,6,12,11,10,12,10,10,12,10,13,13,2,11,10,12,10,10,10,11,10,5,9,7,14,20,11,8,12,10,10,10,10,15,11,7,12,11,12,11,13,D/WB R,1,1,1,1,1,1,1,14,19,1,1,1,1,14,20
2103514,Magal,1651,16/09/1980,35,0,0,0,0,170,74,3,2,2,1,2,3,4,3,2,1,2,10,9,10,9,10,10,8,9,9,14,11,10,13,10,15,11,16,10,11,9,11,16,10,13,11,12,14,14,11,12,12,4,8,13,13,20,13,11,12,15,12,10,16,11,11,8,12,13,8,8,13,DM/M C,1,1,1,1,1,1,1,1,13,20,18,1,11,1,12
2103515,Pio,1651,17/01/1986,30,0,0,0,0,167,57,3,3,2,2,3,2,3,2,1,1,3,2,6,5,7,9,6,4,8,2,11,13,1,13,12,9,9,5,7,6,13,10,4,2,9,10,9,7,8,16,15,4,5,9,13,16,20,11,4,8,9,9,14,9,17,8,14,10,13,7,14,8,M C,1,1,1,1,1,1,1,1,1,1,20,1,1,1,1
2103519,Rodriguinho,1651,02/02/1983,33,0,0,0,0,174,77,3,1,2,3,3,3,3,3,4,4,1,11,10,10,11,11,9,10,9,3,4,10,14,4,10,15,12,14,12,13,11,9,8,12,10,12,5,12,15,13,11,12,7,12,13,12,20,13,11,13,11,14,12,14,6,13,12,12,12,10,10,7,AM/S R,1,1,20,10,12,16,1,1,1,1,1,1,1,1,1
2103730,Éder,1651,06/08/1984,31,0,0,0,0,183,81,14,11,11,6,13,13,7,14,7,10,13,5,1,2,2,3,10,1,1,3,1,1,2,2,1,10,13,15,8,11,8,14,12,2,11,1,14,9,8,13,10,9,11,11,14,11,20,6,9,10,8,9,10,10,11,12,10,13,11,7,1,6,GK ,20,1,1,1,1,1,1,1,1,1,1,1,1,1,1
2103731,Thiago Mattos,1651,12/05/1984,32,0,0,0,0,171,64,1,3,3,2,3,2,1,3,4,1,2,6,9,8,8,13,10,9,12,1,7,10,11,5,10,9,5,6,8,7,13,11,12,9,9,9,4,7,12,12,12,12,5,8,11,11,20,11,4,9,2,9,7,9,17,13,10,10,10,10,12,8,M/AM C,1,1,1,20,1,1,1,1,1,1,18,1,1,1,1
2103742,Éverton,1651,23/06/1984,32,0,0,0,0,182,80,2,1,2,1,1,3,2,2,2,2,3,8,4,5,7,14,8,8,10,4,11,10,4,13,10,9,10,8,8,10,15,15,9,9,8,9,12,9,13,11,10,9,10,6,16,9,20,13,8,9,8,7,8,9,14,13,11,12,10,9,11,7,DM/M C,1,1,1,1,1,1,1,1,1,20,16,1,1,1,1
2103743,Leandro Franco,1651,10/08/1981,34,0,0,0,0,175,70,1,4,2,1,1,2,1,1,3,1,3,11,10,13,13,12,7,10,8,4,7,10,15,6,12,9,10,7,9,10,10,9,12,12,9,9,5,7,11,12,12,9,8,20,13,12,11,11,9,14,5,14,8,15,12,10,7,10,13,12,12,9,AM/S LC,1,1,17,18,20,5,1,1,1,1,12,15,3,1,1
2103816,Adoniran,1651,12/12/1985,30,0,0,0,0,173,70,1,3,4,2,2,3,1,3,1,2,1,7,6,3,6,13,4,7,12,1,11,13,1,13,13,10,9,9,9,4,11,13,14,10,9,8,12,8,12,13,13,8,2,9,10,13,20,13,10,11,9,3,7,10,15,13,10,10,10,10,13,7,DM/M C,1,1,1,1,1,1,1,1,1,20,16,1,1,1,1
2103818,Roger,1651,10/08/1985,30,0,0,0,0,184,86,4,1,4,2,2,2,3,4,3,4,2,6,8,9,6,10,7,12,9,13,15,13,8,17,10,17,12,17,9,12,10,10,15,11,13,8,13,15,17,12,13,17,12,10,16,17,20,15,16,15,14,13,10,14,13,15,10,14,14,10,8,12,DM/M C,1,1,1,1,1,1,14,1,10,20,20,1,1,1,8
2103821,Cléberson,1651,04/07/1984,31,0,0,0,0,180,75,3,1,3,1,1,2,3,2,2,1,3,7,5,14,14,10,7,14,8,6,6,7,8,1,14,6,12,8,11,8,6,11,9,13,4,14,8,7,8,12,8,8,6,11,14,9,20,13,9,9,9,4,5,9,6,13,12,10,13,6,7,3,S ,1,1,20,1,1,1,1,1,1,1,1,1,1,1,1
2103963,Róbson,1651,13/09/1978,37,0,0,0,0,185,0,10,10,14,3,12,15,12,12,8,10,14,5,1,3,2,6,10,3,2,2,3,3,3,2,9,10,9,10,11,10,10,16,12,2,10,2,11,11,10,7,11,11,10,9,13,8,20,9,11,10,6,4,9,10,17,14,12,11,11,3,2,6,GK ,20,1,1,1,1,1,1,1,1,1,1,1,1,1,1
2103997,Ronaille Calheira,1651,23/03/1984,32,0,0,0,0,178,73,3,2,3,1,2,3,2,2,4,2,2,6,3,9,10,9,7,10,7,10,7,10,12,7,11,8,9,10,9,9,9,9,11,10,6,10,8,11,11,9,10,10,10,15,11,10,20,10,9,9,7,8,8,15,2,12,12,15,10,8,5,6,S ,1,1,20,14,1,1,1,1,1,1,1,1,1,1,1
2104025,Fábio Lima,1651,17/05/1984,32,0,0,0,0,186,0,14,11,9,3,11,14,9,8,9,5,9,6,3,1,1,2,8,1,3,1,2,1,3,2,2,9,8,12,7,9,7,14,11,1,6,2,14,8,7,10,14,8,8,2,16,10,20,4,8,9,4,9,9,9,12,11,13,11,10,3,8,4,GK ,20,1,1,1,1,1,1,1,1,1,1,1,1,1,1
2104040,Uilton,1651,19/04/1984,32,0,0,0,0,169,0,4,1,1,3,1,2,1,3,2,1,2,4,7,11,9,15,8,4,10,1,10,12,7,13,11,10,9,10,8,9,9,9,6,5,15,10,12,9,8,12,15,9,6,20,11,12,7,9,8,9,9,6,9,9,13,12,11,9,10,3,11,2,DM/M C,1,1,1,11,11,1,1,1,1,17,20,14,1,1,1
2104064,Neto Baiano,1651,17/09/1982,33,0,0,0,0,184,85,1,2,2,2,3,2,3,2,3,1,2,4,5,7,14,13,9,15,9,4,10,11,16,10,11,13,12,14,13,12,9,14,12,12,13,11,8,13,13,12,11,13,15,20,13,13,11,13,15,10,12,12,8,5,12,11,9,13,14,9,13,13,S ,1,1,20,1,1,1,1,1,1,1,1,1,1,1,1
2104271,Rafael Defendi,1651,21/01/1983,33,0,0,0,0,191,88,13,12,13,3,10,16,11,14,11,12,13,4,2,3,1,4,9,3,2,3,1,6,3,1,6,7,10,12,10,10,9,9,12,1,12,2,11,10,15,10,12,11,14,11,17,11,20,12,13,10,10,8,10,10,11,11,12,10,14,12,11,4,GK ,20,1,1,1,1,1,1,1,1,1,1,1,1,1,1
2104297,Bonfim,1651,30/03/1984,32,0,0,0,0,182,75,2,2,1,1,1,1,2,1,3,2,2,5,3,1,4,8,1,13,4,1,14,7,1,11,12,9,11,9,8,10,4,13,9,5,7,5,13,6,8,6,9,8,13,8,10,5,20,11,12,9,6,5,9,9,8,9,14,13,13,1,1,4,D C,1,1,1,1,1,1,20,1,1,12,11,1,1,1,1
2104325,Wellington Bruno,1651,25/04/1986,30,0,0,0,0,175,75,1,3,2,1,3,2,3,2,2,3,2,10,11,14,11,12,9,8,11,13,9,10,9,9,14,6,10,10,11,12,14,11,1,13,9,12,9,10,11,14,14,7,8,10,12,13,20,11,7,11,8,9,5,10,10,12,9,9,14,9,9,1,M/AM C,1,1,1,20,1,1,1,1,1,1,17,1,1,1,1
2104328,Otacílio Neto,1651,17/11/1982,33,0,0,0,0,175,74,3,3,2,3,3,2,2,1,3,1,3,12,10,11,11,10,12,10,13,13,8,9,13,6,10,13,9,12,9,9,9,11,12,11,9,12,5,10,9,13,11,12,7,20,12,12,9,10,12,11,12,14,8,11,20,12,12,11,12,11,12,10,S ,1,1,20,14,12,1,1,1,1,1,11,8,1,5,1
2104366,Marquinho,1651,03/07/1986,29,0,0,0,0,182,79,2,3,1,4,3,3,3,3,1,1,1,12,14,13,14,12,13,12,14,6,12,14,11,12,14,12,14,13,12,13,13,12,15,12,10,14,11,16,15,13,13,13,10,20,12,12,5,12,12,14,12,12,7,15,6,15,16,16,14,10,16,9,M/AM LC,1,1,1,15,19,1,1,8,1,1,20,15,1,15,1
2104370,Vinicius Reche,1651,28/01/1984,32,0,0,0,0,174,72,2,3,3,3,3,3,1,3,3,3,2,10,10,13,7,13,13,10,13,6,5,12,11,7,13,6,11,9,9,9,12,8,16,13,5,11,8,12,10,15,14,11,7,20,11,11,9,14,11,10,7,13,8,12,9,12,13,8,15,13,13,7,M LC,1,1,1,15,14,10,1,10,1,1,18,20,10,14,1
2104376,William Rocha,1651,22/08/1985,30,0,0,0,0,191,80,2,2,3,2,3,3,1,1,3,1,3,5,3,8,4,10,8,12,7,6,12,10,5,12,8,11,13,13,4,12,8,11,15,4,11,10,13,8,11,8,13,11,17,9,13,10,20,12,13,12,10,10,10,9,19,11,11,14,13,5,8,7,D/DM C,1,1,1,1,1,1,20,1,1,17,1,1,1,1,1
2104378,Zé Soares,1651,27/07/1983,32,0,0,0,0,174,65,1,4,2,4,1,4,2,4,3,3,2,11,11,12,8,10,10,8,5,9,6,11,10,8,10,18,9,17,9,9,8,10,15,12,8,10,5,11,12,13,11,9,6,10,11,13,20,10,5,12,8,12,8,9,8,12,11,14,12,9,9,3,AM RLC,1,1,10,19,16,20,1,1,1,1,1,1,1,1,1
2104379,Maicon,1651,16/02/1983,33,0,0,0,0,174,71,3,3,1,3,2,3,3,1,2,2,3,8,9,11,7,10,3,7,9,8,6,10,11,6,11,12,9,12,9,9,11,9,13,14,3,11,5,10,10,13,13,5,4,20,14,12,15,11,5,12,6,13,10,14,13,13,8,15,6,13,14,7,D/WB/M/AM L,1,1,3,13,19,14,1,16,1,1,7,18,1,20,1
2104392,Esquerdinha,1651,09/04/1984,32,0,0,0,0,175,70,3,1,3,3,1,3,2,3,2,2,3,13,11,13,8,10,13,5,11,6,5,10,11,4,12,6,10,8,10,7,13,9,10,13,7,13,5,6,9,13,12,5,5,20,10,12,5,9,5,11,7,6,9,12,11,14,9,10,9,8,12,12,D/WB/M/AM RLC,1,1,14,17,19,16,1,19,1,1,10,16,10,20,1
2104538,Marcelinho,1651,10/01/1984,32,0,0,0,0,181,80,2,2,4,1,1,2,3,2,1,3,2,8,10,10,14,11,9,11,10,4,6,9,11,4,11,9,9,9,12,9,8,9,11,10,7,12,5,9,11,12,11,10,10,10,13,13,20,10,10,11,9,11,7,10,11,12,12,13,12,12,12,8,S ,1,1,20,1,1,1,1,1,1,1,1,1,1,1,1
2104631,Jean Carlos,1651,17/03/1984,32,0,0,0,0,178,74,3,2,1,2,3,3,3,3,2,1,3,6,9,11,10,10,4,10,10,4,4,11,12,7,11,12,11,11,11,11,10,12,13,12,10,11,6,11,12,12,12,10,9,20,13,12,7,11,10,13,15,8,9,15,5,12,12,11,8,8,8,9,AM/S C,1,1,20,18,14,13,1,1,1,1,9,10,7,1,1
2104670,Fábio Santos,1651,21/04/1987,29,0,0,0,0,184,74,1,3,2,4,3,3,3,2,2,2,2,3,6,12,12,12,4,13,12,5,4,10,13,2,11,14,12,12,12,11,9,12,9,10,5,12,9,12,13,13,12,14,13,13,12,13,20,12,13,11,11,10,6,5,13,12,14,11,10,1,8,1,S ,1,1,20,1,1,1,1,1,1,1,1,1,1,1,1
2104673,Paulinho Macaíba,1651,18/08/1983,32,0,0,0,0,173,70,1,4,2,2,3,3,2,1,1,2,2,2,8,12,11,9,6,10,7,2,5,10,11,4,12,7,10,16,8,9,9,10,11,12,9,14,7,8,10,14,14,7,6,11,12,14,20,12,7,12,7,13,11,7,14,14,11,11,12,12,12,14,S ,1,1,20,10,10,10,1,1,1,1,1,1,1,1,1
2104676,Ytalo,1651,12/01/1988,28,0,0,0,0,178,72,1,3,2,2,1,1,2,2,1,1,1,9,9,13,13,12,10,13,13,6,7,12,13,7,12,10,11,12,13,12,12,10,5,11,11,12,12,12,12,13,12,14,12,12,14,14,20,14,10,12,12,10,10,11,7,13,12,9,11,4,11,7,S ,1,1,20,12,1,1,1,1,1,1,1,1,1,1,1
2104690,Renan,1651,19/06/1986,30,0,0,0,0,186,82,2,3,2,3,3,1,3,1,3,1,2,12,14,10,12,12,14,10,14,12,13,14,12,14,13,16,13,14,13,13,12,12,13,12,8,12,13,14,14,12,12,14,10,20,15,11,6,15,16,13,11,12,7,11,13,15,14,14,14,14,13,10,DM/M C,1,1,1,1,1,1,1,8,1,16,20,14,1,10,1
2104755,Renato Peixe,1651,26/02/1979,37,0,0,0,0,176,70,1,2,3,3,3,1,3,1,1,3,1,10,11,9,11,9,12,10,10,10,7,10,10,6,10,12,9,10,7,9,10,9,2,9,9,10,10,8,8,12,12,9,8,20,12,12,12,12,9,12,11,11,6,9,16,15,12,10,10,6,9,8,D L,1,1,1,1,1,1,1,20,1,1,1,1,1,15,1
2104762,Leandro,1651,31/03/1985,31,0,0,0,0,185,79,1,1,2,3,1,1,3,1,3,3,1,2,6,9,7,9,4,10,8,4,12,9,6,11,9,18,12,15,9,11,7,10,17,10,8,10,13,13,13,12,13,13,12,10,16,12,20,15,12,14,17,12,8,9,13,13,13,13,11,6,7,14,DM C,1,11,1,11,1,1,14,1,5,20,15,1,1,1,1
2104765,Serginho Catarinense,1651,16/09/1984,31,0,0,0,0,177,76,2,1,3,1,3,3,2,1,3,1,1,9,10,9,9,12,10,5,12,5,10,13,11,9,12,9,11,10,11,9,12,11,13,11,9,11,9,11,12,13,13,9,8,8,14,13,20,12,6,12,9,11,3,9,18,13,10,9,12,1,1,7,DM/M C,1,1,1,14,1,1,1,1,1,20,18,1,1,1,1
2104834,Mika,1651,27/01/1987,29,0,0,0,0,183,70,1,2,3,3,2,2,1,3,1,4,3,10,8,10,10,10,10,10,12,5,12,12,6,11,11,11,10,12,11,11,10,11,9,9,8,11,13,13,13,12,12,11,12,10,14,12,20,13,10,10,9,5,8,10,12,11,11,10,13,14,15,10,DM C,1,1,1,1,1,1,11,1,1,20,15,1,1,1,1
2104835,Rafael Bitencourt,1651,13/04/1987,29,0,0,0,0,177,71,2,1,2,1,3,3,4,3,2,2,2,10,9,10,10,9,10,5,9,6,7,10,4,8,10,9,10,8,9,10,11,13,5,8,10,10,7,7,12,11,10,11,7,10,12,10,20,12,6,9,7,6,4,9,15,13,13,13,12,10,17,7,AM C,1,1,1,20,1,1,1,1,1,1,15,1,1,1,1
2104844,Cidinho,1651,23/10/1987,28,0,0,0,0,170,68,1,3,2,3,3,3,3,3,1,2,1,8,6,14,14,12,8,10,8,1,7,9,7,3,12,10,11,9,10,9,9,11,6,11,1,14,9,8,9,14,14,9,10,3,15,14,20,6,6,10,6,10,10,10,15,10,12,11,13,6,10,7,S ,1,1,20,1,1,1,1,1,1,1,1,1,1,1,1
2104896,Marciano,1651,12/07/1980,35,0,0,0,0,174,0,1,3,3,1,3,2,2,1,4,2,1,10,8,10,4,10,10,7,10,10,10,8,8,12,10,15,8,14,11,11,8,8,13,13,8,9,13,12,14,13,9,9,6,10,12,13,20,9,10,14,12,14,6,15,15,13,8,11,9,11,10,9,M/AM C,1,1,10,17,10,10,1,1,1,15,20,1,1,1,1
2104916,Kléo,1651,20/04/1982,34,0,0,0,0,175,66,2,2,2,2,1,3,1,2,2,2,3,13,12,11,10,12,14,7,10,1,6,11,9,6,11,12,9,10,10,10,12,10,9,9,9,10,7,9,10,12,12,8,8,12,14,11,20,8,8,9,11,14,9,7,13,13,9,10,10,10,8,6,M/AM RC,1,1,1,20,1,17,1,1,1,1,18,1,15,1,1
2104919,Misael,1651,04/07/1987,28,0,0,0,0,170,65,3,3,2,1,1,3,1,2,2,3,2,6,12,14,10,12,11,7,10,4,5,11,12,5,12,10,9,11,9,9,11,12,15,16,6,11,6,9,10,16,15,8,5,9,13,16,20,13,7,14,7,13,7,14,9,13,15,13,13,6,8,12,S RL,1,1,20,14,15,15,1,1,1,1,7,5,5,1,1
2105144,Daniel Melo,1651,28/08/1980,35,0,0,0,0,190,83,1,2,2,2,1,4,1,1,2,3,1,1,4,5,1,6,5,13,5,4,13,8,7,13,6,8,10,13,7,11,4,10,12,10,8,4,13,12,12,8,7,8,16,10,12,9,20,9,14,15,5,10,10,10,11,12,12,12,11,11,11,10,D C,1,11,1,1,1,1,20,1,1,5,1,1,1,1,1
2105145,Raphael Andrade,1651,07/09/1982,33,0,0,0,0,189,86,2,2,4,3,1,3,1,3,3,2,3,7,3,2,3,7,6,12,8,4,10,7,6,11,7,9,14,10,9,11,7,11,3,1,14,8,11,8,9,10,11,9,14,7,9,10,20,12,12,12,5,10,8,10,17,13,11,13,10,10,16,7,D C,1,1,1,1,1,1,20,1,1,1,1,1,1,1,1
2105154,Diego Paulista,1651,05/08/1986,29,0,0,0,0,181,74,1,3,1,1,2,1,1,2,4,1,3,5,6,4,3,13,4,6,13,5,8,12,3,13,13,9,7,8,7,8,7,13,6,5,10,8,7,8,10,14,13,10,9,10,14,14,20,6,7,12,9,9,9,9,17,10,11,12,8,9,17,8,DM/M C,1,1,1,1,1,1,5,1,1,19,20,1,1,1,1
2105163,Bruno Andrade,1651,28/11/1983,32,0,0,0,0,189,0,2,2,2,1,3,1,3,2,2,4,3,5,6,7,13,13,5,13,6,1,5,6,3,1,11,6,7,7,7,6,6,8,6,11,14,12,3,5,6,12,9,5,11,8,12,9,20,9,9,8,8,8,8,8,10,11,10,12,11,1,1,5,S ,1,1,20,1,1,1,1,1,1,1,1,1,1,1,1
2105353,Thiago Marabá,1651,18/05/1986,30,0,0,0,0,167,67,3,3,1,1,3,2,1,1,3,3,2,7,8,12,14,10,7,11,7,3,7,8,10,3,13,9,9,8,10,8,9,13,9,12,13,14,8,7,9,15,14,8,4,1,13,15,20,13,7,9,6,5,5,9,19,10,10,14,12,3,11,6,AM/S C,1,1,20,17,1,1,1,1,1,1,10,1,1,1,1
2105434,Paulo César,1651,27/03/1986,30,0,0,0,0,194,97,12,11,11,2,12,10,11,12,11,7,12,3,2,1,2,6,5,3,2,1,3,3,1,3,4,12,9,13,10,8,4,8,11,3,8,3,9,8,10,8,7,14,13,4,13,7,20,12,14,9,6,9,4,8,9,8,14,10,14,12,16,6,GK ,20,1,1,1,1,1,1,1,1,1,1,1,1,1,1
2105440,Welliton,1651,22/10/1986,29,0,0,0,0,175,76,1,2,1,3,2,3,1,1,4,2,3,5,3,9,14,14,3,10,11,2,4,12,14,4,15,9,13,15,13,11,9,11,14,10,2,17,7,14,14,15,14,10,11,11,13,15,20,12,12,8,12,14,13,12,13,16,14,7,12,7,15,5,S ,1,1,20,1,10,10,1,1,1,1,1,1,1,1,1
2105510,Hulk,1651,25/07/1986,29,48,11,0,0,180,85,3,1,3,2,2,1,3,3,3,3,2,16,15,14,16,14,16,8,17,11,5,15,14,8,15,12,12,14,12,12,14,13,16,17,15,16,9,10,12,17,15,17,10,20,18,15,10,16,15,14,12,14,7,11,16,17,14,13,13,8,8,13,AM RL,1,1,13,10,15,20,1,1,1,1,1,7,10,1,1
2105530,Leandro Xavier,1651,17/02/1984,32,0,0,0,0,178,81,3,1,3,1,3,1,1,3,1,3,2,8,6,10,8,14,8,5,13,5,10,14,5,10,14,9,13,9,9,4,13,11,3,13,8,13,9,9,11,11,11,9,5,3,8,9,20,8,8,10,9,10,10,10,19,12,11,9,11,7,14,1,M/AM C,1,1,1,18,1,1,1,1,1,1,20,1,1,1,1
2105544,Israel,1651,22/07/1985,30,0,0,0,0,179,0,2,3,2,2,2,2,4,1,3,2,1,11,11,9,8,12,10,8,9,3,11,9,4,8,9,13,6,5,7,6,6,10,7,9,10,10,10,8,12,13,13,9,8,20,12,13,10,7,11,9,11,9,9,12,18,11,12,13,10,9,7,3,AM LC,1,1,8,20,16,1,1,1,7,1,8,13,1,10,9
2105600,Tales,1651,28/12/1985,30,0,0,0,0,186,80,3,1,3,1,1,2,2,1,3,2,1,2,1,1,1,7,1,13,5,6,13,4,2,13,2,9,7,9,6,10,1,11,6,9,11,6,13,6,7,9,10,7,12,9,11,13,20,12,10,9,9,9,9,9,20,12,12,12,12,10,14,5,D C,1,1,1,1,1,1,20,1,1,1,1,1,1,1,1
2105621,Raí,1651,21/09/1986,29,0,0,0,0,177,72,3,1,1,1,3,2,2,1,2,2,3,10,12,12,9,10,11,6,10,11,7,10,8,9,11,11,8,14,7,8,13,8,15,13,6,11,11,12,11,14,14,8,7,20,13,13,12,12,7,11,11,10,9,13,18,12,11,11,10,8,8,7,D/WB/AM LC,1,1,1,18,19,1,1,18,1,1,1,13,1,20,1
2105622,Curuca,1651,27/08/1984,31,0,0,0,0,164,71,1,3,1,3,1,3,1,4,3,3,1,8,8,10,9,14,8,9,10,3,10,12,8,9,11,13,12,9,10,10,11,14,5,10,11,10,10,9,12,12,12,7,4,10,8,13,20,12,6,10,13,3,10,10,17,10,10,11,10,8,8,8,DM/M/AM C,1,1,1,16,1,1,1,1,1,18,20,1,1,1,1
2105641,Gabriel,1651,16/07/1986,29,0,0,0,0,170,0,1,2,1,2,2,2,1,1,3,4,3,8,7,11,8,15,8,6,9,4,7,10,11,5,11,12,11,5,11,9,4,11,4,9,12,13,9,8,9,14,14,7,6,10,12,13,20,14,6,9,8,9,7,9,12,9,8,10,6,7,8,13,S ,1,1,20,1,1,1,1,1,1,1,1,1,1,1,1
2105790,Pantera,1651,07/01/1983,33,0,0,0,0,186,96,11,9,11,4,13,11,11,13,11,12,10,2,2,3,3,6,7,1,1,2,1,5,4,1,9,8,12,16,10,11,10,10,12,2,10,3,12,11,10,7,12,11,13,1,6,9,20,10,12,13,7,5,8,10,14,12,12,11,11,9,9,13,GK ,20,1,1,1,1,1,1,1,1,1,1,1,1,1,1
2105945,Diego Silva,1651,23/10/1982,33,0,0,0,0,181,81,3,3,1,2,1,1,2,3,1,2,2,8,7,14,13,16,9,13,7,6,9,10,10,8,14,8,7,10,8,11,9,12,13,8,8,12,11,12,8,11,10,15,10,1,14,11,20,11,12,11,5,8,10,7,5,9,1,13,4,9,13,15,S ,1,1,20,1,1,1,1,1,1,1,1,1,1,1,1
2106153,Léo Gago,1651,17/02/1983,33,0,0,0,0,178,76,3,3,2,2,2,4,2,3,2,3,3,10,10,10,10,10,12,9,13,4,12,11,14,12,9,12,11,14,11,10,9,10,14,10,10,8,12,13,11,12,11,12,8,20,13,11,14,12,12,13,12,12,9,9,7,13,7,10,13,9,13,6,DM/M C,1,1,1,1,1,1,1,1,1,20,18,1,1,1,1
2106341,Wanderson,1651,06/10/1980,35,0,0,0,0,181,78,1,1,1,1,3,2,2,2,1,2,3,6,4,6,7,14,8,8,10,8,9,11,4,13,14,8,11,11,7,9,13,14,14,8,10,9,9,9,13,8,9,11,11,11,14,8,20,15,10,11,11,6,6,10,15,10,11,11,8,8,9,8,DM C,1,1,1,1,1,1,1,1,1,20,15,1,1,1,1
2106387,Diego,1651,22/08/1986,29,0,0,0,0,178,63,2,1,1,1,4,3,3,2,4,1,3,13,12,13,11,11,16,6,13,1,1,12,14,1,12,5,5,6,7,5,11,6,8,10,3,10,6,6,8,13,14,7,9,20,12,14,10,11,5,10,5,10,10,10,2,12,10,11,11,1,12,5,M/AM/S LC,1,1,16,19,20,1,1,1,1,1,16,16,1,1,1
2106566,Glédson,1651,06/02/1983,33,0,0,0,0,192,86,12,13,14,8,13,11,13,15,13,12,13,3,4,5,4,9,8,7,5,3,4,8,8,5,8,12,13,12,12,13,6,11,16,8,15,6,12,10,10,9,13,12,15,3,14,10,20,12,15,15,9,12,7,5,10,12,15,15,17,12,14,7,GK ,20,1,1,1,1,1,1,1,1,1,1,1,1,1,1
2106581,Rodrigo Heffner,1651,08/09/1982,33,0,0,0,0,175,73,4,3,3,3,1,2,2,4,2,1,2,10,12,6,7,10,13,9,11,13,12,13,5,8,12,16,11,12,9,11,13,11,14,10,4,13,13,13,14,12,13,10,7,9,14,13,20,12,10,14,9,13,6,14,15,13,8,13,13,14,14,11,D R,1,1,1,1,1,1,1,13,20,1,1,1,1,1,10
2106674,Doka Madureira,1651,11/02/1984,32,0,0,0,0,178,72,3,1,3,3,1,2,2,2,3,1,2,13,13,14,11,15,14,7,14,4,5,13,14,7,15,11,10,13,12,8,11,10,10,17,7,11,7,9,14,13,13,14,8,8,10,14,20,10,10,12,12,14,6,15,15,12,13,10,12,5,9,5,M/AM LC,1,1,14,16,20,14,1,1,1,1,10,19,14,1,1
2106688,Reinaldo,1651,13/06/1984,32,0,0,0,0,194,85,1,3,1,3,2,3,1,2,3,2,2,4,5,11,10,10,8,13,6,6,7,12,15,8,10,10,13,11,9,10,10,9,15,11,5,12,8,11,14,12,10,11,13,20,7,12,11,12,14,7,5,12,14,5,10,6,12,12,11,13,11,11,S ,1,1,20,1,1,1,1,1,1,1,1,1,1,1,1
2106753,Hudson,1651,21/05/1977,39,0,0,0,0,189,95,13,10,7,2,9,6,11,12,3,6,11,3,2,2,3,1,8,1,3,3,3,1,1,2,2,8,6,12,4,12,5,13,10,1,6,3,7,6,5,13,5,5,13,2,4,12,20,6,16,8,8,7,8,8,19,12,11,11,13,5,14,5,GK ,20,1,1,1,1,1,1,1,1,1,1,1,1,1,1
2106785,Bruno Aguiar,1651,25/03/1986,30,0,0,0,0,186,84,2,1,3,3,1,3,3,3,2,3,3,7,10,9,8,11,13,14,7,6,13,10,13,12,11,14,12,15,12,12,9,12,11,12,13,11,13,12,13,14,10,14,14,10,13,14,20,12,14,13,12,12,9,7,12,15,14,12,12,11,11,13,D C,1,11,1,1,1,1,20,1,1,1,1,1,1,1,1
2106787,Nei,1651,06/12/1985,30,0,0,0,0,175,72,1,2,3,2,10,1,1,1,1,2,2,12,11,9,8,9,10,11,10,5,10,12,10,10,11,13,12,17,11,12,9,10,12,8,12,12,10,12,12,12,12,11,8,10,14,11,20,13,11,13,15,12,11,15,8,13,13,11,13,8,12,11,D/WB RL,1,1,1,1,1,1,14,17,20,1,1,1,12,16,19
2106791,Alexandre Black,1651,28/09/1986,29,0,0,0,0,178,80,2,2,3,3,1,2,1,2,3,1,3,8,3,8,2,10,8,11,5,3,14,9,5,12,10,10,12,10,9,8,9,12,15,10,9,8,13,8,10,10,8,12,13,15,16,10,20,11,12,9,10,10,10,10,14,12,8,12,12,1,7,3,D C,1,1,1,1,1,1,20,1,1,15,10,1,1,1,1
2106792,George,1651,07/01/1986,30,0,0,0,0,175,71,3,3,2,2,2,1,4,3,2,2,2,11,12,13,2,9,9,8,8,10,9,10,1,8,10,9,10,9,8,11,8,11,8,8,15,6,11,9,9,15,12,11,8,20,11,14,9,7,6,9,6,9,3,9,16,8,11,7,11,9,5,8,D/WB L,1,1,1,1,1,1,1,20,1,1,8,10,1,18,1
2106798,Caio,1651,20/05/1986,30,0,0,0,0,177,70,3,4,3,2,2,1,2,1,3,4,4,6,5,8,8,10,5,2,12,2,6,13,4,5,13,5,9,4,9,6,7,12,4,13,9,11,7,7,6,13,13,7,7,10,10,13,20,11,7,9,8,9,7,9,9,11,10,12,12,6,15,5,M/AM C,1,1,1,20,1,1,1,1,1,1,18,1,1,1,1
2106803,Fabiano,1651,24/11/1985,30,0,0,0,0,187,75,3,2,2,3,2,2,2,3,3,1,1,10,8,11,10,12,10,11,9,3,10,12,13,11,12,13,14,11,8,8,10,12,7,16,13,14,7,10,9,12,13,11,7,13,12,11,20,10,10,11,6,10,10,9,16,10,8,12,11,3,1,2,M/AM/S C,1,10,20,18,1,1,12,1,1,14,16,1,1,1,1
2106876,Jorge Henrique,1651,29/10/1982,33,0,0,0,0,175,73,1,1,3,1,3,3,3,4,3,2,2,11,9,11,9,9,12,7,9,1,5,10,12,7,10,14,9,12,9,9,10,9,14,16,10,11,8,11,11,11,12,8,5,20,13,12,9,11,9,14,10,12,7,12,13,14,9,12,12,9,9,13,D/WB/M/AM LC,1,1,12,17,19,13,1,20,1,5,18,15,8,18,1
2106958,Patrick,1651,19/07/1983,32,0,0,0,0,173,70,3,3,1,2,1,2,1,1,1,1,2,9,9,10,8,9,7,6,8,13,9,10,11,9,10,12,10,11,10,10,9,10,13,12,8,11,10,11,11,11,11,12,5,8,15,11,20,12,8,14,5,13,9,15,13,13,11,13,12,12,12,11,D/WB R,1,1,1,5,1,7,1,9,18,15,8,1,12,6,20
2106960,Agenor,1651,07/08/1981,34,0,0,0,0,179,79,3,3,1,1,2,2,1,3,3,1,3,3,6,7,8,9,7,11,8,6,12,9,9,12,9,14,11,13,11,11,9,9,12,11,14,9,13,14,13,11,9,12,9,8,14,10,20,13,12,13,12,13,7,14,16,8,11,12,10,10,12,11,DM/M C,1,11,1,1,1,1,13,1,1,20,17,1,1,1,1
2107031,Guilherme Finkler,1651,24/09/1985,30,0,0,0,0,184,79,3,4,3,4,1,1,2,3,2,1,2,12,9,14,11,17,14,5,12,7,7,14,12,5,15,7,14,9,12,9,15,12,11,15,9,11,4,10,9,9,13,10,12,9,10,9,20,10,9,12,2,14,10,12,14,13,9,12,11,12,11,8,M/AM RLC,1,1,7,18,17,19,1,1,1,1,20,16,15,1,1
2107117,Valtinho,1651,22/03/1985,31,0,0,0,0,189,85,1,3,3,4,3,3,1,1,2,3,2,7,7,3,6,9,7,9,8,4,12,14,1,13,9,9,10,6,8,6,5,14,9,9,6,7,11,8,13,9,8,8,10,9,12,8,20,10,10,9,9,9,9,9,12,9,13,12,11,3,8,5,D/DM C,1,1,1,1,1,1,19,1,1,20,15,1,1,1,1
2107192,Paulo Sérgio,1651,25/01/1981,35,0,0,0,0,187,81,12,13,10,4,9,13,6,10,5,9,12,3,1,1,3,3,6,1,2,2,2,3,4,1,2,8,10,15,8,12,7,14,9,3,11,3,11,8,6,12,6,8,16,9,11,9,20,2,11,9,9,9,9,9,16,12,14,11,12,4,9,5,GK ,20,1,1,1,1,1,1,1,1,1,1,1,1,1,1
2107194,Démerson,1651,16/03/1986,30,0,0,0,0,185,81,2,1,3,3,2,4,3,2,1,2,3,7,8,7,8,10,8,13,8,7,14,10,8,13,10,14,11,15,12,10,7,12,13,12,13,11,13,13,13,11,12,8,13,9,12,11,20,14,12,12,11,10,5,6,11,9,13,12,13,8,9,6,D C,1,1,1,1,1,1,20,1,1,1,1,1,1,1,1
2107195,Édson Silva,1651,09/05/1986,30,0,0,0,0,187,92,3,2,1,1,3,4,3,3,2,1,1,5,10,8,8,9,4,12,9,7,12,9,13,12,8,14,11,14,12,11,9,11,14,8,11,9,12,13,12,10,11,13,13,20,16,10,6,13,15,12,13,13,6,10,7,12,12,16,17,14,13,10,D C,1,12,1,1,1,1,20,11,8,8,4,1,1,1,1
2107202,Cris,1651,08/07/1987,28,0,0,0,0,175,60,1,1,2,1,2,2,2,1,2,1,2,7,5,3,8,14,7,6,9,2,8,10,4,12,9,6,10,5,9,6,14,12,5,9,9,11,7,8,13,14,14,8,9,2,13,14,20,14,6,9,7,1,8,9,12,10,13,12,10,9,5,8,M C,1,1,1,1,1,1,1,1,1,1,20,1,1,1,1
2107206,Ednaldo Baiano,1651,22/04/1987,29,0,0,0,0,179,78,1,3,2,2,2,3,3,1,3,1,1,2,5,7,4,13,6,6,7,3,10,13,2,9,13,8,9,1,9,7,13,11,7,4,8,9,8,7,12,13,13,5,5,6,11,13,20,12,7,9,7,9,6,9,18,10,12,10,11,3,1,2,M C,1,1,1,1,1,1,1,1,1,1,20,1,1,1,1
2107219,Reinaldo Alagoano,1651,13/04/1986,30,0,0,0,0,179,74,3,3,4,1,3,3,3,2,3,2,2,5,10,11,13,12,4,13,8,5,5,10,14,7,11,13,10,13,12,11,10,12,12,12,5,13,10,12,12,13,13,12,12,9,12,12,20,13,13,10,11,12,7,8,11,12,14,13,10,11,14,13,S ,1,1,20,1,1,1,1,1,1,1,1,1,1,1,1
2107220,Eduardo,1651,12/11/1986,29,0,0,0,0,173,70,2,3,1,3,3,2,1,3,2,1,3,8,9,10,10,11,9,8,9,9,8,10,9,10,11,10,11,12,9,9,11,10,11,13,9,9,10,10,11,10,11,12,7,5,12,10,20,10,10,9,9,12,13,12,10,11,8,12,11,11,10,2,AM RLC,1,1,15,20,15,17,1,1,1,1,5,7,10,1,1
2107429,Lenilson,1651,09/10/1983,32,0,0,0,0,171,68,1,3,3,1,1,1,2,1,3,2,3,8,7,9,11,13,12,8,8,5,7,9,6,8,11,10,7,9,8,8,11,10,11,11,10,11,8,8,8,12,13,8,5,9,8,13,20,12,6,10,10,10,3,10,19,13,12,12,11,9,8,4,M/AM C,1,1,12,20,1,1,1,1,1,1,18,1,1,1,1
2107479,Rodrigo Ramos,1651,19/08/1979,36,0,0,0,0,183,78,11,10,14,6,10,10,12,12,11,13,8,3,2,3,3,8,6,2,2,3,1,4,1,1,4,10,12,13,14,11,9,15,4,1,17,1,11,10,9,11,13,10,11,9,12,8,20,5,12,10,8,10,10,10,10,16,11,12,10,9,7,5,GK ,20,1,1,1,1,1,1,1,1,1,1,1,1,1,1
2107495,Anderson Alberti,1651,24/04/1990,26,0,0,0,0,186,85,7,7,9,1,9,8,5,10,8,10,11,3,2,1,2,2,8,1,3,2,3,1,1,2,2,6,9,7,6,12,6,13,1,2,8,2,13,7,6,12,15,6,12,8,15,10,20,3,14,8,9,8,7,9,19,10,9,12,7,6,10,3,GK ,20,1,1,1,1,1,1,1,1,1,1,1,1,1,1
2107496,Rafael Forster,1651,23/07/1990,25,0,0,3,0,181,75,3,2,1,3,1,4,2,3,1,1,1,8,12,11,5,12,14,12,13,7,13,14,13,13,13,11,12,13,13,13,12,11,14,12,13,12,11,12,14,12,12,14,14,20,10,13,10,13,13,11,9,11,4,14,19,13,15,13,15,12,11,6,D/WB LC,1,1,1,1,1,1,20,16,1,12,1,1,1,16,1
2107497,Tales,1651,20/01/1990,26,0,0,17,3,168,64,1,1,2,3,2,3,3,2,1,1,2,10,10,11,11,11,15,4,11,2,3,10,14,4,12,7,11,7,11,11,11,11,12,12,8,10,5,8,12,14,13,7,5,10,12,13,20,12,7,8,7,8,10,7,15,15,14,9,11,6,10,9,M/AM C,1,1,14,20,1,1,1,1,1,1,16,1,1,1,1
2107498,Léo Vieira,1651,22/09/1990,25,0,0,2,0,193,77,15,11,15,1,12,15,9,12,10,10,11,6,3,3,2,6,10,2,1,3,2,4,1,1,7,8,14,16,10,11,4,15,15,1,8,2,15,11,10,11,7,11,17,7,17,13,20,6,13,11,11,2,9,11,19,15,11,11,10,2,12,8,GK ,20,1,1,1,1,1,1,1,1,1,1,1,1,1,1
2107499,Raul,1651,13/03/1990,26,0,0,1,0,173,72,2,3,2,1,1,2,3,2,2,3,1,11,10,9,9,11,8,7,9,5,6,10,9,5,11,12,11,11,9,10,9,10,15,13,10,10,7,11,11,12,10,9,7,11,12,13,20,12,9,13,7,12,10,12,14,14,9,15,14,13,13,10,D/WB R,1,1,1,1,1,1,1,1,18,1,1,1,1,1,20
2107500,Rafael,1651,09/07/1990,25,2,0,6,1,172,72,1,1,1,1,3,2,3,2,1,1,1,6,15,13,8,13,6,10,8,10,11,12,6,14,14,16,14,15,10,12,10,12,17,13,6,14,11,14,15,16,16,13,9,11,13,16,20,14,10,14,15,15,12,12,15,17,12,15,16,10,12,5,D/WB R,1,1,1,1,1,1,1,12,20,1,1,1,12,12,20
2107501,Fábio,1651,09/07/1990,25,2,0,0,0,172,69,2,3,3,4,1,4,3,1,2,3,3,9,12,13,10,13,10,8,10,9,11,12,13,13,13,12,10,14,11,10,8,10,15,15,8,14,9,11,15,15,15,14,9,15,14,15,20,12,8,12,14,14,14,15,14,16,10,15,15,14,15,6,D/WB RL,1,1,1,1,10,10,1,19,20,1,1,10,10,16,16
2107504,Bruno Veiga,1651,09/01/1990,26,0,0,0,0,170,69,2,2,2,1,3,2,3,3,1,3,2,8,11,13,11,12,7,9,9,5,4,12,13,5,13,10,11,9,11,10,12,10,15,13,5,11,6,9,11,15,14,8,6,10,15,15,20,12,8,12,8,10,7,14,8,15,12,13,14,8,12,8,S ,1,1,20,10,12,13,1,1,1,1,1,1,1,1,1
2107506,Bernardo,1651,20/05/1990,26,0,0,12,1,177,70,2,3,1,1,1,1,1,2,3,1,3,13,11,12,11,13,13,8,12,9,5,12,13,6,14,14,11,11,9,10,11,12,8,14,10,11,4,7,8,13,13,7,8,9,14,12,20,12,6,10,8,11,10,14,10,12,12,8,10,5,12,15,AM RLC,1,1,15,20,15,16,1,1,1,1,14,10,14,1,1
2107507,Lucão,1651,28/06/1990,26,0,0,1,2,184,76,3,3,1,4,3,1,2,2,2,3,2,5,6,7,6,9,5,11,7,8,12,11,5,12,9,14,9,13,9,10,10,10,14,6,11,6,12,13,15,11,8,13,9,8,16,11,20,14,14,11,12,9,9,6,9,12,12,11,12,11,10,7,D C,1,1,1,1,1,1,20,1,1,1,1,1,1,1,1
2107508,Átila,1651,11/04/1990,26,0,0,9,0,188,80,2,3,1,2,2,2,3,2,2,2,3,3,4,6,8,9,13,14,11,7,11,9,7,12,9,13,12,13,10,11,8,9,15,8,12,9,11,13,13,11,11,13,14,7,14,11,20,14,14,12,11,11,8,7,9,9,9,10,13,13,11,7,D C,1,11,1,1,1,1,20,1,1,1,1,1,1,1,1
2107509,Lulinha,1651,10/04/1990,26,0,0,13,11,170,67,3,1,1,1,2,2,3,1,4,2,2,12,10,12,10,13,9,6,10,7,4,12,14,4,13,12,11,8,10,11,12,10,12,14,6,12,5,10,11,13,15,7,4,13,12,14,20,11,6,12,6,10,10,13,5,7,9,8,9,10,12,8,AM RC,1,1,15,20,12,19,1,1,1,1,15,7,15,1,1
2107512,Fellipe Bastos,1651,01/02/1990,26,0,0,11,2,176,76,1,3,1,1,2,4,3,3,1,3,2,11,12,12,10,12,14,11,15,10,12,12,12,12,12,15,13,14,12,12,12,12,12,10,10,14,13,13,13,13,13,13,9,9,13,13,20,14,13,11,5,11,10,13,8,12,8,9,12,8,15,12,DM/M C,1,1,1,1,1,1,1,1,1,19,20,1,10,1,1
2107515,Renan Rocha,1651,25/03/1987,29,0,0,0,0,194,94,11,11,13,2,14,13,14,14,14,14,12,3,3,3,5,4,5,8,5,5,5,7,8,7,6,11,11,13,12,13,5,11,13,5,11,6,13,11,11,10,11,14,14,4,11,9,20,11,18,12,10,10,7,11,7,13,13,11,13,8,14,7,GK ,20,1,1,1,1,1,1,1,1,1,1,1,1,1,1
2107516,Luizão,1651,03/01/1987,29,0,0,4,0,184,84,2,1,1,1,2,1,1,2,2,3,2,3,7,9,10,9,5,13,10,12,13,10,2,13,9,14,12,14,11,12,7,10,15,10,7,10,13,13,14,14,12,14,13,7,16,13,20,13,14,12,12,15,8,13,13,14,8,13,15,9,12,8,D C,1,13,1,1,1,1,20,5,11,6,3,1,1,2,4
2107518,Tchô,1651,21/04/1987,29,0,0,8,3,174,70,2,1,1,4,2,1,3,3,2,3,2,10,10,14,10,12,10,7,10,7,5,11,8,6,12,12,12,12,10,8,11,11,12,14,9,13,6,9,10,14,13,8,13,15,13,14,20,11,8,12,12,11,13,10,13,11,12,13,14,12,14,10,M/AM RC,1,1,11,20,1,15,1,1,1,1,16,1,12,1,1
2107521,Denílson,1651,04/07/1987,28,0,0,0,0,180,77,3,1,4,2,1,2,2,2,2,3,3,4,11,11,3,5,6,6,6,13,13,11,5,13,11,12,11,12,9,9,12,9,12,10,6,14,11,12,11,14,15,9,9,7,12,14,20,13,8,10,11,10,10,8,8,11,13,9,13,9,11,10,D R,1,1,1,1,1,1,1,10,20,1,1,1,1,10,15
2107522,Fabrício,1651,11/01/1987,29,0,0,0,0,185,75,2,2,3,1,2,2,3,2,1,2,3,11,12,12,11,13,11,12,11,11,12,11,12,13,11,14,12,15,12,11,13,10,8,14,8,14,11,13,14,14,13,11,12,20,14,13,8,14,11,10,12,10,2,13,10,13,5,7,10,7,5,13,WB/M LC,1,1,1,1,1,1,1,15,1,14,15,17,1,20,1
2107523,Caio Tavera,1651,06/02/1987,29,0,0,0,0,173,75,1,3,1,2,3,2,1,1,3,3,3,8,6,11,8,12,5,8,9,4,8,8,7,6,8,9,10,10,13,9,10,12,4,5,13,10,10,8,9,13,13,9,6,20,10,12,10,13,8,9,9,8,4,9,17,12,10,12,9,4,17,4,AM/S C,1,1,20,16,1,1,1,1,1,1,12,1,1,1,1
2107529,Pará,1651,14/02/1986,30,0,0,0,0,174,65,1,3,4,3,1,3,2,3,1,2,3,10,10,12,6,12,8,9,8,12,14,11,11,13,12,10,11,13,11,10,10,11,15,10,8,11,12,15,15,14,12,9,7,17,13,15,20,15,8,12,8,12,5,18,13,17,9,11,14,11,11,10,D/WB RL,1,1,1,1,1,1,1,18,20,1,1,1,1,16,19
2107553,Anelka,1651,07/12/1984,31,0,0,0,0,183,80,2,1,2,3,3,3,1,2,3,2,1,1,3,3,5,9,1,14,7,5,12,9,4,14,5,3,12,10,9,7,2,11,3,1,7,4,13,8,6,14,8,9,11,9,9,11,20,9,13,10,7,10,4,10,20,12,13,10,6,6,9,7,D C,1,1,1,1,1,1,20,1,1,1,1,1,1,1,1
2107561,Léo Rosa,1651,13/12/1985,30,0,0,0,0,178,72,2,1,2,1,2,1,1,1,2,1,3,8,12,8,3,12,4,6,4,6,8,9,3,14,7,6,11,8,9,8,6,14,12,2,3,5,10,9,9,14,14,9,9,10,12,14,20,14,7,10,8,9,9,9,9,10,10,9,11,1,4,8,D/WB R,1,1,1,1,1,1,1,1,17,1,1,1,1,1,20
2107620,Leandro Silva,1651,06/10/1979,36,0,0,0,0,183,83,3,2,2,3,3,3,2,3,3,1,1,4,4,4,8,9,11,11,10,4,12,9,12,12,9,13,12,12,11,12,10,12,12,12,14,9,12,12,14,9,8,8,12,9,14,9,20,10,14,12,8,12,7,10,12,11,12,11,11,2,7,1,D C,1,5,1,1,1,1,20,1,1,10,1,1,1,1,1
2107626,Mineiro,1651,05/12/1981,34,0,0,0,0,185,72,3,2,1,2,1,1,1,3,2,3,1,11,10,10,8,9,11,10,10,11,10,10,8,11,9,12,11,12,10,10,10,10,13,10,10,10,10,11,9,11,11,9,11,20,11,11,9,11,10,11,13,11,10,12,11,12,12,11,13,14,12,9,D/WB LC,1,1,1,1,1,1,20,19,1,14,1,1,1,17,1
2107703,Alencar Baú,1651,16/07/1986,29,0,0,0,0,188,90,13,12,8,4,10,11,9,13,6,5,11,6,2,1,1,1,8,1,3,3,1,1,2,3,5,9,9,7,7,13,6,13,9,2,5,2,10,7,6,12,8,6,13,9,11,11,20,1,8,9,9,2,5,9,11,12,10,10,13,1,8,7,GK ,20,1,1,1,1,1,1,1,1,1,1,1,1,1,1
2107704,Rafael Paty,1651,15/03/1981,35,0,0,0,0,179,79,3,3,1,3,1,2,1,2,1,2,2,5,7,14,11,14,7,14,8,6,7,7,3,3,10,9,14,8,10,8,8,13,11,9,14,12,8,7,8,12,10,8,10,10,4,12,20,7,11,13,8,9,9,9,15,11,11,10,9,11,7,2,S ,1,1,20,1,1,1,1,1,1,1,1,1,1,1,1
2107709,Jean,1651,20/12/1981,34,0,0,0,0,181,76,3,2,1,1,1,3,1,3,3,1,2,7,7,6,14,14,7,9,8,1,4,13,4,7,14,7,10,6,9,8,12,13,4,13,5,11,9,8,9,13,12,8,10,20,10,10,10,10,7,9,9,4,4,9,13,12,12,10,11,7,15,8,AM C,1,1,15,20,1,1,1,1,1,1,15,1,1,1,1
2107771,Jean Rolt,1651,12/05/1981,35,0,0,0,0,184,83,2,4,3,2,2,2,3,1,1,2,3,1,5,8,7,8,13,11,13,2,12,9,13,11,8,14,12,17,8,12,6,11,16,10,15,5,11,14,12,10,11,11,9,5,14,10,20,11,11,13,13,13,7,9,12,11,12,14,13,13,14,6,D C,1,1,1,1,1,1,20,1,12,1,1,1,1,1,1
2107777,Jeferson,1651,15/07/1984,31,0,0,0,0,180,76,3,2,3,2,3,2,2,2,1,1,3,12,13,12,10,14,11,11,13,7,11,14,11,12,13,8,13,11,13,12,12,11,12,13,5,12,10,13,13,12,13,12,10,20,13,12,8,13,12,12,6,10,13,9,4,8,6,10,12,7,12,9,M/AM C,1,1,1,20,1,1,1,1,1,1,18,1,1,1,1
2107808,Júlio César,1651,02/09/1986,29,0,0,0,0,192,85,14,14,13,4,14,14,13,16,15,12,14,1,2,3,3,9,3,2,1,3,3,2,2,3,7,5,12,5,14,14,11,16,17,1,6,3,13,12,15,16,11,12,15,3,16,13,20,10,13,15,8,13,10,11,15,13,14,11,14,14,12,11,GK ,20,1,1,1,1,1,1,1,1,1,1,1,1,1,1
2107809,Alex Ferreira,1651,10/01/1986,30,0,0,0,0,170,65,3,4,1,1,1,2,2,1,1,2,1,2,12,7,6,8,2,7,4,3,8,11,6,9,10,13,10,12,10,10,5,10,13,11,7,12,10,11,14,12,8,12,3,7,13,13,20,12,9,13,6,13,7,14,13,13,12,13,14,14,12,9,WB/M R,1,1,1,1,1,1,1,1,15,1,1,1,18,1,20
2107819,Felipe Santana,1651,17/03/1986,30,0,0,0,0,194,80,3,2,1,3,2,2,2,1,2,3,2,4,6,9,10,8,5,15,5,12,15,10,4,13,7,14,11,16,9,13,6,10,15,5,11,9,11,16,14,13,10,13,17,9,13,17,20,15,14,12,13,15,13,3,13,10,16,13,14,10,8,6,D C,1,10,5,1,1,1,20,1,5,13,5,1,1,1,1
2107887,Thiago Neves,1651,27/02/1985,31,7,0,0,0,182,70,2,3,2,2,2,1,4,3,3,2,1,15,13,14,13,15,14,13,15,7,7,15,15,8,15,13,14,12,15,13,15,13,12,14,11,14,7,13,11,14,15,13,12,20,12,13,10,13,11,11,11,9,15,14,2,18,3,8,6,13,12,13,M/AM RLC,1,1,12,20,15,18,1,1,1,1,18,15,18,1,1
2108018,Lionn,1651,29/01/1989,27,0,0,0,0,184,77,3,1,3,1,3,1,2,1,1,3,3,11,12,10,8,12,11,10,12,14,10,10,12,12,13,14,11,13,11,11,9,11,16,12,9,13,11,13,13,13,13,13,12,8,11,14,20,15,12,12,10,10,8,7,14,14,12,11,13,10,5,6,D R,1,1,1,1,1,1,1,1,20,1,1,1,1,1,12
2108021,Zada,1651,28/03/1987,29,0,0,0,0,174,64,2,2,1,3,3,1,2,3,1,1,1,5,11,8,2,12,7,7,5,4,9,9,7,11,11,4,9,4,7,8,8,11,9,9,9,7,9,8,9,14,14,13,8,20,14,12,10,8,6,9,3,9,7,9,17,11,10,10,11,1,3,6,D/WB/M L,1,1,1,1,1,1,1,18,1,1,1,17,1,20,1
2108039,Adriano,1651,24/12/1986,29,0,0,0,0,178,69,4,2,3,1,2,2,2,1,1,1,2,7,3,9,14,11,7,14,8,3,7,8,8,4,9,9,11,8,12,8,5,14,3,9,1,13,6,7,8,14,14,8,4,8,13,14,20,12,8,9,4,7,9,9,10,10,11,14,13,9,11,6,S ,1,1,20,1,1,1,1,1,1,1,1,1,1,1,1
2108261,Danilo Dias,1651,06/11/1985,30,0,0,0,0,173,63,2,1,2,2,1,1,1,2,2,3,3,12,12,14,13,13,13,7,12,7,7,13,13,7,14,8,13,8,13,11,15,11,12,16,9,13,6,8,11,13,12,10,8,10,12,13,20,11,6,11,6,12,10,10,12,11,10,12,13,14,14,6,AM RC,1,1,15,20,10,17,1,1,1,1,1,1,1,1,1
2108372,Bill,1651,02/07/1984,31,0,0,0,0,183,86,2,3,3,2,3,3,1,3,2,1,2,8,8,10,13,10,6,13,12,3,8,9,13,7,10,18,13,15,14,13,8,12,12,12,12,13,10,13,14,13,12,13,11,10,8,13,20,14,15,12,11,11,9,4,9,15,10,10,16,10,16,12,S ,1,1,20,3,1,1,1,1,1,1,1,1,1,1,1
2108396,Tiago Ferreira,1651,10/11/1985,30,0,0,0,0,176,63,4,3,2,4,1,1,2,2,2,2,3,10,9,11,12,10,10,10,11,1,9,11,6,6,15,10,13,7,9,10,11,16,7,12,11,13,9,10,11,13,13,7,10,3,9,14,20,12,7,10,10,10,4,10,14,9,11,13,13,1,16,2,S ,1,1,20,1,1,1,1,1,1,1,1,1,1,1,1
2108428,Montoya,1651,11/09/1985,30,0,0,0,0,188,80,3,3,1,1,4,2,3,2,1,2,1,3,6,5,4,5,4,13,7,11,13,8,2,13,9,14,11,13,11,11,8,11,12,7,12,9,12,13,12,12,10,12,13,8,12,11,20,13,14,13,13,11,10,8,13,11,11,11,13,9,11,12,D C,1,13,1,1,1,1,20,1,1,1,1,1,1,1,1
2108455,Rudnei,1651,07/10/1984,31,0,0,0,0,188,80,2,3,1,4,1,2,1,2,1,2,1,5,7,11,8,13,9,10,11,8,14,11,10,12,10,16,14,15,13,14,12,12,12,12,12,9,14,14,13,11,12,13,14,7,15,11,20,14,14,11,12,11,11,13,12,13,9,11,7,13,11,11,DM/M C,1,6,1,7,1,1,11,1,1,17,20,1,1,1,1
2108457,Michel Simplício,1651,26/03/1986,30,0,0,0,0,180,75,2,3,2,2,3,2,2,2,3,3,2,1,10,11,9,10,7,10,11,1,6,10,11,4,13,9,8,6,9,9,8,8,14,14,2,10,8,7,8,12,11,9,7,10,15,14,20,11,9,10,7,12,10,7,8,11,13,13,11,11,8,5,AM RL,1,1,13,13,20,20,1,1,1,1,1,1,1,1,1
2108458,Cristiano Teixeira,1651,15/03/1988,28,0,0,0,0,168,59,3,1,1,3,2,1,2,3,3,2,2,6,8,15,7,13,6,5,6,5,7,14,4,8,15,9,9,8,8,8,9,13,5,16,11,7,8,7,8,13,12,8,5,20,14,14,2,6,7,9,6,9,7,9,19,11,11,10,10,4,8,7,D/WB/M/AM LC,1,1,1,19,16,1,1,20,1,1,10,17,1,17,1
2108462,Tiago Rocha,1651,12/02/1985,31,0,0,0,0,193,90,14,11,11,3,12,9,10,11,9,9,9,2,2,2,1,5,4,1,2,2,3,3,3,3,1,7,12,11,9,10,8,15,13,3,14,2,8,8,8,4,8,4,15,8,5,5,20,7,14,9,3,5,9,9,11,10,13,10,8,3,14,2,GK ,20,1,1,1,1,1,1,1,1,1,1,1,1,1,1
2108552,Russo,1651,19/02/1983,33,0,0,0,0,181,81,1,1,1,1,2,1,2,4,2,2,1,6,8,3,7,13,6,6,5,5,11,9,6,10,10,5,9,8,8,7,12,11,9,9,11,7,11,14,12,12,12,8,10,10,11,12,20,12,12,8,16,9,9,9,7,11,10,10,9,1,4,8,DM/M C,1,1,1,1,1,1,1,1,1,20,16,1,1,1,1
2108734,Rogerinho,1651,24/12/1984,31,0,0,0,0,173,68,1,1,1,1,1,1,2,3,3,1,3,11,11,12,10,11,14,5,12,7,5,12,14,6,12,12,10,11,11,11,12,12,12,15,7,13,7,9,11,12,14,7,6,20,13,12,7,11,5,13,7,12,9,10,10,13,10,14,12,6,16,6,M/AM LC,1,1,13,20,19,1,1,1,1,1,17,18,1,1,1
2108799,Rodrigão,1651,22/04/1983,33,0,0,0,0,184,82,2,1,2,3,3,1,2,1,1,1,1,6,5,3,4,3,5,13,4,6,12,2,3,12,4,12,11,12,12,11,10,13,10,10,13,9,11,12,11,11,9,12,13,9,11,9,20,12,14,9,11,12,9,2,20,12,10,12,14,12,7,2,D C,1,1,1,1,1,1,20,1,1,1,1,1,1,1,1
2108813,Charles,1651,14/02/1985,31,0,0,0,0,173,72,3,3,3,2,3,1,2,1,2,3,3,7,12,11,11,12,13,8,14,8,13,13,11,13,13,16,13,15,11,10,12,12,11,12,11,13,12,14,16,12,12,13,7,12,10,12,20,10,13,11,15,12,13,14,7,8,13,8,10,10,9,12,DM/M C,1,1,1,1,1,1,1,1,1,19,20,1,1,1,1
2108839,Carlos Magno,1651,29/01/1986,30,0,0,0,0,178,74,2,3,3,1,1,2,1,2,2,1,3,13,12,13,10,13,13,6,11,11,7,13,15,7,13,7,8,7,9,8,12,8,10,14,3,12,8,7,9,13,14,8,8,7,13,12,20,10,8,14,8,12,9,15,11,12,13,13,14,14,14,10,D/WB/M/AM RC,1,1,8,20,2,19,1,10,18,11,15,5,16,12,18
2108880,Emerson,1651,03/08/1982,33,0,0,0,0,186,85,12,11,12,4,13,11,13,12,13,11,11,5,3,1,2,12,10,3,2,3,1,6,4,3,14,5,11,13,12,11,10,11,12,3,13,3,9,12,11,14,16,10,16,4,11,11,20,14,11,12,11,11,5,11,12,10,14,10,7,7,8,8,GK ,20,1,1,1,1,1,1,1,1,1,1,1,1,1,1
2108885,Edson Borges,1651,20/01/1985,31,0,0,0,0,191,82,1,3,1,2,2,3,1,1,1,2,3,2,10,7,6,9,13,14,8,8,12,9,7,12,11,14,10,13,6,12,7,8,12,6,13,7,13,11,12,10,9,10,16,7,13,12,20,13,16,11,16,13,11,4,12,13,6,13,10,5,10,6,D C,1,1,1,1,1,1,20,1,1,1,1,1,1,1,1
2108886,Maurício Ramos,1651,10/04/1985,31,0,0,0,0,186,77,3,1,3,1,1,4,1,3,1,2,3,1,6,6,6,10,4,14,7,8,14,10,9,13,10,14,13,15,12,11,6,12,13,11,13,7,14,14,14,13,12,14,14,7,14,13,20,13,14,13,12,11,12,11,12,13,14,10,14,9,14,8,D C,1,13,1,1,1,1,20,6,10,1,1,1,1,1,1
2108888,Márcio Goiano,1651,02/01/1985,31,0,0,0,0,181,72,1,3,1,3,3,1,1,1,3,2,1,7,9,8,8,6,11,6,3,2,10,11,5,11,8,9,8,9,7,11,3,13,12,9,1,10,11,17,13,12,12,12,9,20,12,12,9,11,12,13,7,6,14,9,12,13,8,12,10,5,2,1,D L,1,1,1,1,1,1,1,20,1,1,1,1,1,15,1
2108889,Cambará,1651,10/04/1984,32,0,0,0,0,185,70,2,2,1,1,4,3,3,3,1,1,3,8,9,10,8,11,8,8,7,1,10,11,6,10,10,4,14,11,11,11,10,13,13,13,12,11,11,11,12,10,11,10,11,10,12,10,20,12,7,10,9,9,9,11,14,14,9,12,11,6,11,6,DM/M C,1,1,1,14,1,1,1,1,1,18,20,1,1,1,1
2108891,Élton,1651,01/08/1985,30,0,0,0,0,185,84,2,1,3,1,1,3,3,4,2,1,1,3,11,12,13,13,4,14,12,3,5,13,13,6,12,13,13,13,8,9,12,12,11,13,8,15,6,14,12,13,13,11,13,20,14,13,10,13,13,12,11,13,7,12,5,9,10,11,12,9,11,12,S ,1,1,20,1,5,5,1,1,1,1,1,1,1,1,1
2108893,Assis,1651,03/02/1984,32,0,0,0,0,179,75,3,1,4,1,4,3,2,3,2,2,3,10,10,11,8,11,9,6,11,11,6,11,12,8,12,13,9,12,9,8,11,9,13,15,6,10,8,11,11,13,13,10,6,20,14,13,5,12,8,13,7,14,10,16,16,14,13,9,13,8,4,5,M/AM RL,1,1,1,13,20,18,1,14,8,1,11,19,19,14,10
2108894,Giancarlo,1651,18/10/1982,33,0,0,0,0,191,88,2,3,3,3,1,3,2,2,1,2,3,3,8,7,14,12,8,15,10,4,7,10,14,7,8,14,12,16,12,12,9,12,14,9,10,12,7,11,13,10,9,15,16,9,13,11,20,14,16,12,12,12,12,4,8,12,10,7,9,8,8,7,S ,1,1,20,1,1,1,1,1,1,1,1,1,1,1,1
2108897,Joel,1651,13/09/1984,31,0,0,0,0,173,68,2,2,3,2,1,2,1,3,2,3,2,8,12,13,10,13,7,8,7,6,11,13,6,10,14,10,7,9,8,12,8,11,10,14,12,10,7,8,9,13,12,10,10,9,11,13,20,9,10,10,4,10,4,10,18,9,11,10,11,8,3,6,M/AM/S R,1,1,20,1,1,18,1,1,1,1,1,1,17,1,1
2108898,Mateus Paraná,1651,21/05/1987,29,0,0,0,0,173,73,1,2,2,1,1,4,1,2,3,3,2,10,10,13,10,11,9,10,8,7,4,11,10,5,12,13,11,13,8,7,9,6,10,12,5,12,8,10,10,14,13,12,6,8,10,13,20,11,9,7,13,11,13,12,10,12,9,10,13,11,12,9,AM/S R,1,1,20,10,1,18,1,1,1,1,1,1,14,1,1
2108906,Diego Zaporo,1651,25/02/1986,30,0,0,0,0,188,80,1,2,2,2,2,2,3,3,3,1,3,6,7,9,11,10,9,11,8,3,2,10,7,3,10,5,7,5,9,7,7,11,13,9,8,9,10,7,6,9,9,11,11,11,10,10,20,11,10,7,2,10,8,2,11,10,9,11,14,12,15,4,S ,1,1,20,1,1,1,1,1,1,1,1,1,1,1,1
2108923,Ícaro,1651,11/06/1984,32,0,0,0,0,190,75,3,1,2,1,2,2,1,4,1,3,2,8,7,10,10,7,8,12,9,4,6,9,8,1,7,7,15,6,13,9,8,12,10,9,14,11,9,8,9,10,11,12,16,10,12,10,20,8,11,10,9,12,6,9,14,9,11,10,11,1,20,2,S ,1,1,20,1,1,1,1,1,1,1,1,1,1,1,1
2108961,Da Silva,1651,18/06/1984,32,0,0,0,0,174,71,2,1,2,1,1,2,3,1,1,2,3,6,10,12,11,11,9,8,9,1,3,10,5,3,12,10,14,10,15,9,11,9,8,10,14,12,11,12,12,12,13,10,7,9,15,13,20,7,9,10,7,3,10,10,12,12,12,11,10,6,2,2,AM/S C,1,1,18,20,1,1,1,1,1,1,15,1,1,1,1
2108963,Junior Santos,1651,25/12/1985,30,0,0,0,0,165,64,2,2,3,1,4,3,1,2,2,1,1,9,11,13,15,13,8,10,11,3,3,14,11,6,16,14,13,8,12,11,13,14,11,16,7,14,9,16,18,14,13,14,9,13,12,12,20,11,12,13,5,17,6,11,12,11,12,10,15,16,13,6,AM C,1,1,14,20,1,1,1,1,1,1,10,1,1,1,1
2109214,Ives,1651,11/06/1985,31,0,0,0,0,173,72,2,4,1,2,2,1,1,2,2,1,1,10,10,10,9,11,11,7,11,11,11,10,11,10,11,13,11,11,9,10,10,10,15,10,5,9,12,13,12,12,11,13,7,8,14,12,20,13,8,12,12,11,11,13,9,14,15,16,15,14,14,8,DM/M C,1,1,1,1,1,1,10,1,1,20,18,1,1,1,1
2109284,Mariano,1651,23/06/1986,30,0,0,0,0,177,69,2,3,2,1,3,2,2,2,2,2,3,9,14,14,8,13,11,7,12,11,12,13,8,14,13,13,13,14,12,13,12,14,14,13,11,14,12,14,15,16,14,12,9,11,12,15,20,17,12,16,7,14,8,10,13,12,11,12,13,10,8,5,D/WB R,1,1,1,1,1,1,1,10,20,1,1,1,15,10,18
2109313,Alison,1651,21/10/1983,32,0,0,0,0,186,76,3,2,2,3,1,2,1,1,1,3,3,3,9,8,10,11,12,13,11,8,13,11,14,13,10,15,12,15,11,12,9,11,15,10,15,9,12,14,13,12,12,10,13,9,13,12,20,13,12,14,14,14,12,15,13,13,14,16,16,7,10,10,D C,1,14,1,1,1,1,20,1,11,10,5,1,1,1,3
2109352,Ítalo,1651,27/09/1984,31,0,0,0,0,181,75,2,2,2,3,1,1,2,2,2,3,4,7,9,10,12,14,7,12,6,3,5,7,5,7,12,9,10,4,8,8,10,9,9,11,14,12,6,7,8,11,13,7,13,20,13,13,10,6,12,11,9,6,9,9,9,12,12,14,14,2,5,6,S ,1,1,20,1,1,1,1,1,1,1,1,1,1,1,1
2109451,Thiago Laranjeira,1651,05/11/1987,28,0,0,0,0,168,62,3,3,3,1,3,2,1,1,2,3,3,14,11,14,11,12,16,7,11,4,5,12,15,5,14,8,7,9,10,8,11,10,5,12,5,12,10,11,15,13,15,6,4,20,11,14,5,10,3,11,10,3,6,10,18,12,12,13,12,3,9,7,M/AM LC,1,1,10,20,17,10,1,1,1,1,16,14,7,1,1
2109453,Eliomar,1651,12/02/1987,29,0,0,0,0,176,72,2,3,3,1,4,3,3,2,1,1,2,11,14,10,12,10,9,11,4,4,3,10,13,3,11,3,11,3,11,7,12,9,12,12,5,10,9,9,10,13,13,14,8,12,13,13,20,13,11,9,11,10,11,10,14,5,11,11,6,3,11,5,AM RC,1,1,15,20,1,18,1,1,1,1,1,1,15,1,1
2109454,Betinho,1651,13/05/1987,29,0,0,0,0,185,86,1,3,1,2,2,3,1,3,3,2,1,5,9,11,11,12,10,14,12,3,4,11,15,5,10,8,12,11,11,11,10,11,10,14,5,12,8,10,13,12,12,14,13,20,14,12,7,14,16,11,7,12,6,5,12,11,15,9,11,5,11,6,S ,1,1,20,1,1,1,1,1,1,1,1,1,1,1,1
2109501,Bruno Rodrigo,1651,12/04/1985,31,0,0,0,0,186,80,1,3,3,1,3,2,3,3,3,1,2,7,7,9,7,9,10,15,8,10,15,11,10,14,10,15,14,14,14,13,7,12,16,8,14,10,14,16,13,11,10,9,14,8,10,10,20,10,14,10,10,12,14,5,8,11,16,12,14,13,15,5,D C,1,11,1,1,1,1,20,1,1,1,1,1,1,1,1
2109574,Rafael Araújo,1651,16/11/1984,31,0,0,0,0,188,70,2,3,3,2,1,3,3,3,4,4,3,6,3,3,8,4,4,14,4,1,12,8,5,14,6,8,13,10,8,12,5,14,12,1,7,8,9,8,9,14,11,9,15,20,15,12,10,6,11,10,10,10,10,10,12,14,13,11,11,11,16,2,D C,1,1,1,1,1,1,20,1,1,1,1,1,1,1,1
2109680,Léo Gamalho,1651,31/01/1986,30,0,0,0,0,187,86,2,3,2,3,1,3,3,3,3,1,2,4,8,10,14,12,6,14,13,2,3,11,14,6,11,11,11,9,12,7,11,11,13,13,11,12,9,12,11,12,10,12,14,16,13,12,20,13,15,11,13,9,11,4,12,14,5,11,7,12,9,17,S ,1,1,20,1,8,10,1,1,1,1,1,1,1,1,1
2110008,Leonel Olímpio,1651,07/07/1982,33,0,0,0,0,184,80,1,2,1,2,1,2,1,1,3,2,3,9,9,11,9,12,8,10,12,8,11,13,10,13,12,14,12,12,12,14,9,12,15,11,16,9,14,13,12,10,12,14,13,5,15,10,20,14,12,14,10,12,6,11,13,15,13,14,14,13,13,8,DM C,1,1,1,1,1,1,7,1,7,20,15,1,1,1,1
2110056,Vinícius,1651,12/06/1984,32,0,0,0,0,190,77,13,12,13,3,13,13,8,13,10,8,13,7,1,2,1,3,10,1,3,2,3,1,3,2,10,6,8,15,7,10,7,13,12,3,7,3,11,8,10,12,12,4,14,10,6,10,20,7,8,11,5,9,10,10,12,12,11,12,13,12,12,7,GK ,20,1,1,1,1,1,1,1,1,1,1,1,1,1,1
2110110,Cléverson,1651,17/12/1983,32,0,0,0,0,181,75,1,3,2,1,1,1,3,2,3,2,1,8,10,11,11,11,7,6,11,2,5,10,11,4,11,11,10,15,8,9,11,9,14,13,7,13,5,11,11,12,11,9,9,10,15,12,20,11,9,13,11,14,9,12,12,12,10,10,12,9,6,9,AM/S C,1,1,18,20,13,12,1,1,1,1,15,1,1,1,1
2110188,Emerson Conceição,1651,23/02/1986,30,0,0,0,0,185,82,3,3,3,2,3,2,1,2,1,4,2,8,12,11,12,13,7,13,10,12,13,12,9,12,11,10,11,12,12,9,11,10,9,10,6,11,11,13,14,13,13,8,14,20,16,12,5,16,15,12,10,10,6,10,12,13,13,11,9,14,13,7,D/WB L,1,1,1,1,1,1,12,20,1,1,1,10,1,16,1
2110194,Basílio,1651,01/01/1982,34,0,0,0,0,180,79,1,1,1,4,2,1,1,3,1,2,2,5,8,7,3,7,5,4,5,1,13,8,5,13,8,14,11,15,9,12,11,12,13,7,14,10,12,13,13,13,12,11,10,20,11,13,10,13,12,11,10,10,14,5,19,12,14,9,13,9,14,5,DM C,1,1,1,1,1,1,1,1,1,20,15,1,1,1,1
2110195,Thiago Silva,1651,22/06/1983,33,0,0,0,0,174,73,2,2,4,3,3,3,1,1,1,3,4,10,13,13,10,12,10,16,12,5,5,12,13,5,12,10,7,7,8,6,11,16,10,9,5,13,8,8,11,14,16,8,5,1,14,13,20,9,6,11,7,10,9,10,11,9,14,12,13,5,13,4,AM/S C,1,1,17,20,7,10,1,1,1,1,10,1,1,1,1
2110301,Wallace,1651,27/03/1985,31,0,0,0,0,191,82,1,3,3,3,3,2,2,2,2,2,2,5,5,5,10,11,7,13,3,3,13,10,9,12,11,9,13,8,9,10,6,7,11,8,13,5,11,10,11,11,8,13,17,7,14,11,20,13,12,9,14,9,4,9,7,10,10,11,11,10,10,8,D C,1,1,1,1,1,1,20,1,1,1,1,1,1,1,1
2110349,Paulo Júnior,1651,25/02/1984,32,0,0,0,0,184,84,3,1,3,3,3,1,1,1,2,1,2,5,5,8,11,11,7,14,9,5,5,6,12,2,11,8,10,12,10,10,6,8,8,12,5,12,5,7,7,12,9,15,12,8,14,11,20,13,15,12,8,12,7,5,12,9,13,11,12,1,6,3,S ,1,1,20,1,1,1,1,1,1,1,1,1,1,1,1
2110350,Val,1651,22/08/1983,32,0,0,0,0,179,0,2,3,2,2,1,2,1,2,2,2,1,4,4,9,6,10,6,13,10,4,14,9,7,14,10,13,12,11,11,11,7,10,5,4,9,6,13,15,15,10,10,14,11,8,15,11,20,15,13,11,10,6,9,10,13,11,11,11,12,7,11,5,DM/M C,1,1,1,1,1,1,1,1,1,20,17,1,1,1,1
2110351,Mossoró,1651,24/06/1985,31,0,0,0,0,181,80,2,3,1,1,4,1,3,1,2,4,1,7,5,10,13,14,4,14,8,7,6,8,5,4,14,8,10,2,10,9,9,13,13,13,3,14,9,8,9,14,13,5,9,10,4,13,20,14,11,10,4,10,10,10,8,9,5,10,12,9,11,9,S ,1,1,20,1,1,1,1,1,1,1,1,1,1,1,1
2110415,Camacho,1651,28/10/1985,30,0,0,0,0,187,0,3,3,2,1,2,2,2,3,2,1,3,4,4,9,7,10,4,8,9,5,12,9,10,11,11,16,9,13,6,8,10,10,10,6,8,5,11,12,15,13,11,14,14,20,13,14,8,11,13,11,8,12,7,10,8,12,11,8,10,2,5,3,D/WB/DM/M LC,1,1,1,1,14,1,20,20,1,18,18,15,1,16,1
2110416,Guilherme,1651,09/11/1986,29,0,0,0,0,185,80,1,2,1,3,2,2,2,1,2,1,1,3,10,10,13,10,3,11,5,4,3,6,15,3,8,11,11,11,10,10,6,8,12,11,7,10,10,9,11,13,13,11,12,10,12,13,20,12,12,13,11,12,7,10,6,10,13,11,11,9,11,7,S ,1,1,20,1,1,1,1,1,1,1,1,1,1,1,1
2110539,Allan Luiz,1651,19/05/1986,30,0,0,0,0,189,84,7,10,10,1,12,10,9,14,10,8,9,3,1,3,2,5,8,1,2,1,2,2,3,1,1,6,8,15,9,8,8,14,11,1,5,3,10,9,8,12,9,9,13,9,14,11,20,8,11,10,10,10,10,9,18,12,13,13,11,3,8,5,GK ,20,1,1,1,1,1,1,1,1,1,1,1,1,1,1
2110545,Rafael Sandes,1651,05/08/1987,28,0,0,0,0,190,90,14,11,14,1,11,12,7,14,7,10,11,4,2,2,3,6,9,1,2,1,1,1,1,1,8,9,12,14,9,10,8,11,13,3,13,1,10,9,8,14,6,9,17,10,14,11,20,8,19,10,9,2,6,9,12,10,12,10,11,6,7,7,GK ,20,1,1,1,1,1,1,1,1,1,1,1,1,1,1
2110600,Cléo,1651,09/08/1985,30,0,0,0,0,187,88,4,1,2,1,2,2,1,3,3,1,3,9,8,12,13,12,9,15,10,12,7,12,15,7,14,13,13,13,14,14,11,14,14,14,9,13,8,11,10,11,14,10,14,13,12,11,20,12,12,11,9,16,11,8,11,9,12,15,12,14,15,13,S ,1,1,20,1,1,1,1,1,1,1,1,1,1,1,1
2110609,Paes,1651,11/12/1982,33,0,0,0,0,189,87,13,12,11,5,11,10,9,13,10,4,12,4,2,2,3,3,7,1,1,2,2,1,4,3,6,10,11,11,7,9,7,13,10,1,7,3,13,7,7,13,10,8,13,5,14,10,20,4,8,9,10,10,8,10,12,10,10,10,10,4,9,4,GK ,20,1,1,1,1,1,1,1,1,1,1,1,1,1,1
2110612,Ferdinando,1651,22/04/1980,36,0,0,0,0,180,74,2,1,3,1,3,1,3,1,3,2,1,1,3,8,8,8,12,10,11,9,14,9,10,12,13,15,10,13,11,8,12,11,8,10,11,11,13,13,14,11,10,12,9,7,12,12,20,8,14,10,12,11,6,12,10,11,10,10,10,1,9,6,D/DM/M C,1,1,1,1,1,1,18,1,1,20,18,1,1,1,1
2110614,Andreson,1651,23/04/1985,31,0,0,0,0,183,80,2,1,2,3,3,2,1,1,2,3,1,6,3,6,10,14,9,12,12,2,10,9,7,11,9,14,12,13,8,11,6,11,10,3,13,8,12,14,12,9,8,12,13,10,13,10,20,12,13,9,7,8,6,9,15,11,13,10,13,2,11,5,DM/M C,1,1,1,1,1,1,1,1,1,20,18,1,1,1,1
2110620,Leandro Brasília,1651,21/01/1987,29,0,0,0,0,170,69,2,3,3,2,1,1,4,2,1,3,4,7,8,12,11,9,10,4,11,5,11,12,8,11,13,11,10,10,11,8,12,9,8,9,10,11,11,11,11,13,14,14,6,11,12,13,20,12,9,12,12,9,14,12,14,11,7,12,12,2,17,8,DM/M C,1,1,1,1,1,1,1,1,1,20,18,1,1,1,1
2110622,Patrick,1651,26/03/1985,31,0,0,0,0,182,74,4,3,4,1,2,2,1,3,3,3,3,6,7,10,12,11,10,12,10,4,4,9,13,4,11,12,10,11,11,7,8,8,13,13,4,11,6,6,8,12,11,10,10,8,13,12,20,10,11,10,9,10,8,11,7,13,7,10,10,10,10,13,S ,1,1,20,5,1,1,1,1,1,1,1,1,1,1,1
2110798,Diguinho,1651,20/03/1983,33,0,0,0,0,171,73,3,3,2,2,4,1,2,1,1,2,1,10,10,12,10,10,9,9,11,12,13,11,11,12,14,16,15,16,12,9,11,12,13,14,12,12,14,13,14,12,15,8,6,12,16,13,20,14,10,13,15,11,13,10,15,11,11,14,14,9,10,8,DM/M C,1,1,1,1,1,1,1,1,1,20,19,1,1,1,1
2110905,Réver,1651,04/01/1985,31,8,1,0,0,192,84,1,1,3,1,1,2,3,1,3,2,1,4,9,12,7,10,11,16,11,7,14,12,10,14,12,9,12,15,12,12,11,12,15,9,18,10,14,13,15,11,10,12,16,8,10,11,20,13,16,13,11,15,15,15,3,11,12,14,13,13,14,6,D C,1,1,1,1,1,1,20,1,1,12,1,1,1,1,1
2111178,Ricardo Berna,1651,11/06/1979,37,0,0,0,0,188,84,8,12,12,5,13,13,12,13,12,8,12,5,3,2,3,9,10,4,3,2,2,9,3,1,8,7,10,14,11,13,9,10,12,1,15,3,12,9,14,8,11,12,11,10,8,8,20,11,14,13,10,16,9,10,9,8,12,13,16,13,18,7,GK ,20,1,1,1,1,1,1,1,1,1,1,1,1,1,1
2111309,Marcos Tamandaré,1651,20/03/1981,35,0,0,0,0,177,73,3,1,2,3,2,1,2,2,1,1,1,6,12,13,12,9,5,10,10,12,13,13,14,11,12,11,12,12,10,11,10,11,12,12,8,14,12,13,13,14,13,11,8,9,14,14,20,14,8,13,8,11,7,10,12,8,13,11,13,9,10,9,D/WB R,1,1,1,1,1,6,1,1,20,1,1,1,12,1,18
2111324,Matheus Lopes,1651,08/03/1985,31,0,0,0,0,187,83,4,3,3,4,1,4,3,2,2,3,2,8,8,13,9,12,5,13,5,9,11,11,3,12,10,11,13,13,13,11,7,11,15,12,6,12,12,13,13,11,13,13,11,20,14,12,1,12,13,10,5,3,9,9,14,15,9,13,7,13,7,8,D C,1,1,1,1,1,1,20,1,1,10,1,1,1,1,1
2111393,Alexandre Pato,1651,02/09/1989,26,27,10,18,10,180,81,1,4,1,3,3,3,3,1,1,2,1,5,11,15,13,16,12,11,14,6,5,13,14,5,16,13,12,8,13,11,13,12,6,16,10,14,6,11,10,16,14,13,9,14,13,16,20,13,11,10,7,13,13,13,10,5,15,10,10,12,14,6,AM/S L,1,1,20,8,19,14,1,1,1,1,1,1,1,1,1
2111397,Rafael Crivellaro,1651,18/02/1989,27,0,0,0,0,184,77,1,1,2,2,3,3,1,3,2,3,1,13,14,13,12,14,14,7,14,4,7,15,14,8,15,6,9,9,14,12,15,14,10,12,8,10,10,11,8,11,12,13,12,20,8,11,11,11,11,11,6,10,10,6,5,11,11,11,9,5,6,5,M/AM RLC,1,1,1,16,13,5,1,1,1,1,20,17,17,1,1
2111403,Jaílton,1651,09/03/1986,30,0,0,0,0,190,71,1,2,3,1,2,2,2,1,2,3,3,6,6,6,7,8,7,14,8,8,14,9,10,12,7,13,10,14,12,8,5,11,14,11,8,12,13,15,13,11,10,15,15,10,12,11,20,13,15,12,11,11,8,11,11,10,13,12,15,13,12,6,D C,1,1,1,1,1,1,20,1,1,1,1,1,1,1,1
2111405,Jáder,1651,04/06/1989,27,0,0,0,0,172,65,3,3,1,2,3,1,1,3,2,4,4,7,8,6,5,9,4,9,2,1,9,10,4,14,10,8,8,9,9,9,5,14,1,8,8,8,11,9,10,12,14,9,6,6,8,15,20,14,8,9,9,2,9,9,17,11,9,12,11,6,16,8,D/WB R,1,1,1,1,1,1,1,1,20,1,1,1,1,1,16
2111406,Júlio Coronel,1651,24/03/1986,30,0,0,0,0,173,72,1,2,3,3,1,3,2,2,1,3,1,4,4,10,9,8,3,4,4,1,1,7,3,3,13,7,7,3,4,5,4,3,4,13,14,8,3,6,10,13,12,5,1,6,7,13,20,12,4,7,7,6,7,7,7,13,9,11,12,1,8,5,AM C,1,1,1,20,1,1,1,1,1,1,1,1,1,1,1
2111409,Marlon,1651,03/01/1989,27,0,0,0,0,190,85,4,1,1,3,2,4,2,3,4,1,1,1,1,1,1,6,2,12,1,1,12,6,1,12,4,8,7,8,3,9,2,12,9,1,13,3,12,5,6,12,10,6,14,20,10,11,9,3,9,9,9,5,9,9,10,11,11,11,10,5,2,5,D C,1,1,1,1,1,1,20,5,1,5,1,1,1,1,1
2111410,Dudé,1651,31/05/1987,29,0,0,0,0,181,76,1,3,1,1,3,1,4,2,1,3,3,7,7,7,7,9,8,10,9,5,10,10,7,10,10,12,11,12,9,10,7,8,12,7,10,9,11,14,13,13,13,10,10,9,15,12,20,13,10,10,12,9,6,10,11,11,14,10,15,15,12,7,DM/M C,1,1,1,1,1,1,6,1,1,20,16,1,1,1,1
2111412,Ramón Motta,1651,06/05/1988,28,0,0,0,0,173,73,3,3,1,4,1,2,2,1,2,3,1,13,15,13,9,13,11,4,13,8,9,13,11,10,14,16,12,15,13,9,12,12,12,14,8,14,9,12,14,15,15,7,5,20,12,14,10,14,7,10,13,12,5,15,13,11,11,10,10,7,12,8,D/WB L,1,1,1,1,12,10,1,18,1,1,10,15,1,20,1
2111414,Rodrigo César,1651,08/07/1988,27,0,0,0,0,183,81,3,2,1,1,1,2,3,3,3,2,1,4,4,4,4,11,6,8,5,4,8,13,2,12,6,14,9,8,6,9,6,13,11,6,9,6,9,7,12,13,12,5,12,16,16,11,20,8,12,10,17,2,4,9,18,12,13,11,10,1,6,5,DM C,1,1,1,1,1,1,15,1,1,20,14,1,1,1,1
2111417,Roger Gaúcho,1651,30/03/1986,30,0,0,0,0,176,67,2,1,3,3,2,1,2,3,1,1,2,8,12,13,9,10,9,5,10,5,11,12,7,11,13,9,11,8,10,12,12,11,10,11,10,13,12,10,11,14,13,9,8,10,13,13,20,14,7,10,12,9,6,11,8,7,9,10,6,8,8,10,AM RC,1,1,10,18,13,20,1,1,1,1,10,1,1,1,1
2111418,Samuel,1651,17/01/1989,27,0,0,0,0,187,86,11,10,8,14,10,11,11,11,13,10,15,1,2,2,1,3,5,7,2,2,1,3,2,2,1,15,12,11,10,11,7,15,10,1,10,1,11,10,9,14,12,8,14,10,7,13,20,6,15,11,10,6,7,10,12,14,11,11,12,1,8,6,GK ,20,1,1,1,1,1,1,1,1,1,1,1,1,1,1
2111419,Sidnei,1651,02/11/1986,29,0,0,0,0,176,66,2,3,2,1,1,1,1,2,1,1,3,10,11,13,8,10,11,7,9,9,11,10,12,12,12,9,10,9,9,11,8,10,14,13,9,12,7,9,11,14,15,8,11,20,14,13,5,13,11,9,8,9,7,8,13,12,13,12,11,12,10,3,D/AM L,1,1,10,1,20,1,1,17,1,1,1,15,1,14,1
2111454,Anderson Pico,1651,04/11/1988,27,0,0,0,0,169,85,3,3,2,2,1,3,3,2,3,2,1,11,12,12,10,10,12,6,13,15,8,10,8,9,11,11,11,14,12,12,10,12,5,13,7,12,8,12,10,14,11,13,5,18,6,14,20,9,13,12,7,12,12,15,11,9,13,9,3,8,14,10,D/WB RL,1,1,1,1,1,1,1,20,15,1,1,14,1,18,14
2111461,Gláuber,1651,26/01/1983,33,0,0,0,0,183,75,3,2,2,2,1,3,2,3,1,3,1,2,5,9,11,7,4,11,13,9,11,12,7,11,6,17,11,16,6,13,6,11,16,5,11,7,11,12,13,11,13,13,12,8,17,12,20,8,12,12,13,13,5,9,12,15,12,11,13,9,11,2,DM/M C,1,1,1,1,1,1,1,1,1,20,16,1,1,1,1
2111537,Andrezinho,1651,15/02/1985,31,0,0,0,0,171,64,1,3,1,1,3,1,1,1,2,2,1,9,13,14,9,11,13,7,8,5,4,12,6,5,14,6,9,8,8,7,12,8,11,14,6,12,5,7,8,14,14,7,5,20,7,13,10,11,6,7,7,7,5,8,8,8,3,8,11,6,12,4,AM L,1,1,12,14,20,1,1,1,1,1,10,15,1,1,1
2111547,Lucas,1651,18/09/1986,29,0,0,0,0,180,73,1,2,3,1,3,1,1,1,3,1,3,5,6,14,14,14,7,14,7,3,7,8,7,3,16,13,11,8,8,7,4,14,11,10,4,11,5,7,8,11,11,8,11,1,12,11,20,11,11,13,7,10,7,8,13,14,12,13,12,14,14,4,S ,1,1,20,1,1,1,1,1,1,1,1,1,1,1,1
2111548,Marcio Azevedo,1651,05/02/1986,30,0,0,0,0,173,75,3,3,3,4,3,3,2,1,1,3,2,11,13,12,9,13,7,7,12,14,11,12,3,10,12,18,12,17,10,9,10,9,13,16,6,12,9,11,13,16,13,14,9,20,15,14,8,15,14,12,10,11,15,14,13,13,14,13,14,10,12,6,D/WB L,1,1,1,1,1,1,1,20,1,1,1,1,1,19,1
2111551,Rafael,1651,08/07/1986,29,0,0,0,0,182,78,4,1,1,3,1,1,4,3,1,3,1,5,7,7,7,12,8,11,8,8,13,11,9,13,12,11,13,14,10,13,12,12,10,13,12,9,13,14,14,12,11,13,12,9,11,12,20,14,14,12,14,12,15,6,12,10,12,12,10,5,10,8,D C,1,1,1,1,1,1,20,1,1,1,1,1,1,1,1
2111661,Tiago Gasparetto,1651,24/02/1984,32,0,0,0,0,188,85,2,1,1,1,1,2,2,3,1,2,1,4,4,3,9,9,8,10,10,2,11,8,4,10,8,10,13,9,9,14,6,13,13,4,12,8,11,9,7,9,11,6,14,10,12,11,20,14,12,10,5,10,10,10,8,10,13,10,11,7,2,7,D/DM C,1,1,1,1,1,1,20,1,1,18,15,1,1,1,1
2111729,André Zubá,1651,23/06/1986,30,0,0,0,0,188,84,13,10,11,5,12,13,15,14,15,5,10,12,1,3,1,4,15,1,3,1,1,1,16,1,11,8,9,11,4,7,6,13,15,1,12,1,10,14,14,11,12,13,17,9,9,10,20,7,9,13,8,14,9,9,13,13,12,14,11,11,7,8,GK ,20,1,1,1,1,1,1,1,1,1,1,1,1,1,1
2111730,Beto,1651,31/05/1987,29,0,0,0,0,188,85,4,3,3,1,3,3,2,1,1,1,3,4,6,12,12,11,9,13,11,4,4,11,11,4,12,11,10,14,11,12,11,9,16,15,4,12,11,14,10,10,5,6,15,11,16,10,20,12,13,16,7,15,10,7,16,14,15,14,16,14,10,2,S ,1,1,20,1,1,1,1,1,1,1,1,1,1,1,1
2111732,David Braz,1651,21/05/1987,29,0,0,12,1,187,82,2,2,3,1,1,3,2,1,2,1,2,3,9,11,7,10,4,15,8,4,14,12,6,14,12,13,13,12,11,13,8,12,14,5,11,14,13,14,13,14,14,15,14,7,14,14,20,14,13,13,12,11,11,6,6,12,13,7,15,15,15,5,D C,1,10,1,1,1,1,20,1,1,1,1,1,1,1,1
2111737,Lino,1651,15/07/1984,31,0,0,0,0,185,83,4,2,2,3,3,3,1,1,2,1,1,4,5,1,4,9,3,14,4,2,14,4,4,10,8,7,9,10,9,7,3,14,15,1,12,7,14,15,15,10,10,14,14,9,17,13,20,8,14,10,4,5,5,10,17,12,10,14,8,6,19,2,D C,1,1,1,1,1,1,20,1,1,1,1,1,1,1,1
2111742,Reinaldo,1651,25/05/1984,32,0,0,0,0,182,76,1,3,1,1,3,1,1,3,1,3,3,2,4,5,6,8,3,4,5,5,12,11,5,12,10,14,11,12,11,12,11,12,14,13,8,13,13,13,13,9,12,14,11,9,16,10,20,12,13,11,12,13,12,5,13,12,13,14,12,13,13,9,DM/M C,1,1,1,1,1,1,1,1,1,20,18,1,1,1,1
2111787,Edmílson,1651,15/10/1987,28,0,0,0,0,175,67,1,1,2,3,3,2,1,2,3,3,3,5,11,12,10,12,3,12,12,4,5,11,12,6,12,10,11,13,12,9,13,13,15,14,6,15,9,11,13,13,12,11,10,1,10,13,20,12,11,12,9,13,2,8,7,13,10,10,11,8,7,2,D/DM/M C,1,1,1,13,1,1,16,1,1,20,16,1,1,1,1
2111789,Felipe,1651,10/01/1988,28,0,0,5,0,193,90,10,11,11,5,12,10,12,14,14,17,11,1,3,1,1,8,5,6,3,3,1,7,3,1,12,14,11,15,8,10,10,9,9,1,5,5,12,12,15,10,14,12,14,20,10,9,18,13,12,11,7,14,10,10,13,15,9,9,13,12,15,9,GK ,20,1,1,1,1,1,1,1,1,1,1,1,1,1,1
2111790,Júnior,1651,07/03/1987,29,0,0,0,0,187,80,3,3,1,3,3,2,3,3,1,1,3,6,2,13,13,13,6,12,6,4,6,7,5,4,10,9,7,6,9,7,4,10,12,10,11,13,5,7,14,13,12,7,15,8,14,13,20,7,10,13,5,5,7,9,18,11,10,10,9,2,7,3,S ,1,1,20,1,1,1,1,1,1,1,1,1,1,1,1
2111791,Zé Leandro,1651,30/01/1985,31,0,0,0,0,170,63,2,3,2,2,2,2,4,2,3,3,2,9,12,7,3,12,5,10,5,8,9,10,4,9,7,9,9,3,7,10,5,12,5,2,4,7,10,9,15,15,15,8,10,10,15,13,20,9,11,11,6,5,9,9,20,14,11,11,9,12,2,8,D/WB R,1,1,1,1,1,1,1,1,18,1,1,1,10,1,20
2111792,Matheus Ferraz,1651,12/02/1985,31,0,0,0,0,189,82,3,1,3,3,2,4,2,2,3,3,1,7,8,9,8,10,7,16,7,5,14,9,10,13,10,16,15,14,12,13,8,13,17,12,13,10,13,13,13,12,12,7,15,20,14,12,8,14,14,14,10,13,3,10,6,11,9,12,10,4,17,2,D C,1,1,1,1,1,1,20,1,1,1,1,1,1,1,1
2111794,Nádson,1651,18/10/1984,31,0,0,0,0,190,84,1,2,3,3,1,3,3,2,3,1,3,6,10,9,6,11,3,11,10,13,14,11,7,13,10,6,14,13,14,15,6,12,14,8,9,7,14,14,12,10,8,11,14,20,14,11,8,11,13,11,9,11,11,11,13,12,13,12,12,10,12,3,D C,1,1,1,1,1,1,20,10,1,13,4,1,1,10,1
2111797,Rogério Conceição,1651,20/09/1984,31,0,0,0,0,191,82,1,2,1,3,3,1,2,2,3,1,1,4,9,10,5,8,3,14,8,3,10,9,8,10,10,12,9,12,9,8,8,11,12,1,9,7,10,12,13,9,10,15,14,9,16,8,20,13,15,12,10,12,9,10,5,12,12,12,10,13,11,7,D C,1,1,1,1,1,1,20,1,1,13,1,1,1,1,1
2111798,Saulo,1651,10/08/1985,30,0,0,0,0,188,81,15,7,7,15,11,8,12,14,12,15,11,5,2,1,3,6,10,3,2,2,2,4,3,3,8,15,14,15,10,11,11,14,11,2,5,1,12,12,15,13,14,13,15,11,13,7,20,14,16,13,16,9,9,10,2,6,5,1,5,5,3,16,GK ,20,1,1,1,1,1,1,1,1,1,1,1,1,1,1
2111799,Carlinhos,1651,23/01/1987,29,1,0,7,0,175,73,1,1,3,1,2,1,2,3,2,2,3,10,13,14,12,12,11,11,13,10,8,12,12,11,13,14,12,12,12,10,12,12,13,14,10,12,8,12,12,15,15,11,13,20,10,14,14,14,11,10,12,11,12,12,7,14,12,14,6,9,13,4,D/WB/M L,1,1,1,1,15,10,1,20,1,1,1,16,1,19,1
2111880,Cristiano,1651,16/05/1987,29,0,0,0,0,179,0,2,3,2,1,1,1,1,1,3,1,4,5,7,8,12,10,11,12,12,4,5,9,13,6,9,12,13,13,12,10,8,11,12,12,14,12,7,13,13,11,9,14,10,10,13,10,20,14,14,11,5,8,10,5,17,9,13,11,12,8,12,4,S ,1,1,20,1,1,1,1,1,1,1,1,1,1,1,1
2111882,Edilson,1651,25/01/1987,29,0,0,0,0,172,0,1,3,2,1,1,2,1,3,3,3,4,5,10,13,11,12,6,8,10,1,5,14,7,7,13,10,9,7,9,8,13,9,10,10,4,10,9,9,12,13,13,8,3,20,8,13,8,14,11,10,5,1,3,10,12,11,10,10,12,9,9,1,AM C,1,1,1,20,14,1,1,1,1,1,15,12,1,1,1
2111884,Giulliano,1651,19/05/1987,29,0,0,0,0,191,90,11,14,14,4,11,10,11,16,14,10,11,5,1,1,1,8,10,4,1,6,3,5,3,2,5,12,12,12,8,9,6,8,12,1,3,2,15,11,11,6,7,11,16,8,14,7,20,14,14,10,5,10,7,10,15,8,13,8,15,12,20,8,GK ,20,1,1,1,1,1,1,1,1,1,1,1,1,1,1
2111886,Jéferson,1651,09/01/1986,30,0,0,0,0,186,86,12,12,12,5,13,13,13,14,14,14,13,3,1,1,2,6,7,2,2,3,2,3,3,1,6,12,11,13,10,11,8,9,13,1,5,3,13,10,10,10,13,11,13,3,12,13,20,10,13,13,5,3,10,10,13,13,11,14,17,15,15,9,GK ,20,1,1,1,1,1,1,1,1,1,1,1,1,1,1
2111888,Leandro Almeida,1651,14/03/1987,29,0,0,0,0,188,82,4,2,2,3,1,3,1,3,1,1,1,8,6,8,7,10,10,14,9,7,13,9,11,12,10,14,13,12,13,12,9,11,12,8,11,11,13,12,13,13,11,13,14,20,15,12,12,14,13,12,14,11,12,8,12,13,15,8,13,12,12,12,D C,1,1,1,1,1,1,20,10,9,1,1,1,1,1,1
2111889,Leandro Castán,1651,05/11/1986,29,2,0,0,0,184,80,2,1,1,2,2,3,1,2,3,2,3,5,7,6,5,10,8,14,8,12,18,10,10,17,11,16,15,17,9,10,9,13,16,8,13,10,15,14,16,11,10,16,10,20,13,13,8,14,16,12,12,10,12,5,13,12,13,12,16,13,10,5,D C,1,1,1,1,1,1,20,1,1,1,1,1,1,1,1
2111891,Leo Veloso,1651,29/05/1987,29,0,0,0,0,180,72,4,2,1,3,3,2,2,3,2,3,2,9,12,12,8,13,9,10,11,9,10,12,9,11,13,13,12,14,11,11,12,11,11,12,6,12,11,13,12,12,13,11,11,20,12,13,7,13,11,10,5,2,11,8,11,11,10,10,12,12,12,5,D/WB/M L,1,1,1,1,1,1,1,19,1,1,1,17,1,20,1
2111893,Thiago Feltri,1651,18/05/1985,31,0,0,0,0,174,64,2,1,4,1,3,2,3,1,1,2,2,7,12,11,11,10,9,8,11,12,10,9,9,10,12,13,12,13,12,11,12,11,12,13,9,12,11,13,11,13,12,7,7,20,13,13,10,12,7,14,10,10,10,12,12,12,15,15,11,10,13,6,D/WB L,1,1,1,1,8,1,1,20,1,1,1,12,1,19,1
2111894,Éder Luís,1651,19/04/1985,31,0,0,0,0,170,69,1,3,1,1,4,1,4,2,1,3,1,6,11,13,10,11,7,7,11,5,6,10,11,8,13,11,13,12,10,13,11,12,12,15,10,14,7,9,14,15,15,7,6,9,14,15,20,15,7,14,6,13,10,14,13,11,13,12,13,9,11,11,AM/S R,1,1,20,1,12,19,1,1,1,1,1,1,10,1,1
2111952,Adílson,1651,18/02/1987,29,0,0,0,0,177,76,1,3,3,2,3,2,2,2,1,2,3,9,10,10,11,10,10,10,11,3,6,10,6,5,10,4,10,12,11,10,9,11,9,7,10,16,9,11,11,13,12,10,10,20,11,13,10,13,9,11,10,10,9,10,12,10,12,13,11,11,16,4,S ,1,1,20,1,13,1,1,1,1,1,1,1,1,1,1
2111953,Afonso,1651,01/02/1988,28,0,0,0,0,179,74,1,3,2,1,2,2,1,2,2,3,2,13,12,9,9,8,13,7,9,10,10,11,9,11,9,13,10,12,8,10,9,9,11,8,8,11,10,12,12,12,11,10,8,7,12,13,20,12,9,9,6,9,4,14,11,10,12,10,13,11,14,5,D/WB R,1,1,1,1,1,1,1,1,20,1,1,1,15,1,19
2111954,Aldo,1651,11/02/1988,28,0,0,0,0,174,71,1,3,1,1,1,3,3,3,2,2,3,4,9,9,7,8,4,9,8,9,12,9,4,11,9,13,9,15,8,10,8,10,15,8,10,11,11,14,12,12,11,11,7,4,16,12,20,14,12,12,13,9,7,10,12,11,13,11,14,12,12,11,D/WB/DM RC,1,1,1,1,1,1,12,1,18,20,15,1,14,1,16
2111956,Anderson Santana,1651,24/04/1986,30,0,0,0,0,184,80,2,2,3,3,2,1,3,1,2,1,1,10,13,12,11,10,13,12,12,13,14,11,15,13,12,13,12,12,15,14,9,14,15,11,14,12,13,12,14,11,11,14,14,20,13,11,5,14,14,19,10,10,8,13,14,13,6,11,14,15,12,9,D/WB L,1,3,1,1,8,1,10,20,1,1,1,13,1,18,1
2111958,Bruno,1651,05/02/1987,29,0,0,0,0,188,89,15,11,11,10,11,14,14,9,5,10,13,3,3,1,2,3,7,1,2,1,3,2,2,3,6,6,11,15,10,11,9,15,8,1,9,3,10,10,9,12,12,10,16,11,7,11,20,9,11,10,10,10,10,9,16,12,14,10,10,1,1,3,GK ,20,1,1,1,1,1,1,1,1,1,1,1,1,1,1
2111960,Carlos Magno,1651,16/01/1989,27,0,0,0,0,172,78,1,3,3,4,2,3,3,3,1,1,3,5,7,8,9,9,6,9,11,6,10,10,10,11,10,12,11,12,11,11,8,10,8,8,11,9,12,11,12,12,11,14,9,8,12,12,20,13,13,8,9,10,10,12,11,10,11,8,10,3,15,7,DM/M C,1,1,1,1,1,1,1,1,1,20,19,1,12,1,10
2111963,Edimar,1651,21/05/1986,30,0,0,0,0,180,73,2,3,2,3,2,3,3,1,2,2,3,13,11,12,8,12,12,9,14,12,10,12,10,13,13,12,13,13,12,14,13,13,13,10,8,10,12,14,14,15,13,10,10,20,12,16,6,13,10,12,10,9,6,10,14,14,10,10,14,11,12,14,D/WB L,1,1,1,1,7,1,1,20,12,1,1,14,1,19,11
2111964,Elisson,1651,26/03/1987,29,0,0,0,0,186,88,12,11,12,3,13,14,12,11,13,8,16,1,4,5,6,8,4,5,1,7,1,11,7,6,10,11,11,12,11,12,5,11,11,5,11,1,12,10,10,10,12,10,15,8,12,10,20,12,14,11,6,8,12,1,16,10,11,12,12,7,7,1,GK ,20,1,1,1,1,1,1,1,1,1,1,1,1,1,1
2111966,Evandro,1651,01/12/1986,29,0,0,0,0,177,78,2,1,3,3,2,2,3,3,3,3,1,14,13,11,11,10,15,10,16,9,5,13,11,6,12,9,11,10,10,11,12,11,8,13,10,12,2,10,11,9,10,12,9,20,11,8,10,12,13,9,9,11,10,12,16,9,11,11,12,7,6,8,M C,1,1,1,14,1,1,1,1,1,15,20,13,10,1,1
2111971,Fábio,1651,30/03/1987,29,0,0,0,0,172,76,3,2,2,3,3,3,3,3,3,3,4,8,8,9,9,12,8,8,14,1,8,14,5,14,13,10,8,9,9,10,13,11,10,10,9,9,13,9,13,14,14,9,2,3,17,14,20,14,9,9,9,9,5,10,14,10,12,10,10,6,3,4,DM/M C,1,1,1,1,1,1,1,1,1,20,16,1,1,1,1
2111973,Guilherme,1651,22/10/1988,27,0,0,0,0,174,73,1,3,3,2,1,3,1,2,3,2,1,12,13,14,13,14,5,12,14,10,5,15,16,5,16,10,15,11,13,13,14,14,8,16,5,14,6,10,5,13,13,12,10,15,6,14,20,12,11,8,8,16,15,11,11,9,14,9,10,8,12,9,AM/S C,1,1,19,20,12,12,1,1,1,1,13,1,1,1,1
2111975,Jefferson,1651,05/07/1988,27,0,0,0,0,176,73,1,3,2,2,3,3,2,3,1,2,3,14,15,13,9,13,15,9,16,13,11,13,14,12,14,13,13,14,12,12,13,12,14,12,11,15,11,14,14,14,14,13,9,20,14,15,12,14,11,14,8,16,5,8,7,12,10,11,13,10,13,12,D L,1,1,1,1,1,1,1,20,1,1,1,10,1,15,1
2111976,Joabe,1651,29/05/1989,27,0,0,0,0,177,76,1,3,3,1,1,3,1,3,1,1,1,8,8,10,8,10,9,8,8,3,5,10,13,6,10,9,10,9,10,9,10,9,11,11,7,10,5,10,10,12,12,10,8,10,12,13,20,11,8,13,5,10,5,12,5,10,12,10,12,11,12,6,AM/S RLC,1,1,20,15,19,17,1,1,1,1,10,14,12,1,1
2111977,Jonathas,1651,06/03/1989,27,0,0,3,3,191,83,3,4,2,2,3,3,2,1,1,4,2,7,6,10,13,13,10,12,14,11,8,10,14,7,13,12,12,14,14,12,8,15,8,14,12,14,6,15,16,13,11,15,16,10,14,14,20,15,14,14,7,14,8,8,13,15,6,9,7,13,14,11,S ,1,1,20,1,1,1,1,1,1,1,1,1,1,1,1
2111982,Leandro Amaro,1651,19/06/1986,30,0,0,0,0,187,82,3,1,2,2,1,1,1,1,3,1,4,5,6,7,8,10,5,14,7,4,12,11,8,12,10,12,12,13,12,11,7,11,12,8,11,10,13,13,12,13,12,14,14,8,14,12,20,16,14,11,14,13,6,7,10,13,13,9,12,8,13,7,D C,1,11,1,1,1,1,20,1,1,1,1,1,1,1,1
2111983,Lucas Chiaretti,1651,22/09/1987,28,0,0,0,0,171,65,2,2,2,2,3,1,1,3,2,1,3,13,11,14,10,14,11,8,12,5,5,15,13,9,15,10,12,10,11,12,14,11,8,13,10,15,9,12,13,15,13,11,6,20,7,13,8,12,11,8,5,11,15,10,15,12,11,10,10,14,10,8,AM RL,1,1,7,1,20,17,1,1,1,1,1,1,1,1,1
2111990,Paulinho Dias,1651,13/05/1988,28,0,0,0,0,175,77,2,3,1,3,2,3,3,1,1,2,2,10,11,10,11,12,10,12,11,12,13,12,12,12,12,14,12,12,12,11,11,11,12,12,12,11,13,13,13,13,13,12,7,8,12,13,20,13,12,12,11,12,12,12,12,11,11,14,12,6,16,6,DM C,1,1,1,1,1,1,1,1,10,20,15,1,1,1,10
2111991,Rafael,1651,23/06/1989,27,0,0,2,0,192,82,15,14,13,1,14,12,10,15,8,15,11,1,5,7,6,6,1,8,1,1,1,10,8,3,5,14,11,14,12,14,10,12,15,1,12,3,14,13,12,12,15,12,16,20,14,11,4,12,10,13,8,14,1,12,12,9,16,16,16,15,16,1,GK ,20,1,1,1,1,1,1,1,1,1,1,1,1,1,1
2111993,Tadeu,1651,01/04/1986,30,0,0,0,0,187,83,2,3,3,3,2,1,2,2,1,2,2,2,6,8,12,9,7,14,12,5,7,9,14,6,9,13,12,14,12,10,9,11,12,12,10,12,9,12,11,12,10,15,14,13,15,12,20,14,16,10,13,11,8,6,9,13,13,12,13,8,12,11,S ,1,1,20,1,1,1,1,1,1,1,1,1,1,1,1
2111995,Thiago Heleno,1651,19/09/1988,27,0,0,0,0,187,85,3,1,2,3,4,3,1,3,3,2,3,7,8,10,9,11,11,14,12,10,14,10,11,14,11,16,13,13,13,12,8,12,8,10,13,7,14,14,11,13,12,14,15,8,11,12,20,12,15,12,14,12,13,6,6,15,12,12,8,11,15,13,D C,1,5,1,1,1,1,20,1,10,1,1,1,1,1,1
2111998,Wellington,1651,09/01/1989,27,0,0,0,0,187,78,3,3,1,2,1,2,2,2,3,1,3,2,4,7,7,6,5,13,6,7,12,8,13,12,7,15,11,14,11,11,6,12,17,13,12,7,12,12,12,11,10,13,14,7,16,11,20,13,13,11,12,13,10,9,20,16,14,15,14,8,13,12,D C,1,11,1,1,1,1,20,1,1,1,1,1,1,1,1
2111999,Woshington,1651,05/01/1990,26,0,0,0,0,181,0,1,2,2,1,1,2,2,2,1,3,2,5,2,7,12,12,5,12,5,4,4,6,4,2,9,7,6,6,12,6,1,12,3,10,8,12,6,5,6,12,12,6,8,5,14,12,20,10,7,9,9,1,9,9,11,12,12,11,10,12,6,2,S ,1,1,20,1,1,1,1,1,1,1,1,1,1,1,1
2112000,William Menezes,1651,05/04/1989,27,0,0,0,0,192,87,14,14,9,1,14,13,10,13,9,8,11,3,2,3,3,6,7,1,1,2,1,3,3,3,1,4,14,15,10,10,9,14,11,1,1,1,10,10,8,14,17,10,16,4,12,10,20,4,13,12,7,11,11,11,10,11,13,12,13,3,12,2,GK ,20,1,1,1,1,1,1,1,1,1,1,1,1,1,1
2112034,Maicosuel,1651,16/06/1986,30,0,0,0,0,179,80,2,2,1,1,3,3,3,3,1,2,3,11,11,15,12,14,14,8,13,6,6,13,11,10,14,8,12,8,12,12,13,13,10,15,5,13,6,13,11,16,17,12,11,9,13,14,20,15,8,11,10,8,15,12,3,12,10,9,9,6,11,10,AM RLC,1,1,13,20,17,17,1,1,1,1,1,1,1,1,1
2112045,Zé Roberto,1651,31/05/1981,35,0,0,0,0,187,82,3,1,3,2,3,2,1,1,4,1,2,5,7,3,5,8,1,14,4,4,13,7,6,13,5,6,6,5,6,10,6,14,12,7,6,8,14,8,9,13,13,12,15,10,13,13,20,12,13,12,5,12,5,8,20,13,10,11,11,1,8,4,D C,1,1,1,1,1,1,20,14,1,1,1,1,1,1,1
2112201,Marcelo Toscano,1651,12/05/1985,31,0,0,0,0,184,83,2,2,4,1,2,1,1,3,3,2,1,12,12,12,13,13,12,12,11,6,6,13,14,7,13,11,13,11,12,13,13,13,12,13,11,13,7,13,13,12,12,13,11,10,12,12,20,13,13,12,6,11,10,12,12,10,6,12,11,8,15,6,S RL,1,1,20,13,15,15,1,1,1,1,1,1,1,1,1
2112342,Tiago Tremonti,1651,08/06/1985,31,0,0,0,0,173,72,2,3,2,3,2,1,2,1,1,3,1,2,10,13,11,11,6,5,9,8,4,11,11,6,12,12,12,11,10,11,11,10,2,15,5,12,4,10,11,11,13,12,6,20,14,13,8,13,10,13,9,3,9,9,7,11,13,13,11,7,13,5,AM RC,1,1,15,20,1,15,1,1,1,1,10,1,1,1,1
2112349,Ávine,1651,21/02/1988,28,0,0,0,0,170,63,3,2,1,1,2,2,2,3,2,2,4,9,9,10,9,11,11,6,7,12,11,11,13,10,13,15,12,12,10,11,10,10,14,13,6,11,8,10,11,11,11,13,4,20,2,12,9,7,4,11,14,13,20,15,11,12,15,14,8,5,7,15,D/WB L,1,1,5,9,12,1,1,19,1,6,10,15,1,20,1
2112353,Daylson,1651,17/03/1985,31,0,0,0,0,178,72,3,4,1,2,2,1,3,2,2,2,3,8,11,12,8,11,6,8,9,12,9,11,5,9,11,9,6,10,7,9,10,6,8,9,6,10,9,10,11,12,14,9,11,10,11,14,20,13,11,9,9,9,4,9,14,9,14,12,10,5,7,7,D/WB R,1,1,1,1,1,1,1,1,18,1,1,1,1,1,20
2112356,Cléberson,1651,30/09/1988,27,0,0,0,0,178,79,3,2,1,4,2,2,1,2,1,1,3,2,10,9,7,9,3,12,6,8,12,4,7,12,9,11,10,13,7,9,7,9,12,5,10,9,11,12,11,12,13,9,11,11,12,13,20,12,14,8,10,8,4,10,20,12,11,11,13,1,16,2,D/DM C,1,1,1,1,1,1,20,1,13,17,1,1,1,1,1
2112362,Marcone,1651,12/09/1987,28,0,0,1,0,180,80,1,3,3,2,3,4,2,2,1,2,2,1,8,8,9,8,12,10,13,11,14,8,10,13,8,17,11,16,10,11,7,9,18,10,12,10,12,16,15,12,10,13,10,7,15,12,20,13,14,12,13,14,7,18,10,11,17,14,11,9,12,11,D/DM/M RC,1,11,1,1,1,1,18,12,17,20,16,1,5,7,15
2112365,Marcel Sacramento,1651,24/08/1987,28,0,0,0,0,183,75,2,4,3,2,2,3,1,3,1,2,3,8,8,11,8,10,8,9,9,2,3,11,13,3,11,9,8,6,9,9,9,6,11,13,12,8,8,14,14,12,13,8,12,10,12,12,20,15,8,12,9,9,9,9,12,11,9,14,9,6,13,3,M C,1,1,15,10,1,1,1,1,1,1,20,1,1,1,1
2112366,Marcelo Rufino,1651,27/10/1985,30,0,0,0,0,174,78,3,3,3,4,3,1,4,1,1,1,4,4,8,11,13,9,8,13,12,3,4,10,15,4,10,8,17,10,12,8,8,13,11,6,6,13,12,11,12,13,12,8,11,1,13,13,20,12,14,10,10,8,10,5,13,14,12,9,9,8,4,8,S ,1,1,20,1,1,1,1,1,1,1,1,1,1,1,1
2112494,Adilson,1651,16/01/1987,29,0,0,0,0,181,75,3,2,3,4,2,3,3,1,3,1,2,4,9,11,8,12,7,10,11,9,13,13,10,14,12,18,13,17,13,15,10,13,12,8,14,13,14,14,14,14,13,14,10,10,15,14,20,14,10,16,14,14,11,14,11,13,12,12,12,11,11,10,DM ,1,1,1,10,1,1,14,1,1,20,14,7,7,1,1
2112495,Diego Torres,1651,02/03/1986,30,0,0,0,0,179,71,3,4,1,2,3,3,3,1,2,1,2,6,9,11,10,11,9,10,10,4,7,11,13,8,11,12,14,6,10,11,12,9,7,9,8,12,8,11,15,13,13,12,9,7,12,13,20,13,9,10,12,10,10,10,9,9,10,13,11,8,7,6,AM C,1,1,1,20,1,1,1,1,1,1,15,1,1,1,1
2112532,Bruno Teles,1651,01/05/1986,30,0,0,0,0,183,75,1,4,3,2,1,1,3,1,2,3,1,10,12,12,9,12,9,10,12,15,11,11,10,12,13,12,11,12,10,12,11,12,13,13,10,12,11,11,12,13,12,12,12,20,13,13,8,12,11,13,9,11,11,12,13,13,12,12,15,13,13,7,D L,1,1,1,1,5,1,7,20,1,1,1,13,1,13,1
2112533,Caio Venâncio,1651,17/02/1988,28,0,0,0,0,185,75,10,7,8,1,10,13,6,10,9,9,12,4,2,1,2,2,8,1,1,2,2,1,3,2,5,9,11,15,6,7,7,10,7,1,12,3,14,8,7,10,17,13,15,9,10,14,20,4,14,9,6,4,4,9,15,10,13,13,10,1,9,6,GK ,20,1,1,1,1,1,1,1,1,1,1,1,1,1,1
2112537,Gabriel Valongo,1651,30/06/1987,29,0,0,0,0,193,98,2,2,2,1,1,1,2,1,2,1,2,3,5,5,7,10,12,12,12,6,13,9,11,12,8,15,11,15,8,8,5,10,13,11,10,7,11,13,12,10,8,3,17,7,15,10,20,11,18,11,14,11,7,7,12,11,13,13,9,8,12,12,D C,1,11,1,1,1,1,20,1,1,1,1,1,1,1,1
2112539,Jhonathan,1651,31/01/1989,27,0,0,0,0,168,72,1,1,1,1,3,1,2,1,3,1,3,6,6,9,9,13,9,9,9,1,7,12,5,5,12,6,11,8,12,8,12,12,12,13,11,13,8,8,8,13,14,8,5,20,10,9,9,13,6,10,10,9,9,10,10,11,12,12,11,4,6,7,AM/S C,1,1,16,20,1,1,1,1,1,1,8,1,1,1,1
2112540,Jucemar Gaúcho,1651,10/08/1986,29,0,0,0,0,172,74,1,2,2,2,3,1,3,1,1,2,2,8,9,9,5,8,7,6,10,9,12,11,9,12,12,8,12,11,11,10,11,12,5,8,11,10,12,13,13,13,12,14,9,10,12,12,20,11,13,10,8,12,8,10,12,8,11,11,10,1,1,8,DM/M C,1,1,1,1,1,1,1,1,1,20,17,1,1,1,1
2112542,Wágner Fogolari,1651,19/11/1989,26,0,0,0,0,191,87,1,1,3,2,3,1,2,2,1,2,1,7,6,9,7,9,8,13,5,7,12,10,10,13,9,13,12,12,11,12,7,11,11,9,8,10,11,8,11,12,11,13,16,8,14,12,20,13,13,9,12,8,6,8,19,11,8,13,12,10,12,12,D C,1,1,1,1,1,1,20,1,1,1,1,1,1,1,1
2112673,Alexandre Matão,1651,26/03/1986,30,0,0,0,0,181,85,1,1,2,3,1,1,2,2,3,3,3,4,7,13,10,13,4,11,4,1,5,8,1,5,9,9,7,6,6,7,8,7,7,9,12,13,7,6,8,10,10,16,13,9,13,11,20,11,16,9,9,7,9,9,8,14,13,14,13,7,7,1,S C,1,1,20,15,1,1,1,1,1,1,10,1,1,1,1
2112675,Romeu,1651,13/02/1985,31,0,0,0,0,180,77,1,2,3,3,1,1,2,2,3,2,2,10,12,14,8,12,11,11,14,10,10,12,11,11,14,12,12,9,10,10,12,9,9,14,6,12,12,11,12,12,11,12,9,12,10,11,20,12,11,12,10,13,12,10,10,16,6,9,10,6,10,12,DM/M C,1,1,1,10,1,1,1,1,1,16,20,1,1,1,1
2112730,Juliano,1651,04/12/1984,31,0,0,0,0,186,83,2,3,2,2,3,2,1,2,2,1,2,2,4,4,5,6,2,13,3,4,11,6,8,13,4,16,9,14,6,11,4,10,4,7,7,4,9,14,13,11,6,7,12,6,16,11,20,11,15,14,14,12,4,8,9,10,14,10,12,2,8,1,D C,1,1,1,1,1,1,20,1,1,1,1,1,1,1,1
2112759,Amaral,1651,05/09/1987,28,0,0,12,1,172,61,3,1,2,2,2,1,1,2,2,2,2,10,11,11,9,12,11,7,8,12,9,12,10,10,12,13,9,10,9,9,11,9,14,12,4,12,9,12,11,13,12,14,6,11,14,13,20,13,5,11,10,10,7,14,12,14,10,11,14,15,14,10,D/WB R,1,1,1,1,1,12,1,10,16,6,7,1,15,8,20
2112929,Leandro Teixeira,1651,17/08/1987,28,0,0,0,0,177,76,4,3,3,2,2,1,1,1,2,2,1,9,7,7,8,13,15,6,10,4,11,10,2,13,10,10,11,9,9,9,12,13,5,10,12,7,10,8,12,13,13,8,6,10,10,12,20,13,9,10,10,10,10,10,16,9,13,11,10,1,1,7,DM/M C,1,1,1,1,1,1,1,1,1,20,16,1,1,1,1
2112936,Marcinho,1651,14/05/1986,30,0,0,0,0,182,72,2,3,3,3,3,3,2,2,3,3,2,14,12,12,11,12,14,12,13,10,9,12,13,9,13,13,13,9,9,9,13,10,11,14,8,10,9,9,9,13,13,11,11,20,15,12,9,10,8,10,10,12,8,14,13,12,10,12,11,10,9,11,AM/S RLC,1,1,17,20,17,16,1,8,1,10,15,13,10,9,1
2113053,Ferron,1651,11/11/1985,30,0,0,0,0,187,83,3,3,1,1,1,1,1,2,3,1,3,4,7,6,8,10,6,13,7,8,12,9,7,13,9,14,12,12,11,11,8,11,13,7,13,9,13,14,13,11,11,7,14,6,14,11,20,13,14,12,12,12,10,7,11,10,12,11,12,10,8,8,D C,1,1,1,1,1,1,20,1,1,1,1,1,1,1,1
2113172,Roberto,1651,29/04/1983,33,0,0,0,0,180,79,3,2,3,1,1,3,3,1,1,1,1,3,2,1,1,7,1,13,6,1,8,7,1,12,4,9,8,9,7,11,6,13,6,1,10,3,13,6,7,9,11,7,10,9,11,8,20,10,13,9,9,6,8,9,18,12,12,14,11,8,16,6,D C,1,1,1,1,1,1,20,1,1,1,1,1,1,1,1
2113173,Léo Oliveira,1651,25/01/1983,33,0,0,0,0,179,75,4,2,2,2,2,1,1,3,2,1,3,6,6,6,7,6,9,7,10,6,12,10,9,11,12,15,11,13,12,11,10,11,15,6,11,6,11,12,13,12,11,11,13,14,14,11,20,14,11,13,15,12,11,10,12,13,10,11,16,14,17,9,DM/M C,1,1,1,1,1,1,1,1,1,20,17,1,1,1,1
2113196,Gustavo,1651,20/02/1986,30,0,0,0,0,185,90,2,2,3,1,1,3,1,3,2,2,3,6,8,9,9,9,16,13,8,8,13,13,9,15,9,14,12,13,11,12,7,10,10,8,10,11,13,12,14,11,8,16,16,10,8,11,20,14,16,11,14,8,10,6,14,10,11,9,9,7,7,9,D C,1,1,1,1,1,1,20,1,1,1,1,1,1,1,1
2113304,Ney Maruim,1651,23/02/1981,35,0,0,0,0,181,81,3,2,2,1,2,2,2,2,3,1,2,7,7,7,5,7,5,7,7,11,10,8,5,8,9,16,9,14,7,8,6,11,14,8,9,7,8,10,9,10,11,8,10,10,13,10,20,12,11,11,14,13,7,19,15,12,9,12,12,10,10,10,D/DM RLC,1,1,1,1,1,1,15,15,17,20,10,1,1,10,13
2113542,Hugo,1651,06/06/1987,29,0,0,0,0,177,70,1,2,3,3,2,3,1,1,3,1,1,8,11,8,9,14,4,8,11,6,10,9,1,10,9,6,8,9,6,11,8,13,10,7,11,9,10,10,11,12,11,9,9,20,11,13,9,10,9,3,8,9,9,9,8,11,10,11,11,6,10,8,D/WB L,1,1,1,1,1,1,1,20,1,1,1,1,1,16,1
2113543,Carlão,1651,19/07/1987,28,0,0,3,0,167,61,3,3,3,3,1,1,3,2,3,3,1,8,10,13,9,11,4,6,9,4,9,11,9,10,12,11,10,10,11,12,11,12,11,13,5,12,9,12,14,12,12,12,4,20,13,13,10,13,7,12,8,14,7,12,15,11,10,12,11,10,12,5,D/WB L,1,1,3,1,1,1,1,20,1,1,1,1,1,18,1
2113548,Lima,1651,10/02/1985,31,0,0,0,0,182,79,2,3,1,2,3,3,3,1,3,4,1,7,8,8,8,11,10,13,10,8,12,12,9,13,12,10,13,11,12,12,12,13,14,4,11,7,13,14,12,13,14,10,11,10,11,12,20,13,11,13,10,13,11,10,6,14,14,14,14,14,12,8,D C,1,1,1,1,1,1,20,1,1,1,1,1,1,1,1
2113725,Leandro Guerreiro,1651,23/02/1984,32,0,0,0,0,176,70,3,3,1,3,1,2,3,1,1,3,2,9,10,15,13,10,9,15,7,6,9,10,6,7,14,10,10,5,13,9,9,9,3,12,7,13,10,9,11,10,12,10,6,10,13,13,20,14,12,10,4,10,10,10,7,11,9,11,10,10,7,4,S R,1,1,20,1,1,15,1,1,1,1,1,1,1,1,1
2113733,Leomar,1651,12/06/1986,30,0,0,0,0,188,82,2,3,1,3,2,1,3,3,3,1,1,5,3,9,2,9,1,12,7,1,12,10,5,10,10,12,8,10,9,7,5,13,14,10,3,6,10,7,8,10,11,11,15,10,13,11,20,8,12,12,5,9,7,10,9,12,10,10,11,11,8,9,D C,1,1,1,1,1,1,20,1,1,1,1,1,1,1,1
2113802,Juliano,1651,06/04/1990,26,0,0,0,0,183,77,1,1,1,3,2,3,2,2,1,1,1,10,8,13,12,14,5,10,14,6,14,11,10,12,11,11,14,9,12,14,11,14,12,12,5,11,13,10,14,14,13,8,12,20,9,11,7,9,10,13,11,14,11,12,16,13,12,13,13,6,8,7,DM C,1,1,1,13,1,1,1,1,1,20,15,1,1,1,1
2114023,Teles,1651,27/03/1987,29,0,0,0,0,174,67,3,3,2,1,4,3,2,2,3,3,1,8,9,9,6,10,9,7,8,10,8,9,9,8,10,11,8,11,9,9,8,9,9,11,6,10,10,11,12,13,14,13,7,20,13,14,6,13,5,10,5,9,7,11,9,11,11,11,8,3,10,2,D/WB L,1,1,1,1,6,1,1,18,1,1,1,12,1,20,1
2114054,Bruno César,1651,03/11/1988,27,2,0,0,0,178,83,3,1,2,2,2,3,3,1,1,3,3,15,15,14,13,15,14,11,17,4,7,15,14,8,16,6,13,10,15,12,15,14,8,15,10,14,6,13,11,12,14,14,7,20,8,13,7,12,12,12,10,12,10,10,11,13,7,8,8,10,13,8,AM LC,1,1,12,20,17,14,1,15,1,1,8,15,1,14,1
2114057,Rafael Bastos,1651,01/01/1985,31,0,0,0,0,185,72,2,3,1,2,1,2,3,1,2,3,2,11,12,13,11,13,15,11,12,4,10,12,16,10,13,11,12,11,13,11,13,12,12,14,6,12,9,8,12,13,13,11,13,9,14,13,20,13,9,13,12,14,7,11,8,14,11,11,10,13,10,14,AM LC,1,1,10,20,17,13,1,1,1,1,14,10,10,1,1
2114058,Saulo,1651,16/03/1987,29,0,0,0,0,178,73,2,1,1,1,2,1,3,3,1,3,1,8,6,8,10,14,12,9,12,2,10,11,13,9,10,10,8,12,7,7,10,7,10,3,5,9,12,11,11,12,9,11,11,8,15,10,20,11,11,14,4,12,9,13,12,11,14,13,15,13,14,10,DM/M C,1,10,1,12,1,1,15,1,1,19,20,1,1,1,1
2114063,Ademir,1651,20/09/1985,30,0,0,0,0,174,72,1,4,2,3,3,1,3,2,3,1,1,9,11,11,7,7,7,8,7,14,12,9,4,11,9,10,8,13,6,8,8,7,12,6,14,9,11,12,14,14,13,11,7,10,13,13,20,13,10,12,6,10,7,10,18,10,12,9,13,1,5,3,D/WB R,1,1,1,1,1,1,1,1,19,1,1,1,1,1,20
2114066,Caique,1651,10/01/1987,29,0,0,0,0,187,77,1,3,2,1,3,2,3,3,4,4,4,5,10,10,12,11,11,10,10,8,11,13,13,11,13,12,12,13,11,11,12,11,15,13,6,11,10,12,12,12,12,9,14,10,13,11,20,11,12,13,8,12,18,14,13,12,15,14,15,11,13,9,AM/S RC,1,1,16,20,13,18,1,1,1,1,1,1,1,1,1
2114068,David Luiz,1651,22/04/1987,29,56,3,0,0,189,84,3,2,2,1,2,2,2,2,2,1,3,8,9,13,12,13,14,14,12,18,17,12,15,16,13,17,16,16,12,10,10,11,17,12,15,12,11,13,16,17,15,16,16,10,16,15,20,14,13,10,12,13,10,13,15,16,18,13,16,11,10,7,D/DM C,1,1,1,1,1,1,20,12,12,17,1,1,1,1,1
2114077,Jardel,1651,29/03/1986,30,0,0,0,0,192,88,2,3,3,3,1,3,1,3,4,1,2,4,4,8,9,10,6,15,6,7,16,9,11,17,9,18,17,18,11,15,6,13,16,6,15,10,16,15,15,13,11,16,17,5,16,13,20,12,17,16,12,15,8,7,14,12,18,12,18,17,13,7,D C,1,1,1,1,1,1,20,1,1,1,1,1,1,1,1
2114080,Jéferson Baiano,1651,20/01/1986,30,0,0,0,0,184,78,2,1,1,1,1,2,2,3,2,2,3,3,8,9,9,10,3,12,11,7,14,10,10,12,9,15,13,14,9,11,9,11,14,7,10,11,12,14,13,11,11,13,12,8,14,12,20,13,11,12,11,11,9,14,10,11,14,11,14,12,13,10,D/DM C,1,12,1,1,1,1,20,1,1,17,13,1,1,1,1
2114082,Júnior Lopes,1651,19/10/1987,28,0,0,0,0,190,87,4,1,2,1,1,2,1,3,2,1,2,2,5,5,6,8,1,14,7,10,13,9,6,14,8,13,11,12,8,11,5,10,9,4,12,4,12,13,14,11,10,14,15,8,13,11,20,13,15,12,4,5,10,10,10,12,10,11,9,1,7,1,D C,1,1,1,1,1,1,20,1,1,1,1,1,1,1,1
2114093,Stefan,1651,16/04/1988,28,0,0,0,0,175,76,3,2,2,1,2,3,2,2,3,2,1,11,10,12,13,11,11,11,11,3,4,11,14,5,13,7,8,10,12,8,11,11,12,11,4,14,8,9,11,14,14,9,7,7,12,14,20,11,7,10,7,10,7,10,9,10,14,10,13,17,14,7,M/AM/S RC,1,1,20,19,13,18,1,1,1,1,16,8,15,1,1
2114095,Uélliton,1651,28/08/1987,28,0,0,0,0,172,75,3,1,2,3,3,1,2,2,2,2,2,9,9,10,9,11,11,12,10,8,13,11,11,12,11,14,11,15,11,11,10,11,11,7,13,10,12,13,14,13,12,13,7,8,16,12,20,13,12,13,13,12,13,10,12,9,6,9,8,9,12,9,DM/M C,1,1,1,1,1,1,8,1,1,20,18,1,1,1,1
2114097,Wallace Reis,1651,26/12/1987,28,0,0,0,0,184,80,2,3,3,3,3,2,3,3,1,1,1,2,6,8,7,11,7,14,8,8,13,11,11,14,8,13,13,13,10,12,9,12,15,14,16,12,13,12,13,12,12,14,14,11,14,13,20,13,14,12,11,13,5,12,10,12,16,12,14,11,13,6,D C,1,16,1,1,1,1,20,6,13,12,8,1,1,6,4
2114098,Willian Schuster,1651,31/05/1987,29,0,0,0,0,180,73,2,3,3,3,1,1,1,3,1,2,3,11,12,12,11,13,10,9,11,10,11,12,13,11,12,8,12,8,11,12,13,13,13,11,7,14,12,12,12,13,12,9,9,12,12,13,20,12,12,11,7,10,12,16,9,8,10,12,10,9,14,6,M RC,1,1,1,10,1,10,1,1,12,10,20,10,17,1,1
2114099,Anderson Martins,1651,21/08/1987,28,0,0,0,0,184,80,2,2,1,2,3,4,1,2,3,2,2,2,8,12,8,12,4,13,9,6,14,13,11,14,13,17,15,15,13,14,11,13,12,5,10,11,14,14,13,14,13,13,13,10,17,14,20,13,13,15,14,13,6,12,13,11,7,14,11,7,9,12,D C,1,16,1,1,1,1,20,9,11,12,5,1,1,1,1
2114100,Élton,1651,12/02/1986,30,0,0,0,0,178,74,1,1,3,2,3,3,2,1,3,1,2,12,10,11,8,13,13,7,14,10,12,13,13,13,14,11,10,12,11,12,11,13,10,11,6,11,12,13,14,11,11,12,8,20,11,12,8,12,12,12,10,12,12,14,10,11,10,11,10,10,10,12,DM/M C,1,1,1,14,10,1,1,14,1,18,20,14,1,14,1
2114154,André Alves,1651,15/10/1983,32,0,0,0,0,181,76,3,2,2,2,2,3,3,2,2,1,2,9,10,12,15,11,8,13,9,7,7,12,12,8,12,11,14,11,13,12,11,13,10,12,8,16,7,13,10,12,13,13,12,12,11,11,20,12,13,10,6,13,7,7,12,13,16,10,14,13,10,6,S ,1,1,20,1,1,1,1,1,1,1,1,1,1,1,1
2114207,Eusébio,1651,22/09/1985,30,0,0,0,0,168,63,3,2,2,1,3,1,2,2,1,1,2,10,11,11,9,12,10,6,9,8,8,12,12,8,12,12,10,11,11,9,11,11,13,13,3,12,6,8,10,14,15,15,4,20,14,14,7,12,4,13,8,12,7,14,15,10,7,13,14,6,9,12,D/WB/M L,1,1,7,13,15,1,1,16,1,8,10,20,1,18,1
2114234,Batista,1651,08/07/1987,28,0,0,0,0,183,83,13,7,9,1,11,13,8,11,9,9,7,2,2,2,2,1,4,1,3,3,2,1,3,1,1,9,8,15,7,10,6,13,10,2,1,2,12,7,6,11,14,7,8,7,15,10,20,6,9,9,5,9,7,9,10,11,10,12,10,10,1,5,GK ,20,1,1,1,1,1,1,1,1,1,1,1,1,1,1
2114243,Zé Paulo,1651,16/05/1987,29,0,0,0,0,176,74,4,3,2,3,3,1,1,2,4,2,1,3,7,10,12,10,5,10,9,2,4,10,12,4,12,5,8,9,9,8,9,9,6,12,5,12,7,8,9,15,14,10,8,9,13,13,20,11,11,12,6,9,8,10,8,11,16,8,7,14,8,14,S ,1,1,20,1,1,1,1,1,1,1,1,1,1,1,1
2114279,Iran,1651,14/06/1979,37,0,0,0,0,175,69,2,3,2,3,1,2,2,2,1,3,2,12,10,5,3,12,7,5,7,12,9,8,1,11,11,9,7,9,7,10,8,12,13,5,6,4,10,13,14,13,9,7,13,20,8,12,17,12,11,12,7,9,9,9,12,11,12,11,12,14,11,13,D/WB RL,1,1,1,1,1,1,1,20,15,1,1,1,1,17,10
2114395,Maicon,1651,18/02/1990,26,0,0,9,3,183,73,1,2,2,1,1,4,3,1,2,3,3,7,11,12,12,12,7,12,6,8,5,11,12,10,13,13,12,10,10,12,10,12,15,12,9,12,9,12,13,16,12,12,11,11,14,16,20,12,9,10,8,12,7,8,13,9,14,13,14,6,14,9,AM/S L,1,1,17,1,20,13,1,1,1,1,1,12,1,1,1
2114397,Felipe Jacques,1651,02/04/1990,26,0,0,0,0,189,84,3,3,1,3,3,3,3,1,2,3,2,8,5,11,4,9,6,12,2,5,11,9,8,10,7,10,12,10,9,10,8,14,10,13,10,11,10,8,12,13,11,12,15,4,16,11,20,13,13,12,9,10,10,10,7,11,10,11,8,9,5,8,D C,1,1,1,1,1,1,20,1,1,1,1,1,1,1,1
2114398,Bruno Costa,1651,06/02/1990,26,0,0,0,0,180,80,4,2,1,2,1,3,3,2,3,2,2,5,10,10,6,11,9,13,7,8,14,10,10,13,12,15,12,15,10,10,8,10,10,9,10,9,13,13,13,12,12,13,10,20,11,13,8,14,13,11,17,9,11,15,14,13,12,10,9,9,7,12,D LC,1,1,1,1,1,1,20,15,1,1,1,1,1,10,1
2114399,Michel Schmöller,1651,11/11/1987,28,0,0,9,1,185,77,3,1,1,1,2,3,3,3,2,3,4,7,7,9,6,9,9,11,9,10,12,12,7,12,6,10,11,10,10,11,7,10,15,7,12,6,11,10,12,13,11,11,12,10,13,13,20,12,12,10,13,1,8,14,20,14,15,13,11,12,13,12,D/DM C,1,10,1,1,1,1,18,1,1,20,10,1,1,1,1
2114417,Jonas,1651,04/07/1983,32,0,0,0,0,188,84,2,1,2,3,1,4,2,3,1,1,1,3,3,5,5,7,6,13,6,6,11,9,5,10,7,11,12,14,11,11,7,10,14,5,11,5,12,14,12,10,6,12,11,7,13,9,20,13,12,14,11,14,8,8,12,12,14,15,15,10,15,5,D/DM C,1,12,1,1,1,1,18,1,1,20,15,1,1,1,1
2114426,Dinei,1651,21/12/1983,32,0,0,0,0,183,82,3,3,3,2,2,2,3,2,1,2,3,4,7,9,12,11,11,12,11,4,4,10,12,5,12,10,11,11,10,10,8,9,10,11,10,12,9,10,13,11,9,12,11,10,13,11,20,11,13,11,6,10,6,10,11,11,11,9,12,7,16,3,S ,1,1,20,1,1,1,1,1,1,1,1,1,1,1,1
2114480,William Alves,1651,29/04/1987,29,0,0,0,0,188,84,3,2,1,3,3,2,1,2,1,2,1,10,11,9,8,10,6,13,6,11,12,10,6,13,9,11,12,12,9,12,8,11,12,6,11,8,13,13,13,11,8,14,14,8,12,11,20,12,14,12,10,11,10,9,9,10,14,15,11,12,17,2,D RC,1,1,1,1,1,1,20,1,18,1,1,1,1,1,1
2114490,Ramires,1651,24/03/1987,29,52,4,0,0,180,73,1,2,1,2,1,3,1,2,2,3,1,10,10,9,9,11,7,10,8,13,13,9,12,15,8,14,12,15,12,15,8,13,16,12,8,13,12,16,18,18,17,10,10,10,16,16,20,20,12,18,10,13,9,17,12,14,16,10,18,12,11,8,M RC,1,1,1,12,12,15,1,1,11,15,20,5,17,1,11
2114493,André Luiz,1651,18/09/1985,30,0,0,0,0,167,0,1,1,2,2,2,3,2,3,3,4,1,9,5,13,11,11,9,6,7,4,6,11,6,4,11,7,12,4,8,10,10,11,3,14,12,15,7,7,12,14,14,6,3,13,9,14,20,11,4,13,11,8,9,13,19,13,12,11,9,7,5,3,S ,1,1,20,1,1,1,1,1,1,1,1,1,1,1,1
2114495,Edgar Silva,1651,03/01/1987,29,0,0,0,0,190,76,3,2,1,2,3,3,2,1,2,4,2,8,8,11,16,12,11,15,12,8,6,10,13,6,10,11,13,10,10,12,8,12,13,7,8,12,5,12,10,10,10,15,17,7,14,10,20,14,10,10,6,10,8,5,12,13,6,11,15,16,15,5,S ,1,1,20,1,1,1,1,1,1,1,1,1,1,1,1
2114496,Acleisson,1651,21/05/1982,34,0,0,0,0,175,71,3,2,1,3,2,3,2,2,2,2,3,8,10,9,8,9,12,8,12,11,13,9,11,12,9,15,10,13,10,11,11,11,11,9,12,9,10,13,12,12,11,13,6,8,13,11,20,12,13,11,15,10,9,12,14,13,10,11,10,10,12,9,DM C,1,1,1,1,1,1,1,1,1,20,15,1,1,1,1
2114513,Clebinho,1651,03/06/1986,30,0,0,0,0,175,71,1,1,1,1,4,1,2,1,3,3,2,15,16,16,12,13,7,5,5,10,5,9,9,7,15,6,6,6,8,10,6,6,10,15,4,10,4,3,9,13,15,8,6,20,8,13,10,12,6,12,10,10,12,10,15,15,10,7,7,7,10,10,M/AM L,1,1,12,10,20,14,1,10,8,1,1,18,10,15,8
2114520,Jé,1651,18/07/1984,31,0,0,0,0,180,81,3,2,1,1,2,2,3,1,1,3,1,6,3,5,7,8,6,12,10,1,11,9,1,12,9,16,11,16,7,6,6,11,15,6,11,8,11,13,14,11,11,9,9,6,14,12,20,12,16,9,9,6,5,9,19,13,10,11,14,10,8,1,DM ,1,1,1,1,1,1,1,1,1,20,13,1,1,1,1
2114557,Maicon Santos,1651,18/04/1984,32,0,0,0,0,188,91,1,1,2,1,1,3,3,3,3,3,1,9,10,11,12,13,9,14,14,9,6,11,11,4,13,8,11,9,13,10,8,11,8,13,5,12,9,10,6,10,9,12,12,20,7,10,7,10,13,8,7,5,14,2,12,7,10,10,9,9,13,5,S ,1,1,20,8,1,1,1,1,1,1,1,1,1,1,1
2114564,Edmílson,1651,15/07/1982,33,0,0,0,0,182,81,1,3,2,3,3,1,2,4,2,3,1,7,6,8,7,9,3,11,7,8,13,10,5,12,7,14,9,12,8,11,8,10,12,9,12,8,11,12,11,9,9,13,10,7,14,9,20,10,14,12,12,4,8,9,15,9,10,10,11,1,6,3,D/DM C,1,1,1,1,1,1,17,1,1,20,1,1,1,1,1
2114645,Léo Rodrigues,1651,30/03/1987,29,0,0,0,0,190,84,13,8,9,1,9,13,9,13,10,3,10,4,2,1,3,1,7,1,2,3,1,2,1,3,5,10,7,15,5,9,7,13,6,1,8,2,9,8,7,13,15,8,15,2,15,10,20,4,10,13,8,10,10,10,12,11,9,13,9,2,13,7,GK ,20,1,1,1,1,1,1,1,1,1,1,1,1,1,1
2114650,Tatá,1651,29/07/1986,29,0,0,0,0,174,66,2,2,2,3,3,2,3,1,1,2,2,10,10,11,10,12,7,8,9,4,4,10,11,6,12,12,10,12,10,11,12,11,2,14,9,11,4,10,10,14,13,12,6,8,13,13,20,12,6,11,13,10,9,10,18,12,3,11,10,6,8,5,AM RL,1,1,12,13,15,20,1,1,1,1,1,1,1,1,1
2114654,Luís Gueguel,1651,14/09/1986,29,0,0,0,0,190,82,1,1,3,3,1,2,3,3,3,1,2,4,3,11,12,8,5,13,8,1,6,7,10,6,8,12,12,13,9,11,6,9,16,8,6,11,8,14,14,11,7,4,15,10,13,11,20,12,12,12,8,15,5,4,7,13,15,17,15,14,16,5,S ,1,1,20,1,1,1,1,1,1,1,1,1,1,1,1
2114660,Careca,1651,13/04/1983,33,0,0,0,0,181,80,3,2,3,1,3,1,2,1,1,1,3,3,8,8,12,13,5,13,13,5,12,10,14,5,9,10,13,5,9,6,5,13,10,9,12,8,9,7,8,12,9,6,13,8,13,12,20,11,13,10,1,10,14,10,8,11,2,12,9,9,6,6,S ,1,1,20,1,1,1,1,1,1,1,1,1,1,1,1
2114683,Fabio Neves,1651,04/10/1986,29,0,0,0,0,171,66,2,3,3,2,2,3,1,2,2,1,2,12,12,12,11,11,12,9,11,2,5,10,15,6,12,12,10,13,12,9,11,10,14,15,3,14,7,9,10,15,16,7,6,11,14,15,20,11,6,13,7,12,12,13,10,13,12,13,13,6,13,11,AM/S C,1,1,20,20,14,10,1,1,1,1,13,5,1,1,1
2114727,Clayton Carioca,1651,23/09/1982,33,0,0,0,0,172,67,2,2,3,1,2,2,1,3,2,1,3,6,7,4,2,10,4,5,7,5,10,9,2,15,10,7,10,10,6,11,7,12,9,6,9,7,10,9,10,13,10,9,7,10,13,12,20,14,8,9,9,1,7,9,8,12,9,13,10,10,3,5,D R,1,1,1,1,1,1,1,1,20,1,10,1,1,1,12
2114730,Thiago Conceição,1651,01/04/1985,31,0,0,0,0,177,0,3,2,3,2,2,1,3,1,1,1,1,5,4,1,5,7,5,5,7,1,7,10,1,12,10,8,9,7,7,9,6,13,4,8,8,5,8,6,7,12,10,6,4,13,12,10,20,4,5,8,8,8,8,8,11,10,9,13,13,1,12,3,DM C,1,18,1,1,1,1,1,1,1,20,15,1,1,1,1
2114731,Fabiano,1651,18/12/1985,30,0,0,0,0,171,68,2,1,1,2,2,3,4,4,3,3,1,8,11,10,7,15,8,9,7,9,11,11,3,11,11,4,12,9,11,11,11,15,3,2,14,9,9,10,11,14,15,10,4,20,13,15,2,8,8,10,9,1,10,10,12,12,9,12,13,8,16,6,D L,1,1,1,1,1,1,1,20,1,1,1,15,1,15,1
2114744,Egídio,1651,16/06/1986,30,0,0,0,0,176,69,2,3,1,1,2,1,3,3,2,2,1,12,13,14,10,15,13,7,11,12,10,14,12,13,15,11,14,9,12,11,14,13,10,13,7,14,9,13,11,15,15,13,7,20,15,15,8,15,9,11,13,11,9,13,9,11,13,9,14,12,14,6,D/WB L,1,1,1,1,8,1,1,20,1,7,8,14,1,19,1
2114759,Galiardo,1651,18/05/1985,31,0,0,0,0,183,70,3,2,3,1,2,1,3,1,1,1,1,10,11,10,9,9,12,11,9,11,12,12,10,11,10,14,10,14,10,11,10,10,13,7,11,11,11,14,13,11,10,12,11,7,14,11,20,12,11,11,12,13,6,17,13,12,12,12,15,13,13,10,D/WB/DM/M RC,1,11,1,5,1,6,18,1,16,19,20,1,14,1,17
2114762,Juninho Cappa,1651,13/03/1986,30,0,0,0,0,189,88,2,2,2,3,2,3,3,1,1,3,3,4,12,13,11,12,4,12,11,8,12,10,5,11,13,10,11,10,12,11,13,11,14,13,6,11,11,11,12,11,10,11,13,7,13,13,20,12,11,13,2,12,10,12,9,10,12,11,9,10,9,7,WB/M/AM RC,1,1,1,18,1,1,1,1,8,15,20,1,18,1,16
2114767,Zé Adriano,1651,29/10/1985,30,0,0,0,0,184,76,1,1,2,1,2,3,1,1,2,1,1,3,6,8,7,8,5,12,8,2,13,10,3,13,8,14,11,15,8,11,7,10,13,1,9,8,13,14,13,10,9,12,13,8,14,11,20,11,12,10,10,1,9,10,15,13,13,13,16,13,14,10,D C,1,12,1,1,1,1,20,1,1,7,1,1,1,1,1
2114768,Allan Dias,1651,19/10/1988,27,0,0,0,0,187,83,3,3,1,1,3,1,3,3,1,3,1,9,11,11,11,11,12,11,12,11,8,13,10,6,12,9,11,8,9,10,12,10,10,9,7,11,11,11,12,12,12,11,15,13,14,12,20,14,13,11,8,11,10,10,7,10,9,10,11,9,8,6,AM/S C,1,1,16,20,13,13,1,1,1,1,15,1,1,1,1
2114773,Carlos,1651,25/02/1985,31,0,0,0,0,187,74,3,1,3,3,1,1,1,3,4,1,1,5,12,11,5,10,5,13,9,13,12,9,8,13,10,16,11,15,14,8,7,10,9,8,7,8,10,14,15,12,9,14,14,20,13,12,10,13,13,9,15,10,9,11,11,9,13,11,14,9,10,7,D LC,1,1,1,1,1,1,20,19,1,10,1,1,1,10,1
2114775,Eric,1651,08/03/1989,27,0,0,0,0,177,72,2,1,3,1,2,2,3,3,3,1,3,7,5,13,13,13,7,13,8,5,6,8,10,1,13,9,9,3,11,8,6,11,4,13,7,13,7,7,7,12,13,8,4,10,4,13,20,11,9,10,8,3,10,10,7,11,9,12,10,3,8,6,S ,1,1,20,1,1,1,1,1,1,1,1,1,1,1,1
2114776,Serginho Paulista,1651,13/03/1988,28,0,0,0,0,176,74,1,2,4,3,1,3,2,3,4,2,1,8,10,8,8,11,10,11,7,6,14,11,8,14,10,5,12,13,12,13,7,14,14,5,15,10,13,12,13,12,11,13,9,9,11,13,20,13,11,14,8,10,6,9,13,13,13,9,11,3,7,4,DM/M C,1,1,1,1,1,1,1,12,1,20,16,1,1,1,1
2114778,Flávio Paulino,1651,14/04/1989,27,0,0,0,0,185,81,1,2,3,3,1,1,3,2,1,3,1,8,8,10,9,9,9,8,12,8,10,9,3,9,11,9,9,10,10,9,9,9,14,8,15,9,10,11,10,10,10,12,12,12,12,10,20,12,13,9,9,3,9,9,15,13,9,13,11,12,7,1,M/AM RC,1,1,7,19,1,15,1,1,1,1,20,1,10,1,1
2114781,Hernanes,1651,29/05/1985,31,28,2,7,2,180,77,1,1,2,3,3,1,2,2,3,1,3,13,13,15,12,16,15,8,15,3,8,15,14,11,16,12,13,11,13,11,14,13,12,15,11,12,11,11,12,11,13,12,10,16,14,11,20,13,11,12,10,14,3,14,15,15,14,11,13,13,18,9,DM/M/AM C,1,1,1,17,11,11,1,1,1,16,20,12,12,1,1
2114782,Jean,1651,24/06/1986,30,6,0,0,0,170,71,1,3,1,1,2,1,2,2,2,4,1,10,13,13,11,14,14,11,15,11,14,14,18,13,14,14,14,13,14,12,13,12,12,13,11,14,12,13,14,14,14,15,6,9,14,13,20,14,10,11,12,13,9,15,14,14,15,14,9,10,13,8,DM/M RC,1,1,1,11,1,1,1,1,15,19,20,1,13,1,15
2114786,Luiz Camargo,1651,04/05/1987,29,0,0,0,0,177,71,1,2,3,3,2,3,3,3,1,2,1,12,11,10,10,12,8,8,7,7,14,14,10,8,12,11,11,12,11,12,14,10,15,11,10,11,13,10,7,11,12,11,8,20,14,12,10,13,11,11,15,8,8,13,20,13,13,12,13,10,9,11,DM/M C,1,1,1,15,1,1,1,1,1,17,20,1,1,1,1
2114792,Robert,1651,11/06/1985,31,0,0,0,0,166,70,3,2,1,3,3,3,2,2,3,3,2,5,8,11,10,10,10,8,9,3,3,11,15,3,10,12,11,11,11,10,9,1,12,14,5,11,6,11,11,14,15,17,3,8,8,14,20,10,9,12,5,13,7,11,15,13,8,11,13,8,15,7,S ,1,1,20,8,10,10,1,1,1,1,1,1,1,1,1
2114829,Aelson,1651,02/08/1985,30,0,0,0,0,164,65,2,1,2,1,2,2,2,3,3,1,2,5,11,9,1,14,3,8,1,3,7,8,3,12,10,12,9,9,9,12,9,9,9,9,15,11,10,9,9,13,12,17,3,20,11,13,9,11,8,11,9,9,7,7,19,10,9,11,10,8,2,2,D/WB L,1,1,1,1,1,1,1,16,1,1,1,1,1,20,1
2114831,Ralf,1651,09/06/1984,32,8,0,0,0,180,73,2,1,2,1,1,2,1,1,3,1,1,7,7,11,9,12,8,13,10,6,16,12,6,16,11,13,14,16,14,14,9,13,15,9,14,8,14,15,15,14,14,13,10,10,17,13,20,15,12,11,6,13,5,12,6,14,8,12,12,9,16,7,DM/M C,1,1,1,1,1,1,1,1,1,20,17,1,1,1,1
2114833,Ricardo Feltre,1651,11/04/1984,32,0,0,0,0,173,79,3,3,2,1,2,2,2,1,1,1,1,7,9,10,8,10,9,7,10,3,9,9,9,10,10,11,10,9,9,9,10,9,9,9,7,10,10,10,11,9,11,10,8,9,14,11,20,10,7,9,5,9,9,9,14,10,10,12,10,1,9,2,D/DM/M RC,1,1,1,1,1,1,1,1,20,19,17,1,1,1,15
2114849,Fábio,1651,11/05/1990,26,0,0,0,0,195,80,14,12,12,5,11,12,14,13,12,9,12,2,2,2,3,4,5,7,4,2,6,6,5,8,6,11,13,13,14,6,3,12,12,4,5,4,13,11,12,10,14,15,18,3,13,10,20,14,13,6,7,9,6,3,10,12,15,8,15,8,14,9,GK ,20,1,1,1,1,1,1,1,1,1,1,1,1,1,1
2114869,Boquita,1651,07/04/1990,26,0,0,0,0,179,73,2,2,2,3,2,2,2,3,2,2,2,9,10,11,11,10,10,10,12,6,10,11,11,9,12,12,10,12,12,10,11,11,15,14,9,11,11,12,12,11,11,12,9,12,14,11,20,11,12,13,6,12,9,16,14,14,13,13,12,12,10,5,M C,1,1,9,14,5,7,1,1,1,14,20,8,12,1,1
2114911,Breno,1651,01/11/1986,29,0,0,0,0,180,78,1,1,3,2,3,3,2,1,3,3,3,1,2,4,3,6,4,12,6,2,12,7,2,12,8,13,11,14,12,11,6,10,15,9,17,7,13,12,12,10,10,12,12,10,14,10,20,12,12,13,10,13,9,10,13,13,12,11,5,1,10,15,D C,1,1,1,1,1,1,20,1,1,1,1,1,1,1,1
2114915,Jaime,1651,20/02/1987,29,0,0,0,0,173,69,1,2,1,2,3,1,2,2,3,2,1,4,9,11,7,10,2,7,9,12,9,11,1,9,11,8,5,8,7,9,9,11,10,7,9,7,10,7,8,13,13,7,7,20,7,13,10,12,7,9,9,9,9,9,10,13,8,12,11,4,7,8,D/WB L,1,1,1,1,1,1,1,18,1,1,1,10,1,20,1
2114916,Jhon,1651,22/10/1988,27,0,0,0,0,182,0,1,2,3,2,2,3,3,3,2,2,3,4,9,10,13,11,9,12,12,3,6,10,13,6,10,11,11,12,11,8,9,10,12,10,5,11,9,12,9,13,9,12,13,7,10,11,20,11,16,10,7,3,10,10,17,14,10,14,13,3,2,7,S ,1,1,20,1,1,1,1,1,1,1,1,1,1,1,1
2114918,João Victor,1651,07/11/1988,27,0,0,8,1,181,78,4,1,3,3,2,1,1,1,3,3,3,10,12,12,8,13,9,7,9,4,14,11,12,13,13,11,13,12,14,12,10,13,10,12,13,8,14,16,14,12,12,13,12,12,14,11,20,14,14,14,11,12,9,11,13,12,11,12,13,9,7,4,DM C,1,1,1,10,1,1,1,1,1,20,15,1,1,1,1
2114924,Tuca,1651,09/08/1981,34,0,0,0,0,188,79,3,1,3,1,1,2,1,3,1,2,2,4,3,3,10,10,6,15,8,3,14,7,10,10,7,14,12,11,12,10,6,10,15,7,8,6,11,10,12,10,9,11,16,8,13,9,20,12,13,11,8,12,8,4,11,12,12,12,11,12,19,6,D C,1,1,1,1,1,1,20,1,1,11,5,1,1,1,1
2114925,Victor Ferraz,1651,14/01/1988,28,0,0,0,0,174,74,2,2,2,1,2,3,3,4,3,2,2,12,14,15,5,12,13,7,8,13,13,13,4,13,12,12,14,13,13,12,11,12,10,11,8,14,11,13,15,15,15,13,6,14,12,15,20,13,13,12,9,11,6,14,8,14,15,12,10,8,12,8,D R,1,1,1,1,1,1,1,1,20,1,1,1,1,1,10
2114952,Pipico,1651,07/03/1985,31,0,0,0,0,172,72,2,2,3,1,3,2,2,3,3,1,3,7,11,12,12,12,12,12,11,4,5,12,12,11,12,12,13,11,9,10,13,12,10,13,9,13,14,12,12,14,14,10,5,4,14,14,20,13,8,10,10,14,8,16,18,10,11,8,9,5,10,9,S RL,1,1,20,13,15,15,1,1,1,1,1,1,1,1,1
2114961,Eduardo,1651,20/11/1986,29,0,0,0,0,173,68,4,3,3,3,1,3,3,3,3,1,2,11,13,13,11,11,8,8,12,13,13,13,9,12,12,12,11,12,11,13,12,11,11,11,10,12,12,13,14,13,13,10,10,10,13,14,20,13,9,13,11,10,5,14,7,11,14,12,6,8,7,6,D/WB RL,1,1,1,12,1,1,7,16,18,5,12,1,1,15,20
2114963,Pitolo,1651,11/01/1988,28,0,0,0,0,173,0,2,3,3,2,2,1,3,1,1,3,3,8,8,13,10,15,8,7,10,1,1,11,14,1,12,7,8,8,10,9,9,6,8,9,15,13,6,5,7,13,15,8,7,8,12,14,20,11,6,9,6,6,5,9,20,13,10,12,12,6,2,3,AM/S C,1,1,19,20,1,1,1,1,1,1,10,1,1,1,1
2114979,Marcos Paraná,1651,04/07/1986,29,0,0,0,0,183,75,1,2,2,2,3,2,3,1,1,3,2,14,12,12,13,13,14,8,14,3,5,13,13,8,13,14,12,12,11,9,13,8,10,13,6,13,7,10,12,13,13,12,10,8,11,13,20,13,12,12,13,9,5,12,8,12,8,10,16,15,8,8,M/AM C,1,1,10,20,1,9,1,1,1,1,16,1,3,1,1
2114985,Teles,1651,14/11/1985,30,0,0,0,0,165,63,3,3,3,1,3,4,2,3,1,2,3,6,13,14,11,13,10,6,11,3,3,12,13,3,13,9,10,8,12,9,10,9,8,10,4,14,8,6,11,14,15,7,7,1,16,16,20,13,7,10,8,10,10,10,10,12,10,11,13,1,7,2,S ,1,1,20,10,12,12,1,1,1,1,1,1,1,1,1
2115005,Kauê,1651,18/02/1987,29,0,0,0,0,190,0,2,3,3,1,3,2,3,3,1,1,1,1,1,1,1,3,1,14,4,1,10,6,4,10,5,9,12,8,8,9,5,14,12,1,9,5,14,7,8,9,8,8,13,8,15,8,20,8,11,5,9,1,8,9,17,12,11,11,11,3,6,8,D C,1,1,1,1,1,1,20,1,1,1,1,1,1,1,1
2115007,Roberval,1651,27/06/1985,31,0,0,0,0,176,80,1,1,1,2,2,1,1,2,3,1,2,8,9,14,13,13,11,8,10,2,2,12,13,2,14,10,6,6,8,7,13,7,7,10,8,14,5,10,10,14,13,10,7,10,10,14,20,12,8,15,10,9,6,9,11,12,14,13,4,8,12,15,AM/S RL,1,1,20,1,16,16,1,1,1,1,1,1,1,1,1
2115011,Élvis,1651,05/11/1985,30,0,0,0,0,170,63,2,3,3,2,3,2,3,1,2,3,2,12,10,12,10,11,13,5,10,6,5,12,13,5,12,5,7,10,10,7,11,10,7,14,4,10,7,9,9,12,13,7,4,10,11,13,20,11,5,12,4,10,10,12,10,7,7,9,13,15,17,4,M/AM RC,1,1,15,20,12,19,1,2,11,4,16,6,15,3,14
2115115,Bruno Silva,1651,03/08/1986,29,0,0,0,0,179,76,2,1,1,3,3,4,3,2,3,2,2,6,2,9,5,12,5,14,12,10,15,13,9,13,13,14,14,14,12,10,11,12,13,10,14,12,15,14,13,13,13,13,9,9,15,12,20,14,11,13,12,13,7,12,9,12,10,10,11,11,11,10,DM/M C,1,1,1,1,1,1,11,1,1,20,16,1,1,1,1
2115126,Ramón,1651,07/04/1983,33,0,0,0,0,186,74,2,3,1,3,1,2,2,3,1,3,1,11,7,10,13,10,7,15,12,7,8,12,15,9,12,12,12,13,9,12,14,12,14,13,6,13,7,13,13,11,16,12,13,9,12,13,20,13,14,12,7,12,10,14,15,13,9,12,10,10,12,11,DM/M/AM C,1,1,15,19,12,14,1,1,1,17,20,1,1,1,1
2115184,Adeílson,1651,07/10/1985,30,0,0,0,0,187,73,3,1,3,1,1,1,3,2,1,2,3,5,9,11,10,12,7,12,14,8,5,7,15,4,12,12,12,12,9,12,12,9,15,12,8,12,6,10,13,14,11,14,13,10,15,15,20,13,12,13,12,11,7,5,7,13,7,12,14,12,10,11,S ,1,1,20,1,10,1,1,1,1,1,1,1,1,1,1
2115194,Bruno Moreno,1651,23/04/1986,30,0,0,0,0,185,77,2,3,1,1,3,3,1,3,3,2,3,7,9,9,11,12,13,6,12,8,12,9,3,13,10,9,10,12,8,9,8,9,6,9,5,7,10,12,12,10,9,8,13,10,15,11,20,13,12,9,8,7,7,9,20,12,12,9,10,2,11,7,DM/M C,1,1,1,1,1,1,1,11,1,20,16,1,1,11,1
2115197,David,1651,23/07/1986,29,0,0,0,0,180,73,2,3,2,1,3,1,1,4,3,3,3,6,3,2,7,12,6,6,8,4,8,13,5,13,13,9,7,8,8,8,10,13,6,6,10,8,9,7,12,13,13,10,9,10,8,13,20,13,8,8,13,9,9,9,8,11,11,9,11,11,11,2,M C,1,1,1,10,1,1,1,1,1,15,20,1,1,1,1
2115208,Aislan,1651,11/01/1988,28,0,0,0,0,193,90,1,1,2,2,1,3,3,1,1,2,3,6,7,11,9,11,6,14,6,7,13,10,10,13,12,11,12,12,10,12,8,11,14,10,12,7,11,12,11,12,10,14,17,9,12,13,20,12,14,5,12,10,9,7,16,14,12,11,13,13,12,10,D C,1,1,1,1,1,1,20,1,1,1,1,1,1,1,1
2115209,Breno,1651,13/10/1989,26,0,0,8,0,191,85,1,1,4,3,3,1,1,1,2,3,3,5,6,10,6,11,6,14,8,7,13,12,9,12,11,13,13,14,12,13,10,12,10,10,11,9,13,13,13,12,12,14,13,11,15,12,20,12,14,10,12,11,17,14,1,14,15,10,9,13,8,18,D C,1,10,1,1,1,1,20,1,11,12,1,1,1,1,6
2115210,Celinho,1651,11/09/1988,27,0,0,0,0,195,0,1,4,1,2,3,1,1,2,2,3,2,7,7,8,9,12,7,5,13,1,9,14,8,9,8,9,8,8,11,5,7,13,5,7,1,8,9,8,12,14,12,8,16,9,11,13,20,7,11,9,7,9,7,9,13,12,13,11,13,4,2,4,M/AM C,1,1,1,18,1,1,1,1,1,1,20,1,1,1,1
2115215,Guilherme Andrade,1651,31/01/1989,27,0,0,0,0,180,75,1,2,3,3,2,3,2,2,3,1,2,4,10,10,10,12,9,10,10,11,14,12,6,13,10,12,12,16,12,12,10,12,6,10,9,10,14,14,12,12,12,10,10,8,11,12,20,14,10,11,11,11,10,13,14,11,11,10,10,9,6,2,D/DM R,1,1,1,1,1,1,7,1,20,17,1,1,1,1,13
2115217,Jorge Miguel,1651,16/02/1988,28,0,0,0,0,182,75,12,12,12,5,12,12,12,12,11,10,11,10,3,3,1,7,12,1,2,2,2,2,1,2,9,12,12,12,9,11,10,10,11,2,11,5,11,10,10,10,13,12,12,3,15,10,20,10,12,12,10,4,6,10,10,10,10,12,9,10,18,8,GK ,20,1,1,1,1,1,1,1,1,1,1,1,1,1,1
2115219,Léo Gonçalves,1651,25/03/1989,27,0,0,0,0,178,69,4,3,1,1,4,3,2,1,2,2,3,8,6,10,10,13,8,4,14,1,9,10,6,9,10,10,11,7,12,9,12,10,4,10,13,13,10,9,12,15,13,7,10,20,11,14,10,8,7,10,10,10,10,10,12,10,12,10,12,12,12,1,M/AM C,1,1,1,20,1,1,1,1,1,1,18,1,1,1,1
2115222,Sérgio Mota,1651,16/11/1989,26,0,0,0,0,175,70,2,3,3,2,2,1,1,3,3,1,3,11,11,12,10,12,12,5,13,4,5,14,10,6,14,12,10,11,11,11,13,11,10,11,9,13,4,13,12,14,14,11,8,20,14,12,5,13,12,10,12,10,10,12,10,12,10,11,11,8,9,15,M/AM C,1,1,1,20,1,1,1,1,1,1,18,1,1,1,1
2115223,Tiago Azulão,1651,26/03/1988,28,0,0,0,0,179,73,1,2,3,2,2,2,3,2,4,2,3,11,11,11,12,11,8,8,9,10,4,12,15,5,11,8,8,11,11,10,10,12,8,8,5,12,9,13,13,12,13,10,10,5,13,14,20,15,10,11,8,10,10,15,12,11,14,12,11,2,20,7,AM RC,1,1,13,20,1,17,1,1,1,1,13,1,13,1,1
2115237,Léo Costa,1651,03/03/1986,30,0,0,0,0,181,71,1,1,3,3,2,3,1,1,2,2,3,8,11,13,13,13,13,7,13,6,5,12,15,4,13,7,12,8,11,10,12,12,11,14,10,13,7,9,12,15,14,10,8,20,13,14,6,13,9,12,7,12,6,13,17,14,11,12,11,7,2,7,M/AM RLC,1,1,15,20,17,15,1,10,1,1,18,13,11,12,1
2115238,Tiago Souza,1651,02/08/1986,29,0,0,0,0,184,86,2,2,1,1,1,1,2,3,3,3,4,6,4,1,3,5,3,13,5,4,13,7,4,13,1,6,8,9,7,10,6,13,1,2,9,5,13,6,8,13,13,7,10,6,12,13,20,12,11,9,6,3,7,8,18,8,14,11,10,8,8,4,D C,1,1,1,1,1,1,20,1,1,1,1,1,1,1,1
2115243,Bruno Barros,1651,15/06/1982,34,0,0,0,0,179,73,1,2,1,2,2,2,2,1,1,1,1,8,10,10,11,10,4,8,12,12,8,10,8,8,11,10,10,10,11,10,9,10,13,11,11,13,8,10,10,11,12,8,8,20,13,11,11,11,8,14,8,14,7,12,11,13,12,13,14,14,14,10,D/WB L,1,1,5,6,10,1,1,18,11,4,7,14,1,20,10
2115246,Francismar,1651,18/04/1984,32,0,0,0,0,172,66,2,3,3,1,1,3,3,1,3,2,1,9,10,13,8,9,9,7,8,5,7,9,8,6,13,11,11,10,9,7,11,11,14,18,8,11,4,9,11,15,13,4,6,20,14,15,7,11,4,10,15,14,10,6,13,10,6,12,12,7,14,5,M/AM RLC,1,1,13,17,20,19,1,14,1,1,11,16,15,12,1
2115248,Lico,1651,26/12/1984,31,0,0,0,0,175,75,3,3,4,1,3,3,3,3,2,2,2,11,11,13,10,12,13,5,11,6,2,7,3,6,13,9,7,6,7,7,6,10,11,11,12,7,6,6,9,13,10,7,4,9,7,12,20,9,6,9,6,8,11,9,11,10,11,11,11,12,8,11,AM L,1,1,1,1,20,12,1,1,1,1,1,1,1,1,1
2115255,Bida,1651,02/08/1984,31,0,0,0,0,185,82,3,1,4,3,3,1,4,1,2,3,2,7,9,10,12,14,13,11,13,6,10,12,12,9,12,8,12,9,12,11,11,12,12,13,5,12,12,9,10,12,11,12,11,10,14,12,20,12,12,14,10,12,6,19,12,13,14,12,11,8,14,10,DM/M/AM/S C,1,1,17,18,1,14,1,1,1,16,20,1,12,1,1
2115371,Cláudio,1651,27/03/1987,29,0,0,2,0,180,73,3,1,3,4,1,3,3,1,1,2,2,1,10,11,10,12,6,8,11,1,2,10,9,2,12,8,10,11,8,9,10,8,12,12,6,12,6,10,11,13,14,9,10,8,12,14,20,10,5,8,7,12,6,12,10,11,12,13,12,11,13,5,AM/S R,1,1,20,13,5,18,1,1,1,1,1,1,12,1,1
2115435,Xaves,1651,27/02/1986,30,0,0,0,0,173,70,3,3,1,2,2,2,4,2,3,1,2,7,9,10,8,10,9,11,12,2,12,10,9,12,10,13,11,12,9,10,11,12,15,10,9,9,12,13,14,11,12,12,6,9,12,12,20,13,11,13,11,11,4,10,11,11,11,11,13,12,12,6,DM/M C,1,1,1,1,1,1,6,1,1,20,17,1,1,1,1
2115443,Flavinho,1651,27/07/1983,32,0,0,0,0,178,68,2,2,2,1,3,1,1,3,2,2,2,9,12,12,11,11,8,10,11,7,7,13,7,5,14,7,10,7,9,9,13,8,11,11,7,12,10,9,8,14,14,9,9,10,8,14,20,11,6,9,4,10,11,9,19,10,9,11,11,9,9,6,AM/S R,1,1,20,13,1,17,1,1,1,1,13,1,1,1,1
2115458,Moreira,1651,11/09/1984,31,0,0,0,0,170,69,4,1,1,2,2,3,3,3,2,1,2,4,2,1,11,12,1,6,6,4,12,9,5,12,10,8,6,6,6,5,5,12,5,2,5,5,10,6,10,13,11,9,7,9,14,14,20,6,9,8,1,8,5,8,18,10,9,12,12,7,5,1,DM/M C,1,1,1,1,1,1,10,1,10,20,17,1,10,1,1
2115532,Douglão,1651,18/05/1986,30,0,0,0,0,193,84,3,1,2,3,3,3,2,1,2,1,2,5,8,6,6,8,6,16,11,11,15,8,6,13,11,16,13,16,8,13,8,11,16,11,8,8,13,12,13,9,8,16,18,6,14,10,20,12,17,12,12,12,6,9,12,17,13,12,12,7,6,16,D C,1,7,1,1,1,1,20,1,1,1,1,1,1,1,1
2115563,Vítor,1651,16/08/1984,31,0,0,0,0,184,77,2,3,1,2,2,3,2,3,3,2,3,8,9,8,8,11,3,12,8,11,12,9,6,11,9,13,11,13,9,12,8,9,13,2,10,9,13,9,10,11,10,12,13,7,7,11,20,12,12,12,10,5,10,14,11,12,13,11,12,12,12,8,D RC,1,13,1,1,1,1,20,1,15,12,1,1,1,1,5
2115577,Fernando,1651,25/07/1987,28,0,0,3,0,182,71,2,1,1,3,3,1,3,3,2,3,3,9,10,9,7,12,9,13,10,10,14,11,11,16,12,17,16,16,11,14,11,12,16,6,13,11,17,17,17,14,16,13,14,7,16,13,20,15,14,15,13,11,7,10,14,13,17,15,16,13,13,5,DM/M C,1,1,1,1,1,1,3,1,1,20,19,1,1,1,1
2115585,Laionel,1651,27/04/1986,30,0,0,0,0,173,65,3,2,3,1,1,3,1,1,3,1,4,11,11,12,10,12,9,5,11,9,5,10,10,4,12,7,11,10,12,9,9,10,13,16,9,13,8,8,11,13,12,11,7,5,14,13,20,10,10,10,7,12,7,11,11,11,11,12,14,15,15,6,AM R,1,1,10,5,14,20,1,1,1,1,1,5,5,1,1
2115785,Deyvid Sacconi,1651,10/04/1987,29,0,0,4,0,174,67,1,3,1,1,2,1,1,2,1,1,1,12,11,12,10,12,13,6,11,2,5,12,13,9,12,11,11,12,10,9,12,11,13,13,4,11,6,11,9,13,14,8,6,8,13,13,20,11,8,7,9,11,10,12,8,8,12,13,12,8,14,9,M/AM RLC,1,1,9,20,17,18,1,1,1,1,16,15,17,1,1
2115886,Jonas,1651,01/04/1984,32,12,3,0,0,181,73,1,3,3,4,2,3,1,3,2,1,3,8,12,15,18,17,11,15,12,2,5,16,16,6,18,11,12,12,17,15,17,18,16,15,11,16,8,13,14,12,15,13,12,12,12,12,20,12,11,16,9,8,8,12,17,8,13,16,17,14,12,6,AM/S C,1,1,20,19,5,5,1,1,1,1,1,1,1,1,1
2115900,Roberto,1651,24/04/1988,28,0,0,13,0,176,74,3,1,2,3,2,1,1,1,1,1,3,5,7,8,8,10,6,9,10,10,12,9,9,14,10,4,11,12,11,11,8,10,13,9,11,9,12,13,13,13,12,12,11,10,12,12,20,12,11,12,12,12,12,10,15,13,12,6,13,13,14,6,DM ,1,1,1,1,1,1,1,1,1,20,12,1,1,1,1
2115933,Filipe Gomes,1651,28/05/1987,29,0,0,0,0,178,74,2,3,2,1,2,2,1,1,1,2,1,4,3,9,5,9,7,10,7,10,12,14,7,9,11,12,12,10,9,12,15,11,13,13,11,11,13,15,13,10,11,11,10,20,14,11,11,11,13,13,13,14,7,10,10,13,8,12,15,15,11,12,DM/M C,1,1,1,1,1,1,1,1,1,19,20,1,1,1,1
2115992,Preto Costa,1651,20/12/1980,35,0,0,0,0,185,78,1,2,3,3,1,2,1,3,1,3,3,2,4,5,7,8,11,12,8,2,12,8,7,12,8,14,12,14,8,11,6,10,14,5,15,7,12,14,13,10,12,11,12,20,14,11,8,12,13,12,11,12,10,10,13,9,11,13,14,13,12,1,D C,1,12,1,1,1,1,20,10,1,7,1,1,1,1,1
2115995,Eleílson,1651,02/04/1985,31,0,0,0,0,194,92,2,3,3,2,1,2,3,3,3,2,3,1,2,5,5,9,3,17,7,9,16,9,12,14,7,14,13,15,9,12,9,13,17,7,16,5,14,10,12,9,5,14,16,8,14,7,20,12,17,15,9,12,5,3,14,13,16,15,14,1,5,10,D C,1,1,10,1,1,1,20,1,1,1,1,1,1,1,1
2115998,Amaral,1651,07/10/1986,29,0,0,0,0,182,67,2,3,3,2,3,2,2,3,3,4,2,9,8,11,10,11,11,14,11,10,14,11,8,13,11,13,14,14,14,13,11,12,14,10,12,11,13,13,14,13,13,12,12,8,15,13,20,15,11,13,15,12,10,13,8,12,13,14,13,10,12,8,D/DM C,1,13,1,1,1,1,19,8,8,20,14,1,1,1,1
2116144,Nêgo,1651,23/05/1985,31,0,0,0,0,168,65,3,3,2,3,1,1,2,3,4,1,3,12,10,12,9,9,14,7,11,5,6,9,12,6,11,16,8,14,10,10,12,6,12,15,7,12,9,11,12,15,14,3,4,5,11,14,20,8,8,7,7,12,12,11,12,12,11,10,11,5,11,5,D/WB R,1,1,1,1,1,1,1,1,16,1,1,1,1,1,20
2116154,Bruno Potiguar,1651,12/06/1984,32,0,0,0,0,178,70,2,2,2,1,2,2,3,2,1,3,4,5,5,1,5,12,5,5,11,1,9,13,4,10,9,11,5,14,7,6,9,13,12,8,9,6,8,7,9,9,12,6,11,8,8,9,20,5,9,8,10,1,8,8,9,10,11,13,9,9,7,4,DM/M C,1,1,1,1,1,1,1,1,1,20,18,1,1,1,1
2116169,Luiz Eduardo,1651,24/05/1985,31,0,0,0,0,181,78,3,3,3,1,1,1,4,3,2,2,1,4,7,10,13,13,9,12,10,2,3,13,13,3,12,12,11,16,9,13,8,11,12,9,6,11,4,12,13,12,13,12,10,8,10,13,20,12,10,12,6,12,7,10,11,8,8,11,11,12,9,5,S ,1,1,20,1,1,1,1,1,1,1,1,1,1,1,1
2116198,Samuel,1651,07/04/1986,30,0,0,0,0,190,84,1,1,1,2,1,1,3,1,3,1,3,5,8,11,7,11,5,13,5,5,11,7,4,9,11,12,11,13,10,10,10,12,12,13,11,11,12,13,12,11,12,6,15,20,14,11,10,11,12,9,14,8,14,9,11,13,10,12,12,12,9,9,D C,1,1,1,1,1,1,20,12,1,1,1,1,1,8,1
2116235,Jeferson,1651,29/01/1982,34,0,0,0,0,176,73,1,1,3,2,2,2,2,4,1,2,2,6,6,7,3,13,4,10,9,5,11,5,6,15,10,9,9,11,9,12,9,15,10,4,12,8,11,10,10,11,12,10,5,20,11,12,8,11,8,10,10,3,9,10,11,11,11,10,10,9,12,1,D RL,1,1,1,1,1,1,1,20,20,1,1,1,1,1,1
2116244,Gledson,1651,28/03/1986,30,0,0,0,0,183,82,2,2,2,1,2,1,1,1,3,2,3,6,5,11,10,12,6,13,5,6,6,6,11,2,8,5,10,4,10,4,7,13,2,9,12,13,6,6,7,12,10,10,11,15,12,12,20,12,11,7,9,9,9,9,8,10,9,12,11,13,16,2,S ,1,1,20,1,1,1,1,1,1,1,1,1,1,1,1
2116274,Bruno Rafael,1651,19/03/1984,32,0,0,0,0,179,72,3,2,2,3,1,3,3,3,3,3,1,3,9,8,8,11,4,11,7,3,13,10,3,14,10,15,13,15,10,11,10,11,13,8,9,8,13,12,11,11,11,11,11,8,15,12,20,13,12,13,10,11,4,8,12,11,14,12,13,12,11,7,DM/M C,1,1,1,1,1,1,10,1,12,20,17,1,10,1,14
2116292,Vinícius,1651,07/01/1988,28,0,0,4,0,185,78,3,2,1,1,2,2,3,3,1,3,1,5,7,8,6,9,8,12,9,8,11,9,8,11,9,11,9,12,8,10,6,9,12,11,5,8,12,12,12,12,11,12,13,20,14,12,7,12,12,12,7,12,7,10,10,12,11,10,13,9,14,10,D L,1,11,1,1,1,1,12,20,1,1,1,1,1,1,1
2116314,Chiquinho,1651,02/05/1989,27,0,0,0,0,167,67,2,2,3,4,1,3,3,3,1,3,3,5,4,12,11,14,7,4,9,3,10,13,5,9,15,9,10,1,9,9,10,10,5,12,9,9,9,8,13,14,12,8,3,10,16,13,20,10,8,9,9,1,5,11,17,11,12,9,11,2,6,8,M/AM C,1,1,1,18,1,1,1,1,1,12,20,1,14,1,1
2116316,César Luz,1651,10/03/1986,30,0,0,0,0,191,89,15,15,10,1,10,15,10,15,4,10,10,3,1,1,2,3,6,1,1,2,1,4,3,3,4,6,10,10,9,10,6,15,5,3,12,2,11,10,9,11,9,10,15,20,10,9,4,9,11,10,4,10,10,10,17,11,9,8,8,10,20,3,GK ,20,1,1,1,1,1,1,1,1,1,1,1,1,1,1
2116320,Caio Mendes,1651,01/06/1986,30,0,0,0,0,179,79,1,3,1,1,2,1,2,3,3,2,1,7,12,11,9,12,5,8,8,3,11,12,8,11,12,9,11,12,11,9,12,11,12,9,7,14,12,12,10,12,13,11,9,20,13,12,3,12,11,10,9,13,12,16,12,12,11,12,10,10,1,1,D L,1,1,1,12,5,1,1,20,1,13,14,14,1,14,1
2116321,Alex Cazumba,1651,30/06/1988,28,0,0,0,0,183,72,1,3,1,1,2,3,2,2,2,2,4,10,11,12,10,12,10,9,10,6,9,12,10,9,12,9,10,8,9,9,11,9,11,13,10,12,10,11,12,13,13,8,12,20,10,14,8,13,9,9,10,9,6,12,8,14,14,10,12,11,12,10,D/WB/M L,1,1,1,1,1,1,1,18,1,1,1,17,1,20,1
2116329,Gustavo Cazão,1651,27/05/1987,29,0,0,0,0,187,70,3,2,4,2,1,1,1,3,2,1,1,2,2,4,2,6,7,14,3,6,8,8,2,13,7,9,13,9,8,13,7,10,13,1,10,5,14,7,8,14,10,8,14,9,11,11,20,11,9,12,2,9,8,9,7,11,11,9,10,7,9,6,D C,1,1,1,1,1,1,20,1,1,1,1,1,1,1,1
2116371,Macena,1651,25/02/1989,27,0,0,0,0,184,82,1,3,3,1,2,2,2,3,1,2,3,6,9,11,10,12,12,12,12,4,5,11,12,5,11,13,10,12,7,8,10,9,12,12,4,12,7,10,14,11,12,14,12,10,13,13,20,10,14,12,10,11,7,8,14,13,10,12,12,8,7,12,AM/S RL,1,1,20,1,16,17,1,1,1,1,1,10,10,1,1
2116395,Mirita,1651,11/09/1985,30,0,0,0,0,185,81,3,1,2,3,2,3,2,2,3,1,3,5,6,8,8,8,7,13,10,5,11,10,5,12,9,13,9,12,8,11,7,9,9,10,7,9,12,12,11,13,10,15,13,8,13,13,20,13,14,10,10,10,9,10,7,12,14,10,12,6,19,6,D/DM/M C,1,7,1,1,1,1,20,1,1,19,18,1,1,1,1
2116414,Wender,1651,07/09/1978,37,0,0,0,0,174,70,2,2,3,3,2,3,3,4,3,1,1,10,12,13,8,14,10,10,12,8,11,10,8,9,7,14,11,12,10,8,9,11,10,5,6,11,10,12,7,12,13,10,12,12,11,12,20,11,10,13,13,4,10,5,8,10,10,11,11,9,9,6,D/DM/M RC,1,1,1,1,1,1,1,1,20,18,17,1,1,1,1
2116458,Ricardo Vilar,1651,04/04/1985,31,0,0,0,0,188,81,12,9,9,5,13,11,13,13,15,10,11,6,3,1,3,2,9,1,1,1,1,3,3,1,5,7,9,14,5,10,7,14,13,3,13,2,15,8,7,6,10,12,14,9,9,5,20,7,13,11,9,3,9,9,14,11,11,11,10,8,7,1,GK ,20,1,1,1,1,1,1,1,1,1,1,1,1,1,1
2116459,Henrique,1651,14/10/1986,29,6,0,0,0,186,78,1,2,2,2,3,1,2,3,2,1,1,3,10,8,9,12,12,14,12,8,14,12,13,14,13,13,13,15,14,12,11,14,14,12,11,12,13,13,14,12,12,14,13,11,13,11,20,14,14,14,12,14,7,15,14,13,13,14,14,13,11,7,D RC,1,10,1,1,1,1,20,1,18,14,5,1,1,1,1
2116477,Keirrison,1651,03/12/1988,27,0,0,0,0,184,80,2,2,1,1,2,3,3,4,3,1,4,7,10,12,14,13,10,12,11,6,7,12,13,7,12,6,14,6,12,13,12,12,11,12,4,14,7,12,12,13,13,11,11,12,10,13,20,12,9,11,5,8,16,10,8,11,5,6,12,9,15,8,S ,1,1,20,6,1,1,1,1,1,1,1,1,1,1,1
2116504,Cícero,1651,27/11/1983,32,0,0,0,0,180,74,1,3,1,2,3,4,3,3,3,3,2,7,13,9,8,9,5,5,7,5,7,12,10,7,10,10,9,9,9,8,11,10,4,8,7,15,4,14,14,15,11,11,11,10,10,14,20,10,9,4,12,7,7,12,9,10,10,11,13,3,16,2,DM/M C,1,1,1,10,1,10,1,1,1,20,17,1,14,1,10
22000707,Dakson,1651,11/07/1987,28,0,0,0,0,180,75,1,1,2,1,2,2,1,2,3,1,2,14,13,10,11,11,14,6,14,5,6,13,12,6,12,11,10,11,10,8,12,11,12,13,10,12,8,12,11,11,12,11,8,14,12,12,20,11,11,10,8,11,8,10,12,11,11,8,11,7,7,9,M/AM C,1,1,1,20,1,1,1,1,1,1,18,1,1,1,1
2200075,Anderson Passos,1651,18/06/1978,38,0,0,0,0,183,82,2,2,2,1,3,2,1,3,1,3,2,8,8,9,11,12,6,13,4,11,12,10,8,13,11,13,10,13,12,11,9,10,12,5,13,9,10,11,11,10,11,12,13,9,14,13,20,10,13,13,6,12,3,10,12,5,11,13,10,8,14,5,D LC,1,1,1,1,1,1,20,16,1,1,1,1,1,1,1
22006061,Tom,1651,23/07/1985,30,0,0,0,0,175,68,1,2,3,2,3,1,1,2,2,3,3,12,15,15,7,16,13,9,8,5,2,10,10,4,16,5,8,8,11,8,12,8,10,15,5,12,4,5,4,14,14,9,8,20,11,13,15,9,5,10,15,12,15,14,14,12,16,10,10,5,5,9,AM RL,1,1,10,14,19,20,1,1,1,1,10,15,15,1,1
22028484,Diego Ferraresso,1651,21/05/1992,24,0,0,0,0,171,68,3,2,3,2,2,2,2,2,1,3,2,10,10,12,8,11,6,6,12,13,11,11,7,12,13,12,10,13,11,10,11,10,13,11,7,11,10,12,13,13,14,10,8,8,12,13,20,13,10,12,13,10,8,18,14,13,14,11,14,2,6,7,D/WB L,1,1,1,1,11,11,1,20,12,1,1,13,10,17,10
22028868,Zé Carlos Júnior,1651,18/07/1985,30,0,0,0,0,178,74,3,4,3,3,3,1,1,1,2,2,1,9,11,13,12,13,12,5,10,1,2,14,13,3,15,15,11,10,7,9,12,7,13,13,11,15,6,5,12,12,13,11,5,12,12,13,20,12,9,10,6,15,6,13,15,19,15,12,11,11,18,5,S L,1,1,20,11,15,12,1,1,1,1,1,1,1,1,1
22036737,Adison,1651,11/03/1991,25,0,0,0,0,180,76,3,1,1,3,3,1,2,2,3,3,2,7,11,12,8,12,6,8,7,5,4,5,4,7,9,9,9,4,9,6,8,8,9,7,13,12,6,7,8,10,13,7,9,9,11,10,20,9,8,11,7,2,7,9,15,10,12,9,11,1,3,4,AM/S R,1,1,20,1,1,18,1,1,1,1,1,1,15,1,1
22037251,Choco,1651,18/01/1990,26,0,0,0,0,173,64,3,3,2,2,1,1,3,3,2,3,3,11,12,12,7,12,9,6,7,8,10,12,8,11,13,10,10,11,11,10,12,9,14,12,3,13,10,12,13,14,15,9,7,16,12,13,20,12,6,13,4,12,8,9,13,12,16,10,12,10,8,3,D R,1,1,1,1,1,10,1,1,20,1,1,1,12,1,15
22040138,Tom,1651,07/04/1990,26,0,0,0,0,180,70,2,2,3,3,1,2,3,1,2,2,3,7,3,10,8,11,12,6,14,1,11,10,4,11,9,9,7,5,10,7,11,9,4,8,14,9,8,8,12,11,12,6,11,10,13,11,20,12,12,9,3,9,9,9,8,12,12,8,11,7,10,5,M C,1,1,1,1,1,1,1,1,1,1,20,1,1,1,1
22042697,Christian,1651,28/07/1983,32,0,0,0,0,188,89,2,2,3,1,3,1,3,2,1,2,2,7,9,10,10,8,10,11,7,4,5,9,8,6,10,11,10,10,9,9,10,8,9,10,7,10,8,11,8,9,8,12,13,5,10,9,20,6,13,14,6,10,6,7,12,6,6,8,6,11,12,8,S ,1,1,20,1,1,1,1,1,1,1,1,1,1,1,1
22054680,Kássio,1651,14/09/1992,23,0,0,0,0,177,67,2,3,3,2,2,3,1,2,1,2,1,5,8,1,6,12,3,5,9,3,10,8,5,9,12,8,7,5,7,6,8,13,2,8,13,7,8,7,7,9,10,6,7,8,8,8,20,8,7,8,8,6,3,8,16,9,12,12,13,3,11,4,M C,1,1,1,1,1,1,1,1,1,1,20,1,1,1,1
22056641,Stênio Júnior,1651,10/06/1991,25,0,0,0,0,180,74,1,2,1,3,3,2,1,4,3,2,3,9,9,12,10,11,10,7,10,7,3,10,8,5,12,8,10,9,10,9,9,8,4,12,5,10,6,9,9,14,15,9,6,7,12,13,20,10,9,10,9,4,6,10,8,13,11,11,11,1,11,7,AM/S R,1,1,20,1,14,19,1,1,1,1,1,1,1,1,1
23006662,Edílson César,1651,28/05/1972,44,0,0,0,0,181,0,1,2,3,3,1,1,2,2,2,1,2,7,5,8,13,14,6,14,6,2,6,5,8,1,9,9,10,8,9,7,6,13,3,8,13,14,8,7,7,14,9,7,6,1,16,11,20,11,9,9,9,9,9,9,12,11,12,11,13,11,10,7,S ,1,1,20,1,1,1,1,1,1,1,1,1,1,1,1
23006888,Laudson,1651,20/05/1985,31,0,0,0,0,189,0,3,4,3,3,1,1,2,1,1,1,2,11,14,7,8,14,9,7,5,4,7,12,6,6,14,9,10,8,7,8,11,13,7,4,11,8,3,8,13,12,12,8,8,20,14,11,9,12,11,9,9,9,6,9,17,11,10,11,8,8,9,5,M L,1,1,1,1,1,1,1,1,1,1,1,20,1,1,1
23008152,Fabrício Lopes,1651,18/05/1984,32,0,0,0,0,189,84,3,3,2,1,3,3,3,1,2,1,1,9,7,9,1,10,5,9,9,2,8,10,4,8,9,10,14,11,10,13,5,11,16,3,11,9,11,9,12,15,12,15,12,9,15,12,20,14,14,10,9,4,10,10,17,15,5,12,12,10,6,7,D C,1,1,1,1,1,1,20,1,1,10,1,1,1,1,1
23033702,Charles Chad,1651,31/12/1981,34,0,0,0,0,187,81,1,3,2,2,1,3,1,1,1,1,4,1,10,9,11,11,4,14,10,1,4,9,13,5,11,14,11,11,13,11,10,12,12,13,11,13,8,12,11,10,11,12,14,7,13,10,20,9,14,14,11,12,8,14,14,11,12,11,9,1,17,7,S ,1,1,20,1,1,1,1,1,1,13,1,1,1,1,1
23039371,Mauro Santos,1651,09/02/1983,33,0,0,0,0,190,90,3,3,3,2,2,1,2,1,3,1,1,3,3,9,8,8,7,7,10,4,4,6,5,4,5,14,10,11,8,8,4,10,9,6,9,6,5,6,11,13,14,14,13,11,17,13,20,14,14,9,8,9,6,9,19,9,10,10,12,5,15,4,S ,1,1,20,1,1,1,1,1,1,1,1,1,1,1,1
23043147,Gleisson Freire,1651,03/05/1982,34,0,0,0,0,186,0,3,2,3,4,2,3,3,2,3,1,1,7,8,8,14,14,5,14,8,4,5,6,2,4,14,9,14,4,7,8,6,13,3,13,12,14,8,7,8,14,10,6,14,1,11,12,20,5,11,9,9,9,9,9,18,11,10,10,11,7,7,3,S ,1,1,20,1,1,1,1,1,1,1,1,1,1,1,1
23048464,Nildo,1651,07/12/1983,32,0,0,0,0,188,87,3,4,4,2,2,3,2,1,1,2,4,1,7,11,11,11,5,13,10,3,4,10,13,6,11,9,11,12,11,10,11,10,2,12,6,11,11,12,10,10,9,13,14,9,6,11,20,11,14,10,9,10,10,3,12,5,9,12,5,1,4,8,S ,1,1,20,1,1,1,1,1,1,1,1,1,1,1,1
23049476,Raphael,1651,19/10/1982,33,0,0,0,0,194,0,1,1,1,3,2,3,1,2,1,2,1,1,4,3,4,11,5,11,6,2,7,12,2,12,10,7,12,7,5,8,7,12,3,7,6,5,12,6,7,7,8,6,13,11,14,6,20,12,11,9,6,3,7,9,18,13,10,10,12,1,12,4,D/DM/M RLC,1,1,1,1,1,1,19,15,15,20,18,1,1,1,1
23084760,Richard Falcão,1651,29/06/1987,29,0,0,0,0,183,77,2,3,3,3,3,2,2,3,3,2,2,6,9,10,11,10,8,12,9,7,6,10,12,6,10,8,11,13,10,13,10,10,9,11,10,11,9,12,13,11,13,9,11,8,12,12,20,14,10,8,5,8,8,10,20,13,9,11,10,7,14,4,S ,1,1,20,12,1,1,1,1,1,1,1,1,1,1,1
23084765,Douglas,1651,19/03/1987,29,0,0,0,0,185,75,1,1,3,3,3,1,2,2,1,2,2,6,6,10,4,9,8,11,9,9,10,6,7,9,6,9,9,7,9,7,5,10,9,11,9,10,10,9,10,10,11,12,12,10,12,10,20,9,11,11,5,10,9,12,15,10,11,10,12,9,1,2,D C,1,1,1,1,1,1,20,1,14,10,1,1,1,1,14
23093479,Rafael,1651,16/06/1988,28,0,0,0,0,187,0,1,4,2,3,1,2,2,1,1,2,1,3,1,3,1,5,1,13,2,3,13,7,4,11,3,9,10,9,7,10,6,8,9,1,3,4,13,6,7,10,10,7,10,20,15,10,8,10,8,9,9,9,9,9,18,11,10,13,14,1,8,3,D C,1,1,1,1,1,1,20,1,1,1,1,1,1,1,1
23108386,Wellingsson,1651,07/09/1989,26,0,0,0,0,184,84,2,3,2,1,3,2,2,3,1,1,3,5,10,10,13,9,12,10,3,3,6,7,3,6,10,10,10,13,7,7,9,9,9,11,12,8,4,7,10,13,12,7,6,20,11,12,10,10,11,9,6,9,4,9,18,13,9,11,10,12,20,8,M/AM/S L,1,1,16,1,19,1,2,5,1,1,1,20,1,9,1
23121061,Clayton,1651,18/07/1988,27,0,0,0,0,192,95,2,2,3,3,3,1,2,3,1,2,2,6,5,3,6,6,2,12,5,4,10,7,10,11,6,9,10,12,10,11,9,9,6,4,14,10,10,9,8,9,10,12,12,9,11,8,20,10,14,7,7,9,8,9,16,10,8,9,10,5,13,2,D C,1,1,6,1,1,1,20,1,1,1,1,1,1,1,1
23123355,Douglas Friedrich,1651,12/12/1988,27,0,0,0,0,194,88,14,7,13,1,14,13,13,14,9,7,13,4,1,3,3,2,9,1,3,1,3,2,1,2,6,7,12,15,9,14,9,12,6,1,10,2,14,10,9,9,13,11,14,11,12,10,20,14,12,13,11,11,7,11,9,10,10,10,14,12,15,1,GK ,20,1,1,1,1,1,1,1,1,1,1,1,1,1,1
23123716,Cleiton Silva,1651,03/02/1987,29,0,0,0,0,175,70,3,3,1,1,2,1,2,1,1,3,2,4,9,13,13,12,10,11,8,3,3,10,12,6,12,7,13,8,14,10,12,13,15,14,5,14,4,10,8,13,13,8,8,13,11,12,20,12,10,11,5,12,7,11,8,12,11,9,12,11,15,7,M/AM/S RL,1,1,20,1,19,18,1,1,1,1,1,18,17,1,1
23140069,Felisberto,1651,24/05/1980,36,0,0,0,0,183,0,2,2,1,3,2,2,3,2,1,4,1,6,6,3,3,10,7,9,8,5,12,11,1,14,8,9,7,7,8,9,9,14,6,9,4,7,12,8,13,9,11,8,7,8,4,10,20,8,7,8,4,9,7,9,15,12,13,10,9,5,19,6,D/DM/M C,1,1,1,1,1,1,18,1,1,20,16,1,1,1,1
23148358,Alonso,1651,29/01/1985,31,0,0,0,0,177,73,2,2,2,1,1,1,4,2,4,2,4,5,5,8,13,11,5,13,3,1,4,6,6,1,13,8,12,5,9,4,6,9,4,13,11,13,4,5,6,13,8,4,4,9,15,8,20,8,7,7,8,8,8,8,7,12,11,9,9,1,5,1,S ,1,1,20,1,1,1,1,1,1,1,1,1,1,1,1
23148864,Wander Luiz,1651,30/05/1987,29,0,0,0,0,180,70,2,3,3,4,3,3,2,1,3,2,2,9,12,11,11,12,10,10,14,10,8,12,6,10,12,10,14,12,11,11,12,11,10,10,14,11,12,12,11,11,12,11,12,20,12,12,11,13,12,9,5,10,10,10,11,11,13,12,11,11,12,10,AM C,1,1,1,20,1,1,1,1,1,1,15,1,1,1,1
23154604,Nathan Ribeiro,1651,02/06/1990,26,0,0,0,0,187,81,1,1,4,2,2,2,1,3,3,3,3,5,7,7,7,7,7,12,7,2,11,8,4,11,7,15,13,12,11,11,8,11,2,1,7,8,11,11,12,8,9,13,15,7,10,9,20,11,13,9,9,9,9,9,12,10,10,12,9,10,11,2,D C,1,1,1,1,1,1,20,1,1,10,1,1,1,1,1
23155806,Avanildo Rodrigues,1651,26/06/1999,17,0,0,0,0,184,0,9,5,9,2,11,13,8,14,9,9,9,3,3,2,2,3,7,1,2,2,3,3,1,2,6,4,9,15,5,12,6,13,7,3,11,1,9,8,6,14,15,8,10,10,10,10,20,2,7,9,9,9,8,8,12,10,11,12,13,3,14,4,GK ,20,1,1,1,1,1,1,1,1,1,1,1,1,1,1
23155808,Renan,1651,06/06/1984,32,0,0,0,0,188,0,4,3,2,2,1,4,3,1,2,2,1,7,7,11,14,13,7,14,6,3,4,8,7,1,8,9,8,3,11,8,8,8,7,9,7,13,7,7,8,9,10,8,12,4,13,12,20,8,8,9,8,8,9,9,19,10,12,9,11,6,13,2,S ,1,1,20,1,1,1,1,1,1,1,1,1,1,1,1
23181441,Edu,1651,11/03/1985,31,0,0,0,0,174,69,2,2,1,1,1,1,1,3,3,3,2,9,14,12,8,10,7,2,7,5,7,9,1,6,14,9,11,2,7,8,8,14,9,13,12,8,7,8,13,13,8,8,5,4,9,10,20,14,6,9,4,5,9,9,16,10,10,10,11,10,5,4,M/AM R,1,1,1,1,1,16,1,1,1,1,1,1,20,1,1
23185180,Maurício,1651,07/05/1987,29,0,0,0,0,180,75,2,3,2,3,3,3,3,3,3,3,1,5,5,1,5,9,3,12,6,7,11,9,4,12,6,12,11,13,9,11,4,11,9,7,12,7,10,9,10,7,12,10,11,9,12,9,20,15,11,9,9,6,9,9,8,11,9,11,10,13,18,4,D C,1,1,1,1,1,1,20,1,1,1,1,1,1,1,1
23186450,Jansiz Rodrigo,1651,06/11/1987,28,0,0,0,0,190,0,2,2,1,1,3,1,2,2,1,2,3,6,7,3,4,11,7,11,8,2,11,10,5,14,6,6,12,4,9,9,6,11,3,2,12,7,9,7,9,14,13,8,12,20,11,14,3,14,12,9,7,4,6,9,9,11,10,11,11,10,11,5,D/DM C,1,1,1,1,1,1,20,1,1,17,13,1,1,1,1
23187143,Everton,1651,02/04/1984,32,0,0,0,0,178,0,2,2,1,1,2,3,3,2,3,1,2,9,13,8,8,13,6,6,7,1,3,11,3,7,13,6,6,8,7,6,9,13,5,13,5,8,6,7,12,11,9,2,7,9,10,13,20,13,7,9,9,2,9,9,14,12,13,13,10,5,5,2,AM RC,1,1,10,20,1,17,1,1,1,1,1,1,15,1,1
23194737,Ivanildo,1651,12/12/1988,27,0,0,0,0,187,0,14,11,8,5,10,9,11,14,10,7,13,2,3,3,2,4,5,1,3,1,2,2,1,1,5,7,9,13,9,10,8,11,4,3,14,2,10,9,8,12,12,9,9,3,10,12,20,8,10,10,10,6,7,10,14,10,11,12,12,11,13,5,GK ,20,1,1,1,1,1,1,1,1,1,1,1,1,1,1
23200183,Benjamin Batista,1651,24/06/1990,26,0,0,0,0,182,0,2,3,2,2,2,3,1,2,2,1,3,4,4,12,13,11,4,8,5,3,4,5,6,3,6,4,5,1,10,3,4,6,6,7,1,7,5,4,5,13,10,3,5,7,7,12,20,9,6,7,7,7,7,7,16,11,11,9,9,7,10,5,S ,1,1,20,1,1,1,1,1,1,1,1,1,1,1,1
23205705,Gustavo,1651,20/08/1988,27,0,0,0,0,184,76,1,1,1,2,2,3,3,2,4,3,2,5,4,8,8,9,6,8,7,1,8,8,3,12,7,7,6,7,8,8,6,12,8,8,12,8,10,8,11,14,14,7,7,1,13,14,20,6,9,8,8,8,8,8,8,9,11,11,12,5,12,2,DM/S ,1,1,16,1,1,1,1,1,1,20,13,1,1,1,1
23211157,Mayckol,1651,18/02/1984,32,0,0,0,0,180,0,1,1,3,2,1,2,3,1,1,2,2,2,1,7,13,13,5,13,3,1,4,6,5,1,9,8,10,7,9,6,5,13,1,9,12,13,6,5,6,7,9,6,8,3,14,8,20,6,10,8,8,8,8,8,18,11,10,11,11,7,14,6,S ,1,1,20,1,1,1,1,1,1,1,1,1,1,1,1
23231766,Diego Guerra,1651,06/11/1990,25,0,0,0,0,186,82,4,2,2,2,2,2,3,1,3,2,3,2,1,2,4,5,5,11,6,5,11,8,6,12,6,6,12,9,11,10,1,12,6,11,8,6,11,7,9,11,11,6,14,10,15,12,20,13,13,9,6,9,9,9,19,11,11,12,10,1,14,3,D C,1,1,1,1,1,1,20,1,1,1,1,1,1,1,1
23242861,Igor Bid,1651,08/05/1989,27,0,0,0,0,178,77,3,2,4,3,3,2,1,3,2,3,1,7,7,9,9,13,7,7,5,3,7,10,2,8,9,3,9,2,8,8,13,10,9,9,9,9,9,7,12,14,14,8,9,10,16,14,20,14,5,9,9,9,9,9,7,12,12,10,11,5,11,5,AM C,1,1,1,20,1,1,1,1,1,1,13,1,1,1,1
23267424,Thiago Fernandes,1651,20/05/1990,26,0,0,0,0,182,74,3,2,1,2,3,3,3,3,4,1,3,6,5,13,13,10,2,13,6,1,3,2,7,5,13,8,8,8,13,7,6,10,9,13,7,13,5,6,8,13,13,7,8,5,15,13,20,12,9,4,9,9,9,9,12,12,11,10,9,9,11,8,S ,1,1,20,1,1,1,1,1,1,1,1,1,1,1,1
23268851,Igor,1651,21/02/1985,31,0,0,0,0,185,79,2,3,2,1,2,1,2,3,2,1,2,1,3,1,5,7,1,12,3,1,7,7,2,12,6,8,12,8,4,9,2,11,1,8,14,6,14,6,7,8,8,7,10,7,8,9,20,10,12,8,8,1,8,8,13,14,12,12,12,11,10,4,D C,1,1,1,1,1,1,20,1,1,1,1,1,1,1,1
23273720,Jhonson Kendrik,1651,27/10/1992,23,0,0,0,0,188,0,2,1,3,3,1,2,1,1,1,3,1,7,8,14,13,14,7,13,6,6,7,8,10,1,12,8,7,5,11,7,8,14,8,11,9,9,8,7,8,10,14,8,10,9,15,14,20,7,9,9,7,8,9,9,17,11,13,13,13,7,14,3,S ,1,1,20,1,1,1,1,1,1,1,1,1,1,1,1
23287456,Thiago Mateo,1651,03/05/1989,27,0,0,0,0,192,0,3,1,2,3,4,3,2,3,1,2,3,3,1,1,1,6,3,15,1,6,12,8,2,12,2,9,11,8,6,7,1,11,7,1,12,4,10,5,6,12,10,6,15,1,10,12,20,12,14,9,6,7,6,9,11,12,10,12,11,1,13,3,D C,1,1,1,1,1,1,20,1,1,1,1,1,1,1,1
23287627,Michel Rodrigues,1651,15/10/1999,16,0,0,0,0,175,0,2,2,2,2,2,1,2,3,3,1,2,4,6,15,9,15,2,10,9,2,4,6,1,2,15,9,12,9,6,7,9,12,4,13,7,6,7,8,9,15,12,9,6,9,13,13,20,8,8,9,9,9,4,8,8,15,13,11,10,10,2,3,S ,1,1,20,1,1,1,1,1,1,1,1,1,1,1,1
23287682,Tiago de Sousa,1651,06/02/1990,26,0,0,0,0,173,0,1,2,1,3,2,3,3,3,2,2,1,12,11,11,13,10,8,9,12,6,9,12,13,8,11,9,7,10,11,12,12,8,9,13,4,10,9,12,11,8,10,11,6,6,13,14,20,11,14,14,6,9,9,13,19,11,12,10,13,5,13,8,M/AM C,1,1,13,17,1,1,1,1,1,1,20,1,1,1,1
23305542,Jildemar,1651,05/01/1989,27,0,0,0,0,185,72,2,2,2,3,2,3,3,2,3,3,1,9,9,10,12,10,6,10,8,7,9,10,4,5,14,10,14,10,11,10,10,10,5,12,11,11,10,9,10,12,11,10,10,10,12,12,20,14,9,10,10,7,9,10,11,13,10,12,11,11,12,2,S ,1,1,20,1,1,1,1,1,1,1,1,1,1,1,1
23311452,Paulo Vitor,1651,24/09/1994,21,0,0,0,0,175,0,1,1,4,1,2,1,1,3,1,3,3,7,5,13,12,14,7,7,9,6,7,11,5,8,14,5,6,7,6,8,11,12,6,13,8,9,3,8,6,14,12,7,7,8,9,13,20,10,6,9,9,9,9,9,8,10,11,9,11,1,11,5,AM C,1,1,1,20,1,1,1,1,1,1,1,1,1,1,1
23348516,Everton,1651,25/05/1991,25,0,0,0,0,184,81,1,1,4,2,3,3,3,1,1,3,2,5,6,12,13,12,5,13,6,1,4,4,4,4,11,8,10,4,9,2,5,11,8,9,1,13,5,5,6,13,13,10,5,20,12,12,6,5,13,7,8,7,8,8,14,13,13,13,12,1,2,2,S ,1,1,20,1,1,1,1,1,1,1,1,1,1,1,1
23359982,Allan,1651,06/10/1995,20,0,0,0,0,177,0,1,2,2,2,3,1,4,1,1,2,1,8,7,9,8,15,8,8,13,5,10,11,6,12,15,8,9,6,9,9,15,13,9,8,7,12,8,9,13,15,10,9,6,1,9,13,20,9,8,9,9,4,9,9,19,8,11,10,12,12,7,2,M C,1,1,1,1,1,1,1,1,1,1,20,1,1,1,1
24011498,Dodô,1651,16/10/1987,28,0,0,0,0,174,70,1,1,3,3,3,2,1,3,2,3,2,4,8,12,11,11,4,10,7,8,10,7,10,9,13,15,8,14,6,9,8,8,15,13,6,12,9,6,13,15,14,12,7,12,14,14,20,14,8,9,14,12,8,8,15,16,12,8,10,6,9,7,AM RL,1,1,14,10,19,20,1,1,1,1,1,14,14,1,1
25004342,Andrei,1651,06/02/1988,28,0,0,0,0,175,69,3,1,1,1,1,2,2,1,1,3,3,7,11,10,7,11,9,7,9,8,6,12,6,10,11,10,9,11,10,11,12,12,4,10,8,11,6,9,9,11,11,6,6,8,12,13,20,10,6,14,10,3,10,10,15,10,9,10,12,1,6,2,D/WB/M/AM R,1,1,1,10,10,19,1,1,18,1,10,10,19,1,20
25012721,Gabriel,1651,18/09/1987,28,0,0,0,0,173,79,1,1,1,1,2,1,1,2,1,1,1,4,7,5,2,9,2,6,2,4,7,8,2,12,8,7,8,9,8,9,6,13,8,3,3,6,7,8,8,13,13,12,5,7,16,13,20,12,10,9,9,9,4,9,10,11,12,11,12,11,11,5,D/WB R,1,1,1,1,1,1,1,5,20,1,1,1,10,5,17
25022172,Erick Luís,1651,16/07/1992,23,0,0,0,0,180,72,1,3,1,1,3,2,1,2,2,1,3,7,9,11,10,10,9,13,9,3,8,10,10,8,11,12,12,10,11,10,10,8,3,12,15,10,8,7,9,13,12,9,10,11,11,13,20,12,8,10,13,6,4,11,10,11,9,9,7,4,12,3,AM/S RL,1,1,20,1,17,17,1,1,1,1,1,1,1,1,1
25039727,Victor,1651,13/08/1990,25,0,0,0,0,176,71,2,2,2,3,1,1,1,4,2,3,1,1,3,6,1,10,1,7,6,3,8,8,1,10,8,9,9,9,5,7,7,11,9,3,3,6,6,7,8,13,13,7,7,14,11,13,20,12,5,9,5,7,9,9,11,10,10,12,8,1,13,2,D R,1,1,1,1,1,1,5,1,20,10,10,1,10,1,15
25049780,Joel,1651,25/11/1994,21,0,0,0,0,185,0,3,1,1,3,3,3,3,2,3,4,3,5,2,8,13,13,5,13,6,4,5,4,2,1,10,8,6,4,8,4,5,5,1,10,7,13,6,5,6,13,13,6,9,4,15,13,20,8,9,8,6,4,8,8,15,10,8,10,12,8,10,5,S ,1,1,20,1,1,1,1,1,1,1,1,1,1,1,1
25052925,Wesley Da Silva,1651,03/06/1996,20,0,0,0,0,184,75,2,1,1,1,3,3,1,3,3,3,3,7,4,13,14,14,7,14,8,4,6,6,8,5,13,6,10,3,8,5,8,10,9,12,12,12,3,7,8,14,11,3,10,9,14,12,20,8,7,9,9,4,7,9,7,13,13,11,10,7,3,7,S ,1,1,20,1,1,1,1,1,1,1,1,1,1,1,1
26000041,Evandro,1651,22/07/1985,30,0,0,0,0,181,0,1,3,3,1,2,3,2,1,3,1,2,7,8,13,13,13,7,5,6,7,7,7,5,8,9,10,10,9,10,5,8,13,4,9,12,10,7,8,8,13,13,8,8,14,8,13,20,10,5,10,10,10,6,10,18,11,11,12,13,7,11,8,M/AM/S RC,1,1,16,20,1,18,1,1,1,1,16,1,15,1,1
27021497,Felipe Garcia,1651,06/11/1990,25,0,0,0,0,185,75,1,1,2,2,3,3,2,1,2,2,3,7,9,10,11,12,8,12,9,4,4,11,10,7,13,10,6,6,7,11,8,8,2,11,3,11,9,9,11,17,15,12,15,9,12,17,20,9,13,4,10,7,2,10,7,11,10,7,8,13,5,4,AM/S C,1,1,19,20,1,1,1,1,1,1,10,1,1,1,1
27106994,Brandão,1651,18/08/1990,25,0,0,0,0,183,77,3,1,1,4,1,2,1,2,2,3,1,6,10,12,12,11,6,11,7,1,5,2,4,4,12,7,11,4,11,7,3,12,10,16,13,11,7,7,8,13,9,7,10,10,11,12,20,12,12,9,10,4,10,9,13,9,11,11,14,7,7,3,AM/S RLC,1,1,20,17,15,17,1,1,1,1,1,1,1,1,1
27107012,Fernando,1651,13/03/1995,21,0,0,0,0,187,81,2,3,1,1,1,2,2,2,1,1,1,5,5,12,10,13,6,13,7,3,6,3,6,2,12,9,10,6,10,6,6,8,9,12,11,11,7,6,7,9,12,7,11,9,5,13,20,4,11,9,5,8,9,9,17,10,9,12,10,9,5,4,S ,1,1,20,1,1,1,1,1,1,1,1,1,1,1,1
28009822,Marcelinho,1651,22/06/1987,29,0,0,0,0,172,68,1,1,2,3,2,4,2,1,3,2,1,13,10,13,11,12,11,5,11,5,4,11,11,4,14,6,8,8,8,8,13,8,11,14,8,11,6,7,9,15,16,6,6,20,12,15,8,12,3,8,8,11,6,12,12,16,14,10,12,7,12,12,M/AM RL,1,1,14,14,20,17,1,1,1,1,6,16,10,1,1
28031210,Adrianinho,1651,10/02/1987,29,0,0,0,0,172,69,3,3,1,3,1,1,1,3,1,1,1,5,1,5,10,13,6,6,11,3,9,11,6,4,13,6,7,5,8,7,11,13,12,11,11,8,9,7,12,13,13,7,6,18,16,13,20,9,5,9,3,8,9,9,19,12,9,12,10,10,10,3,M C,1,1,1,1,1,1,1,1,1,1,20,1,1,1,1
28065671,Rafael Leão,1651,06/04/1993,23,0,0,0,0,176,64,1,1,1,3,3,1,1,3,3,1,1,7,5,7,8,14,7,7,7,4,8,14,4,14,13,9,8,8,9,8,13,14,9,5,7,6,10,8,9,11,12,5,8,10,16,10,20,6,7,8,9,5,9,9,7,15,11,9,12,8,11,5,DM C,1,1,8,1,1,1,1,1,1,20,15,1,1,1,1
28068591,Gladestony,1651,05/08/1993,22,0,0,0,0,183,72,2,1,3,4,3,1,1,3,2,1,1,8,3,9,9,14,6,8,8,3,11,13,6,14,14,10,14,9,9,10,7,14,10,10,4,8,12,9,12,13,11,9,9,10,10,11,20,8,7,10,4,8,7,10,19,11,11,11,14,8,17,1,DM ,1,1,1,1,1,1,1,1,1,20,10,1,1,1,1
28085588,Andreas Pereira,1651,01/01/1996,20,0,0,0,0,176,69,4,2,1,4,3,3,1,2,1,1,3,17,12,14,10,15,17,4,15,4,2,15,14,6,16,11,10,7,12,9,14,10,12,19,3,12,3,9,12,14,14,11,6,16,11,13,20,12,7,6,7,11,5,6,11,17,9,9,12,10,14,5,M/AM LC,1,1,1,20,18,13,1,1,1,1,18,13,1,1,1
28086710,Jamerson Neves,1651,23/06/1994,22,0,0,0,0,188,81,1,2,2,3,2,1,2,2,3,3,1,2,1,1,1,3,3,12,3,1,9,7,2,13,6,9,11,4,7,8,1,12,7,1,1,4,13,6,7,11,12,5,13,9,11,12,20,7,12,9,5,9,5,9,11,10,12,7,8,1,9,6,D C,1,1,1,1,1,1,20,1,1,1,1,1,1,1,1
28086745,Lucas Evangelista,1651,06/05/1995,21,0,0,10,1,181,77,1,3,2,2,1,3,3,2,1,1,2,11,12,14,11,13,12,12,12,8,10,13,12,10,13,9,13,8,10,11,13,11,12,14,8,13,9,10,12,14,14,10,10,20,10,14,10,12,9,10,10,12,11,16,9,14,12,10,13,9,12,9,M/AM C,1,1,1,20,10,14,1,10,1,10,18,14,14,7,1
28086810,Bruno Gomes,1651,19/07/1996,19,0,0,0,0,182,75,1,2,2,1,2,4,2,2,3,1,3,7,6,12,12,11,8,12,12,9,6,7,13,7,11,11,11,12,13,12,11,11,16,12,10,14,6,12,13,15,13,13,10,12,11,15,20,12,8,11,7,12,8,9,13,12,6,8,12,6,6,7,S ,1,1,20,1,1,1,1,1,1,1,1,1,1,1,1
28088652,Joshua Nascimento,1651,28/09/1996,19,0,0,0,0,171,72,3,1,1,1,1,3,2,2,1,1,2,6,4,13,14,11,6,12,7,1,5,7,5,3,9,8,10,7,8,6,7,13,8,8,5,12,2,6,7,14,11,7,4,8,9,13,20,4,6,8,8,8,8,8,11,11,9,9,11,9,11,8,S ,1,1,20,1,1,1,1,1,1,1,1,1,1,1,1
29040482,Fabrício,1651,13/06/1986,30,0,0,0,0,169,65,1,1,2,1,3,2,1,2,3,3,3,8,8,13,10,14,12,8,10,5,9,9,7,10,13,8,12,9,10,10,8,11,10,15,10,10,10,9,13,14,14,7,6,14,11,12,20,11,7,10,7,9,10,10,12,12,10,12,11,3,10,6,M/AM LC,1,1,10,20,15,1,1,1,1,14,18,15,1,1,1
29061243,Wesley,1651,10/11/1981,34,0,0,0,0,175,67,2,2,3,2,2,3,3,2,3,3,3,7,7,13,12,11,8,6,11,7,6,11,9,6,13,10,10,11,10,11,11,10,11,16,12,13,6,11,12,12,14,10,7,20,10,14,10,11,8,10,7,11,8,8,6,11,10,9,9,7,10,7,AM/S LC,1,1,17,20,17,1,1,1,1,1,1,1,1,1,1
29068373,Igor Coronado,1651,18/08/1992,23,0,0,0,0,170,62,3,4,2,2,3,1,3,2,1,2,3,11,10,15,11,15,11,10,12,3,3,14,11,3,15,8,13,9,12,12,14,13,12,15,7,12,4,11,10,14,15,12,5,9,13,12,20,11,7,15,3,14,3,15,14,11,13,12,14,14,13,3,AM C,1,1,15,20,13,13,1,1,1,1,14,10,12,1,1
29087731,Alefe Santos,1651,01/03/1995,21,0,0,0,0,163,0,3,2,3,3,4,2,2,2,1,4,3,8,9,12,8,10,6,5,7,5,4,10,6,4,12,2,9,4,9,7,11,6,5,15,3,10,7,10,9,12,11,11,5,6,13,13,20,9,8,9,1,9,8,8,15,11,13,10,11,1,9,2,M/AM RL,1,1,1,1,17,20,1,1,1,1,1,15,16,1,1
29091537,Vinícius,1651,05/01/1995,21,0,0,0,0,194,87,3,3,1,2,3,4,2,2,1,1,1,7,5,11,13,8,10,14,9,7,4,6,12,5,10,10,12,6,11,11,9,6,3,7,15,13,5,11,12,7,9,14,17,20,13,7,10,14,15,10,10,10,8,10,9,12,10,11,10,12,2,6,S ,1,1,20,1,1,1,1,1,1,1,1,1,1,1,1
29108106,Rodrigo Branco,1651,14/07/1991,24,0,0,0,0,187,69,2,4,2,3,2,1,3,4,1,3,3,2,2,11,11,6,2,11,3,1,1,3,4,1,5,7,6,3,5,3,1,9,4,7,5,11,3,2,5,10,8,3,11,7,12,9,20,9,6,7,7,1,7,7,17,10,12,11,12,8,14,5,S ,1,1,20,1,1,1,1,1,1,1,1,1,1,1,1
29117667,Rafael Zuchi,1651,11/06/1994,22,0,0,0,0,188,77,3,3,2,2,3,1,2,3,2,2,2,8,10,10,11,12,11,12,11,10,12,11,10,12,11,12,12,11,12,12,12,11,10,12,10,11,11,12,12,13,12,12,12,11,12,12,20,11,11,12,12,11,11,12,14,8,8,11,10,12,10,12,D C,1,1,1,1,1,1,20,1,1,1,1,1,1,1,1
29117672,Danilo Mariotto,1651,15/01/1996,20,0,0,0,0,184,76,2,2,2,1,1,2,3,3,3,3,1,8,9,14,14,10,8,12,10,3,7,8,4,6,13,10,13,3,7,7,8,11,4,10,12,14,9,8,10,12,8,9,6,8,6,12,20,10,10,10,6,7,9,10,12,11,10,13,14,1,1,8,S C,1,1,20,15,1,1,1,1,1,1,10,1,1,1,1
29129471,Dedê,1651,16/10/1993,22,0,0,0,0,170,63,3,1,2,2,2,1,2,3,3,4,1,8,9,12,11,14,6,13,10,8,7,10,5,2,14,7,11,8,10,8,10,14,10,13,13,12,10,8,10,13,11,10,2,20,13,11,10,10,6,10,10,10,9,10,10,12,10,12,12,1,14,6,AM/S C,1,1,20,19,1,1,1,1,1,1,1,1,1,1,1
29152567,João Morelli,1651,03/11/1996,19,0,0,0,0,176,0,2,2,3,2,2,2,1,2,3,3,2,7,8,10,10,9,7,8,9,4,2,9,10,2,12,7,9,7,10,10,11,9,9,11,3,12,2,10,10,12,13,7,9,5,10,10,20,12,9,9,2,7,9,9,9,10,11,11,13,5,15,8,AM/S RC,1,1,20,18,12,15,1,1,1,1,1,1,1,1,1
29154405,Denilson Carvalho,1651,08/11/1998,17,0,0,0,0,179,0,3,3,1,2,2,2,1,3,3,2,2,7,9,8,8,9,9,8,11,6,10,9,6,10,11,8,9,11,9,6,10,10,7,9,11,8,7,9,12,11,10,9,10,20,11,12,9,10,9,9,9,6,9,8,10,12,12,12,12,7,4,7,AM RLC,1,1,1,20,15,15,1,1,10,1,14,1,1,1,12
29179727,Campanholo,1651,26/04/1990,26,0,0,0,0,183,74,1,1,1,3,1,1,2,3,3,3,1,11,10,12,14,11,10,13,12,7,8,10,11,9,11,12,10,10,12,13,11,12,4,11,12,10,12,13,12,11,10,11,12,4,12,11,20,13,12,11,11,11,8,10,7,12,11,11,10,4,14,1,S ,1,1,20,1,1,1,1,1,1,1,1,1,1,1,1
30035311,Watthimen,1651,17/07/1990,25,0,0,0,0,171,70,3,3,2,1,1,1,3,1,4,3,3,6,6,13,13,12,6,13,6,1,6,6,9,2,8,9,11,4,11,5,7,11,7,9,6,8,7,6,8,13,13,7,5,10,15,13,20,12,6,9,3,9,9,9,17,10,13,13,11,11,9,1,S ,1,1,20,1,1,1,1,1,1,1,1,1,1,1,1
30035404,Gabriel Barbosa,1651,30/08/1996,19,4,2,13,4,178,68,3,3,3,2,1,2,2,2,2,3,3,4,11,13,15,15,8,13,12,4,6,15,11,6,16,11,14,10,14,13,13,12,15,14,11,13,8,13,14,15,15,13,8,20,13,15,10,13,13,12,6,12,8,14,3,16,13,13,15,8,15,7,AM/S R,1,1,18,1,13,20,1,1,1,1,1,1,1,1,1
301522,Valdomiro,1651,06/02/1979,37,0,0,0,0,192,84,3,2,3,3,2,3,1,2,1,1,2,2,8,7,8,11,3,13,8,7,12,13,3,12,10,12,12,9,10,10,13,9,16,5,14,8,14,9,14,10,10,15,16,20,12,8,10,15,16,12,16,13,9,13,9,9,18,10,16,8,5,4,D C,1,1,1,1,1,1,20,1,1,1,1,1,1,1,1
301622,Wéldon,1651,06/08/1980,35,0,0,0,0,183,77,1,3,2,3,3,4,1,2,4,3,1,7,10,11,12,11,4,12,10,4,5,9,13,6,11,12,11,12,11,10,6,10,11,12,6,11,7,11,12,10,12,12,11,8,13,10,20,9,12,11,9,13,12,12,12,12,14,14,11,15,13,12,AM/S L,1,1,20,12,17,14,1,1,1,1,1,1,3,1,1
301628,André Luís,1651,31/07/1979,36,1,0,0,0,192,86,3,1,1,2,4,3,1,2,2,3,2,7,7,7,7,10,13,15,11,9,11,7,9,11,8,20,12,13,7,12,7,11,16,6,11,7,9,12,12,8,7,13,13,20,12,7,15,13,14,12,16,14,7,5,11,17,12,13,8,8,2,12,D C,1,5,1,1,1,1,20,1,1,1,1,1,1,1,1
301702,Alecsandro,1651,04/02/1981,35,0,0,0,0,183,81,7,7,8,10,10,11,6,6,10,15,5,6,11,11,14,12,10,15,12,7,7,10,17,7,11,14,14,13,13,13,11,12,11,12,14,15,7,13,12,12,9,10,13,14,11,11,20,14,14,12,14,13,10,7,11,12,12,11,12,7,9,15,S ,3,1,20,7,1,1,1,1,1,1,1,1,1,1,1
301703,Dudu,1651,02/02/1980,36,0,0,0,0,178,76,2,2,1,1,3,2,1,1,1,2,3,10,11,11,11,11,11,10,9,4,5,11,10,4,12,12,10,11,11,9,9,10,15,14,10,11,8,12,11,7,8,10,9,20,9,7,15,7,9,12,8,9,7,9,9,8,16,11,11,6,14,1,AM/S R,1,1,20,10,1,16,1,1,1,1,5,1,1,1,1
301753,Badé,1651,27/01/1982,34,0,0,0,0,170,69,1,3,2,3,4,3,3,2,1,1,1,12,13,12,11,12,12,7,13,13,11,12,12,10,12,11,9,12,9,10,12,9,12,12,7,14,12,9,9,11,11,13,5,20,11,9,10,12,12,12,10,12,10,11,10,11,11,9,12,13,12,11,D/WB/AM L,1,1,1,11,16,1,1,17,1,1,10,15,1,20,1
301793,Juninho,1651,06/03/1981,35,0,0,0,0,185,78,16,7,7,4,14,10,12,13,11,6,9,6,1,2,1,3,10,1,2,2,2,1,3,1,4,8,9,12,8,11,8,14,14,1,6,3,8,9,14,12,10,14,16,8,12,9,20,15,14,9,10,10,10,9,13,14,12,10,11,11,8,3,GK ,20,1,1,1,1,1,1,1,1,1,1,1,1,1,1
301797,Robert,1651,27/02/1981,35,0,0,10,8,184,81,1,2,2,1,3,1,2,2,2,3,3,1,6,8,10,9,7,13,12,4,4,8,12,6,10,14,11,12,9,8,8,10,14,12,5,10,5,9,10,9,8,11,9,12,14,9,20,9,11,12,6,14,10,6,16,15,4,15,7,11,8,14,S ,1,1,20,8,4,4,1,1,1,1,1,1,1,1,1
301839,Guaru,1651,04/02/1981,35,0,0,0,0,169,66,1,3,3,1,1,1,1,3,2,2,2,13,12,12,10,11,13,5,12,9,4,12,13,4,12,8,11,12,10,11,12,11,13,12,6,12,6,7,9,13,14,6,4,20,12,13,10,9,7,11,5,11,12,12,13,14,12,9,9,14,13,13,M/AM LC,1,1,14,18,20,14,1,4,1,1,15,18,3,8,1
301840,Edu Dracena,1651,18/05/1981,35,3,0,0,0,187,80,3,1,1,2,2,2,1,3,1,2,3,4,8,8,8,11,11,14,10,9,14,12,12,14,12,16,13,13,15,14,10,13,14,7,16,10,14,12,12,10,9,9,14,13,12,9,20,13,14,12,12,18,14,9,6,15,15,10,15,12,18,8,D C,1,14,1,1,1,1,20,1,1,1,1,1,1,1,1
301928,Nílson,1651,26/12/1975,40,0,0,0,0,183,80,11,10,12,8,11,13,12,14,10,13,11,3,1,1,1,8,5,3,1,1,3,3,3,1,4,10,8,13,10,10,10,10,12,1,11,1,11,11,11,7,10,11,14,5,11,8,20,10,12,9,10,8,10,10,12,12,11,9,12,13,14,6,GK ,20,1,1,1,1,1,1,1,1,1,1,1,1,1,1
302074,Kléberson,1651,19/06/1979,37,32,2,0,0,176,64,1,1,1,1,1,5,1,1,1,1,1,12,14,12,11,13,14,12,13,5,13,13,14,10,13,7,13,10,13,12,12,11,13,13,10,12,10,14,8,7,9,10,7,13,9,7,20,9,9,10,6,12,12,15,8,14,11,13,13,12,16,8,DM/M C,1,1,1,10,10,10,1,1,1,17,20,13,13,1,1
302172,Nobre,1651,06/11/1980,35,0,0,0,0,183,81,3,3,2,3,1,2,1,3,3,1,3,6,7,7,12,13,6,16,10,4,8,10,9,8,10,18,15,18,15,16,11,14,17,5,12,14,12,17,13,7,9,10,13,8,16,8,20,12,17,15,15,20,8,7,12,14,10,15,13,7,13,14,S ,1,1,20,1,1,1,1,1,1,1,1,1,1,1,1
302453,Luciano,1651,29/06/1978,38,0,0,0,0,185,80,1,3,3,3,2,2,3,3,3,2,2,6,5,3,7,8,1,14,1,6,13,13,5,12,11,11,9,10,7,9,3,11,14,2,17,7,11,6,10,12,8,13,11,8,14,13,20,14,13,12,9,14,10,10,14,7,10,12,11,10,15,6,D C,1,1,1,1,1,1,20,1,1,1,1,1,1,1,1
302461,Fábio Simplício,1651,23/09/1979,36,1,0,0,0,171,75,3,2,1,3,1,3,1,2,3,1,1,6,7,10,12,12,6,8,9,6,8,13,10,8,12,14,11,12,11,12,12,12,17,13,7,12,13,12,10,8,8,12,4,9,14,8,20,8,11,15,15,15,9,15,11,14,15,13,15,12,14,2,DM/M/AM C,1,1,1,19,1,8,1,1,1,16,20,1,7,1,1
302464,Gabriel,1651,05/06/1981,35,1,0,0,0,171,69,3,1,2,3,2,1,2,1,3,2,3,11,12,12,10,14,11,10,11,10,8,14,16,10,14,12,13,13,14,12,14,12,10,15,13,14,10,12,13,12,14,9,5,7,14,12,20,10,8,10,12,14,10,14,12,11,14,15,14,13,16,4,D/WB R,1,1,1,8,1,13,1,1,20,5,10,1,13,1,17
302469,Marquinhos,1651,29/09/1981,34,0,0,0,0,183,83,2,2,1,3,1,3,2,2,1,1,3,14,14,12,13,14,15,10,13,6,5,15,16,5,15,10,12,11,13,12,14,14,14,15,17,13,8,11,12,10,10,10,12,11,10,10,20,10,12,14,12,14,13,12,11,12,15,13,14,7,11,12,AM RC,1,1,12,20,1,15,1,1,1,4,12,1,10,1,1
302582,Marquinhos,1651,21/10/1982,33,0,0,0,0,194,80,2,3,3,1,1,3,1,2,3,1,2,8,7,7,8,9,7,15,7,7,12,9,5,11,8,13,13,13,11,12,6,11,12,9,15,9,14,13,12,11,8,5,17,10,13,11,20,14,14,13,13,14,14,8,11,13,11,9,10,11,8,12,D C,1,1,1,1,1,1,20,1,1,1,1,1,1,1,1
302583,Rubinho,1651,04/08/1982,33,0,0,0,0,186,85,13,11,10,9,13,11,14,12,13,12,9,3,1,3,2,10,8,10,2,1,1,9,4,1,8,9,13,14,13,9,8,11,13,9,8,9,14,11,11,10,10,11,14,6,15,10,20,10,10,16,13,14,5,10,18,12,14,12,14,12,11,10,GK ,20,1,1,1,1,1,1,1,1,1,1,1,1,1,1
302590,Danilo Santos,1651,12/11/1983,32,0,0,0,0,172,67,2,1,2,3,2,3,1,4,3,2,2,6,3,11,12,11,6,9,4,3,6,8,10,6,11,19,8,17,7,9,8,8,12,16,11,8,1,7,11,13,10,10,3,10,11,13,20,14,10,13,9,6,5,9,11,11,7,11,8,12,11,7,M/AM/S C,1,1,20,16,1,1,1,1,1,1,16,13,13,1,1
302690,Gilvan,1651,20/01/1980,36,0,0,0,0,188,84,15,14,13,3,12,15,8,14,10,7,10,6,3,3,1,2,8,1,1,1,3,2,3,2,3,10,9,15,9,12,9,13,13,3,5,1,12,10,9,11,14,10,16,3,13,11,20,7,12,13,10,9,7,10,17,13,12,9,10,5,8,8,GK ,20,1,1,1,1,1,1,1,1,1,1,1,1,1,1
302698,Lopes,1651,01/06/1979,37,0,0,0,0,186,78,1,2,1,1,4,2,1,1,1,3,3,12,10,11,11,11,13,10,12,6,6,11,13,5,12,10,11,11,11,9,11,11,13,17,5,13,8,7,9,9,9,13,12,12,9,9,20,10,13,11,13,14,12,13,12,11,12,10,6,10,9,14,M/AM C,1,1,12,20,13,10,1,1,1,1,18,11,8,1,1
302728,Andrezinho,1651,30/07/1983,32,0,0,0,0,178,72,1,3,2,3,3,3,2,2,2,1,1,15,14,15,12,15,15,8,13,14,12,15,14,13,16,10,12,12,12,13,15,13,13,14,15,13,11,13,15,12,13,10,10,5,12,11,20,11,13,14,10,11,9,11,14,13,16,15,14,9,12,12,M/AM RLC,1,1,1,20,15,15,1,1,1,12,17,1,1,1,1
302848,Wando,1651,05/08/1980,35,0,0,0,0,170,60,3,2,2,3,1,2,3,3,3,2,3,7,8,12,10,13,8,9,10,7,7,9,13,5,12,12,13,10,13,12,11,12,14,14,9,11,7,11,12,13,13,5,5,11,13,12,20,11,5,13,10,11,13,11,8,14,9,6,3,1,18,3,AM/S C,1,1,20,17,1,14,1,1,1,1,13,1,10,1,1
302915,Souza,1651,04/03/1982,34,0,0,0,0,188,86,2,3,2,1,2,3,3,2,3,2,2,6,9,11,12,11,8,14,13,6,6,11,15,7,11,15,11,14,10,10,10,11,12,14,12,14,5,14,11,10,7,14,14,16,15,11,20,11,14,12,14,15,11,8,4,12,6,10,9,10,5,15,S ,1,1,20,12,1,3,1,1,1,1,1,1,1,1,1
302961,Beto,1651,09/10/1978,37,0,0,0,0,187,0,13,12,15,1,8,11,6,11,9,8,9,3,3,3,1,2,7,1,2,3,2,2,1,3,4,7,7,15,5,13,6,13,10,3,14,3,8,7,6,10,11,7,7,9,11,9,20,2,7,9,5,9,7,9,13,15,6,14,10,10,9,4,GK ,20,1,1,1,1,1,1,1,1,1,1,1,1,1,1
302976,Jair,1651,29/03/1980,36,0,0,0,0,187,87,12,11,11,3,12,11,11,12,12,10,12,7,1,2,1,7,9,2,1,1,3,6,3,2,5,10,12,11,11,10,9,10,3,5,10,11,11,11,13,9,12,7,14,4,13,8,20,13,15,12,4,12,8,8,12,11,12,13,13,8,15,8,GK ,20,1,1,1,1,1,1,1,1,1,1,1,1,1,1
303204,Fábio,1651,30/09/1980,35,0,0,0,0,188,92,14,12,12,4,15,11,14,15,13,15,12,1,5,10,6,9,1,7,3,4,3,11,9,6,10,13,14,14,13,12,10,13,17,2,16,3,15,13,12,11,14,10,16,7,12,10,20,12,13,11,3,15,12,2,10,12,18,17,18,15,15,8,GK ,20,1,1,1,1,1,1,1,1,1,1,1,1,1,1
303254,Raniere,1651,16/08/1980,35,0,0,14,0,190,78,11,11,11,2,13,9,13,12,11,9,9,4,3,2,2,7,8,3,2,2,2,3,1,1,8,12,10,10,9,11,3,9,14,1,13,5,11,8,9,8,13,10,15,3,14,9,20,4,13,13,10,10,10,10,13,13,18,13,19,12,14,5,GK ,20,1,1,1,1,1,1,1,1,1,1,1,1,1,1
303391,Marcelo Moretto,1651,10/05/1978,38,0,0,0,0,196,94,12,11,12,13,12,12,12,12,8,11,12,4,3,3,3,3,6,1,2,1,3,2,5,2,4,11,11,13,10,10,8,7,9,2,12,1,11,9,11,7,9,14,16,8,15,8,20,11,15,10,7,12,6,9,15,16,9,12,13,12,18,4,GK ,20,1,1,1,1,1,1,1,1,1,1,1,1,1,1
303441,Lúcio,1651,08/05/1978,38,105,4,4,0,188,84,3,1,2,1,2,1,2,1,2,3,1,3,8,11,7,10,10,15,10,8,13,10,10,13,10,18,14,18,12,12,8,12,17,14,18,11,13,13,10,8,8,8,13,10,18,7,20,10,16,12,13,17,12,5,16,14,16,18,19,13,10,13,D C,1,1,1,1,1,1,20,1,1,1,1,1,1,1,1
303463,Diego Barcelos,1651,05/04/1985,31,0,0,0,0,172,70,3,3,2,1,2,3,2,2,1,2,3,11,12,12,11,13,8,6,11,3,5,12,6,6,14,9,12,11,12,13,12,13,14,13,9,12,7,14,13,12,14,12,5,8,13,12,20,13,8,12,9,14,9,12,10,13,13,15,16,5,13,10,M/AM C,1,1,7,20,12,12,1,1,1,1,16,1,1,1,1
303515,Fernando Prass,1651,09/07/1978,37,0,0,0,0,191,89,12,15,14,12,15,12,14,15,14,15,10,1,2,2,2,10,5,5,3,3,2,9,10,3,9,11,14,15,13,15,8,13,14,14,16,2,14,13,14,9,15,7,16,5,16,8,20,14,15,15,11,16,12,12,15,11,14,15,13,12,10,8,GK ,20,1,1,1,1,1,1,1,1,1,1,1,1,1,1
303586,Guilherme Weisheimer,1651,22/10/1981,34,0,0,0,0,184,75,2,2,4,2,2,2,1,1,2,1,1,6,11,12,9,11,9,11,10,5,6,10,14,7,12,9,9,10,8,10,9,10,10,12,10,11,8,12,8,9,8,13,12,10,12,8,20,8,12,11,6,12,9,6,10,14,12,8,11,7,8,9,S ,1,1,20,10,7,7,1,1,1,1,1,1,1,1,1
303588,Matheus Vivian,1651,05/04/1982,34,0,0,0,0,188,83,3,3,1,3,1,3,2,1,1,1,1,4,6,8,8,11,7,13,7,5,13,9,12,12,11,14,14,15,12,12,8,11,14,7,12,7,14,15,12,9,8,15,14,8,11,9,20,12,13,13,14,14,12,6,12,14,12,13,16,13,14,7,D C,1,10,1,1,1,1,20,1,1,1,1,1,1,1,1
303596,Eduardo Martini,1651,11/01/1979,37,0,0,0,0,192,89,15,12,14,12,14,14,14,15,14,15,12,1,1,1,2,1,1,3,5,2,2,2,2,1,6,9,12,15,13,12,10,12,13,3,13,8,10,13,16,8,12,13,15,5,14,11,20,12,13,9,7,13,8,1,11,13,17,9,15,13,16,11,GK ,20,1,1,1,1,1,1,1,1,1,1,1,1,1,1
303599,Pedro Ayub,1651,15/06/1977,39,0,0,0,0,177,73,1,1,3,2,1,2,1,3,1,3,1,7,11,5,7,14,7,7,8,5,14,13,7,12,12,9,9,8,9,12,9,14,14,5,17,7,9,5,11,9,10,14,8,6,12,9,20,8,9,15,8,9,8,9,15,9,11,12,11,11,17,5,D/WB/DM R,1,1,1,1,1,1,1,1,17,20,11,1,1,1,16
304037,Vélber,1651,20/05/1978,38,0,0,0,0,168,66,1,1,1,3,1,2,2,1,2,3,2,11,10,10,10,9,11,6,10,1,6,9,13,5,10,10,8,10,9,10,10,8,10,12,7,11,8,8,8,11,11,8,3,13,12,11,20,10,6,11,11,11,10,15,8,10,13,7,8,6,13,12,M/AM LC,1,1,11,20,18,12,1,1,1,10,17,16,8,1,1
304130,Cristian,1651,28/08/1979,36,0,0,0,0,171,68,2,3,3,2,3,4,1,3,2,3,3,12,12,14,11,14,12,9,11,7,8,13,15,8,13,5,10,11,12,11,13,12,14,14,12,12,12,9,10,11,11,14,6,10,13,11,20,10,8,13,5,13,6,13,11,13,15,13,11,12,14,9,M/AM C,1,1,1,20,6,12,1,1,1,1,19,10,11,1,1
304132,Ozéias Graciano,1651,21/05/1983,33,0,0,0,0,192,91,1,2,3,1,3,1,2,1,1,3,3,1,5,5,7,7,5,13,6,10,11,7,5,11,7,12,12,15,8,9,6,10,15,6,14,5,10,11,10,8,7,13,15,7,13,11,20,12,17,11,8,9,9,9,9,12,11,8,12,6,16,4,D C,1,1,1,1,1,1,20,1,1,8,1,1,1,1,1
304139,Schwenck,1651,08/02/1979,37,0,0,0,0,181,81,1,3,2,1,2,2,3,3,3,2,3,3,9,9,12,10,9,13,11,5,4,10,13,7,9,12,10,12,11,11,11,11,14,13,12,10,9,12,12,10,10,8,12,12,11,10,20,11,13,10,11,12,10,5,16,11,15,12,7,8,11,8,S ,1,1,20,1,1,1,1,1,1,1,1,1,1,1,1
304150,Luisão,1651,13/02/1981,35,44,3,10,0,193,90,1,3,3,1,4,2,2,1,1,3,1,2,3,5,10,10,2,16,3,4,16,10,11,15,8,15,12,17,10,17,7,16,15,5,20,8,15,15,14,8,8,15,18,9,13,9,20,13,18,19,14,15,8,2,8,18,16,16,19,11,10,11,D C,1,5,1,1,1,1,20,1,1,1,1,1,1,1,1
304160,Luciano Bebê,1651,11/03/1981,35,0,0,0,0,163,65,3,1,3,1,2,1,3,3,3,4,1,9,12,12,8,11,11,3,10,6,10,12,11,11,12,12,12,12,11,12,13,11,13,13,14,12,7,15,13,11,13,5,2,10,10,10,20,12,8,13,12,13,8,12,14,14,6,7,10,8,6,8,M C,1,1,1,14,1,1,1,1,1,15,20,1,1,1,1
304255,Léo Aro,1651,14/12/1983,32,0,0,0,0,175,67,2,1,2,1,2,3,3,4,2,1,3,1,9,14,12,13,4,10,8,1,8,10,13,6,13,8,14,9,10,12,12,12,14,15,10,14,7,11,16,11,16,8,10,3,10,11,20,12,7,11,10,14,11,14,13,11,5,13,12,11,12,12,S ,1,1,20,13,12,12,1,1,1,1,1,1,1,1,1
304331,Marcinho Beija-Flor,1651,11/12/1979,36,0,0,0,0,172,74,2,4,2,2,2,1,4,3,1,1,2,8,6,12,10,9,8,7,10,2,5,11,13,4,11,11,10,11,11,9,11,9,11,13,4,11,6,7,10,12,12,4,3,16,13,13,20,13,2,13,10,12,9,10,12,14,10,12,9,9,5,4,M/AM/S C,1,1,20,19,14,14,1,1,1,1,16,7,7,1,1
304369,Ludemar,1651,01/06/1979,37,0,0,0,0,177,72,3,1,2,4,3,1,1,3,1,2,1,4,11,11,7,11,5,11,8,6,5,8,10,5,10,10,10,11,12,5,7,8,17,10,6,15,7,11,12,14,12,10,11,8,13,14,20,7,11,7,12,12,10,10,13,17,12,16,14,9,7,7,S ,1,1,20,5,1,10,1,1,1,1,1,1,1,1,1
304461,Thiago Martinelli,1651,14/01/1980,36,0,0,0,0,181,73,2,1,3,2,4,2,3,3,3,3,1,3,6,8,6,10,5,12,6,6,12,10,9,12,10,12,13,13,12,12,6,12,15,9,13,9,12,13,12,10,11,10,11,7,13,9,20,9,9,13,13,13,11,6,12,11,12,15,14,8,10,6,D C,1,10,1,1,1,1,20,1,1,1,1,1,1,1,1
304473,Fábio Gomes,1651,06/02/1981,35,0,0,0,0,179,73,2,3,3,2,3,2,3,2,4,2,2,9,10,10,7,12,10,11,11,10,13,8,10,13,12,12,12,10,12,11,10,11,11,10,14,9,10,12,10,10,12,12,9,20,12,10,7,10,8,10,11,12,8,13,13,6,10,11,11,11,12,8,DM/M C,1,1,1,1,1,1,13,13,1,20,19,10,1,10,1
304570,Gláuber,1651,02/09/1981,34,0,0,0,0,184,76,3,1,1,3,1,2,1,3,1,2,2,1,9,9,9,8,9,10,9,9,11,11,10,9,9,10,11,10,9,9,11,9,13,11,11,10,13,11,1,9,11,10,12,15,14,10,20,12,11,11,11,12,12,14,11,9,12,14,12,13,11,10,D/DM/M C,1,1,1,1,1,1,20,10,1,19,16,1,1,5,1
304595,Testinha,1651,27/12/1977,38,0,0,0,0,172,74,1,1,3,1,1,3,1,3,1,2,1,11,13,11,9,10,9,7,10,4,6,10,14,6,11,13,7,12,9,7,10,7,13,9,6,10,8,9,10,12,13,7,6,20,13,12,14,11,7,9,13,3,5,9,13,11,12,12,9,11,9,6,M/AM RLC,1,1,1,20,19,19,1,1,1,1,12,16,18,1,1
304604,Ivonaldo,1651,15/02/1983,33,0,0,0,0,169,66,2,1,3,1,1,2,4,2,3,2,3,8,6,8,5,14,4,5,6,8,10,10,4,14,10,5,10,10,9,7,9,14,6,5,11,8,11,10,10,14,11,9,5,7,14,10,20,13,7,10,10,6,8,10,12,12,8,9,13,8,3,5,D/WB R,1,1,1,1,1,1,1,1,20,1,1,1,1,1,17
304738,Éder,1651,14/05/1980,36,0,0,0,0,171,74,4,2,1,3,3,2,2,1,3,3,2,13,12,11,12,11,13,3,13,3,5,13,13,6,13,5,11,9,11,12,12,12,5,11,8,11,7,11,12,12,11,12,7,20,12,12,7,13,6,10,8,11,10,10,6,5,9,8,11,6,14,8,M/AM LC,1,1,1,20,18,1,1,1,1,1,18,16,1,1,1
304762,Maurinho,1651,11/10/1978,37,2,0,0,0,175,66,1,1,2,3,3,1,2,1,1,1,2,13,12,10,9,10,8,7,10,8,9,10,10,9,10,12,10,14,9,10,10,10,16,12,7,10,8,9,11,12,9,9,9,9,12,12,20,11,9,12,10,14,18,12,16,12,17,13,5,10,13,14,D/WB/M R,1,1,1,1,1,4,1,1,20,1,1,1,16,1,17
304766,Lelo,1651,18/03/1982,34,0,0,0,0,188,80,2,4,2,1,2,2,3,4,3,3,3,8,10,11,10,11,9,11,9,6,8,10,11,8,11,10,11,10,12,11,10,11,6,11,9,12,9,11,10,10,10,6,14,7,12,10,20,11,14,11,7,10,10,12,12,10,11,11,7,5,17,5,S ,1,1,20,5,10,7,1,1,1,1,1,6,1,1,1
304822,Ramalho,1651,03/06/1980,36,0,0,0,0,180,75,2,3,2,3,4,2,3,2,2,1,1,6,6,7,6,9,7,8,12,5,12,11,6,12,9,13,11,13,10,13,10,13,12,12,16,10,12,14,13,11,10,11,10,7,13,11,20,12,10,11,11,12,6,8,14,12,12,13,14,8,13,10,DM C,1,1,1,1,1,1,1,1,1,20,15,1,1,1,1
304828,Fábio,1651,19/09/1978,37,0,0,0,0,200,85,15,12,13,2,13,11,15,14,14,9,11,2,2,2,2,5,7,13,4,3,5,8,7,8,6,11,10,11,10,11,3,8,15,4,14,6,13,9,10,8,12,16,20,3,14,7,20,14,14,14,10,16,7,2,11,14,15,12,17,8,12,6,GK ,20,1,1,1,1,1,1,1,1,1,1,1,1,1,1
304847,Kleyr,1651,14/09/1980,35,0,0,0,0,185,72,2,2,1,2,1,1,1,2,1,1,2,9,12,14,12,13,10,13,11,7,9,12,15,9,13,9,12,8,10,9,12,9,4,15,7,12,7,9,8,11,12,9,13,7,9,13,20,9,8,13,5,10,8,9,10,11,16,13,12,1,17,1,S C,1,1,20,15,1,1,1,1,1,1,1,1,1,1,1
305094,Marinho Donizete,1651,31/07/1980,35,0,0,0,0,165,60,3,1,3,3,2,3,3,3,2,3,4,6,6,12,2,14,1,5,8,8,10,10,3,12,12,10,11,10,10,10,11,13,11,6,14,8,11,10,10,15,15,15,3,20,12,16,8,11,6,10,6,6,15,10,18,9,15,12,14,13,13,10,D L,1,1,1,1,10,1,1,20,1,1,1,12,1,15,1
305179,Leandro Guerreiro,1651,17/11/1978,37,0,0,0,0,182,72,1,1,1,1,1,1,1,1,1,1,1,9,12,10,9,12,8,13,12,7,14,12,10,13,13,8,14,15,11,11,12,11,15,8,16,10,14,15,15,10,10,13,11,7,16,11,20,13,11,11,10,12,7,18,8,12,14,14,15,12,10,9,D/DM C,1,1,1,1,1,1,19,1,13,20,12,1,1,1,12
305625,Ratinho,1651,30/10/1979,36,0,0,0,0,175,70,1,3,1,3,3,3,2,2,2,3,3,9,10,12,11,13,9,8,13,4,5,12,13,5,13,12,12,11,12,12,13,11,9,15,5,12,7,12,13,11,11,5,7,20,10,11,7,11,8,13,9,6,9,10,19,12,11,11,12,1,4,7,AM RLC,1,1,15,20,15,17,1,1,1,1,10,1,1,1,1
305635,Eduardo,1651,07/03/1981,35,0,0,0,0,184,76,3,3,2,3,2,3,1,3,3,2,2,5,6,7,4,8,7,15,1,5,13,9,1,11,8,9,14,9,8,11,7,14,1,4,9,7,9,7,7,7,8,8,14,9,12,10,20,9,10,9,6,4,7,9,17,8,13,9,9,4,8,7,D C,1,20,1,1,1,1,20,1,1,1,1,1,1,1,1
305641,Vítor,1651,10/02/1976,40,0,0,0,0,183,0,1,2,2,1,3,1,3,2,1,2,1,6,2,1,4,7,4,14,6,6,9,8,6,13,6,8,10,8,7,5,3,11,4,4,5,5,8,6,8,6,10,7,11,10,14,10,20,6,9,8,8,4,8,8,14,12,10,11,9,1,14,3,D C,1,1,1,1,1,1,20,1,1,11,10,1,1,1,1
305647,Jabá,1651,20/05/1981,35,0,0,0,0,164,63,3,3,3,2,3,1,2,2,1,3,3,6,7,10,11,11,7,10,6,2,2,8,11,5,11,11,8,8,9,8,8,9,13,13,7,10,6,8,12,13,14,6,1,10,12,10,20,11,6,10,12,10,8,4,15,13,16,8,6,6,16,11,S ,1,1,20,1,1,1,1,1,1,1,1,1,1,1,1
305649,Dênis,1651,25/02/1982,34,0,0,0,0,176,68,3,1,2,1,2,3,2,1,3,1,2,7,4,4,9,13,7,7,11,1,5,13,7,9,14,9,8,2,11,8,13,14,3,13,9,8,8,8,11,13,7,8,9,9,14,9,20,8,9,7,12,9,9,9,14,10,10,11,11,2,2,3,M/AM C,1,1,1,20,1,1,1,1,1,1,16,1,1,1,1
305658,Aderaldo,1651,14/06/1977,39,0,0,0,0,182,76,2,1,2,1,2,3,3,2,3,3,1,7,6,9,7,7,13,11,5,6,11,9,8,10,12,12,10,14,11,11,8,10,12,13,13,7,12,11,11,11,11,10,13,20,15,11,8,11,10,17,16,15,11,10,18,11,7,15,12,12,10,11,D LC,1,1,1,6,1,1,20,16,12,10,1,1,1,1,1
305886,Luciano Gigante,1651,07/10/1980,35,0,0,0,0,159,0,1,2,2,1,2,4,1,1,2,2,4,10,6,12,10,9,13,4,7,8,2,10,13,6,9,6,11,6,7,10,12,10,4,15,11,10,4,13,13,14,14,6,5,20,11,13,9,10,4,12,6,11,15,10,16,13,12,11,13,2,9,6,AM/S LC,1,1,20,16,18,1,1,1,1,1,15,1,1,1,1
306017,Márcio Nunes,1651,27/09/1980,35,0,0,0,0,188,87,1,3,1,2,3,2,1,2,2,1,2,5,3,4,2,7,3,13,6,6,13,5,2,13,6,9,7,9,6,9,2,10,3,3,10,6,13,6,7,7,7,4,14,9,10,7,20,12,14,9,5,9,9,9,15,13,12,12,9,6,6,2,D C,1,1,1,1,1,1,20,1,1,1,1,1,1,1,1
306258,Dennys,1651,18/04/1978,38,0,0,0,0,192,92,9,12,10,16,8,9,9,6,7,8,8,2,3,2,1,1,2,1,2,3,1,3,1,1,1,8,10,15,6,8,6,14,14,2,4,1,12,7,6,8,8,9,15,11,6,9,20,7,11,8,8,1,7,8,14,8,15,14,10,14,14,2,GK ,20,1,1,1,1,1,1,1,1,1,1,1,1,1,1
306262,Paulo Sérgio,1651,01/10/1978,37,0,0,0,0,173,69,1,2,1,2,3,1,1,1,1,1,3,13,12,4,3,5,14,5,4,13,11,12,13,11,12,13,12,13,11,11,12,12,12,11,13,12,12,13,13,13,12,13,6,10,13,12,20,13,13,10,12,12,8,12,11,12,13,11,9,11,17,14,D R,1,1,1,1,1,1,1,1,20,1,1,1,1,1,15
306446,Johildo,1651,18/08/1978,37,0,0,0,0,190,80,2,3,2,1,1,2,1,2,3,2,1,6,7,8,8,5,5,13,7,4,10,8,5,10,8,11,10,9,9,11,7,14,9,2,11,6,9,7,10,6,9,13,16,9,11,9,20,6,13,9,11,8,9,9,14,12,10,11,10,10,4,1,D C,1,20,1,1,1,1,20,1,1,1,1,1,1,1,1
306503,Ângelo,1651,12/06/1981,35,0,0,1,0,175,76,2,2,3,2,2,3,3,2,2,1,3,10,13,12,8,12,8,5,12,7,10,12,5,12,12,13,12,12,12,13,12,12,13,12,12,13,13,13,13,12,12,10,5,6,14,13,20,12,10,12,13,11,8,13,14,12,13,12,15,14,13,8,D/WB R,1,1,1,1,1,1,1,1,20,1,1,1,15,1,20
306525,Daniel Mendes,1651,14/07/1981,34,0,0,3,0,171,69,2,1,1,1,3,3,2,2,1,3,3,13,10,11,13,12,7,8,13,5,8,12,10,6,13,11,10,8,12,10,12,9,11,12,5,12,7,14,13,11,12,9,6,7,11,9,20,12,8,14,9,11,5,9,15,11,15,10,13,12,15,8,AM/S RL,1,1,20,1,20,20,1,1,1,1,1,13,13,1,1
306845,Veloso,1651,21/05/1983,33,0,0,0,0,191,89,14,11,8,2,12,14,7,14,9,9,10,3,2,1,2,4,6,1,3,1,1,1,1,1,6,5,9,10,5,11,7,8,11,3,13,3,11,8,7,12,13,8,14,9,16,11,20,3,9,9,6,9,9,9,13,9,12,10,9,2,8,4,GK ,20,1,1,1,1,1,1,1,1,1,1,1,1,1,1
306933,Joélson,1651,19/11/1980,35,0,0,0,0,179,79,2,2,1,1,2,3,3,2,2,3,2,9,11,11,10,11,8,11,10,5,4,11,11,4,11,12,11,11,12,11,10,10,12,12,10,12,4,11,11,10,12,9,10,9,13,11,20,11,13,12,11,11,8,13,12,7,10,13,12,14,13,7,M/AM RC,1,1,15,20,10,16,1,1,1,1,17,5,12,1,1
306948,Fernando Cardozo,1651,17/03/1979,37,0,0,0,0,186,79,3,1,1,2,3,1,2,2,3,4,3,6,8,8,9,10,7,14,9,12,12,11,10,12,10,12,12,14,13,13,8,9,16,11,11,12,10,15,16,7,6,9,15,7,11,8,20,11,14,12,8,12,7,8,12,9,16,7,14,15,16,5,D C,1,10,1,1,1,1,20,1,1,5,1,1,1,1,1
307325,Moacri,1651,20/10/1981,34,0,0,0,0,185,78,4,3,1,3,2,1,3,1,4,3,2,2,2,1,3,7,3,13,5,1,13,7,5,11,9,9,11,9,7,10,4,13,2,1,10,3,10,6,7,7,10,7,12,7,15,9,20,10,11,17,10,1,9,9,13,13,10,8,10,10,6,4,D C,1,1,1,1,1,1,20,1,1,1,1,1,1,1,1
307343,André Luís,1651,06/05/1977,39,0,0,0,0,182,77,13,13,9,5,13,12,9,15,10,6,10,7,1,2,3,3,9,1,3,3,2,1,3,3,10,8,13,10,8,8,7,11,12,3,12,2,9,8,12,11,11,5,12,9,13,11,20,6,12,15,4,12,9,10,13,5,11,12,13,3,15,4,GK ,20,1,1,1,1,1,1,1,1,1,1,1,1,1,1
307399,Leandro Silva,1651,06/08/1988,27,0,0,0,0,188,87,13,12,9,1,9,11,8,13,9,9,6,3,1,3,2,1,5,1,3,1,1,1,1,3,5,5,11,14,4,7,6,13,5,3,14,2,8,7,6,11,10,5,13,12,14,13,20,6,14,8,7,3,8,9,7,9,12,10,10,4,7,5,GK ,20,1,1,1,1,1,1,1,1,1,1,1,1,1,1
307457,Machado,1651,25/04/1976,40,0,0,0,0,176,74,3,1,1,3,2,1,3,2,2,2,2,12,11,13,11,12,12,7,12,5,4,12,11,5,12,11,6,12,10,6,10,7,14,12,12,11,6,7,6,7,8,10,6,10,10,8,20,7,9,8,6,8,7,6,19,12,12,8,7,9,6,1,AM/S C,1,1,20,18,10,14,1,1,1,1,10,7,10,1,1
307482,Viola,1651,10/10/1981,34,0,0,0,0,184,75,2,3,4,3,1,3,4,3,1,3,2,6,5,10,13,12,6,9,7,1,6,7,6,1,12,9,11,6,11,5,6,13,7,12,10,13,5,6,4,13,11,7,6,10,14,13,20,8,7,9,9,1,6,8,20,11,9,10,11,1,8,3,S ,1,1,20,1,1,1,1,1,1,1,1,1,1,1,1
307491,Marcelo Costa,1651,24/07/1980,35,0,0,0,0,176,68,3,3,1,2,1,1,3,3,1,3,1,12,11,11,11,12,13,9,12,10,10,12,14,10,12,12,11,11,11,11,11,12,15,14,11,12,12,12,12,12,11,10,7,8,15,11,20,12,10,12,12,13,8,16,6,15,14,15,14,13,15,11,M/AM RC,1,1,11,19,10,18,1,1,1,14,20,13,17,1,5
307494,Michel Neves,1651,13/07/1980,35,0,0,0,0,181,72,2,3,2,3,2,2,1,3,1,3,1,6,11,11,9,11,9,10,11,3,3,10,12,5,10,13,10,10,8,7,10,8,15,13,6,10,6,5,10,12,11,9,11,20,13,11,10,10,9,11,12,11,14,11,10,11,16,13,10,11,7,12,AM/S RC,1,1,19,20,14,18,1,1,1,1,15,7,11,1,1
308087,Juninho,1651,09/07/1981,34,0,0,0,0,185,85,10,12,10,5,12,11,13,12,11,13,12,3,2,3,2,7,7,7,3,3,3,8,12,1,8,10,12,13,12,12,8,12,15,2,14,1,14,12,8,9,11,6,13,4,14,8,20,13,15,11,9,10,10,10,11,13,12,11,10,8,9,14,GK ,20,1,1,1,1,1,1,1,1,1,1,1,1,1,1
308322,Jefferson,1651,02/01/1983,33,22,0,5,0,188,82,15,16,15,5,15,11,16,16,15,15,15,4,4,9,5,10,1,5,5,1,5,10,1,5,9,1,14,14,15,15,8,13,16,15,17,6,16,11,13,11,14,12,14,20,17,13,2,13,15,17,2,15,8,1,8,10,15,13,20,15,10,5,GK ,20,1,1,1,1,1,1,1,1,1,1,1,1,1,1
308324,Accioly,1651,30/03/1981,35,0,0,0,0,187,82,2,2,3,1,2,3,1,3,3,1,4,3,6,5,7,8,5,16,7,7,13,10,8,12,5,15,10,14,11,14,6,12,14,6,13,8,14,13,11,8,10,12,15,6,14,9,20,14,15,11,14,11,5,5,11,11,14,10,14,10,11,9,D C,1,5,1,1,1,1,20,1,1,1,1,1,1,1,1
308326,Wesley,1651,10/11/1980,35,0,0,0,0,179,74,1,2,3,3,2,2,3,3,3,2,2,14,13,12,10,12,14,10,13,6,5,13,11,7,11,7,11,10,11,10,11,10,12,15,12,11,10,11,11,11,11,11,9,20,12,11,11,11,11,10,6,12,5,13,14,16,10,13,9,14,13,7,AM/S C,1,1,20,17,10,5,1,1,1,1,14,5,1,1,1
308334,Ewerton Maradona,1651,12/07/1982,33,0,0,0,0,172,68,1,2,2,1,3,2,2,2,1,3,1,9,9,11,10,15,9,9,11,4,10,10,9,10,11,10,11,8,14,9,11,10,10,8,11,11,10,11,13,12,14,14,6,20,10,12,10,10,6,9,7,4,10,10,15,12,11,10,12,7,11,5,M/AM C,1,1,1,20,1,1,1,1,1,1,17,1,1,1,1
308347,Júlio Baptista,1651,01/10/1981,34,42,5,10,3,185,82,2,2,3,4,2,3,3,3,4,2,3,10,12,11,16,11,16,14,15,11,9,12,16,10,14,14,13,16,13,12,13,13,13,16,10,14,9,12,10,11,10,17,14,11,10,12,20,8,16,8,12,12,20,14,14,16,13,14,12,9,9,11,M/AM C,1,1,15,20,10,9,1,1,1,13,19,7,6,1,1
308379,Ricardo Oliveira,1651,06/05/1980,36,16,5,0,0,183,83,1,2,4,4,3,2,1,1,1,1,1,8,9,13,16,13,13,14,16,5,5,12,14,7,15,8,14,14,16,14,11,13,16,14,10,16,7,12,13,14,11,15,12,12,15,14,20,11,14,13,10,15,9,10,12,18,5,13,13,12,13,7,S ,1,1,20,2,6,3,1,1,1,1,1,1,1,1,1
308404,Daniel,1651,04/06/1981,35,0,0,0,0,188,82,14,12,10,3,12,13,9,11,7,9,12,6,2,1,1,6,10,1,3,1,2,2,3,3,7,8,11,15,8,10,8,10,10,2,14,3,14,9,8,11,8,4,10,9,12,12,20,4,11,10,10,5,7,9,13,11,9,13,13,4,18,2,GK ,20,1,1,1,1,1,1,1,1,1,1,1,1,1,1
308409,Róbston,1651,23/12/1981,34,0,0,0,0,190,84,1,1,1,1,1,2,2,1,3,1,4,3,10,13,11,13,8,12,12,6,14,11,10,13,14,11,12,10,10,12,11,10,13,16,13,11,11,12,10,11,10,15,16,8,14,11,20,9,13,10,15,11,12,15,7,12,15,11,11,7,8,8,DM/M C,1,1,1,14,1,1,1,1,1,19,20,1,1,1,1
308411,Eduardo Teles,1651,30/10/1981,34,0,0,0,0,185,80,1,1,2,3,1,3,3,3,1,2,3,7,3,1,4,7,4,14,3,1,14,9,8,12,3,9,14,10,9,9,3,14,11,1,14,8,14,8,14,14,9,9,13,8,12,12,20,9,10,4,7,4,15,10,19,9,12,11,10,2,12,1,D C,1,1,1,1,1,1,20,1,1,1,1,1,1,1,1
308421,Maicon,1651,26/07/1981,34,76,7,19,2,186,82,1,1,1,1,1,1,1,1,1,1,1,12,15,15,12,16,9,12,14,16,9,14,8,14,16,15,15,16,13,11,14,13,12,14,13,18,11,13,10,13,14,16,12,10,9,14,20,8,16,14,13,15,15,7,15,10,12,15,8,13,14,16,D/WB R,1,1,1,1,1,5,1,1,20,1,1,1,14,1,19
308630,Márcio,1651,20/12/1981,34,0,0,0,0,191,82,13,11,13,7,14,11,14,13,10,15,9,7,1,4,2,7,10,2,3,2,1,7,2,1,3,17,3,16,11,16,3,2,16,18,15,1,6,13,15,13,15,14,15,5,16,6,20,15,15,8,17,17,15,10,11,15,17,15,16,8,7,15,GK ,20,1,1,1,1,1,1,1,1,1,1,1,1,1,1
308788,Michel,1651,09/06/1981,35,0,0,0,0,188,81,1,2,4,2,4,1,4,1,2,3,2,17,15,11,10,12,17,12,14,14,9,13,16,9,13,12,8,14,12,9,12,8,12,10,9,10,8,10,9,11,10,12,12,20,14,10,7,12,12,8,10,8,8,10,14,13,16,12,13,12,12,10,D/WB/DM/M LC,1,1,1,7,7,1,1,17,1,20,20,17,1,17,1
308962,João Paulo,1651,12/02/1981,35,0,0,0,0,194,80,9,10,10,3,11,10,10,11,12,15,11,4,3,3,1,6,9,1,2,1,2,1,3,1,5,4,11,9,6,12,7,13,10,1,10,3,9,7,7,10,13,8,15,15,12,9,20,4,11,10,10,10,9,10,14,11,11,11,12,2,3,1,GK ,20,1,1,1,1,1,1,1,1,1,1,1,1,1,1
308963,Gílson,1651,11/11/1979,36,0,0,0,0,192,82,11,12,12,10,10,11,11,12,10,13,11,2,1,2,1,3,7,2,2,2,2,2,4,1,7,10,12,11,11,10,12,11,6,10,13,10,11,12,11,9,12,9,13,10,12,10,20,11,12,13,13,12,8,10,9,13,10,10,10,10,1,5,GK ,20,1,1,1,1,1,1,1,1,1,1,1,1,1,1
308972,Fabrício,1651,05/07/1982,33,0,0,0,0,180,76,1,1,4,1,2,2,1,3,1,3,2,12,11,10,11,11,11,11,12,7,11,12,11,12,12,15,10,15,10,9,11,11,12,13,15,11,12,15,13,11,11,11,9,10,13,11,20,11,11,13,13,13,15,13,16,17,16,14,15,12,10,14,DM/M C,1,1,1,1,1,1,10,1,11,20,19,1,14,1,12
309119,Wesley Bigu,1651,21/11/1984,31,0,0,0,0,170,0,3,2,3,4,1,2,1,2,1,4,3,5,5,6,4,13,4,10,9,9,11,11,6,15,9,10,8,11,11,11,10,9,3,6,15,9,7,11,11,10,12,11,8,20,8,11,10,14,8,10,8,6,9,10,18,7,11,13,10,7,5,7,D/WB L,1,1,1,1,1,1,1,20,1,1,1,1,1,17,1
309596,Genalvo,1651,05/01/1982,34,0,0,0,0,174,73,1,4,3,2,2,1,2,1,3,1,3,9,9,10,8,12,10,7,12,7,11,13,12,10,12,10,7,11,12,10,10,8,13,8,10,8,12,11,11,11,11,9,8,9,12,11,20,12,10,13,13,9,9,10,8,12,11,11,13,6,13,6,DM/M C,1,1,1,1,1,1,1,1,1,20,19,10,14,1,1
309597,Leandro Diniz,1651,23/11/1979,36,0,0,0,0,171,70,1,1,3,1,2,2,2,3,1,1,4,8,6,4,6,14,8,8,10,7,10,14,6,10,14,7,11,6,11,9,14,14,2,3,13,12,10,7,10,10,9,9,6,10,16,11,20,8,6,10,8,10,9,10,9,11,10,9,14,5,2,2,M C,1,1,1,13,1,1,1,1,1,1,20,1,1,1,1
31001329,Alan Arruda,1651,12/09/1981,34,0,0,0,0,177,0,3,2,1,1,2,2,1,2,3,3,3,6,8,8,5,8,6,8,6,8,8,9,7,10,8,7,7,10,7,6,8,9,12,7,18,6,11,11,11,3,8,9,7,14,8,4,20,4,7,8,3,12,6,10,14,12,9,9,12,10,8,10,D/WB/DM RC,1,1,1,1,1,1,18,12,20,16,15,1,1,12,17
310558,Leandro Bonfim,1651,08/01/1984,32,0,0,0,0,174,72,4,3,1,1,2,3,1,2,3,2,3,11,11,11,11,11,14,5,11,7,8,12,10,7,12,10,11,9,11,15,12,12,12,12,6,12,8,13,10,14,13,12,6,15,14,14,20,13,12,11,4,12,16,14,2,10,14,13,7,7,12,16,M/AM C,1,1,1,20,8,8,1,1,1,1,18,2,2,1,1
310560,Leandro Domingues,1651,24/08/1983,32,0,0,0,0,173,70,3,2,3,2,1,1,2,2,4,1,3,13,13,12,13,14,13,6,14,4,6,14,16,5,15,11,12,11,13,9,13,14,13,16,12,13,8,9,8,12,13,10,7,9,13,12,20,11,9,12,5,11,14,6,6,11,13,15,12,12,13,8,M/AM RC,1,1,7,20,13,17,1,1,1,5,16,12,14,1,1
310624,Júlio Santos,1651,12/12/1981,34,0,0,3,0,182,78,4,1,2,1,3,2,2,2,3,3,3,4,6,8,8,10,5,13,9,4,12,8,6,10,10,15,13,12,10,12,7,11,14,7,11,8,12,12,14,11,8,13,10,5,15,10,20,13,12,13,15,13,6,8,13,11,15,11,13,13,9,10,D C,1,1,1,1,1,1,20,1,1,1,1,1,1,1,1
310625,Kaká,1651,22/04/1982,34,92,29,10,7,186,78,4,1,1,1,2,2,2,1,1,3,2,15,14,16,14,17,12,11,14,7,6,17,16,6,17,8,14,10,14,12,14,15,14,14,15,15,6,13,10,13,9,13,12,14,10,13,20,11,12,11,5,14,16,12,18,10,13,15,20,18,14,5,AM LC,1,1,12,20,15,13,1,1,1,6,10,9,8,1,1
310693,Wesley,1651,07/06/1982,34,0,0,0,0,170,71,2,1,3,4,1,1,1,1,1,2,1,7,3,5,9,11,7,7,10,1,7,11,5,6,12,8,9,6,8,8,13,13,10,10,7,11,6,8,12,14,13,6,6,9,8,11,20,9,7,4,10,10,7,10,12,10,13,12,9,13,7,8,M/AM C,1,1,1,18,1,1,1,1,1,1,20,1,1,1,1
310730,Paulinho Guará,1651,29/08/1979,36,0,0,0,0,182,78,1,1,2,1,4,1,4,3,1,3,1,9,11,9,13,11,11,13,12,7,8,11,13,7,11,9,13,11,12,12,12,11,13,9,11,12,10,14,12,9,11,12,13,5,16,10,20,13,12,14,3,15,8,6,17,10,14,15,15,15,13,4,S ,1,1,20,10,10,11,1,1,1,1,1,1,1,1,1
310765,Douglas,1651,09/03/1983,33,0,0,0,0,188,80,14,10,12,3,14,13,10,14,12,12,12,4,2,2,1,11,8,6,2,1,2,11,1,1,10,9,10,12,11,12,8,8,10,3,13,3,14,12,13,11,12,13,15,9,13,12,20,11,14,10,11,3,11,11,12,10,13,8,13,16,12,11,GK ,20,1,1,1,1,1,1,1,1,1,1,1,1,1,1
310771,Augusto Ramos,1651,03/12/1985,30,0,0,0,0,178,77,1,1,3,4,2,3,2,1,1,1,1,12,11,11,3,11,9,6,4,12,10,11,3,15,12,10,11,10,10,10,12,10,8,10,13,10,9,12,12,12,12,11,9,20,12,12,9,12,12,12,10,10,10,10,5,8,7,9,13,14,15,6,D/WB/M L,1,1,1,1,8,1,1,19,1,1,1,17,1,20,1
310774,Mateus,1651,25/06/1983,33,0,0,0,0,172,71,2,1,1,2,3,1,1,2,1,1,1,12,11,13,13,13,14,6,14,1,4,13,13,3,13,7,6,12,9,9,11,9,8,14,8,13,7,8,9,10,12,11,6,8,12,10,20,11,9,12,7,10,7,10,13,12,12,12,12,14,13,5,AM C,1,1,1,20,1,10,1,1,1,1,10,1,1,1,1
310851,Márcio,1651,24/01/1981,35,0,0,0,0,184,89,11,11,11,15,13,15,13,13,8,11,15,10,10,10,11,14,15,10,13,11,10,14,16,13,14,11,12,12,15,13,10,13,13,14,13,11,13,12,12,9,12,14,12,5,14,9,20,12,15,14,10,12,9,12,10,13,14,10,11,12,9,15,GK ,20,1,1,1,1,1,1,1,1,1,1,1,1,1,1
310855,Maciel,1651,29/11/1978,37,0,0,0,0,171,64,1,1,1,2,1,1,2,1,2,1,1,12,11,13,12,10,13,9,10,6,4,10,8,5,13,10,9,9,8,5,8,10,8,14,7,12,6,5,9,12,11,6,8,10,12,12,20,8,6,8,6,12,13,9,12,11,9,14,5,8,8,12,AM RL,1,1,12,5,18,20,1,1,1,1,3,7,10,1,1
310856,Nei,1651,02/05/1980,36,0,0,0,0,186,80,1,2,1,1,2,1,3,3,3,1,2,9,11,11,14,11,6,12,12,8,6,11,13,11,10,9,11,10,10,9,10,9,15,12,8,10,10,11,10,9,7,10,12,10,11,9,20,10,10,11,11,10,8,9,14,14,12,13,12,12,13,14,S ,1,1,20,5,5,11,1,1,1,1,1,1,1,1,1
310870,Heurelho Gomes,1651,15/02/1981,35,11,0,15,0,191,91,16,12,13,16,14,6,16,18,14,16,19,8,1,3,3,12,10,2,2,2,3,4,3,3,11,2,15,12,15,10,10,8,15,1,16,8,17,14,13,11,16,16,18,5,14,11,20,12,18,14,2,14,12,11,14,13,14,15,16,13,16,11,GK ,20,1,1,1,1,1,1,1,1,1,1,1,1,1,1
310874,Maxwell,1651,27/08/1981,34,10,0,6,0,176,73,1,1,2,2,2,3,1,2,3,3,1,9,15,12,8,15,10,8,12,14,15,14,12,16,14,14,15,11,16,16,13,15,14,13,10,12,14,15,14,12,11,14,8,20,12,13,8,11,14,16,9,14,11,12,16,14,13,15,16,15,14,5,D/WB L,1,1,1,1,12,1,1,20,8,1,1,15,1,17,8
310879,Jussiê,1651,19/09/1983,32,0,0,0,0,180,76,2,1,3,2,1,1,2,1,3,3,3,12,12,15,8,13,12,7,11,6,4,13,14,4,15,11,11,10,10,5,12,8,10,15,6,13,5,7,8,12,13,13,9,12,11,10,20,11,11,10,11,14,14,11,12,15,14,13,13,13,13,8,AM/S LC,1,1,17,20,15,13,1,1,1,1,12,15,13,1,1
310880,Walter Minhoca,1651,12/01/1982,34,0,0,0,0,173,65,2,1,1,1,2,1,2,4,3,3,3,11,13,14,11,13,12,9,12,6,5,11,11,5,12,10,11,9,12,10,13,12,11,15,8,11,8,9,10,14,12,10,8,20,13,14,5,10,9,11,7,10,7,13,13,13,10,11,12,10,10,11,AM/S C,1,1,20,16,10,1,1,1,1,1,1,1,1,1,1
310931,Andrey,1651,09/11/1983,32,0,0,0,0,194,91,12,11,10,9,12,10,13,13,9,12,12,2,3,2,2,6,4,1,1,2,2,3,5,2,8,15,11,15,12,10,2,12,9,10,10,9,11,10,10,8,12,13,16,20,15,7,1,7,13,12,19,16,8,9,5,10,12,11,13,12,10,12,GK ,20,1,1,1,1,1,1,1,1,1,1,1,1,1,1
310942,Pereira,1651,30/07/1979,36,0,0,0,0,188,73,1,3,2,2,3,1,4,2,3,3,3,2,6,7,9,7,7,14,7,7,12,8,10,12,6,15,12,16,10,11,9,10,16,3,14,10,13,14,15,12,12,13,12,20,16,12,8,13,15,13,15,12,11,3,12,12,12,13,13,12,12,11,D C,1,18,1,1,1,1,20,5,1,1,1,1,1,1,1
310946,André Beleza,1651,20/04/1985,31,0,0,0,0,169,65,1,1,3,1,1,1,3,3,3,2,1,12,10,13,8,12,13,5,8,4,5,13,9,5,14,7,10,8,6,8,13,11,15,14,7,12,10,7,7,13,15,5,5,10,9,12,20,10,7,7,10,4,12,6,6,14,7,11,8,13,12,7,AM C,1,1,5,20,5,10,1,1,1,1,10,2,5,1,1
310956,Luiz Henrique,1651,23/09/1982,33,0,0,0,0,177,74,1,2,3,3,1,1,1,3,1,2,1,4,7,6,6,8,5,12,4,7,14,8,8,12,6,15,12,15,10,9,7,10,14,8,10,8,10,10,11,13,12,13,12,7,10,12,20,11,12,14,13,11,10,11,12,13,15,10,12,11,12,9,D C,1,10,1,1,1,1,20,12,10,1,1,1,1,1,1
310961,Lauro,1651,03/09/1980,35,0,0,0,0,193,94,10,12,10,14,13,12,12,14,13,15,10,1,2,1,2,8,3,15,2,2,2,8,4,3,12,12,12,12,13,12,3,12,16,5,12,8,13,13,14,9,12,12,15,9,14,8,20,13,15,12,16,15,6,11,11,11,15,13,14,13,8,6,GK ,20,1,1,1,1,1,1,1,1,1,1,1,1,1,1
310973,Wederson,1651,22/07/1981,34,0,0,0,0,176,76,2,4,1,2,1,2,1,1,2,1,3,13,14,10,10,13,15,7,16,13,9,13,14,9,13,14,12,11,12,9,11,11,12,12,8,11,10,14,8,10,10,12,6,20,13,10,5,9,11,14,14,14,7,10,15,11,14,12,12,8,15,4,D/WB L,1,1,1,1,10,1,1,20,1,1,1,15,1,18,1
310985,Edno,1651,31/05/1983,33,0,0,0,0,181,82,3,3,3,3,3,4,1,4,1,1,2,12,11,12,12,12,11,12,13,9,3,11,11,4,13,10,11,11,11,10,11,11,12,13,10,11,6,12,12,12,11,12,10,20,13,12,7,15,12,12,9,15,8,15,6,13,14,12,13,12,12,11,AM/S RC,1,1,20,18,14,17,1,1,1,1,1,1,1,1,1
310986,Eli Marques,1651,14/03/1982,34,0,0,0,0,180,75,3,2,1,1,2,1,1,2,2,3,4,8,9,11,7,9,8,11,12,10,11,11,9,12,12,12,10,12,11,10,10,10,13,13,10,12,10,11,12,11,11,12,11,8,17,10,20,12,11,11,5,12,7,20,13,12,13,12,15,13,14,5,DM/M C,1,1,1,10,1,1,1,14,13,20,20,10,10,10,10
311044,Renan,1651,24/01/1985,31,0,0,8,0,186,86,12,13,13,8,13,12,13,13,11,11,11,1,3,1,1,10,4,6,10,1,3,11,2,2,13,7,12,13,12,11,12,10,17,10,13,3,13,13,18,11,14,13,13,10,10,11,20,13,13,9,7,10,4,11,12,14,15,15,20,15,16,7,GK ,20,1,1,1,1,1,1,1,1,1,1,1,1,1,1
311045,Marcelo Boeck,1651,28/11/1984,31,0,0,0,0,190,86,14,14,11,7,13,12,13,13,14,14,12,7,1,1,2,8,10,8,1,1,2,9,3,1,9,14,13,13,11,13,9,12,18,1,15,5,12,12,13,8,13,12,15,7,14,8,20,14,13,13,6,10,11,11,11,17,18,13,16,11,10,10,GK ,20,1,1,1,1,1,1,1,1,1,1,1,1,1,1
311047,Thiago Pereira,1651,22/01/1984,32,0,0,0,0,187,80,1,2,3,1,3,3,1,2,3,3,3,3,3,4,5,6,5,12,5,2,11,8,7,11,8,12,11,12,11,12,5,9,9,6,13,7,11,13,12,8,8,10,13,10,11,8,20,10,10,13,11,12,7,3,13,14,15,7,15,9,16,7,D C,1,1,1,1,1,1,20,1,1,1,1,1,1,1,1
311048,Felipe Soares,1651,22/07/1985,30,0,0,0,0,182,70,1,1,2,2,2,2,1,1,3,2,3,10,9,11,6,11,12,8,12,11,10,11,16,10,12,10,9,10,8,7,6,7,12,12,9,11,9,13,12,12,13,9,10,20,14,12,7,9,9,10,17,9,6,12,8,10,11,8,10,9,12,9,D/WB/M/AM L,1,1,1,1,16,1,1,19,1,1,1,19,1,20,1
311049,Marcelo Labarthe,1651,12/08/1984,31,0,0,0,0,174,64,1,3,2,3,1,1,2,1,2,3,3,9,12,9,9,12,11,8,9,7,10,13,13,10,11,8,10,12,13,12,10,11,10,13,14,9,10,13,13,10,13,7,5,8,12,11,20,9,6,12,8,13,7,11,9,16,15,13,14,14,16,8,M/AM C,1,1,1,17,6,8,1,1,1,14,20,7,12,1,1
311050,Cléber Oliveira,1651,12/05/1985,31,0,0,0,0,180,77,1,1,1,3,1,3,1,3,2,2,3,8,9,14,9,13,8,8,9,1,8,14,2,9,17,9,12,5,6,8,10,13,12,15,3,9,5,8,13,5,12,11,9,10,14,9,20,13,12,8,10,4,14,10,9,13,11,11,10,13,12,14,M/AM RC,1,1,7,20,1,17,1,1,1,1,18,1,17,1,1
311051,Nilmar,1651,14/07/1984,31,20,9,0,0,180,68,3,1,1,3,1,3,2,2,2,3,2,10,12,16,14,14,9,10,9,8,5,13,15,7,16,7,13,12,14,12,14,13,17,16,10,17,7,13,14,14,15,5,9,12,10,14,20,12,9,8,8,12,12,8,8,16,7,14,12,12,15,9,S ,1,1,20,9,10,13,1,1,1,1,1,1,1,1,1
311054,Erandir,1651,05/08/1982,33,0,0,0,0,182,74,2,1,3,3,3,2,1,2,1,1,2,4,7,9,9,10,11,10,11,8,11,12,11,10,10,11,11,13,10,11,8,10,13,10,18,11,11,12,10,9,10,10,10,11,13,9,20,9,9,13,15,12,10,14,13,10,16,12,17,11,12,11,D/DM/M C,1,14,1,1,1,1,19,12,1,20,16,11,1,10,1
311057,Albertinho,1651,06/06/1980,36,0,0,0,0,170,63,1,3,2,1,4,2,2,2,2,3,2,7,7,13,12,13,7,11,9,4,7,13,7,5,14,7,11,4,8,6,11,13,11,12,14,10,11,8,12,13,12,9,4,3,16,14,20,12,10,14,10,1,10,10,17,10,11,10,11,8,2,7,AM/S C,1,1,19,20,1,1,1,1,1,1,1,1,1,1,1
311060,Magnum,1651,24/01/1982,34,0,0,0,0,174,72,2,3,1,3,2,3,1,1,3,3,2,10,11,12,11,12,11,6,12,8,6,12,12,6,12,12,9,13,11,11,12,12,14,15,4,13,12,10,12,13,14,10,6,20,14,13,7,12,6,13,10,13,11,10,11,13,13,14,13,14,12,10,M/AM LC,1,1,5,20,19,10,1,5,1,5,17,18,6,10,1
311077,Marcinho Guerreiro,1651,23/09/1980,35,0,0,0,0,178,70,3,2,1,3,2,2,2,3,2,1,2,5,4,3,3,5,5,6,7,5,13,11,5,13,11,18,13,15,12,13,12,13,11,13,15,13,12,13,13,12,13,13,10,13,11,11,20,13,14,11,17,11,12,5,5,15,15,16,11,10,13,18,DM C,1,1,1,1,1,1,1,1,1,20,15,1,1,1,1
311081,Brandão,1651,16/06/1980,36,0,0,0,0,189,78,3,1,2,2,1,4,3,2,2,2,2,6,11,9,13,11,9,16,12,7,10,11,15,10,11,16,14,16,10,13,9,11,14,9,8,11,13,18,14,9,9,16,15,20,16,10,8,12,16,12,16,14,7,7,15,15,12,15,11,8,13,10,S ,1,1,20,1,10,1,1,1,1,1,1,1,1,1,1
311123,Tiago,1651,19/05/1981,35,0,0,0,0,188,82,3,3,3,2,1,3,2,2,1,1,2,4,4,7,5,9,8,14,5,8,12,12,9,13,9,17,11,12,9,6,8,10,10,10,10,7,12,13,10,8,8,14,14,10,11,9,20,14,15,7,15,13,8,5,19,10,7,9,10,5,3,4,D C,1,1,1,1,1,1,20,1,1,1,1,1,1,1,1
311125,Chiquinho Baiano,1651,13/03/1980,36,0,0,0,0,178,72,3,1,3,4,2,2,2,2,2,3,1,11,11,11,9,11,11,5,10,12,9,11,11,9,12,8,11,10,11,12,11,11,9,10,10,12,9,13,12,10,11,11,9,20,11,10,7,11,9,12,8,10,10,12,13,13,9,11,10,12,14,4,D/WB L,1,1,1,1,1,1,1,20,1,1,1,12,1,19,1
311142,Felipe,1651,22/02/1984,32,0,0,0,0,190,84,11,10,12,4,11,11,13,13,12,8,14,1,2,2,3,11,1,10,3,1,2,10,3,1,12,11,13,14,13,10,10,12,12,2,13,2,13,11,13,11,12,12,15,7,10,11,20,15,10,10,11,10,8,1,7,15,12,10,11,13,5,16,GK ,20,1,1,1,1,1,1,1,1,1,1,1,1,1,1
311144,Wendel,1651,25/05/1984,32,0,0,0,0,178,76,2,2,1,1,4,3,3,2,3,2,1,4,6,8,8,10,5,11,10,4,12,9,2,13,11,12,10,12,7,8,7,9,14,5,15,10,11,13,13,11,12,12,8,17,14,11,20,13,12,12,13,14,8,12,10,12,16,11,12,11,16,10,D/DM/M C,1,1,1,1,1,1,20,1,1,18,17,1,1,1,1
311147,Bruno Moraes,1651,07/07/1984,31,0,0,0,0,180,72,2,3,3,4,3,1,2,1,1,1,1,9,9,12,11,13,11,11,11,7,6,13,10,7,14,8,12,6,12,9,13,13,13,14,8,13,6,9,6,8,8,12,10,7,8,9,20,8,11,10,9,11,17,10,9,18,8,13,11,10,10,15,S ,1,1,20,10,5,5,1,1,1,1,1,1,1,1,1
311148,Diego,1651,28/02/1985,31,28,2,12,5,173,73,1,3,4,2,2,1,3,1,2,3,4,14,14,18,15,19,14,7,15,4,5,18,13,7,19,12,11,8,12,13,14,8,7,18,5,11,7,13,14,14,17,10,4,10,14,14,20,14,9,13,14,9,5,10,9,15,6,8,10,7,5,18,M/AM LC,1,1,9,20,15,14,1,1,1,1,16,15,13,1,1
311150,Thiago Leal,1651,26/07/1984,31,0,0,0,0,188,90,15,10,9,4,12,9,13,8,9,7,11,3,2,1,2,2,6,1,3,1,2,1,2,3,5,9,10,16,8,11,8,15,7,2,7,2,10,6,8,10,7,9,10,5,15,9,20,6,12,3,9,6,9,9,13,9,13,9,13,8,12,2,GK ,20,1,1,1,1,1,1,1,1,1,1,1,1,1,1
311151,Wescley,1651,15/02/1984,32,0,0,0,0,184,77,1,3,3,2,2,2,3,1,2,2,1,8,9,8,7,10,12,12,11,6,12,11,12,11,11,13,12,12,11,11,10,11,13,9,12,9,12,10,11,12,11,11,11,7,12,11,20,10,11,11,14,11,8,10,11,9,12,14,15,8,12,13,D C,1,14,1,1,1,1,20,1,1,13,7,1,1,1,1
311154,Nélio,1651,16/02/1984,32,0,0,0,0,170,60,4,4,2,4,2,1,3,2,3,1,1,13,12,14,8,11,13,5,9,2,4,13,13,3,13,6,7,7,7,7,10,7,10,15,4,11,9,7,9,13,14,6,4,10,12,13,20,10,5,12,9,6,8,5,8,17,8,10,13,12,16,8,AM RLC,1,1,1,20,18,18,1,1,1,1,15,15,15,1,1
311157,Viola,1651,21/11/1984,31,0,0,0,0,176,75,2,2,3,3,3,1,2,2,3,1,1,5,10,10,2,11,5,6,1,5,10,7,2,11,7,9,6,13,7,7,7,12,16,9,12,11,11,13,13,13,13,11,4,20,13,13,4,13,10,9,9,7,9,15,11,11,11,15,13,6,13,5,WB/M R,1,1,12,1,1,15,1,1,15,1,1,1,17,1,20
311190,Bóvio,1651,17/01/1982,34,0,0,0,0,178,76,3,3,2,4,2,2,1,3,2,4,2,5,10,8,9,10,9,11,11,6,11,12,6,10,10,12,10,12,9,10,10,9,14,11,12,9,11,11,11,10,10,10,8,10,14,10,20,10,11,13,13,12,10,14,13,15,11,12,14,9,13,6,DM/M C,1,7,1,5,1,1,12,1,11,20,18,1,8,1,9
311191,Botti,1651,23/02/1981,35,0,0,0,0,174,64,3,1,3,2,3,3,1,1,4,3,2,12,12,13,11,13,13,8,11,6,4,12,11,4,13,14,10,13,11,13,12,11,13,12,9,13,8,10,13,13,11,13,7,8,9,13,20,14,12,8,9,13,16,13,13,16,10,11,14,5,8,11,AM RC,1,1,14,20,1,17,1,1,1,1,14,1,1,1,1
311215,Gilberto Matuto,1651,14/05/1981,35,0,0,0,0,168,68,1,3,2,1,3,2,1,2,2,1,3,9,11,11,8,10,9,7,9,13,10,10,9,10,10,12,9,14,9,9,8,9,12,11,11,11,10,12,12,14,13,7,4,8,14,14,20,13,8,10,6,4,9,13,12,11,9,11,14,10,13,8,D/WB R,1,1,1,1,1,5,1,13,18,1,1,1,6,10,20
311270,Tiago Pereira,1651,01/02/1980,36,0,0,0,0,184,80,3,1,1,2,2,2,1,1,4,1,1,10,13,10,11,10,7,12,6,5,10,8,6,10,13,9,10,11,9,9,10,9,11,7,13,6,10,12,11,14,13,13,11,5,14,15,20,10,13,10,11,5,11,9,8,11,13,13,14,9,5,1,S ,1,1,20,1,1,1,1,1,1,1,1,1,1,1,1
311301,Grafite,1651,02/04/1979,37,4,1,0,0,189,88,4,2,1,2,2,2,3,3,2,3,2,6,9,13,16,7,6,11,8,4,3,7,19,7,11,18,12,20,16,12,8,15,18,14,16,15,10,6,7,13,11,16,14,15,16,13,20,10,19,15,18,16,12,9,10,7,18,11,17,11,6,15,S ,1,1,20,7,10,12,1,1,1,1,1,1,1,1,1
311447,Rodrigão,1651,01/01/1982,34,0,0,0,0,187,86,2,3,1,4,2,3,3,2,3,3,2,9,6,5,6,9,7,12,8,8,12,10,4,11,9,10,12,11,9,12,7,10,8,1,8,10,12,12,11,10,11,14,15,5,15,10,20,8,15,10,6,9,10,10,18,13,9,12,9,4,8,3,D C,1,1,1,1,1,1,20,1,1,1,1,1,1,1,1
311537,Alê Menezes,1651,10/10/1977,38,0,0,0,0,187,82,1,3,1,1,1,2,2,1,1,3,1,7,6,10,10,10,7,12,4,6,7,3,3,2,11,9,13,8,11,8,7,14,1,10,4,14,8,7,8,9,7,8,14,20,11,9,10,11,14,9,4,8,8,9,11,12,12,10,10,6,17,7,S ,1,1,20,1,1,1,1,1,1,1,1,1,1,1,1
311681,Ziquinha,1651,29/09/1979,36,0,0,0,0,167,63,1,1,1,1,3,3,2,3,1,1,3,7,5,10,11,13,6,6,8,2,5,8,3,1,8,9,10,5,10,7,5,10,4,9,5,14,8,7,8,14,14,6,7,10,10,14,20,13,6,9,4,9,9,9,19,12,9,11,10,4,8,6,S ,1,1,20,1,1,1,1,1,1,1,1,1,1,1,1
311773,Marcello Galvão,1651,23/09/1981,34,0,0,0,0,189,87,12,9,8,6,9,10,7,9,8,8,6,3,3,2,1,1,5,1,1,2,2,1,3,2,4,8,8,11,5,4,3,12,4,1,4,2,12,5,4,10,14,6,13,8,13,9,20,2,12,11,4,8,8,8,16,11,13,10,13,6,12,7,GK ,20,1,1,1,1,1,1,1,1,1,1,1,1,1,1
311776,Abedi,1651,14/04/1979,37,0,0,0,0,166,68,1,2,4,3,4,3,1,3,1,4,2,7,11,12,9,10,9,5,7,3,8,8,9,8,11,14,10,15,9,10,9,10,14,15,6,14,7,12,14,11,14,18,3,7,14,9,20,12,6,12,11,13,5,16,11,14,12,10,16,14,14,11,M/AM RC,1,1,10,17,10,20,1,1,11,15,19,5,18,1,12
311912,Rodrigo Calaça,1651,25/08/1981,34,0,0,0,0,184,72,10,11,11,4,12,12,12,12,12,15,12,5,5,7,8,11,11,7,10,5,6,9,10,10,11,11,11,10,11,10,7,10,14,5,10,5,13,11,12,10,12,11,11,5,16,11,20,12,10,12,8,11,8,7,12,13,15,9,13,13,8,6,GK ,20,1,1,1,1,1,1,1,1,1,1,1,1,1,1
311919,Nadson,1651,30/01/1982,34,2,0,0,0,171,69,1,2,2,3,3,1,4,3,2,3,2,3,11,13,13,12,10,11,11,1,2,10,15,3,13,11,12,11,12,9,11,12,11,15,5,12,6,8,8,13,14,9,5,11,11,12,20,9,8,13,7,13,10,9,17,14,6,13,4,6,12,15,S ,1,1,20,9,13,12,1,1,1,1,1,1,1,1,1
311931,Cássio,1651,25/11/1983,32,0,0,0,0,185,84,3,2,2,3,2,1,1,2,3,3,3,4,5,11,12,11,9,13,8,5,4,8,12,5,11,9,12,9,13,10,8,11,14,12,6,15,3,8,7,10,11,14,12,8,12,11,20,10,11,12,9,10,7,10,15,14,12,14,12,10,11,6,S ,1,1,20,1,1,1,1,1,1,1,1,1,1,1,1
311936,Kanu,1651,08/02/1983,33,0,0,0,0,175,65,3,2,2,2,2,3,3,1,1,1,2,10,11,12,17,10,9,9,9,7,6,9,11,6,11,7,11,10,13,9,7,9,12,13,9,13,6,8,9,14,13,9,9,10,13,14,20,10,7,11,7,11,8,10,13,11,12,13,12,13,12,5,AM/S R,1,1,20,10,10,17,1,1,1,1,1,1,1,1,1
311938,Tiago Cardoso,1651,08/05/1984,32,0,0,0,0,185,82,13,13,12,5,14,13,12,15,12,12,12,5,2,3,1,5,10,3,3,3,1,7,3,3,7,11,10,12,11,12,6,10,14,3,13,7,12,12,12,9,13,13,13,3,15,7,20,13,15,11,9,12,8,11,9,12,15,13,14,14,15,4,GK ,20,1,1,1,1,1,1,1,1,1,1,1,1,1,1
311939,Bruno Mineiro,1651,02/02/1983,33,0,0,0,0,176,68,2,1,1,2,1,3,3,2,2,3,3,2,7,10,13,11,9,13,10,5,6,10,13,7,14,12,11,13,12,11,10,11,14,12,12,12,6,10,13,13,13,9,11,12,11,12,20,12,9,13,7,14,9,12,16,15,12,12,15,14,13,5,S ,1,1,20,8,5,5,1,1,1,1,1,1,1,1,1
311976,Vinícius,1651,10/08/1982,33,0,0,0,0,190,84,3,2,1,1,2,2,2,2,1,3,3,2,10,9,16,6,16,14,16,2,10,12,15,10,10,5,9,12,9,14,6,7,10,14,6,10,13,8,10,10,8,13,14,10,17,14,20,14,16,15,7,13,5,13,15,11,11,9,11,2,7,1,S ,1,1,20,1,1,1,1,1,1,1,1,1,1,1,1
312053,Artur Moraes,1651,25/01/1981,35,0,0,0,0,192,90,11,14,12,4,14,13,12,12,11,7,13,3,3,1,3,8,8,3,3,2,6,5,7,12,8,10,11,13,6,14,4,13,14,11,12,3,15,14,12,6,10,10,15,6,14,9,20,13,14,13,8,6,6,4,16,12,10,9,17,13,13,6,GK ,20,1,1,1,1,1,1,1,1,1,1,1,1,1,1
312055,Rafael Bracali,1651,05/05/1981,35,0,0,0,0,185,76,12,13,14,7,14,12,14,16,13,12,14,8,1,2,3,10,11,6,1,1,2,11,4,1,11,11,12,12,11,14,9,13,14,3,14,3,14,13,13,11,13,11,13,9,12,11,20,11,12,16,12,15,2,12,14,11,15,14,16,14,16,8,GK ,20,1,1,1,1,1,1,1,1,1,1,1,1,1,1
312059,Nenê,1651,19/07/1981,34,0,0,4,1,181,70,3,1,2,1,1,3,4,4,4,3,1,15,15,15,15,15,16,11,16,6,5,15,18,4,17,10,10,11,15,11,15,13,15,16,10,16,7,13,13,12,12,12,10,20,16,12,7,14,12,17,9,14,7,14,15,16,10,14,13,8,8,14,M/AM/S RLC,1,1,16,20,18,15,1,1,1,1,15,17,15,1,1
312086,Rodrigo Hote,1651,05/01/1983,33,0,0,0,0,179,79,2,1,2,3,2,3,4,2,1,3,3,7,7,6,14,14,7,9,9,1,7,8,9,6,14,9,9,4,11,8,11,13,5,13,10,10,8,5,9,12,9,3,4,9,9,9,20,14,9,9,9,9,4,9,7,12,10,9,12,9,8,6,AM/S C,1,1,18,20,1,1,1,1,1,1,15,1,1,1,1
312093,Corrêa,1651,29/12/1980,35,0,0,0,0,176,73,2,2,3,1,3,1,2,1,1,3,1,11,11,10,10,13,12,9,11,12,10,13,14,11,13,14,11,12,11,10,12,11,13,13,12,11,12,13,10,10,11,12,6,12,14,10,20,9,7,10,12,13,9,15,20,14,16,13,13,14,16,8,DM/M RC,1,1,1,10,1,1,4,1,12,18,20,1,15,1,15
312137,Cesinha,1651,12/03/1980,36,0,0,0,0,184,74,1,2,4,3,2,3,2,2,3,3,4,12,13,12,12,13,12,10,10,5,5,12,11,5,13,8,11,10,12,10,8,11,11,12,8,12,10,11,12,8,8,8,10,20,12,8,2,8,6,12,6,11,5,8,12,14,12,11,12,13,14,6,AM RLC,1,1,10,20,18,15,1,1,1,1,1,10,10,1,1
312147,Douglas,1651,18/02/1982,34,1,0,0,0,175,75,2,2,2,2,3,1,1,1,2,3,2,15,14,15,12,16,15,12,13,6,6,17,14,6,16,8,12,11,13,12,17,15,9,15,14,13,11,13,13,12,12,13,9,20,12,11,9,12,11,13,12,14,5,13,14,15,13,15,13,10,15,9,M/AM C,1,1,1,20,12,1,1,1,1,1,18,11,1,1,1
312248,Marcelo,1651,02/03/1984,32,0,0,0,0,183,78,7,12,10,13,12,12,13,13,13,14,12,6,3,1,1,4,10,2,2,2,3,1,2,3,9,10,10,12,8,12,6,12,15,1,9,1,11,9,11,7,13,10,11,3,13,10,20,10,11,11,10,11,8,10,14,12,15,17,15,14,18,6,GK ,20,1,1,1,1,1,1,1,1,1,1,1,1,1,1
312250,Thiago Junio,1651,03/04/1984,32,0,0,0,0,185,81,2,2,3,2,2,1,1,2,3,3,3,2,3,5,8,5,7,16,8,8,12,10,7,12,5,15,10,10,8,12,5,10,9,1,10,5,12,10,12,14,8,15,14,9,14,13,20,12,15,12,4,4,10,10,15,13,8,12,14,13,9,1,D C,1,1,1,1,1,1,20,1,1,1,1,1,1,1,1
312251,Rodolfo Soares,1651,20/05/1985,31,0,0,0,0,187,83,1,2,1,2,2,2,3,3,3,3,1,5,7,6,7,11,6,9,8,5,14,14,6,13,11,7,9,8,12,7,11,9,5,8,5,7,12,13,10,9,9,15,15,10,11,10,20,12,15,9,9,5,6,10,4,6,10,4,9,8,14,4,D C,1,1,1,1,1,1,20,1,1,15,10,1,1,1,1
312252,Marcelo Mattos,1651,10/02/1984,32,0,0,3,0,179,74,1,2,3,2,3,3,1,2,3,1,1,3,7,7,6,12,13,14,10,9,14,13,14,13,10,15,15,17,15,13,11,14,16,13,15,12,14,13,12,12,12,14,12,8,14,12,20,13,14,13,14,15,13,13,12,14,14,13,13,12,9,5,DM/M C,1,1,1,1,1,1,12,1,1,20,17,1,1,1,1
312253,Caetano Calil,1651,20/05/1984,32,0,0,0,0,182,78,3,3,1,1,2,1,2,3,2,2,3,10,8,14,13,13,13,9,14,6,3,14,14,5,14,10,10,12,12,12,12,10,15,14,15,9,7,12,11,11,10,12,10,10,16,11,20,12,12,15,10,16,5,15,14,14,15,11,14,7,15,11,AM/S C,1,1,18,20,10,12,1,1,1,1,1,1,1,1,1
312337,Daniel Carvalho,1651,18/03/1983,33,4,2,15,3,178,86,2,1,2,2,3,3,3,2,2,2,3,15,15,15,13,15,15,5,12,3,5,15,15,8,17,10,15,10,15,13,15,13,10,15,12,14,6,12,9,12,13,11,11,20,10,10,10,8,13,11,9,13,13,12,16,12,12,8,10,9,12,12,AM C,1,1,1,20,14,10,1,1,1,1,12,5,1,1,1
312338,Leandrão,1651,18/07/1983,32,0,0,0,0,189,87,2,3,1,3,2,1,2,2,2,2,2,5,10,10,13,10,13,13,13,7,8,11,14,7,13,12,13,12,13,13,12,13,12,10,11,14,5,12,13,11,13,15,15,7,14,11,20,12,16,13,9,11,6,9,10,17,13,15,9,7,8,14,S ,1,1,20,1,1,1,1,1,1,1,1,1,1,1,1
312421,Dagoberto,1651,22/03/1983,33,0,0,0,0,175,75,3,1,2,3,1,1,3,3,1,2,3,14,13,14,13,14,12,10,14,4,6,14,17,8,15,13,14,12,12,10,13,12,12,16,11,15,5,10,10,13,14,9,8,12,12,13,20,11,7,12,9,15,11,12,6,18,12,15,12,8,16,14,AM/S L,1,1,20,14,16,13,1,1,1,1,1,1,1,1,1
312449,Diego Clementino,1651,18/03/1984,32,0,0,0,0,175,67,1,1,3,3,2,1,4,1,1,2,1,4,11,11,10,11,4,6,2,4,3,10,10,8,11,10,10,12,10,9,11,10,15,13,5,12,4,10,11,14,13,6,5,13,12,12,20,12,6,12,12,12,14,12,5,13,13,10,13,14,12,5,AM/S RL,1,1,20,10,18,15,1,1,1,1,1,1,1,1,1
312451,Augusto Recife,1651,03/08/1983,32,0,0,0,0,169,61,1,3,3,2,3,3,2,3,4,3,1,10,10,11,7,11,7,6,11,11,13,11,11,12,11,15,11,14,10,10,10,10,11,12,15,10,11,14,14,12,12,10,5,8,12,11,20,12,9,13,13,14,14,14,13,11,16,12,11,13,11,8,DM/M C,1,1,1,1,1,1,10,8,11,20,18,3,7,4,12
312479,Túlio Souza,1651,25/03/1983,33,0,0,0,0,176,67,1,2,3,1,1,1,1,3,1,4,3,6,11,12,10,10,9,8,12,5,13,11,7,10,12,9,10,12,11,11,10,10,15,13,4,14,7,11,13,11,11,11,9,5,14,11,20,12,10,13,7,12,10,13,8,12,11,12,14,9,11,9,D/WB/DM/M/AM RC,1,1,7,12,1,18,1,1,17,20,17,1,17,1,16
312481,Rogélio,1651,04/02/1982,34,0,0,0,0,183,72,3,2,1,3,2,3,1,1,2,2,2,8,6,2,7,11,10,12,7,4,11,11,6,11,9,13,10,11,9,12,5,11,11,1,5,10,11,12,13,11,11,11,12,10,14,13,20,12,11,11,13,2,7,10,9,10,5,18,13,6,18,7,D C,1,1,1,1,1,1,20,1,1,1,1,1,1,1,1
312555,Magrão,1651,09/04/1977,39,0,0,0,0,187,79,12,16,15,3,13,14,13,11,11,10,13,3,3,3,1,8,6,10,5,2,7,9,7,3,9,11,12,13,12,15,5,13,14,5,17,7,12,9,12,10,11,8,14,3,13,8,20,11,12,11,8,15,15,11,13,13,18,16,12,13,13,11,GK ,20,1,1,1,1,1,1,1,1,1,1,1,1,1,1
315064,Toró,1651,13/04/1986,30,0,0,0,0,178,78,3,3,1,2,4,1,1,2,3,3,1,12,7,11,10,10,12,7,12,7,12,10,13,12,12,15,11,15,11,11,10,11,13,13,11,9,12,12,11,12,11,11,4,11,12,12,20,12,11,13,14,11,13,13,11,16,8,10,11,12,11,12,DM/M RC,1,1,14,14,1,15,13,1,1,20,18,1,15,1,1
315069,Rodolfo,1651,23/10/1982,33,0,0,0,0,185,86,2,3,1,3,2,3,1,3,2,1,3,9,7,12,8,11,13,12,12,10,13,13,12,13,12,14,14,14,12,12,10,13,13,11,12,12,13,12,14,10,9,13,12,20,14,10,11,13,13,13,11,14,12,10,18,13,13,14,14,14,13,10,D C,1,1,1,1,1,1,20,1,1,12,1,1,1,1,1
315070,Zé Carlos,1651,22/02/1982,34,0,0,0,0,181,84,2,1,3,2,2,1,1,2,2,2,4,6,9,7,7,7,3,15,10,2,9,10,4,7,4,16,9,12,6,7,7,9,14,8,14,6,10,9,9,14,11,15,9,8,16,14,20,14,15,10,17,12,9,9,17,11,10,13,8,8,10,4,D C,1,1,1,1,1,1,20,1,1,1,1,1,1,1,1
315078,Andrezinho,1651,11/08/1982,33,0,0,0,0,170,68,1,1,2,2,3,3,2,1,2,3,3,9,13,13,8,13,7,2,8,5,6,9,6,7,12,10,10,9,10,8,7,9,13,12,8,9,7,8,12,12,9,5,5,10,9,11,20,14,11,10,10,8,13,10,7,12,9,11,8,4,12,7,M/AM RLC,1,1,1,10,19,20,1,1,1,1,17,19,19,1,1
315079,Anderson Luís,1651,10/03/1987,29,0,0,3,0,184,89,4,3,1,1,1,2,3,2,2,1,3,4,4,10,5,12,7,13,7,8,12,11,5,14,13,10,12,13,10,10,11,11,13,5,5,7,12,12,12,9,9,13,11,10,14,10,20,13,12,12,11,10,7,12,18,14,15,11,14,9,12,12,D C,1,1,1,1,1,1,20,1,1,15,10,1,1,1,1
315080,Eduardo,1651,23/04/1983,33,0,0,0,0,183,79,3,1,2,3,2,3,3,3,2,2,2,15,11,11,7,11,8,7,12,18,14,12,12,13,13,11,12,10,13,13,12,14,14,14,12,7,14,14,14,8,11,10,9,20,12,9,5,11,9,10,12,7,7,8,13,11,7,7,7,6,4,5,M LC,1,1,1,14,12,8,1,1,1,15,20,17,10,1,1
315083,Fábio Bala,1651,30/09/1981,34,0,0,0,0,172,73,2,1,2,3,2,1,1,4,3,3,3,5,13,13,10,12,7,8,12,8,8,14,14,10,13,12,11,11,10,11,11,12,14,13,8,10,9,11,12,16,12,8,7,8,13,15,20,12,7,11,10,11,18,11,6,11,13,11,14,11,10,12,S ,1,1,20,11,1,1,1,1,1,1,1,1,1,1,1
315094,Diego,1651,02/02/1982,34,0,0,0,0,186,86,10,11,11,4,12,11,15,14,14,9,12,1,2,3,2,7,1,2,1,2,3,10,2,3,10,12,9,13,10,8,5,10,14,2,13,5,12,11,11,11,12,12,12,4,15,10,20,12,14,13,5,15,8,10,12,11,15,13,15,12,15,5,GK ,20,1,1,1,1,1,1,1,1,1,1,1,1,1,1
315096,Wilson,1651,31/01/1984,32,0,0,0,0,186,79,14,14,14,11,14,12,14,15,12,14,13,1,2,2,2,11,11,7,3,2,3,11,13,1,11,12,12,12,13,9,5,12,13,8,17,2,13,14,15,10,13,13,14,5,15,10,20,13,13,12,8,14,5,11,13,7,14,13,15,15,14,6,GK ,20,1,1,1,1,1,1,1,1,1,1,1,1,1,1
315100,Henrique,1651,02/05/1983,33,0,0,0,0,188,78,2,2,3,1,3,2,1,3,2,3,1,4,7,7,8,9,10,15,13,8,14,8,10,13,9,14,15,16,12,11,6,12,15,6,14,6,14,14,13,9,10,10,14,5,11,9,20,11,16,13,14,16,15,6,10,14,16,13,14,11,11,7,D C,1,10,1,1,1,1,20,1,1,1,1,1,1,1,1
315109,Felipe Melo,1651,26/08/1983,32,22,2,0,0,183,80,2,4,2,3,3,1,1,3,2,3,1,5,8,11,10,14,8,15,11,8,15,14,12,16,14,18,14,18,11,9,13,11,18,13,13,12,15,16,16,12,12,17,13,7,14,13,20,14,16,13,18,18,5,12,13,16,8,12,16,2,5,20,DM/M C,1,8,1,1,1,1,12,1,1,20,20,1,1,1,1
315110,Alanzinho,1651,22/02/1983,33,0,0,0,0,166,62,3,1,2,2,3,3,1,1,1,2,1,13,13,16,10,16,10,6,11,4,5,12,13,7,16,7,11,7,10,9,12,12,10,17,5,10,7,8,11,14,17,7,4,20,10,12,8,9,5,7,5,12,7,13,14,9,11,9,12,14,16,5,AM LC,1,1,10,20,16,12,1,1,1,1,14,14,10,1,1
315111,Ibson,1651,07/11/1983,32,0,0,0,0,173,76,1,3,1,2,2,3,3,3,3,2,1,11,11,13,10,13,10,11,11,3,12,14,14,11,12,11,12,14,13,11,13,13,13,10,11,12,12,13,14,10,13,12,7,7,14,11,20,14,11,9,12,14,7,15,11,12,13,14,14,12,12,7,DM/M C,1,1,1,12,1,10,1,1,1,20,20,1,13,1,5
315116,Jean,1651,03/03/1982,34,0,0,0,0,175,68,1,3,3,1,1,1,3,3,3,2,1,7,10,12,11,12,9,11,11,4,5,11,13,5,12,6,11,13,11,11,11,11,15,13,11,12,5,12,13,12,13,13,7,9,15,12,20,12,8,12,5,15,14,9,5,12,9,15,11,11,16,11,S ,1,1,20,1,1,1,1,1,1,1,1,1,1,1,1
315118,Victor Simões,1651,23/03/1981,35,0,0,0,0,176,79,3,3,4,3,2,3,2,2,4,1,3,10,10,14,14,11,12,16,13,9,5,13,14,7,15,12,15,15,7,9,10,9,12,18,16,14,5,15,15,16,14,12,7,20,14,15,8,9,12,9,11,16,10,10,8,11,12,13,6,12,9,13,S ,1,1,20,1,1,1,1,1,1,1,1,1,1,1,1
315130,Thiago Xavier,1651,27/12/1983,32,0,0,0,0,180,76,1,2,1,1,3,2,3,2,3,3,1,6,8,8,8,11,7,14,8,8,12,11,7,12,11,14,14,14,13,13,10,13,15,6,12,7,14,15,13,10,11,14,11,10,14,11,20,13,12,14,14,13,12,8,13,11,14,14,14,12,12,7,DM/M C,1,1,1,1,1,1,10,1,1,20,17,1,1,1,1
315145,Rafael Marques,1651,21/09/1983,32,0,0,0,0,182,75,1,1,2,3,3,2,2,1,3,2,2,5,11,10,10,9,8,15,9,9,15,10,11,14,8,12,14,15,13,14,10,13,17,11,12,11,13,14,15,12,11,13,11,20,14,13,6,14,13,12,11,12,10,7,10,12,13,14,15,14,16,9,D C,1,1,1,1,1,1,20,1,1,1,1,1,1,1,1
315153,Claudemir,1651,17/08/1984,31,0,0,0,0,173,69,2,3,2,1,2,1,1,3,3,1,2,13,9,9,7,12,14,10,11,12,11,12,14,12,13,12,12,12,15,13,12,12,14,7,11,9,12,12,11,11,12,9,12,12,15,11,20,13,12,11,11,11,6,10,14,13,12,15,15,13,13,9,D/DM/M RC,1,1,1,10,1,1,13,1,20,19,17,1,1,1,15
315156,João Diego,1651,09/04/1987,29,0,0,0,0,175,64,3,1,2,1,1,2,3,2,1,3,3,11,8,13,10,11,11,4,11,2,2,14,12,2,13,3,8,8,9,9,12,9,10,13,4,12,8,8,12,13,13,11,10,10,14,13,20,11,9,14,5,13,5,10,7,13,9,9,12,12,12,10,AM C,1,1,14,20,5,10,1,1,1,1,12,5,10,1,1
315162,Ygor,1651,01/06/1984,32,0,0,5,0,179,73,2,1,4,1,1,3,1,3,1,3,3,5,10,11,6,11,8,13,9,4,12,9,8,13,9,15,13,16,13,11,10,12,12,9,17,6,12,14,15,12,13,12,8,8,15,11,20,14,13,10,15,14,9,6,15,17,13,14,12,13,11,11,DM C,1,1,1,1,1,1,13,1,1,20,15,1,1,1,1
315167,Morais,1651,17/07/1984,31,0,0,0,0,169,64,2,1,1,1,2,2,3,1,1,2,1,13,11,14,10,13,14,6,11,10,6,14,14,6,13,11,12,11,11,11,14,12,7,14,10,13,6,11,11,13,14,8,6,13,10,12,20,11,7,11,10,13,15,12,11,15,17,14,12,9,8,13,M/AM RLC,1,1,12,20,18,17,1,1,1,1,16,15,14,1,1
315177,Geovani,1651,20/09/1982,33,0,0,0,0,178,75,2,1,1,3,4,3,2,3,1,1,2,11,10,11,9,10,13,4,12,6,6,10,11,7,11,11,10,9,10,8,11,11,8,8,8,10,11,10,10,11,11,10,10,20,11,12,8,11,11,7,10,11,8,10,18,13,13,12,11,6,10,7,M/AM C,1,1,1,20,1,1,1,1,1,12,19,1,1,1,1
315180,Marcelo Lomba,1651,18/12/1986,29,0,0,0,0,190,83,11,12,13,3,15,13,14,15,8,13,12,1,3,2,2,11,4,9,1,1,2,11,6,2,11,15,12,14,13,11,9,11,10,4,16,7,11,12,14,11,14,14,15,10,14,11,20,14,13,12,7,14,3,11,13,14,10,12,12,10,15,8,GK ,20,1,1,1,1,1,1,1,1,1,1,1,1,1,1
315187,Ilaílson,1651,09/04/1985,31,0,0,0,0,177,75,1,2,1,2,4,2,1,2,2,2,3,8,6,4,7,13,8,8,7,4,8,14,2,12,11,10,10,9,10,10,9,13,5,4,12,9,13,9,12,9,8,9,9,17,13,8,20,9,8,9,3,5,10,10,7,13,11,12,11,9,6,7,DM/M C,1,1,1,1,1,1,1,1,1,20,18,1,1,1,1
315194,Rodrigo Arroz,1651,21/03/1984,32,0,0,0,0,183,80,1,2,3,1,2,2,2,2,3,4,2,7,7,9,11,11,11,13,8,9,13,10,10,12,11,14,12,12,11,11,7,11,14,7,12,6,12,14,13,10,11,13,14,8,13,10,20,13,14,12,11,12,15,10,12,13,12,10,14,13,10,7,D C,1,1,1,1,1,1,20,1,1,10,1,1,1,1,1
315222,Laerte,1651,08/01/1981,35,0,0,0,0,191,80,2,3,1,3,2,2,3,1,3,1,1,5,3,4,5,6,2,15,8,2,12,9,4,13,7,9,12,10,9,10,5,7,13,1,5,5,11,14,12,14,9,10,16,10,10,14,20,14,13,9,9,9,7,9,11,12,13,8,11,3,9,8,D C,1,1,1,1,1,1,20,1,14,1,1,1,1,1,12
315228,Wanderson,1651,13/10/1980,35,0,0,0,0,175,60,1,3,1,2,2,3,3,2,3,2,3,8,9,12,10,12,9,8,10,7,9,13,6,9,13,10,8,10,9,9,12,9,6,4,7,12,11,10,10,11,13,7,9,9,6,12,20,10,7,12,7,10,10,10,20,12,14,12,12,10,8,7,M C,1,1,1,10,1,1,1,1,1,10,20,1,1,1,1
315239,Rondinelli,1651,17/03/1978,38,0,0,0,0,178,78,1,3,2,3,2,1,3,2,1,4,3,8,11,4,8,9,11,10,11,7,4,7,5,9,5,13,9,10,8,10,10,10,12,11,11,10,7,11,10,12,10,11,11,20,16,12,10,13,11,12,11,10,9,9,6,17,11,6,9,9,13,2,D/WB L,1,1,1,1,1,1,1,20,1,1,1,10,1,17,1
315249,Tiago Bastos,1651,22/05/1983,33,0,0,0,0,168,0,2,2,3,2,2,3,2,1,1,3,1,3,6,7,5,8,5,9,2,5,10,9,4,14,10,8,10,10,7,14,9,11,8,6,5,7,8,9,9,12,9,9,4,10,10,9,20,14,11,9,9,9,9,9,7,11,13,10,9,7,9,4,D R,1,1,1,1,1,1,1,1,20,1,1,1,1,1,15
315258,João Rodrigo,1651,18/02/1984,32,0,0,0,0,174,67,1,2,1,2,2,2,3,2,3,3,2,5,11,6,6,11,3,7,7,11,11,12,5,12,11,9,7,8,8,8,12,14,2,8,9,10,9,11,11,11,11,11,7,10,12,10,20,10,12,12,6,10,7,9,7,9,12,10,12,4,4,6,D/WB R,1,1,1,1,1,1,1,10,19,13,1,1,1,10,20
315262,Antônio Carlos,1651,22/06/1983,33,0,0,0,0,183,85,2,1,4,1,4,3,3,1,1,3,4,7,8,8,8,11,11,15,8,5,14,11,9,15,13,10,13,8,13,11,11,13,14,7,13,12,13,14,14,12,11,13,15,4,13,11,20,14,14,6,11,11,5,11,9,12,11,13,13,13,13,10,D C,1,15,1,1,1,1,20,1,1,1,1,1,1,1,1
315276,Eberson,1651,21/03/1983,33,0,0,0,0,172,67,2,1,2,2,4,1,2,4,3,1,3,8,9,11,10,11,10,9,8,6,8,11,12,6,11,11,11,10,10,11,10,10,12,12,7,11,7,12,12,13,12,14,6,14,15,12,20,12,7,12,10,10,14,11,10,14,12,9,13,13,13,8,M/AM C,1,1,10,20,1,1,1,1,1,1,18,1,1,1,1
315279,Ney Mineiro,1651,09/09/1979,36,0,0,0,0,184,80,2,3,3,1,3,2,3,1,2,2,3,2,10,12,13,11,2,11,10,2,5,9,14,4,11,10,9,13,10,10,8,8,13,8,4,14,7,12,12,12,13,11,12,10,13,13,20,12,13,13,7,15,10,10,20,10,11,12,12,7,18,2,S ,1,1,20,12,1,14,1,1,1,1,4,1,7,1,1
315288,Almir,1651,20/05/1982,34,0,0,0,0,177,79,1,1,1,1,2,1,1,3,2,3,3,10,10,12,12,12,10,11,7,6,10,12,12,11,12,11,11,13,12,11,12,11,9,13,13,12,10,11,11,12,13,12,8,13,14,11,20,12,13,11,9,11,7,13,7,14,11,7,8,11,12,12,M/AM C,1,1,14,20,1,1,1,1,1,8,18,1,1,1,1
315324,Luiz Carlos,1651,31/08/1980,35,0,0,0,0,186,86,2,3,2,4,1,2,1,1,1,3,1,2,6,8,13,11,12,14,11,2,5,9,16,6,9,13,11,13,13,10,7,11,15,13,10,12,8,12,11,12,8,14,13,10,14,10,20,11,16,13,11,12,8,5,14,15,4,14,15,15,14,10,S ,1,1,20,14,1,1,1,1,1,1,1,1,1,1,1
315335,Alan Bahia,1651,14/01/1983,33,0,0,0,0,171,72,1,2,1,3,4,2,1,4,3,3,3,7,6,11,9,10,10,9,11,9,11,11,12,11,11,12,11,12,11,11,10,11,14,12,13,11,9,10,9,10,9,11,5,9,12,9,20,9,6,12,14,14,8,12,13,13,15,16,5,12,12,9,DM/M C,1,1,1,1,1,1,1,1,1,20,17,1,10,1,1
315336,David,1651,29/05/1982,34,0,0,0,0,177,70,3,4,4,1,2,2,1,3,1,3,2,11,10,11,10,9,11,11,12,9,13,13,11,10,12,14,13,13,12,11,12,12,14,6,11,12,12,12,12,12,12,12,10,9,13,12,20,14,11,10,10,10,7,17,8,11,12,13,13,12,13,12,DM/M C,1,1,1,13,10,12,1,9,11,20,18,11,12,9,11
315344,Vágner Eugênio,1651,18/11/1983,32,0,0,0,0,186,83,3,2,3,3,4,3,2,1,2,2,2,6,6,7,8,8,8,12,8,10,10,7,10,11,9,12,10,10,11,10,6,8,3,6,11,7,10,10,10,8,9,14,16,7,13,8,20,13,15,9,13,10,9,8,13,13,10,11,10,1,19,8,D C,1,1,1,1,1,1,20,1,1,1,1,1,1,1,1
315384,Joílson,1651,07/07/1979,36,0,0,0,0,168,62,2,1,1,1,2,3,1,2,3,2,2,7,10,10,9,11,8,6,9,10,7,10,4,7,9,12,9,9,8,9,9,9,13,12,10,10,8,11,9,12,12,10,3,7,14,14,20,12,8,11,13,9,11,15,15,13,13,12,12,5,11,9,D/WB/M/AM RC,1,1,13,20,9,10,1,1,17,12,18,1,15,1,18
315429,Gedeil,1651,05/11/1983,32,0,0,0,0,184,81,2,3,4,4,3,1,2,1,3,2,3,7,7,10,9,11,7,12,7,5,12,11,8,12,11,7,13,15,11,10,10,9,13,1,13,10,13,15,13,11,12,8,13,10,14,11,20,12,14,13,10,13,9,10,16,12,14,12,11,9,1,6,DM/M C,1,1,1,1,1,1,1,1,1,20,17,1,1,1,1
315449,Peter,1651,17/05/1984,32,0,0,0,0,177,62,2,3,1,3,1,4,1,1,1,2,2,9,11,5,5,10,7,8,7,8,11,12,4,11,12,10,12,11,11,11,9,10,13,1,13,10,11,11,11,12,13,12,8,8,10,12,20,13,7,16,10,4,7,10,12,12,12,12,14,13,12,8,D/WB R,1,1,1,1,1,1,1,1,20,1,1,1,10,1,16
315456,Everton,1651,11/07/1981,34,0,0,0,0,187,82,10,11,10,4,11,12,11,11,12,18,11,1,1,2,1,4,3,1,1,2,2,1,2,3,9,9,10,16,8,8,7,11,11,1,10,2,11,8,10,11,10,10,10,5,15,11,20,12,13,15,9,9,9,9,18,13,15,10,12,13,11,8,GK ,20,1,1,1,1,1,1,1,1,1,1,1,1,1,1
315467,Diogo Orlando,1651,04/12/1983,32,0,0,0,0,179,77,2,1,3,2,1,2,2,1,1,2,3,5,9,9,8,10,8,11,8,7,12,11,7,12,10,13,12,13,12,12,11,12,12,13,11,10,12,12,14,12,11,13,8,11,15,12,20,12,12,12,14,12,10,14,16,11,10,11,13,10,10,1,DM/M C,1,1,1,1,1,1,13,1,14,20,17,1,12,1,9
315469,Robinho,1651,18/09/1980,35,0,0,0,0,176,0,2,3,3,2,4,1,2,1,3,3,2,7,7,5,13,13,7,9,9,2,8,12,6,7,13,10,10,9,7,7,7,13,11,13,13,13,9,7,9,13,9,8,6,10,11,10,20,13,6,12,10,7,10,10,7,11,12,15,13,9,5,3,M/AM/S C,1,1,18,20,1,1,1,1,1,1,19,1,1,1,1
315471,Gláuber,1651,11/11/1983,32,0,0,0,0,174,69,1,3,1,1,2,1,3,1,1,2,1,9,10,11,9,11,10,4,9,3,4,11,15,4,11,5,6,8,7,11,11,12,10,14,5,11,9,6,8,11,13,13,5,20,12,11,10,10,4,13,6,9,13,9,13,12,13,11,10,1,9,6,M/AM LC,1,1,1,20,19,1,1,1,1,1,18,19,1,1,1
315502,Jones,1651,29/04/1984,32,0,0,0,0,180,77,3,3,2,2,3,2,3,2,1,1,2,13,10,12,11,10,14,11,8,4,7,10,13,7,11,9,10,10,11,8,8,10,11,14,6,13,6,9,11,13,13,11,11,7,14,13,20,12,11,12,5,3,10,10,12,16,13,13,13,13,13,13,S ,1,1,20,8,11,14,1,1,1,1,1,1,6,1,1
315529,Madson,1651,21/05/1986,30,0,0,0,0,158,68,2,4,3,1,2,2,2,3,3,3,2,12,11,15,12,14,11,4,13,5,7,12,13,7,15,13,11,11,10,11,13,11,11,16,5,14,6,11,12,16,16,5,2,20,14,15,8,14,6,8,8,10,13,15,16,13,13,14,6,6,8,15,AM/S RLC,1,1,17,20,18,16,1,1,1,1,15,14,10,1,1
315531,Preto,1651,09/07/1986,29,0,0,0,0,181,77,1,1,2,2,1,1,2,3,2,2,2,9,10,10,10,11,9,10,9,4,5,11,11,6,10,12,11,12,11,10,10,10,16,12,8,11,7,10,11,12,11,9,11,11,14,12,20,13,10,14,12,13,5,12,15,14,9,14,14,10,8,10,S L,1,1,20,12,15,12,1,1,1,1,7,7,5,1,1
315542,Daniel Alves,1651,06/05/1983,33,82,6,0,0,172,70,4,1,1,1,1,3,3,2,3,2,1,14,14,14,10,14,14,8,13,14,11,14,14,15,15,17,13,15,12,14,15,12,16,15,12,17,14,15,17,15,14,14,7,10,18,14,20,17,9,15,13,12,7,14,18,16,11,14,12,8,8,15,D/WB/M R,1,1,1,1,1,12,8,7,20,1,1,5,17,8,19
315560,Marcelo Nicácio,1651,05/01/1983,33,3,0,5,1,180,79,1,3,3,2,3,1,3,2,2,4,3,3,4,6,13,13,5,13,12,2,4,11,15,6,8,12,13,14,12,11,11,12,12,12,5,11,10,11,12,12,11,12,13,11,12,11,20,12,14,10,11,13,7,9,15,12,9,14,14,9,13,9,S ,1,1,20,1,1,1,1,1,1,1,1,1,1,1,1
315561,Gustavo Strzoda,1651,02/05/1982,34,0,0,0,0,183,71,4,1,1,4,3,1,3,2,1,2,1,9,6,4,5,15,9,10,9,8,10,10,5,8,11,5,10,9,11,9,11,15,4,10,13,10,14,8,13,10,8,10,12,9,15,11,20,8,11,10,10,10,10,10,20,10,12,12,10,8,10,7,DM/M C,1,1,1,1,1,1,15,1,1,20,17,1,1,1,1
315562,Luís Alberto,1651,17/11/1983,32,0,0,0,0,183,80,3,2,3,1,2,3,2,3,3,2,3,9,9,10,9,12,8,12,14,10,12,12,12,14,12,15,13,14,12,13,12,12,12,10,13,12,14,14,13,10,10,12,11,7,12,10,20,11,11,14,11,12,13,16,14,14,14,12,11,10,10,10,DM/M C,1,6,7,9,1,3,7,1,11,20,18,1,6,1,13
315565,Bruno Recife,1651,02/03/1982,34,0,0,0,0,181,73,1,3,1,2,2,3,4,2,4,1,3,12,11,12,8,12,12,8,10,13,10,14,12,11,12,7,8,9,8,9,13,9,5,10,5,11,10,12,8,13,14,10,8,20,12,12,12,10,10,11,4,11,9,10,11,17,7,12,13,12,11,9,D/WB L,1,1,1,1,1,1,1,19,1,1,1,1,1,20,1
315568,Magno Novaes,1651,30/03/1983,33,0,0,0,0,185,75,11,10,10,8,9,12,13,12,14,11,8,4,3,3,3,9,7,2,1,2,1,7,2,7,10,8,12,14,10,12,6,8,14,7,11,3,9,12,8,12,14,13,13,7,17,11,20,12,14,12,8,15,6,1,11,12,13,7,15,16,16,6,GK ,20,1,1,1,1,1,1,1,1,1,1,1,1,1,1
315587,Jean Batista,1651,21/11/1981,34,0,0,0,0,179,80,2,2,3,2,4,3,1,3,1,1,3,10,14,4,5,13,6,12,7,7,11,8,7,10,8,10,7,10,9,11,7,12,12,6,12,6,7,9,13,13,12,14,8,20,10,13,5,8,14,10,5,9,7,10,19,10,9,12,12,1,10,3,D/WB L,1,1,1,1,1,1,1,20,1,1,1,1,1,17,1
315589,Everton Hora,1651,02/10/1983,32,0,0,0,0,171,70,2,2,3,3,2,2,1,2,1,2,2,2,8,9,10,9,2,9,11,9,14,10,12,13,10,15,12,15,10,12,9,11,15,12,15,11,13,15,14,11,12,11,6,8,15,11,20,14,12,12,14,13,2,15,12,12,12,15,14,6,7,6,DM/M C,1,1,1,5,1,1,1,10,14,20,18,1,9,6,12
315633,Amauri,1651,01/02/1982,34,0,0,0,0,175,72,3,3,4,1,1,3,3,3,3,3,3,1,8,10,9,8,1,9,9,2,9,8,10,8,9,11,7,11,6,7,7,6,14,11,4,10,7,10,11,13,14,10,10,6,13,14,20,11,12,12,10,11,7,17,11,11,13,11,16,14,16,5,M/AM/S RC,1,1,20,19,1,17,1,1,1,1,18,1,8,1,1
315635,Santiago,1651,18/02/1980,36,0,0,0,0,190,82,3,2,3,1,3,2,1,2,2,3,4,5,5,6,9,8,11,13,11,9,11,9,11,12,8,16,11,15,12,11,6,12,14,9,13,9,12,14,12,7,6,5,15,20,13,8,5,11,14,13,13,11,11,11,11,9,12,10,12,12,14,8,D C,1,1,1,1,1,1,20,1,1,10,1,1,1,1,1
315810,Emerson Silva,1651,03/05/1983,33,0,0,0,0,186,83,3,1,4,1,4,2,1,3,3,1,1,5,8,7,8,11,14,15,6,5,14,11,10,13,12,13,13,14,13,13,10,13,11,12,13,12,13,13,13,13,12,7,13,20,13,12,9,15,16,12,12,13,15,8,16,13,9,12,13,12,13,11,D C,1,18,1,1,1,1,20,1,1,1,1,1,1,1,1
315811,Padovani,1651,21/12/1983,32,0,0,0,0,194,87,1,1,3,1,1,2,1,3,3,3,1,2,5,5,7,7,11,12,9,3,12,8,11,13,6,14,9,14,8,11,4,9,14,5,10,4,11,13,12,9,9,12,16,5,13,10,20,12,14,13,7,12,7,5,11,10,16,12,14,11,11,9,D C,1,7,1,1,1,1,20,1,1,1,1,1,1,1,1
315827,Perivaldo,1651,09/05/1982,34,0,0,0,0,186,82,2,1,2,2,2,3,3,1,1,3,3,6,6,1,2,8,4,13,7,1,13,8,1,12,7,9,9,4,8,8,6,13,1,7,9,6,13,6,8,9,10,8,12,20,7,10,2,9,9,9,9,5,7,9,14,14,11,10,11,1,10,8,D/DM C,1,1,1,1,1,1,20,1,1,17,10,1,1,1,1
315831,Victor Santana,1651,22/07/1982,33,0,0,0,0,177,70,3,3,3,3,1,4,3,3,1,1,1,6,5,13,11,10,6,8,5,1,3,7,6,2,10,1,10,8,10,7,7,10,12,9,13,13,6,6,7,11,12,13,13,11,14,11,20,13,13,10,6,6,6,9,12,10,12,10,12,5,13,4,S ,1,1,20,1,1,1,1,1,1,1,1,1,1,1,1
315836,João Marcos,1651,24/06/1981,35,0,0,0,0,177,73,3,2,2,2,2,4,1,1,3,3,2,12,10,11,12,12,12,9,13,5,12,13,10,13,12,15,11,15,12,11,10,12,12,8,10,12,12,14,13,12,12,10,9,20,13,11,8,12,12,12,13,13,7,11,11,13,15,11,12,8,9,12,DM/M LC,1,1,9,13,10,7,1,1,1,19,20,17,11,1,1
315862,Juninho,1651,16/09/1982,33,0,0,0,0,182,78,3,1,2,2,2,2,2,1,4,1,2,10,10,11,9,12,15,13,15,11,13,12,16,12,13,14,14,14,12,13,11,13,15,11,17,11,14,13,14,11,14,14,12,10,15,12,20,15,12,15,14,13,7,15,15,12,15,14,15,14,13,6,D C,1,16,1,1,1,1,20,1,1,13,10,1,1,1,1
315864,Nivaldo,1651,13/04/1981,35,0,0,0,0,187,80,3,2,2,2,1,1,3,3,2,3,2,5,8,7,7,11,7,15,11,13,11,9,10,11,8,17,10,15,10,10,7,8,14,12,13,7,10,12,14,9,9,12,16,20,6,10,5,13,13,12,16,12,15,7,14,14,12,12,14,7,10,8,D C,1,10,11,1,1,1,20,10,5,10,1,1,1,5,1
315865,Adriano,1651,26/10/1984,31,17,0,4,0,173,73,2,2,1,2,3,1,2,2,3,2,3,13,15,12,11,14,11,6,15,12,11,15,12,13,15,10,12,12,13,13,13,13,15,12,10,13,12,14,10,14,12,14,7,20,6,11,18,12,9,13,10,14,14,19,15,13,11,13,14,11,12,6,D/WB RL,1,1,1,1,10,8,8,20,17,1,12,14,10,19,18
315883,Marlúcio,1651,20/09/1981,34,0,0,0,0,177,75,2,3,3,2,4,2,2,3,2,3,1,4,7,5,7,11,5,6,4,5,5,7,3,2,8,7,9,5,7,6,5,12,3,8,13,7,5,6,7,13,7,7,8,12,13,11,20,8,4,8,5,6,7,8,8,11,12,11,13,10,3,3,M/AM/S RL,1,1,16,10,19,20,1,1,10,1,1,16,18,1,14
315886,Ricardinho,1651,09/09/1984,31,0,0,0,0,168,73,3,2,1,1,1,2,1,2,1,3,3,11,12,11,5,12,12,8,10,6,11,11,9,10,12,12,10,10,10,10,12,11,12,12,5,11,10,11,12,11,12,9,7,20,15,12,5,12,6,12,12,15,6,13,13,10,17,13,15,16,17,5,D/WB L,1,1,1,1,1,1,1,20,1,1,1,12,1,17,1
315941,Marcelo Régis,1651,08/10/1982,33,0,0,0,0,184,73,3,1,1,3,3,1,3,3,2,4,1,9,7,9,12,9,8,10,10,10,6,10,14,8,10,13,9,11,11,9,9,9,7,10,11,12,5,11,9,13,11,8,7,12,12,13,20,11,9,11,10,9,3,8,18,13,11,12,9,7,3,7,S ,1,1,20,1,1,1,1,1,1,1,1,1,1,1,1
315962,Vinícius Orlando,1651,15/09/1983,32,0,0,0,0,184,78,3,1,2,2,3,3,2,1,2,2,2,6,4,8,6,6,2,13,4,7,11,8,5,12,7,16,10,17,11,9,7,10,12,7,10,7,9,15,14,12,14,12,12,5,13,13,20,11,12,11,15,9,9,9,11,11,16,9,14,12,14,8,D C,1,10,1,1,1,1,20,1,1,1,1,1,1,1,1
315982,Rodolpho,1651,11/07/1981,34,0,0,0,0,180,79,11,12,11,6,13,12,13,14,10,8,14,4,5,4,4,7,8,6,4,4,4,8,8,5,8,11,10,11,9,11,7,8,13,5,12,7,13,10,10,10,14,10,11,20,12,12,5,9,11,12,9,10,7,5,10,11,13,9,15,14,15,6,GK ,20,1,1,1,1,1,1,1,1,1,1,1,1,1,1
315984,Edu,1651,30/11/1981,34,0,0,0,0,185,85,3,2,3,2,2,3,1,2,1,1,3,6,9,12,15,13,12,13,12,5,4,12,12,7,12,9,12,16,12,15,12,13,16,13,9,13,9,15,11,10,7,15,12,20,12,11,12,12,15,13,11,14,5,12,14,15,7,13,14,11,12,8,S L,1,1,20,1,15,10,4,6,1,1,1,1,1,1,1
315989,Luciano Totó,1651,28/06/1983,33,0,0,0,0,184,70,1,3,1,2,2,1,3,3,2,1,3,3,7,9,7,10,5,12,8,7,12,10,11,12,10,12,11,13,9,12,8,12,14,8,12,9,12,14,12,11,12,12,13,8,13,11,20,13,9,13,11,12,7,8,11,12,13,13,14,11,11,10,DM/M C,1,1,1,1,1,1,1,1,1,20,18,1,1,1,1
315995,Jorge Henrique,1651,23/04/1982,34,0,0,0,0,169,69,2,1,3,1,2,3,2,4,2,2,2,12,11,13,11,12,11,11,11,1,13,12,14,13,13,13,11,12,11,11,12,11,15,12,12,12,12,13,13,14,13,10,7,10,17,14,20,14,10,12,9,16,12,16,14,12,9,14,8,8,14,7,S RLC,1,1,20,15,15,15,1,12,12,1,10,10,10,12,12
315998,Henrique,1651,07/10/1982,33,0,0,0,0,181,75,3,2,1,1,2,2,3,4,1,2,3,3,4,6,7,7,9,11,9,4,11,8,3,12,6,12,11,13,10,12,5,11,13,1,12,6,12,13,11,10,10,13,10,10,14,10,20,12,11,10,9,8,9,10,9,11,12,10,10,1,8,3,D C,1,11,1,1,1,1,20,1,1,1,1,1,1,1,1
316004,Chiquinho,1651,20/06/1983,33,0,0,0,0,171,65,2,1,3,2,4,2,2,3,1,1,2,12,11,13,9,11,13,5,10,11,8,12,11,8,12,10,8,13,9,10,11,8,16,16,11,13,7,8,11,13,14,4,4,20,12,12,5,13,4,11,12,14,15,7,7,12,18,12,9,13,7,12,AM LC,1,1,1,17,20,1,1,13,1,1,13,13,1,13,1
316006,Luiz Müller,1651,09/05/1981,35,0,0,0,0,198,94,13,11,11,8,13,11,13,10,11,10,12,3,1,1,3,5,8,4,3,2,3,6,3,1,9,12,14,13,13,11,11,11,15,3,8,2,11,12,13,9,12,15,16,11,10,8,20,9,17,11,9,13,4,10,12,13,19,15,18,12,14,1,GK ,20,1,1,1,1,1,1,1,1,1,1,1,1,1,1
316007,Fabiano Heves,1651,18/01/1983,33,0,0,0,0,186,80,11,10,13,12,12,15,11,13,10,14,10,7,2,1,2,6,9,1,2,3,2,5,1,1,4,11,13,15,13,13,14,13,14,13,9,8,12,10,9,10,9,10,9,5,12,7,20,9,8,11,9,8,6,10,12,16,13,11,9,12,7,18,GK ,20,1,1,1,1,1,1,1,1,1,1,1,1,1,1
316008,Cleiton Xavier,1651,23/03/1983,33,0,0,5,0,175,71,3,1,1,1,3,1,3,1,3,3,4,13,14,14,13,15,15,11,15,10,9,15,14,10,15,9,12,10,13,10,15,13,11,16,11,13,12,14,10,12,13,13,8,10,13,12,20,12,9,11,11,14,13,16,7,12,14,11,13,9,14,7,M/AM RLC,1,1,8,20,15,16,1,1,1,8,16,13,14,1,6
316078,Jaílson,1651,16/06/1981,35,0,0,0,0,176,67,3,2,2,3,4,4,1,3,3,3,1,7,5,12,13,11,5,9,10,5,4,9,10,4,13,12,11,10,10,11,11,10,13,13,10,11,8,9,11,14,12,9,9,5,12,15,20,11,10,13,9,11,11,7,7,12,9,11,14,13,14,11,S ,1,1,20,4,6,8,1,1,1,1,1,1,1,1,1
316083,Anderson,1651,20/11/1983,32,0,0,0,0,189,83,14,13,13,4,13,12,13,14,11,14,12,2,2,2,3,2,4,2,1,3,3,3,3,2,7,8,11,13,10,12,5,11,11,2,11,1,12,13,12,9,14,14,15,1,12,11,20,15,15,10,7,10,4,10,11,10,14,9,13,16,16,4,GK ,20,1,1,1,1,1,1,1,1,1,1,1,1,1,1
316089,Paulo Renato,1651,11/03/1983,33,0,0,0,0,180,69,4,1,2,3,1,1,2,4,1,2,2,5,7,10,9,13,7,7,6,1,8,13,7,7,13,10,11,9,11,8,10,13,15,13,9,9,9,8,11,14,13,11,10,20,14,15,10,7,11,5,10,3,8,10,4,17,13,7,18,10,10,4,M/AM C,1,1,1,20,13,13,1,1,1,1,18,1,1,1,1
316090,Válber,1651,22/09/1981,34,0,0,0,0,173,70,3,1,3,3,1,2,2,2,2,3,3,11,11,12,12,12,12,9,12,5,5,13,16,5,13,15,11,13,11,12,12,12,13,13,12,12,7,10,13,13,13,13,7,20,14,14,9,13,8,12,4,12,11,6,6,13,9,12,7,11,12,8,M/AM LC,1,1,1,20,17,1,1,1,1,1,16,15,1,1,1
316098,Otacílio,1651,02/01/1984,32,0,0,0,0,171,66,2,3,2,3,1,2,1,3,1,1,3,6,13,12,9,12,6,6,8,6,9,12,2,7,13,8,6,10,7,6,5,9,12,15,10,8,10,7,9,14,14,11,6,10,13,14,20,11,6,10,7,1,13,10,12,12,15,10,10,10,8,7,M/AM RC,1,1,15,17,1,19,1,1,1,1,20,1,18,1,1
316100,Roni,1651,22/02/1984,32,0,0,0,0,180,0,3,1,3,3,3,2,1,1,3,3,2,9,8,10,12,16,9,11,10,2,2,8,5,2,11,3,9,6,11,9,10,13,8,8,11,11,9,9,10,14,12,9,9,1,13,12,20,13,12,9,8,9,9,9,20,11,11,9,10,3,15,3,S ,1,1,20,1,1,1,1,1,1,1,1,1,1,1,1
316101,Rovérsio,1651,17/01/1984,32,0,0,0,0,188,78,2,3,1,2,2,2,3,2,3,4,3,6,8,9,8,11,9,12,11,9,13,9,9,14,10,10,13,13,15,10,6,10,13,5,10,7,12,12,9,11,10,8,14,10,9,9,20,12,13,11,9,9,18,14,12,14,13,15,14,11,14,6,D C,1,1,1,1,1,1,20,10,13,7,1,1,7,1,10
316102,Vinícius,1651,16/05/1986,30,0,0,0,0,186,68,2,1,3,1,3,3,1,1,3,4,1,6,7,11,8,11,7,12,12,10,12,12,12,11,12,14,12,13,13,12,8,11,14,7,11,5,13,15,14,10,11,14,13,10,16,11,20,15,14,13,8,12,7,14,14,11,14,7,13,13,13,8,M C,1,1,1,10,1,1,1,1,1,15,20,1,1,1,1
316133,Willian Alves,1651,08/03/1982,34,0,0,0,0,193,87,15,11,12,2,11,11,11,12,10,12,11,5,3,1,2,2,7,1,3,2,2,1,2,2,4,10,9,15,4,9,7,9,8,3,11,1,8,8,7,11,13,3,17,10,15,11,20,7,9,10,9,3,10,10,15,10,11,11,11,6,4,5,GK ,20,1,1,1,1,1,1,1,1,1,1,1,1,1,1
316162,Cleiton Cearense,1651,29/11/1977,38,0,0,0,0,174,65,2,3,2,4,2,3,1,2,1,1,2,14,11,10,12,10,16,7,13,9,10,12,12,5,10,11,8,9,8,8,9,7,12,13,10,10,4,16,12,8,10,7,8,20,13,9,10,12,8,11,11,8,8,15,19,8,8,11,9,5,10,8,D/WB/M L,1,1,1,10,10,1,12,19,1,13,13,20,1,18,1
316164,Daniel Sobralense,1651,10/02/1983,33,0,0,0,0,173,67,4,4,1,1,2,3,1,4,3,1,3,10,11,15,10,14,9,9,11,2,7,15,14,7,15,8,12,7,13,11,14,9,8,16,10,13,9,8,10,12,13,12,7,11,13,11,20,11,11,8,13,15,7,14,15,8,6,10,11,12,14,11,AM RLC,1,1,13,20,18,16,1,1,1,1,12,7,7,1,1
316190,Leandro Tatu,1651,26/04/1982,34,0,0,0,0,173,74,2,2,1,3,2,3,2,3,2,1,3,13,9,12,12,12,11,11,9,7,5,11,11,4,13,9,13,10,9,10,8,8,11,13,7,13,6,10,12,13,13,7,8,14,13,13,20,12,10,11,7,10,7,13,10,12,11,10,13,10,9,7,AM/S RC,1,1,20,16,10,15,1,1,1,1,1,1,1,1,1
316191,Raul,1651,26/07/1981,34,0,0,0,0,183,79,3,2,2,2,1,2,1,3,2,1,1,10,11,10,11,9,11,12,12,10,11,12,9,11,11,12,10,13,9,10,10,11,14,11,10,9,11,13,12,11,9,12,11,7,12,10,20,11,12,11,8,11,8,14,12,10,10,10,13,9,15,8,DM/M/AM RC,1,1,10,18,1,17,7,1,8,16,20,1,19,1,10
316218,Wágner Diniz,1651,21/09/1983,32,0,0,0,0,170,68,2,3,2,1,1,1,2,1,2,3,2,10,10,12,8,11,9,5,10,10,9,11,10,10,12,14,11,14,11,10,10,10,12,13,11,12,8,10,10,12,13,14,5,8,14,12,20,12,5,12,6,12,9,14,7,12,12,13,14,5,11,8,D/WB R,1,1,1,8,1,12,1,1,18,5,7,1,14,1,20
316234,Adaílton,1651,16/04/1983,33,0,0,7,1,191,82,3,2,4,2,2,3,1,2,1,2,1,10,9,9,8,12,7,13,12,7,11,9,8,13,11,11,14,12,13,11,9,12,12,8,15,9,13,15,13,11,7,13,15,20,14,10,7,12,13,12,8,14,14,12,13,11,14,15,15,13,15,7,D/DM C,1,10,1,1,1,1,20,1,1,17,1,1,1,1,1
316235,Felipe Saad,1651,11/09/1983,32,0,0,0,0,187,83,3,1,3,3,2,2,2,2,3,2,2,4,9,7,4,11,6,15,7,13,12,10,7,13,10,15,13,16,12,12,9,12,14,8,12,7,12,13,14,11,10,15,14,20,13,10,5,11,15,13,13,15,12,10,15,14,14,13,15,12,16,7,D LC,1,1,1,1,1,1,20,17,1,1,7,1,1,12,1
316237,Renato,1651,12/05/1984,32,0,0,0,0,184,83,3,2,1,1,2,2,2,1,2,2,2,5,9,11,5,12,7,13,11,8,11,13,4,13,11,12,11,12,10,8,9,8,14,6,8,10,11,13,14,10,13,12,13,8,12,12,20,13,14,7,10,10,7,8,6,8,11,11,12,4,4,5,D C,1,18,1,1,1,1,20,1,1,1,1,1,1,1,1
316241,Thiago Santos,1651,14/05/1984,32,0,0,0,0,173,77,3,3,3,1,1,2,3,2,1,3,1,4,9,13,10,10,4,8,8,13,8,10,7,12,13,10,11,11,11,11,10,11,3,11,4,10,10,11,13,14,11,10,10,20,12,13,10,9,9,10,13,10,7,11,19,12,13,9,14,1,9,1,AM LC,1,1,10,20,20,1,1,1,1,1,15,1,1,1,1
316243,Dudu Paraíba,1651,11/03/1985,31,0,0,0,0,182,78,4,1,1,3,2,1,1,2,3,3,3,12,14,10,8,11,12,8,10,11,8,10,11,9,12,13,12,12,11,10,8,11,13,10,9,11,8,12,13,12,12,11,10,20,12,11,8,14,11,10,13,12,8,12,15,14,10,12,13,9,4,5,D/M L,1,1,1,1,10,1,1,20,1,1,1,17,1,15,1
316244,Alcides,1651,13/03/1985,31,0,0,0,0,186,78,3,3,4,3,2,4,1,1,2,2,2,6,9,8,7,10,7,13,8,11,12,8,7,12,11,14,10,11,11,9,8,10,14,12,11,12,11,11,12,10,10,10,12,12,14,10,20,11,13,12,11,14,14,11,5,15,5,13,16,5,12,6,D RC,1,1,1,1,1,1,19,9,20,1,1,1,1,1,9
316246,Alessandro Azevedo,1651,27/02/1982,34,0,0,0,0,174,70,2,2,1,3,1,3,3,3,1,3,1,8,8,9,9,10,10,8,10,2,9,10,12,9,10,5,8,8,10,8,11,8,10,11,7,11,10,9,9,11,11,12,6,20,13,10,10,11,7,13,5,9,9,12,18,10,12,9,16,5,2,4,DM/M LC,1,1,10,11,6,1,1,1,1,17,20,16,1,1,1
316254,Júnior Xuxa,1651,12/03/1984,32,0,0,0,0,178,72,1,3,3,3,3,2,3,2,3,3,1,9,10,11,12,12,13,9,13,7,9,12,12,9,12,9,11,9,12,12,12,12,15,14,12,11,11,11,12,11,11,10,8,10,14,11,20,12,11,13,8,10,7,15,10,12,16,14,14,8,12,7,DM/M/AM RC,1,1,1,20,1,16,1,1,5,18,16,1,15,1,10
316265,Gilmar,1651,09/03/1984,32,0,0,0,0,177,74,2,2,1,1,3,2,3,2,2,2,3,4,8,11,11,12,10,11,9,6,5,9,14,2,13,12,11,13,11,10,10,8,12,13,5,11,4,8,6,13,13,11,8,8,15,13,20,11,11,12,9,12,10,17,8,15,13,9,15,14,14,8,S ,1,1,20,1,10,12,1,5,7,1,1,10,10,5,7
316268,Éder Satillo,1651,17/04/1983,33,0,0,0,0,175,69,1,1,1,3,1,1,3,3,1,3,3,7,3,13,14,14,7,14,7,5,6,8,5,1,9,3,12,4,10,8,8,12,2,8,9,14,7,7,8,14,10,8,4,11,11,10,20,11,9,9,9,1,9,9,9,10,11,11,10,2,12,2,S ,1,1,20,1,1,1,1,1,1,1,1,1,1,1,1
316269,Vítor,1651,15/04/1985,31,0,0,0,0,192,82,15,14,13,2,14,14,12,13,11,8,11,5,3,2,1,6,10,1,2,2,2,4,1,1,5,10,11,15,6,13,10,13,12,1,9,1,14,11,10,5,10,11,17,10,7,7,20,5,14,10,10,10,6,10,13,12,12,8,11,7,1,5,GK ,20,1,1,1,1,1,1,1,1,1,1,1,1,1,1
316271,Bruno Lopes,1651,04/03/1985,31,0,0,0,0,182,74,2,2,2,3,3,3,3,4,1,2,1,6,4,7,4,7,4,13,7,4,12,10,1,12,9,10,10,11,11,11,5,8,11,1,14,10,13,10,11,12,14,11,14,8,11,14,20,8,12,7,10,1,9,9,15,13,12,10,10,4,15,5,D C,1,1,1,1,1,1,20,1,1,1,1,1,1,1,1
316276,Tiago Matos,1651,04/06/1985,31,0,0,0,0,177,75,1,2,2,4,2,2,3,1,1,3,4,8,7,8,5,15,9,11,6,5,15,15,7,10,11,7,11,11,11,7,11,13,10,1,10,10,10,9,11,7,10,10,11,3,14,10,20,8,15,10,6,10,6,15,11,10,10,10,10,10,18,4,D/M C,1,8,1,1,1,1,20,1,1,10,16,1,1,1,1
316277,Advaldo,1651,15/06/1986,30,0,0,0,0,169,71,3,2,2,1,1,2,3,3,3,2,2,12,9,11,13,11,15,6,9,7,9,13,13,9,12,9,7,10,9,9,10,9,10,10,5,11,12,12,11,13,14,6,6,8,13,13,20,11,9,12,10,9,11,11,10,11,12,10,12,10,11,10,M/AM C,1,1,14,18,1,11,1,1,2,14,20,1,13,1,5
316278,Juca,1651,21/07/1985,30,0,0,0,0,177,70,2,4,2,1,3,1,1,3,1,2,1,4,8,9,11,11,9,11,11,4,4,9,12,6,11,12,10,12,11,10,9,10,13,11,5,12,5,11,11,12,11,12,9,10,16,11,20,12,9,11,10,11,7,11,13,13,11,12,12,7,13,12,M/AM/S C,1,1,19,20,1,1,1,1,1,1,18,1,1,1,1
316281,Thiago Dias,1651,08/03/1985,31,0,0,0,0,174,71,3,3,3,4,3,2,2,1,1,3,1,11,8,10,14,11,13,10,13,3,5,10,10,5,12,8,10,11,14,9,11,12,10,11,6,11,10,11,13,13,11,13,10,10,14,11,20,12,9,14,6,11,9,7,15,13,12,12,10,8,9,8,M/AM RC,1,1,9,20,10,15,1,1,1,1,18,6,11,1,1
316309,Rodrigo Tosi,1651,06/01/1983,33,0,0,0,0,184,80,3,1,2,3,3,2,3,3,1,1,2,11,12,12,11,11,11,11,13,5,10,12,9,5,14,7,9,10,11,9,11,11,6,10,9,12,6,10,10,11,11,10,13,20,12,11,10,12,13,7,7,11,7,12,9,12,15,14,13,2,14,8,M/AM C,1,1,15,20,1,1,1,1,1,12,17,1,1,1,1
316322,Gustavo Lazzaretti,1651,09/03/1984,32,0,0,0,0,186,84,3,3,1,1,2,1,3,2,1,2,2,3,5,5,9,6,3,13,3,4,13,13,9,14,10,14,11,13,10,11,3,11,12,11,11,7,11,12,11,10,8,12,13,7,13,10,20,14,14,12,14,12,7,10,11,13,8,14,15,13,13,11,D C,1,1,1,1,1,1,20,1,1,1,1,1,1,1,1
316326,Anselmo,1651,10/06/1981,35,0,0,0,0,184,77,3,2,1,2,1,1,3,1,4,2,2,3,3,4,2,8,3,10,3,3,12,7,3,11,8,12,9,10,10,11,5,10,11,3,12,5,11,11,12,7,8,14,12,20,10,8,5,13,14,13,12,11,11,13,7,11,13,12,9,14,14,5,D C,1,5,1,1,1,1,20,10,1,10,5,1,1,10,1
316327,Marcelo Bonan,1651,27/05/1981,35,0,0,0,0,187,87,16,12,11,5,13,9,10,11,10,10,9,6,2,2,3,5,9,1,1,1,3,2,1,1,10,9,9,13,6,8,5,12,11,2,6,3,15,7,9,7,12,13,14,3,12,8,20,12,14,12,5,13,9,9,12,13,10,13,13,11,12,11,GK ,20,1,1,1,1,1,1,1,1,1,1,1,1,1,1
316333,Douglas Silva,1651,07/03/1984,32,0,0,0,0,186,80,3,3,2,1,2,2,3,2,2,1,4,4,4,11,9,10,5,15,9,4,14,12,7,13,15,14,7,15,12,8,14,11,15,9,13,13,12,15,14,13,10,12,13,10,12,14,20,14,13,12,14,14,3,15,19,5,13,16,16,13,14,3,D/DM C,1,20,7,1,1,1,20,1,13,19,1,1,1,1,1
316359,Anderson,1651,30/11/1978,37,0,0,0,0,186,85,3,1,1,1,2,2,1,3,1,2,3,3,3,1,1,7,1,13,6,4,13,7,1,13,4,9,7,9,7,8,6,11,9,1,10,5,13,6,4,8,9,5,12,9,14,11,20,9,14,9,3,9,9,9,8,13,14,13,12,7,1,5,D C,1,1,1,1,1,1,20,1,1,1,1,1,1,1,1
316393,Genivaldo,1651,26/02/1981,35,0,0,0,0,189,86,12,12,12,3,12,14,11,11,9,9,8,6,1,2,3,3,9,1,2,3,2,1,3,3,2,9,10,10,8,12,7,13,6,3,9,1,14,8,12,7,10,8,15,10,14,7,20,14,14,9,2,7,9,9,20,11,12,9,12,10,19,4,GK ,20,1,1,1,1,1,1,1,1,1,1,1,1,1,1
316404,Marco Túlio,1651,28/02/1981,35,0,0,0,0,173,73,1,4,1,1,3,3,2,2,3,2,3,14,9,12,7,12,14,9,12,8,10,13,10,10,12,8,9,11,10,9,14,9,12,14,9,10,10,8,12,12,13,10,6,20,13,12,12,9,6,12,6,10,10,15,5,12,4,14,10,10,10,11,DM/M C,1,1,1,14,12,10,1,7,1,20,18,14,12,5,3
316408,Davi,1651,06/06/1984,32,0,0,0,0,175,74,1,3,3,1,1,1,1,3,2,2,1,9,12,15,13,14,11,8,13,2,4,13,18,5,16,10,13,11,13,12,14,14,11,15,7,14,8,12,7,13,15,12,8,20,13,13,8,10,11,13,7,13,13,11,14,13,7,12,13,3,11,5,M/AM C,1,1,13,20,1,1,1,1,1,15,18,1,1,1,1
316415,Fabinho,1651,29/11/1983,32,0,0,0,0,173,72,1,1,3,1,1,3,3,3,2,3,3,11,12,12,8,9,8,6,13,15,11,12,9,11,11,9,9,6,6,6,10,10,10,10,6,12,11,11,9,14,12,13,8,20,11,13,7,13,11,8,12,11,6,6,10,11,13,8,10,10,15,13,D/WB L,1,1,1,1,1,1,1,18,1,1,1,11,1,20,1
316418,Weligton,1651,26/08/1979,36,0,0,0,0,186,75,2,3,1,3,3,3,2,3,1,2,1,8,8,10,6,11,7,14,5,10,16,10,6,13,11,17,15,16,14,15,8,15,15,6,16,7,16,14,14,10,10,8,13,20,9,10,5,8,16,8,16,12,13,14,16,12,18,15,15,9,10,9,D C,1,1,1,1,1,1,20,1,1,1,1,1,1,1,1
316426,Neneca,1651,11/09/1980,35,0,0,0,0,190,85,11,12,12,8,12,11,12,13,12,12,14,3,2,3,1,4,7,3,3,1,1,3,2,3,4,10,12,10,10,13,8,11,13,8,8,2,14,11,10,9,10,12,17,9,14,9,20,12,17,12,4,12,3,10,13,11,13,12,13,3,18,10,GK ,20,1,1,1,1,1,1,1,1,1,1,1,1,1,1
316448,Vicente,1651,10/09/1979,36,0,0,0,0,191,86,2,1,1,3,1,3,2,2,1,2,3,3,6,9,10,9,3,14,10,1,9,10,10,11,10,13,12,9,13,9,13,13,13,12,15,11,8,16,11,7,7,16,13,12,16,8,20,8,14,15,3,18,10,13,15,12,12,12,9,7,12,7,D C,1,1,15,1,1,1,20,1,1,10,1,1,1,1,1
316503,Kléber,1651,12/08/1983,32,0,0,0,0,173,78,1,2,3,1,3,4,1,1,1,1,2,8,10,12,14,14,7,12,12,7,8,13,13,11,14,18,13,17,12,13,11,13,19,15,14,13,9,12,14,13,13,15,9,12,14,14,20,13,15,9,16,14,11,11,14,15,3,13,9,8,5,19,S ,1,1,20,1,1,1,1,1,1,1,1,1,1,1,1
316504,Marcelo Saragosa,1651,22/01/1982,34,0,0,0,0,180,72,1,2,1,2,2,3,1,3,2,3,3,7,10,11,9,11,12,12,10,11,12,12,11,12,12,14,13,12,13,9,12,7,13,7,12,10,12,14,14,12,10,12,10,5,14,13,20,14,13,14,17,12,11,7,14,10,11,7,13,9,11,6,DM/M C,1,1,1,10,1,7,1,1,13,17,20,7,13,1,10
316515,Rico,1651,04/04/1981,35,0,0,0,0,173,79,1,2,1,3,1,3,3,1,3,4,1,3,8,14,14,14,11,9,13,1,7,11,14,6,14,17,12,15,12,13,12,13,15,15,12,13,6,8,8,12,13,14,8,8,14,12,20,11,11,11,15,15,6,7,15,10,17,12,7,7,2,20,S ,1,1,20,11,12,10,1,1,1,1,1,1,1,1,1
316521,Danielson,1651,09/01/1981,35,0,0,0,0,186,75,3,2,3,3,1,1,1,3,3,2,2,3,3,6,6,11,9,13,7,11,12,12,11,12,11,8,8,10,13,11,10,12,13,7,13,3,11,13,8,7,8,14,15,11,14,9,20,13,13,12,10,12,12,9,11,15,14,11,14,15,13,6,D C,1,1,1,1,1,1,20,7,1,1,1,1,1,1,1
316527,Borges,1651,05/10/1980,35,1,0,0,0,176,75,1,1,3,3,1,1,2,3,1,2,3,1,10,10,13,12,7,13,12,6,7,9,14,7,11,12,10,11,13,11,9,12,15,12,9,15,4,12,10,12,9,14,9,13,10,10,20,11,12,11,10,14,15,6,10,13,12,16,13,12,14,7,S ,1,1,20,1,1,1,1,1,1,1,1,1,1,1,1
316532,Marcelo,1651,19/09/1981,34,0,0,0,0,184,0,3,2,3,3,1,3,3,2,2,2,1,8,5,10,6,11,6,2,10,5,8,13,2,13,15,6,12,10,11,11,13,15,10,1,12,8,13,10,9,8,8,7,8,9,6,9,20,9,9,7,8,2,5,10,16,8,11,9,8,3,15,4,DM/M C,1,1,1,1,1,1,1,1,1,20,18,1,1,1,1
316533,Marcinho,1651,25/03/1981,35,0,0,0,0,174,70,3,3,3,3,4,3,2,1,2,2,2,12,12,13,9,14,12,7,14,7,6,14,14,7,14,8,11,9,10,12,15,13,12,14,6,12,7,10,12,12,13,8,7,10,14,11,20,11,7,11,7,13,7,12,10,16,10,10,12,11,12,8,AM C,1,1,1,20,1,12,1,1,1,10,15,1,8,1,1
316535,Paulinho,1651,03/11/1983,32,0,0,0,0,184,73,1,1,3,1,2,3,1,3,3,2,4,5,12,10,6,9,2,12,6,12,9,9,4,9,9,10,8,10,5,8,8,8,15,4,8,7,9,14,12,12,12,8,13,20,12,12,10,15,12,10,8,9,6,10,20,11,12,15,10,1,10,7,D/WB LC,1,1,1,1,6,1,18,20,1,1,1,12,1,18,1
316538,Juninho,1651,11/01/1983,33,0,0,14,2,179,71,1,1,1,2,3,4,1,1,2,2,2,9,11,11,11,12,11,9,12,6,9,13,12,9,12,9,10,7,10,10,11,11,15,13,5,12,11,11,12,11,12,11,9,10,13,11,20,11,12,12,5,14,10,16,13,12,11,11,14,13,15,5,M/AM C,1,1,1,20,5,12,1,1,1,11,19,8,13,1,1
316542,Aílton,1651,20/08/1984,31,0,0,0,0,180,76,2,2,2,1,4,3,3,2,3,1,1,10,13,16,13,14,10,10,10,4,6,12,15,6,15,12,13,12,10,12,12,10,5,14,7,14,12,16,14,13,16,14,10,10,11,13,20,16,10,8,7,12,11,12,16,16,10,6,9,11,9,13,S ,1,1,20,13,10,10,1,1,1,1,1,1,1,1,1
316548,Enrico,1651,04/05/1984,32,0,0,0,0,177,73,3,3,3,2,1,3,1,3,1,2,1,12,12,12,9,12,12,8,11,3,4,12,9,4,12,7,11,10,9,9,12,8,6,12,5,13,6,13,12,9,13,10,8,20,10,10,5,8,6,7,4,4,8,9,7,8,12,7,11,14,4,6,M/AM LC,1,1,13,20,17,10,1,1,1,1,16,16,7,10,1
316578,Ramires,1651,13/01/1982,34,0,0,0,0,186,0,2,3,2,3,3,4,1,2,2,3,2,5,7,5,11,14,9,9,13,5,11,15,9,15,14,7,10,9,9,11,13,14,4,1,4,10,15,11,12,11,10,11,15,20,14,9,1,11,10,10,10,2,10,10,20,10,11,13,14,1,19,1,DM/M C,1,1,1,1,1,1,1,1,1,20,17,1,1,1,1
316579,Beto,1651,28/05/1983,33,0,0,0,0,177,76,1,3,1,3,2,1,1,2,3,3,3,10,7,8,8,12,10,8,10,1,11,13,2,11,11,12,12,12,11,11,12,12,4,11,10,10,11,9,14,9,10,9,8,10,12,9,20,13,9,11,7,12,9,13,18,12,12,7,10,1,6,5,DM/M C,1,1,1,1,1,1,13,1,1,20,18,1,1,1,1
316583,Betão,1651,11/11/1983,32,0,0,0,0,180,75,2,1,1,1,2,2,4,3,2,3,2,4,10,9,6,11,6,12,7,9,13,12,8,14,11,14,11,16,10,10,8,10,15,8,17,8,12,15,13,12,11,12,11,12,17,13,20,12,13,11,13,13,8,15,14,13,14,11,16,13,13,8,D C,1,11,1,1,1,1,20,13,13,1,1,1,1,1,1
316588,Júlio César,1651,27/10/1984,31,0,0,0,0,186,78,11,12,13,6,14,12,15,16,12,11,12,2,3,2,2,10,7,9,1,3,2,11,2,1,12,8,13,13,12,10,11,13,13,2,13,1,13,11,12,11,13,11,12,20,15,11,7,12,11,13,11,12,6,11,14,14,20,13,15,13,14,6,GK ,20,1,1,1,1,1,1,1,1,1,1,1,1,1,1
316591,Marcelo Sarvas,1651,16/10/1981,34,0,0,0,0,178,73,3,1,3,3,2,3,2,1,1,2,1,12,9,13,9,14,12,3,9,3,10,13,11,11,13,15,11,12,11,10,13,10,13,13,8,11,11,12,15,10,12,11,9,16,12,11,20,10,11,14,9,14,9,12,14,9,9,10,13,14,7,4,DM/M C,1,1,1,8,1,1,1,1,1,19,20,12,12,1,1
316596,Rosinei,1651,03/05/1983,33,0,0,0,0,170,63,4,1,3,3,1,1,2,1,2,3,3,12,9,11,10,12,11,10,11,7,12,11,10,12,13,7,12,14,13,13,12,13,15,14,13,12,13,12,15,11,12,13,5,14,13,12,20,15,3,13,15,14,12,16,10,14,5,13,13,14,12,13,M RC,1,1,5,13,1,9,1,1,8,13,20,1,15,1,11
316598,Tiago,1651,02/07/1983,33,0,0,0,0,188,84,12,11,12,2,13,15,12,12,8,9,14,8,13,10,10,12,13,10,12,8,8,11,14,10,11,11,10,11,12,10,11,12,14,10,14,10,12,11,11,11,11,12,13,7,13,11,20,13,12,11,8,13,7,10,19,15,13,10,15,13,13,14,GK ,20,1,1,1,1,1,1,1,1,1,1,1,1,1,1
316606,Viapiana,1651,15/03/1981,35,0,0,0,0,181,76,2,1,2,3,2,1,3,2,3,2,1,11,9,11,9,13,11,11,12,10,2,11,12,6,12,8,9,9,10,9,13,8,10,15,14,10,10,11,10,9,11,9,8,15,12,10,20,12,9,13,7,12,7,8,20,12,11,11,11,8,11,4,M RLC,1,1,1,13,10,10,1,1,1,1,15,20,16,1,1
316611,Edmílson,1651,15/09/1982,33,0,0,0,0,183,77,1,2,2,2,1,2,1,2,1,3,2,7,9,12,13,11,8,13,9,5,7,12,11,8,12,12,12,12,13,13,12,12,13,15,12,14,12,13,14,12,11,8,13,13,14,12,20,12,11,13,10,10,10,8,20,14,12,13,12,12,11,6,S RL,1,1,20,1,15,15,1,1,1,1,1,1,1,1,1
316612,Deola,1651,19/04/1983,33,0,0,0,0,189,84,11,14,13,8,12,9,13,11,14,14,12,1,5,3,3,6,8,9,4,6,7,7,5,14,7,15,12,14,11,10,4,11,14,5,15,4,13,12,12,10,12,12,13,3,15,9,20,14,13,13,12,17,9,3,15,17,16,12,12,7,8,14,GK ,20,1,1,1,1,1,1,1,1,1,1,1,1,1,1
316617,Hílton,1651,27/02/1981,35,0,0,0,0,181,75,3,1,3,3,2,1,3,3,3,1,2,9,7,9,12,13,9,8,7,4,9,8,5,6,9,5,9,9,11,9,8,9,9,9,12,9,7,10,11,11,12,6,11,10,11,11,20,12,10,8,8,7,6,9,7,13,11,10,11,6,13,2,AM/S C,1,1,19,20,1,1,1,1,1,1,5,1,1,1,1
316618,Zé Love,1651,29/10/1987,28,0,0,1,0,179,83,3,2,1,2,1,3,2,2,3,1,2,5,13,13,12,13,5,12,11,3,7,11,13,7,14,12,12,14,12,10,12,13,12,15,4,14,11,11,14,13,13,13,10,11,12,14,20,13,13,11,7,12,10,12,6,18,5,16,8,11,14,10,S LC,1,1,20,15,15,13,1,1,1,1,5,5,5,1,1
316621,Léo,1651,29/08/1983,32,0,0,0,0,181,77,1,2,2,3,1,3,3,1,3,3,1,12,11,12,11,11,12,9,11,6,6,13,5,7,13,11,12,11,10,10,14,11,12,13,8,14,7,13,9,13,13,10,13,8,9,13,20,12,10,12,9,10,12,10,15,11,17,15,11,3,4,5,AM C,1,1,1,20,1,1,1,1,1,1,15,1,1,1,1
316624,Thiago Gomes,1651,17/02/1982,34,0,0,0,0,191,75,3,3,2,1,2,1,4,3,2,4,3,1,5,4,4,10,10,13,5,3,13,9,7,13,8,13,11,13,10,11,6,10,16,7,15,5,13,14,14,11,9,13,15,8,15,11,20,13,11,12,14,13,6,8,14,13,15,15,14,13,12,6,D C,1,12,1,1,1,1,20,1,1,9,4,1,1,1,1
316630,Lúcio,1651,20/06/1979,37,0,0,0,0,176,68,4,3,2,3,1,3,2,2,2,3,4,12,11,12,6,12,14,7,9,11,7,11,13,9,12,14,11,14,11,11,12,10,15,15,9,15,9,11,14,14,14,8,8,20,16,13,5,12,6,13,8,13,17,14,13,14,14,10,15,7,14,12,D/WB/M L,1,1,1,1,11,1,1,19,1,1,11,17,1,20,1
316632,César,1651,06/07/1980,35,0,0,0,0,189,80,1,1,2,2,3,1,2,1,2,2,1,3,6,7,6,8,4,14,7,8,13,9,6,13,8,10,12,13,9,10,7,11,14,10,12,8,12,14,13,9,9,13,13,9,14,10,20,10,12,14,12,13,9,7,8,16,16,15,15,8,12,8,D C,1,11,1,1,1,1,20,5,10,7,1,1,1,1,1
316637,Cairo,1651,24/12/1984,31,0,0,0,0,187,87,13,9,9,4,12,8,10,11,6,7,11,4,1,3,1,3,8,1,1,1,3,1,3,1,1,9,11,11,6,9,6,13,13,2,7,3,7,7,5,12,11,2,13,10,12,13,20,3,14,10,9,4,5,9,10,11,11,11,10,8,13,8,GK ,20,1,1,1,1,1,1,1,1,1,1,1,1,1,1
316640,Robinho,1651,25/01/1984,32,92,28,11,5,172,65,3,1,3,2,3,3,3,3,1,1,1,12,14,16,14,19,8,7,11,5,6,15,14,4,19,9,12,9,13,8,15,15,15,16,13,15,4,10,13,13,14,11,6,13,12,13,20,11,12,12,7,11,12,14,14,8,8,12,7,13,16,9,AM/S LC,1,1,20,15,18,12,1,1,1,1,1,1,1,1,1
316642,William,1651,14/05/1983,33,0,0,3,1,185,83,2,1,3,1,1,1,1,1,3,1,2,5,8,11,13,12,6,14,10,4,7,12,16,7,12,15,14,14,11,12,12,12,16,14,12,13,7,12,14,12,12,9,13,9,13,11,20,11,13,13,14,12,9,6,7,14,12,12,12,12,12,10,S ,1,1,20,1,1,1,1,1,1,1,1,1,1,1,1
316643,Leandro Luz,1651,01/03/1983,33,0,0,4,1,180,83,3,1,3,4,1,2,1,3,3,1,3,6,12,13,14,12,9,10,7,4,4,7,12,8,14,7,12,15,13,8,11,12,18,15,6,13,4,10,14,13,13,8,10,20,11,13,11,11,8,12,15,11,7,10,9,13,10,15,12,7,10,8,AM/S L,1,1,20,1,18,14,1,1,1,1,1,1,1,1,1
316660,Danilo Bueno,1651,07/12/1983,32,0,0,0,0,175,72,2,2,3,1,3,2,1,2,3,2,2,8,13,12,10,12,13,8,10,10,7,13,11,8,13,10,10,12,11,10,13,11,11,12,6,13,11,11,11,13,14,13,10,9,12,12,20,13,8,10,13,9,11,12,8,10,12,11,15,14,12,8,AM RC,1,1,1,20,1,17,1,1,1,10,15,1,14,1,1
316678,Rafinha,1651,04/08/1983,32,0,0,0,0,167,61,1,2,2,3,1,2,3,2,1,2,1,11,13,15,12,13,6,7,13,12,7,13,11,7,14,12,13,13,12,12,13,12,16,15,5,13,8,12,13,16,15,5,4,9,15,15,20,14,4,11,7,15,9,13,9,12,12,13,13,14,12,9,AM RC,1,1,13,20,14,18,1,1,1,1,12,11,13,1,14
316691,Gabriel Santos,1651,05/03/1983,33,0,0,11,0,186,88,3,2,2,4,3,1,3,2,2,2,1,6,6,10,5,11,7,14,5,7,13,10,10,12,11,11,14,12,10,13,5,10,14,4,5,8,12,15,13,12,12,8,13,6,13,13,20,14,15,12,16,12,15,11,10,12,14,13,15,12,15,5,D C,1,15,1,1,1,1,20,1,10,1,1,1,1,1,5
316692,Josimar,1651,19/04/1985,31,0,0,0,0,191,78,1,1,2,2,1,2,4,1,2,2,2,4,9,11,10,11,4,13,9,4,3,8,6,4,12,11,10,14,10,10,7,9,12,12,5,12,8,12,10,7,11,10,13,13,11,6,20,14,11,7,9,13,9,9,17,13,14,12,11,12,12,8,S ,1,1,20,1,1,1,1,1,1,1,1,1,1,1,1
316696,Rafael Santos,1651,10/11/1984,31,0,0,0,0,187,88,1,2,3,3,3,3,4,3,3,3,1,6,8,8,7,11,7,13,5,10,11,12,7,12,13,18,11,14,11,9,7,9,15,4,12,9,10,13,13,12,10,14,12,20,15,11,9,13,14,13,16,13,11,10,5,14,17,12,12,11,9,7,D C,1,11,1,1,1,1,20,1,1,1,1,1,1,1,1
316698,Rafael Ueta,1651,19/03/1983,33,0,0,0,0,176,71,1,2,3,3,2,2,3,1,2,1,3,5,5,8,7,11,12,10,7,1,8,12,4,8,8,10,6,8,7,5,8,11,15,10,10,7,7,6,11,12,11,10,10,18,12,13,20,12,10,11,10,10,11,10,8,11,10,9,5,9,10,12,M/AM C,1,1,1,20,1,1,1,1,1,14,18,1,1,1,1
316700,Roger,1651,07/01/1985,31,0,0,0,0,187,82,2,2,3,3,2,1,2,2,4,3,1,1,9,11,17,11,10,14,13,4,5,12,16,6,12,12,14,15,14,9,11,12,15,13,5,14,8,12,10,11,12,7,15,13,16,12,20,12,15,12,12,12,9,5,6,10,13,15,12,11,13,8,S ,1,1,20,5,1,1,1,1,1,1,1,1,1,1,1
316703,Vaguinho,1651,13/09/1981,34,0,0,0,0,174,63,4,1,3,2,1,3,3,1,2,3,1,11,11,12,11,12,12,9,11,10,7,11,13,7,13,11,11,9,10,11,11,11,15,14,3,12,8,8,10,11,13,14,7,7,13,11,20,7,5,12,8,11,10,18,15,12,18,12,14,7,5,18,M/AM/S R,1,1,20,12,13,18,1,5,11,1,10,9,17,8,14
316709,Felipe Lopes,1651,07/08/1987,28,0,0,0,0,189,84,1,2,2,1,1,1,3,2,1,3,1,4,6,5,6,10,5,11,5,8,14,10,6,14,9,11,15,14,11,10,7,11,16,4,12,6,14,16,10,10,9,12,15,12,13,11,20,8,15,12,12,12,16,7,11,15,11,13,13,12,13,11,D C,1,1,1,1,1,1,20,1,1,10,1,1,1,1,1
316710,Léo San,1651,22/07/1982,33,0,0,0,0,185,80,1,2,1,2,1,2,1,1,2,4,2,6,1,6,3,8,1,13,5,7,11,8,4,11,4,9,10,9,9,8,7,13,17,1,13,7,12,8,15,10,8,7,13,10,13,10,20,13,14,11,3,4,4,9,20,12,14,12,10,12,6,1,D C,1,1,1,1,1,1,20,1,1,1,1,1,1,1,1
316713,Netinho,1651,27/04/1984,32,0,0,0,0,172,65,3,1,3,1,3,1,1,3,2,2,3,13,12,12,12,13,15,8,12,11,3,12,16,2,13,10,11,11,13,10,12,12,15,13,4,13,9,10,12,11,14,10,5,20,13,12,9,14,8,8,8,14,12,17,13,12,10,14,14,8,16,8,M/AM/S LC,1,1,18,20,18,1,1,1,1,1,17,18,1,1,1
316715,Alex,1651,25/03/1982,34,4,0,0,0,175,72,1,3,1,1,2,3,3,2,3,2,1,15,14,16,13,16,16,10,16,8,5,15,16,8,16,9,13,10,11,13,15,11,15,17,10,14,7,14,13,12,11,13,7,20,12,10,10,11,9,11,10,15,11,13,15,16,14,10,17,15,13,8,M/AM LC,1,1,10,20,15,10,1,1,1,1,17,15,1,10,1
316719,Heverton,1651,28/10/1985,30,0,0,0,0,173,73,2,3,2,1,1,1,2,1,1,3,1,13,13,12,11,12,13,9,11,7,4,12,14,4,13,7,10,10,11,10,13,11,11,15,6,12,12,10,8,12,13,11,6,11,12,12,20,11,9,11,6,13,14,8,11,15,7,14,14,13,15,7,M/AM C,1,1,13,20,12,11,1,1,1,5,18,10,9,1,1
316726,Roberto,1651,18/01/1985,31,0,0,18,0,177,76,2,3,3,3,2,3,3,2,3,1,2,10,10,10,10,14,10,12,10,12,15,14,10,13,12,13,14,8,13,15,12,5,15,11,12,6,15,15,16,12,13,13,10,5,12,12,20,16,12,11,12,13,12,12,14,14,14,14,15,14,14,6,DM/M C,1,1,1,1,1,1,1,1,1,20,16,1,1,1,1
316734,Renato Silva,1651,26/07/1983,32,0,0,0,0,183,80,4,3,3,2,2,3,1,2,2,1,3,6,4,8,7,7,7,13,7,5,12,11,10,12,9,13,11,13,10,11,10,11,13,10,10,7,12,12,14,12,10,13,12,7,14,11,20,14,13,13,15,14,7,10,2,14,11,14,9,11,12,11,D C,1,1,1,1,1,1,20,1,1,1,1,1,1,1,1
316741,Camazzola,1651,30/08/1982,33,0,0,0,0,182,73,3,1,2,1,1,2,1,3,1,3,3,7,10,9,6,10,6,10,12,6,11,13,4,11,11,15,10,14,11,11,9,11,13,8,10,9,11,13,13,11,9,13,9,9,12,11,20,13,11,13,14,12,10,10,15,13,14,15,14,12,12,12,DM/M/AM C,1,1,1,19,10,10,1,1,1,20,19,10,14,1,1
316742,Dante,1651,18/10/1983,32,13,2,0,0,187,82,4,3,3,1,3,3,3,3,3,3,2,6,10,12,8,14,7,15,7,12,17,15,10,18,13,12,16,18,17,12,14,12,18,16,15,6,16,10,9,8,11,17,14,20,15,10,12,13,15,16,14,15,7,10,16,14,9,17,14,7,8,13,D C,1,1,1,1,1,1,20,12,1,1,1,1,1,10,1
316744,Paulo Matos,1651,25/01/1984,32,0,0,0,0,171,60,2,4,3,1,1,1,1,2,2,2,1,7,9,11,10,11,7,8,10,1,3,10,12,3,12,13,8,13,10,8,9,7,9,11,6,12,6,10,11,13,13,8,6,8,14,14,20,12,5,9,8,9,9,13,18,10,8,9,12,1,15,2,AM/S C,1,1,20,18,1,1,1,1,1,1,12,1,1,1,1
316747,Santos,1651,09/04/1980,36,0,0,0,0,180,76,11,13,10,3,10,9,9,14,9,9,9,2,3,1,3,1,3,2,3,3,2,1,3,1,6,1,10,14,8,12,8,15,10,2,5,1,11,9,8,8,10,6,10,9,12,8,20,3,10,9,7,9,7,9,17,11,10,9,8,11,2,7,GK ,20,1,1,1,1,1,1,1,1,1,1,1,1,1,1
316755,Alexsandro,1651,16/04/1980,36,0,0,0,0,181,78,3,2,2,3,2,3,2,3,4,1,1,8,10,9,11,8,7,9,7,3,3,10,12,3,10,11,9,11,10,10,7,7,10,9,7,8,10,10,10,13,13,8,8,10,13,14,20,10,7,11,2,11,8,10,9,12,13,9,11,5,9,4,S ,1,1,20,1,1,1,1,1,1,1,1,1,1,1,1
316757,Marcelo Pitol,1651,06/04/1982,34,0,0,0,0,192,87,13,14,10,7,11,11,13,12,12,15,12,3,3,4,4,6,9,8,7,5,6,7,9,7,7,12,11,13,12,13,6,11,12,5,12,5,13,11,13,8,11,14,14,3,16,8,20,13,14,12,10,14,7,4,11,12,14,13,20,14,18,7,GK ,20,1,1,1,1,1,1,1,1,1,1,1,1,1,1
316762,Élton,1651,15/09/1983,32,0,0,0,0,180,75,1,4,3,3,2,1,1,2,2,3,2,8,9,11,8,11,10,9,9,7,11,10,11,11,11,13,11,11,10,11,11,10,15,13,9,11,10,12,11,12,12,10,10,20,14,12,12,11,9,12,14,12,5,18,12,12,14,14,13,11,14,12,DM/M C,1,2,6,15,11,11,2,5,7,16,20,10,11,6,10
316763,Leanderson,1651,13/09/1982,33,0,0,0,0,178,68,3,1,3,3,3,3,2,2,1,3,3,4,7,6,5,7,6,5,10,7,13,11,5,13,8,13,10,13,10,12,9,11,12,10,13,10,12,13,11,12,11,12,10,10,13,12,20,13,13,11,12,11,5,7,8,11,12,10,12,11,12,7,DM/M C,1,1,1,1,1,1,1,1,1,20,18,1,1,1,1
316764,César Santín,1651,24/02/1981,35,0,0,0,0,174,72,1,3,1,2,1,1,3,3,3,1,1,9,12,12,12,13,11,8,11,6,3,12,14,3,13,5,12,7,12,10,12,12,6,13,6,11,5,11,3,11,12,9,6,12,8,10,20,10,10,8,14,6,4,14,15,6,12,14,14,17,12,5,S ,1,1,20,10,14,13,1,1,1,1,1,7,4,1,1
316767,Patric,1651,25/03/1989,27,0,0,6,0,173,68,2,2,1,3,2,2,2,1,3,1,3,11,13,12,11,12,12,6,12,10,11,12,12,10,11,14,13,13,11,13,14,13,12,14,11,16,10,14,14,15,14,9,7,9,15,15,20,15,9,9,9,11,4,13,5,16,12,13,14,11,12,15,D/WB RL,1,1,1,1,15,15,1,13,20,1,1,10,10,14,18
316769,Anderson Marques,1651,06/02/1983,33,0,0,0,0,182,77,2,2,3,3,1,1,3,2,2,2,2,5,6,8,9,10,8,11,6,8,12,9,10,12,10,11,12,12,11,11,8,10,12,11,11,8,13,11,11,12,11,11,10,9,11,12,20,14,13,12,12,11,10,8,15,11,9,10,13,9,10,9,D RC,1,1,1,1,1,1,20,1,15,1,1,1,1,1,1
316806,Édson Sitta,1651,17/06/1983,33,0,0,0,0,180,77,2,1,2,2,3,1,4,1,3,1,2,11,13,12,11,11,11,11,14,12,12,11,11,12,12,13,13,12,12,11,10,13,11,12,7,13,12,13,14,11,14,11,6,8,13,11,20,13,9,15,10,12,10,15,11,13,7,12,13,12,12,11,M RC,1,1,1,5,1,8,1,10,14,15,20,7,15,5,15
316853,Lopes,1651,11/03/1983,33,0,0,0,0,190,90,12,11,11,5,11,10,11,14,7,11,8,2,1,2,3,7,6,1,1,3,2,2,3,3,9,12,10,12,11,11,4,11,11,3,10,5,13,11,10,8,12,12,14,4,9,7,20,9,17,11,10,11,13,9,11,12,17,14,14,13,15,7,GK ,20,1,1,1,1,1,1,1,1,1,1,1,1,1,1
316856,Xuxa,1651,31/08/1981,34,0,0,0,0,174,71,3,1,1,2,1,1,3,1,2,2,1,11,12,13,12,13,12,10,11,9,5,13,13,5,13,9,11,11,12,12,12,11,11,11,8,11,12,9,12,13,13,10,9,20,12,12,10,11,8,12,6,11,10,7,6,10,13,10,12,13,13,6,M/AM C,1,1,1,20,1,1,1,1,1,1,18,1,1,1,1
316997,Wellington Paulista,1651,22/04/1983,33,0,0,0,0,183,70,4,2,1,3,2,3,2,3,2,2,3,1,12,11,14,12,10,16,13,8,5,13,16,9,13,15,15,13,13,13,12,12,15,13,10,13,10,12,14,11,11,11,14,11,16,12,20,12,13,9,13,13,6,12,6,12,13,14,9,6,9,8,S R,1,1,20,10,11,15,1,1,1,1,1,1,1,1,1
317003,Marcel,1651,10/08/1981,34,0,0,0,0,182,78,2,3,1,3,1,1,1,3,2,2,4,12,13,9,12,11,10,8,10,1,2,9,12,2,11,10,10,12,10,10,11,10,15,12,10,11,5,14,13,11,11,8,9,15,12,11,20,10,10,10,12,11,5,8,6,14,13,14,14,13,15,6,M/AM RLC,1,1,10,20,17,16,1,1,1,1,17,17,15,1,1
317011,Willian Kozlowiski,1651,19/11/1983,32,0,0,0,0,179,76,1,3,2,1,2,2,4,3,4,1,2,5,8,9,9,12,5,7,8,4,6,9,8,7,10,9,10,9,7,6,9,12,13,11,11,8,7,10,13,11,12,9,7,10,17,11,20,12,9,14,5,5,6,10,10,9,11,10,11,1,13,1,AM RC,1,1,15,20,10,17,1,1,1,1,13,6,15,1,1
317015,Amaral,1651,24/11/1983,32,0,0,0,0,175,71,1,1,3,3,2,3,1,2,1,1,3,5,9,8,8,9,14,9,14,10,12,6,9,11,8,15,12,15,12,9,9,8,11,10,14,7,10,11,14,12,12,13,7,10,15,11,20,13,13,8,16,10,11,9,11,14,11,12,13,13,12,12,DM/M C,1,1,1,1,1,1,1,1,1,20,18,1,1,1,1
317016,Asprilla,1651,04/05/1981,35,0,0,0,0,181,85,4,2,3,1,1,2,1,3,1,3,2,4,5,6,7,10,8,12,9,5,11,11,10,11,10,13,12,13,13,11,8,12,13,8,14,8,12,13,10,8,9,7,11,20,16,8,7,9,14,14,13,15,8,12,8,12,9,11,12,7,12,8,D/DM C,1,11,1,1,1,1,20,13,1,16,15,1,1,1,1
317017,Cristian,1651,25/06/1983,33,0,0,0,0,181,75,1,3,2,1,1,3,1,3,2,3,2,12,12,12,12,13,14,7,15,5,14,15,15,12,14,14,14,12,17,7,14,14,8,13,7,13,14,14,12,10,11,14,10,10,11,11,20,12,14,5,12,13,14,11,15,11,9,5,12,7,13,11,DM/M C,1,10,1,1,1,1,5,1,1,20,16,1,1,1,1
317029,Thiago Floriano,1651,12/03/1984,32,0,0,0,0,169,64,4,3,3,1,1,1,4,4,2,1,3,6,8,9,14,13,7,14,9,5,7,9,6,5,13,9,9,5,14,9,12,13,10,12,13,8,8,7,9,8,9,9,6,1,13,12,20,14,7,8,7,5,8,9,20,11,11,13,11,5,3,3,AM/S C,1,1,20,17,1,1,1,1,1,1,1,1,1,1,1
317030,Thiago Almeida,1651,04/02/1984,32,0,0,0,0,174,70,3,4,2,1,3,1,3,2,1,3,2,1,7,10,10,9,3,7,11,1,13,12,11,11,10,13,8,14,10,10,9,9,16,10,5,9,13,13,12,11,11,9,7,7,14,11,20,13,9,13,9,6,9,9,12,13,9,11,15,11,13,10,DM/M C,1,5,1,1,1,1,10,1,1,20,18,1,1,1,1
317032,Victor,1651,21/01/1983,33,6,0,0,0,193,84,12,13,14,3,15,13,14,16,13,12,15,7,2,4,3,12,10,8,2,3,2,11,6,1,12,13,15,15,13,13,13,13,14,10,15,8,15,13,13,12,14,13,16,20,14,12,6,13,13,11,11,17,5,12,13,12,19,13,18,14,14,9,GK ,20,1,1,1,1,1,1,1,1,1,1,1,1,1,1
317034,André Santos,1651,08/03/1983,33,24,0,0,0,179,74,3,1,1,1,1,3,2,2,2,1,4,12,13,14,12,15,14,7,14,12,5,14,11,7,15,9,11,9,14,10,12,12,6,16,10,14,8,12,12,10,9,13,7,20,10,11,7,7,9,12,14,15,10,16,7,14,12,14,6,15,13,12,D/WB/M/AM LC,1,1,1,19,18,1,1,19,1,1,18,18,1,20,1
317041,Luciano Sorriso,1651,08/09/1983,32,0,0,0,0,180,73,2,1,4,2,1,3,3,3,1,3,3,11,11,11,8,9,12,11,12,6,11,13,14,10,12,10,14,12,11,11,11,12,16,13,9,11,13,11,13,11,12,14,11,10,14,11,20,13,14,12,9,11,14,13,7,11,12,11,14,12,15,12,DM/M C,1,1,1,10,1,10,1,1,10,20,17,1,10,1,1
317042,Brida,1651,18/11/1984,31,0,0,0,0,170,68,2,3,3,1,3,3,2,2,2,1,2,7,12,4,7,12,3,9,8,7,10,9,4,12,10,10,12,10,8,7,9,12,10,7,6,5,12,10,10,15,14,6,6,20,11,15,7,10,6,10,5,6,10,10,6,9,11,8,11,2,9,6,D/WB L,1,1,1,1,1,1,1,20,1,1,1,1,1,19,1
317047,Rodrigo Silva,1651,15/06/1983,33,0,0,0,0,183,70,4,1,2,3,3,2,2,1,1,1,1,11,11,8,10,11,10,12,11,4,5,10,12,6,11,8,11,10,9,8,10,10,14,13,10,12,5,7,10,11,11,13,14,6,14,10,20,14,13,12,9,10,8,8,11,17,13,10,10,13,12,6,S ,1,1,20,5,5,5,1,1,1,1,1,1,1,1,1
317048,Tom,1651,18/03/1986,30,0,0,0,0,181,72,2,2,1,2,3,2,2,3,3,1,2,12,13,13,10,9,13,10,14,7,11,13,9,11,13,12,12,15,9,13,14,11,15,13,10,10,13,14,14,11,12,11,12,8,14,11,20,13,11,12,11,13,7,15,12,12,14,15,14,11,12,5,DM/M C,1,1,1,14,9,9,1,1,1,19,20,14,14,1,1
317052,Danilo Portugal,1651,10/05/1983,33,0,0,0,0,178,78,2,3,3,2,1,3,1,3,3,1,2,8,8,9,7,9,8,8,11,9,11,9,8,9,10,14,9,11,9,10,9,10,15,7,12,4,9,11,12,10,8,10,6,7,15,10,20,11,10,14,14,11,12,12,11,11,13,13,6,12,7,16,DM/M RC,1,1,1,12,1,5,1,1,8,18,20,1,19,1,11
317054,Fábio,1651,14/03/1984,32,0,0,0,0,173,61,1,1,3,1,1,1,2,2,2,3,1,4,8,11,10,11,8,9,10,3,5,11,11,5,12,11,11,12,10,9,11,11,13,12,8,12,7,10,9,13,14,9,7,11,14,14,20,12,5,13,8,10,8,11,11,7,14,10,13,14,15,10,AM/S C,1,1,20,16,1,1,1,1,1,1,12,1,1,1,1
317059,João Paulo,1651,22/02/1983,33,0,0,0,0,184,82,1,2,2,2,3,1,3,2,1,3,2,10,10,9,10,9,13,12,13,11,12,9,9,11,9,15,10,12,8,10,8,10,12,10,9,8,12,11,12,10,11,11,10,11,15,11,20,12,13,11,13,11,8,12,13,11,14,14,14,12,11,13,D C,1,1,1,1,1,1,20,10,1,10,1,1,1,1,1
317062,Pedro Henrique,1651,12/10/1985,30,0,0,0,0,190,83,11,10,12,6,13,15,11,12,8,10,14,4,1,1,1,4,6,10,3,1,2,9,2,3,8,10,13,11,11,12,5,11,12,2,10,5,12,10,9,10,12,6,15,11,11,10,20,11,14,14,10,10,7,10,13,12,15,11,13,11,14,10,GK ,20,1,1,1,1,1,1,1,1,1,1,1,1,1,1
317069,André Luiz,1651,13/02/1983,33,0,0,0,0,183,77,3,3,2,1,1,2,4,1,1,1,2,3,10,10,8,3,13,9,3,11,9,9,3,9,11,13,11,11,10,10,10,9,13,13,4,11,9,12,9,12,10,11,10,8,9,14,20,13,12,12,5,5,19,5,14,13,6,15,14,14,13,5,D/WB RL,1,1,1,1,1,1,1,15,16,1,1,1,1,12,20
317073,Élton,1651,07/02/1983,33,0,0,0,0,187,85,1,2,1,1,2,3,1,4,1,2,1,2,1,6,3,9,1,12,4,5,10,8,2,15,8,14,9,10,11,11,6,11,1,2,10,8,8,8,10,7,10,6,14,20,10,9,10,8,14,9,15,1,9,9,9,9,9,9,7,5,16,1,D C,1,1,1,1,1,1,20,1,1,12,10,1,1,1,1
317082,Wellington,1651,13/09/1982,33,0,0,0,0,178,71,2,1,3,1,3,1,4,3,2,3,2,10,10,10,8,10,11,8,11,1,9,10,13,9,11,7,8,10,9,9,10,8,8,8,10,9,10,11,10,11,11,9,8,20,12,10,10,9,10,9,9,9,9,9,15,12,11,10,13,5,11,2,DM/M C,1,1,1,9,11,1,1,1,1,17,20,13,1,1,1
317084,Adriano,1651,19/04/1982,34,0,0,0,0,180,78,2,3,2,1,3,2,1,3,3,3,2,8,4,13,12,13,13,9,5,5,6,13,7,5,13,6,9,9,10,8,13,13,12,13,12,10,9,8,8,13,8,7,13,8,10,10,20,9,8,11,10,10,8,10,12,10,10,10,12,8,18,11,M/AM/S C,1,1,16,20,1,1,1,1,1,1,16,1,1,1,1
317100,Sinval,1651,11/11/1981,34,0,0,0,0,183,87,2,3,1,2,2,2,1,2,3,3,2,3,5,4,3,2,2,12,9,3,11,2,3,11,4,14,8,12,9,9,7,10,7,9,13,7,10,12,12,9,10,10,14,13,9,10,20,10,15,7,10,9,6,2,13,11,13,10,11,6,2,4,D C,1,1,1,1,1,1,20,1,1,1,1,1,1,1,1
317141,Marcelinho,1651,16/02/1983,33,0,0,0,0,180,72,1,3,3,3,2,2,1,1,1,2,3,10,11,11,9,11,10,9,10,13,10,12,12,10,11,10,9,13,11,11,11,10,13,13,7,12,10,12,12,13,15,11,10,5,14,13,20,12,8,15,8,13,11,12,11,13,9,12,14,14,16,9,D/WB RC,1,1,1,1,1,12,20,1,19,1,1,1,15,1,16
317200,Sóstenes,1651,20/10/1980,35,0,0,0,0,175,65,1,3,1,2,2,1,1,1,1,2,1,5,3,4,12,9,5,7,5,2,5,9,6,6,10,8,7,7,7,5,11,10,3,8,12,9,6,6,8,13,12,12,6,20,8,12,9,12,6,8,8,8,3,8,9,11,9,11,10,11,1,4,AM C,1,1,13,20,1,1,1,1,1,1,10,1,1,1,1
317215,Wallison,1651,13/02/1986,30,0,0,0,0,186,76,14,9,11,1,14,14,8,10,3,10,8,5,1,1,2,4,8,1,2,1,2,2,3,1,6,3,9,15,9,8,8,9,16,2,3,3,12,9,15,11,16,9,16,1,15,11,20,8,11,10,10,9,10,10,10,9,10,12,9,3,9,3,GK ,20,1,1,1,1,1,1,1,1,1,1,1,1,1,1
317217,Marlon,1651,21/11/1986,29,0,0,0,0,185,78,1,3,3,3,2,3,2,2,2,1,1,5,6,8,6,10,6,11,5,4,12,8,7,12,10,12,11,14,12,11,4,10,12,6,9,7,12,11,14,12,12,11,13,8,12,13,20,12,12,11,12,7,7,6,14,11,15,7,11,10,9,8,D C,1,1,1,1,1,1,20,1,1,1,1,1,1,1,1
317224,Rodiney,1651,06/01/1980,36,0,0,0,0,187,84,2,4,3,1,2,2,1,3,2,2,1,2,4,8,6,6,4,13,8,5,12,8,10,13,6,15,13,12,9,9,4,9,12,5,13,7,10,14,11,10,12,10,15,1,15,11,20,13,12,10,14,10,8,3,10,14,12,11,12,9,9,13,D C,1,1,1,1,1,1,20,1,1,1,1,1,1,1,1
317226,Josemar,1651,14/06/1980,36,0,0,0,0,193,86,3,4,3,2,1,3,1,2,1,3,3,2,3,3,3,6,10,13,8,7,12,7,10,12,9,14,12,15,9,10,8,11,12,6,12,7,12,12,12,8,8,13,16,5,15,8,20,12,12,11,12,13,7,10,13,8,10,13,14,11,10,5,D C,1,1,1,1,1,1,20,5,1,1,1,1,1,1,1
317255,Diego Gaúcho,1651,15/11/1981,34,0,0,0,0,186,81,4,1,2,2,2,1,1,2,3,3,1,4,7,6,7,11,11,13,9,7,12,10,8,12,10,16,11,13,12,11,7,10,13,5,11,7,12,12,12,8,9,7,13,10,13,7,20,11,14,13,11,12,6,5,12,13,13,12,12,13,12,6,D C,1,10,1,1,1,1,20,1,1,1,1,1,1,1,1
317288,Vágner Love,1651,11/06/1984,32,22,4,5,4,171,72,3,3,3,1,3,1,1,2,2,2,3,10,10,13,14,14,11,13,12,5,7,12,16,8,14,11,14,12,12,11,13,13,13,15,8,16,7,12,11,14,14,15,7,12,12,13,20,13,14,12,8,15,7,11,15,17,11,14,12,11,15,11,AM/S C,1,1,20,17,5,5,1,1,1,1,1,1,1,1,1
317289,Elias,1651,16/05/1985,31,35,0,0,0,173,70,3,3,1,2,3,2,3,3,3,1,1,10,12,13,12,13,11,8,13,4,13,14,12,13,13,10,14,12,14,14,14,14,16,14,10,14,13,14,15,13,14,12,9,10,14,14,20,14,12,13,5,14,6,15,13,13,15,16,13,12,12,11,DM/M C,1,1,7,15,1,1,1,1,1,18,20,1,10,1,1
317291,Aílton,1651,13/10/1984,31,0,0,0,0,175,72,1,1,2,2,3,2,3,2,2,4,3,13,12,14,9,13,13,8,11,6,4,13,12,5,14,9,9,10,10,8,12,12,15,13,2,12,7,7,9,13,14,9,6,10,14,13,20,11,9,11,10,9,4,10,11,11,11,9,16,15,15,6,M/AM/S C,1,1,16,20,12,14,1,1,1,1,18,6,11,1,1
317299,João Guilherme,1651,21/04/1986,30,0,0,0,0,185,77,1,1,2,2,1,1,2,2,1,1,2,8,8,10,9,10,14,14,14,10,14,10,10,13,12,13,10,12,11,12,9,13,14,12,11,8,12,14,9,12,12,14,14,5,17,13,20,15,14,11,9,11,7,7,13,18,12,10,9,13,15,12,D C,1,10,1,1,1,1,20,1,1,15,8,1,1,1,1
317300,Leonardo,1651,19/03/1986,30,0,0,34,3,186,72,3,1,1,1,1,3,2,3,2,1,1,4,6,10,6,11,6,12,10,5,12,11,11,13,12,5,12,13,12,12,6,11,11,13,11,7,12,11,13,14,12,7,13,8,14,14,20,14,10,12,15,12,5,10,7,12,13,12,13,12,8,5,D C,1,1,1,1,1,1,20,1,1,1,1,1,1,1,1
317302,Jonathan,1651,27/02/1986,30,0,0,0,0,170,72,1,2,3,3,1,2,3,3,2,1,1,12,14,14,11,12,8,10,10,13,12,13,10,12,14,13,13,15,11,11,12,10,12,12,9,15,11,13,15,14,13,13,7,10,9,14,20,15,15,11,9,10,15,13,13,13,12,10,12,12,13,9,D/WB/M R,1,1,1,1,1,11,1,10,20,1,1,1,18,8,19
317303,Sandro,1651,19/03/1986,30,0,0,0,0,176,77,2,3,3,3,1,1,2,4,1,1,1,8,14,14,10,12,8,6,8,14,9,13,10,8,12,11,10,10,8,6,8,10,11,9,4,13,9,12,13,15,14,11,5,20,15,14,3,15,10,11,10,11,9,7,8,11,13,9,13,13,13,8,M L,1,1,1,5,15,1,1,10,1,1,5,20,1,10,1
317305,Arouca,1651,11/08/1986,29,0,0,41,0,171,74,3,1,2,1,1,3,1,1,2,2,3,4,11,12,11,14,7,7,8,10,14,14,8,14,14,11,14,13,13,13,13,14,14,14,12,13,13,14,14,13,13,13,6,9,12,14,20,14,12,13,10,16,12,13,11,14,18,18,13,13,18,2,DM/M C,1,1,1,1,1,1,1,1,8,20,16,1,1,1,3
317306,Evandro,1651,23/08/1986,29,0,0,14,4,179,74,3,1,3,1,2,3,1,2,2,3,3,13,14,14,13,15,14,10,14,7,8,16,11,8,15,7,12,10,16,12,14,14,13,15,10,14,10,13,11,13,13,11,8,12,12,12,20,12,10,12,5,15,9,15,15,10,13,9,15,14,14,11,M/AM C,1,1,1,20,12,12,1,1,1,1,18,8,8,1,1
317312,Éderson,1651,13/01/1986,30,1,0,0,0,181,74,2,1,2,3,1,1,1,1,3,2,2,12,13,14,12,16,14,14,14,7,6,16,12,9,16,9,8,11,12,10,15,11,14,14,8,13,7,11,12,13,14,13,11,15,11,13,20,12,12,12,9,14,17,15,15,14,13,12,18,16,16,7,M/AM RLC,1,1,10,20,20,17,1,1,1,1,18,1,1,1,1
317313,Gérson,1651,03/04/1986,30,0,0,0,0,173,73,2,3,3,3,1,1,3,1,3,2,1,6,10,13,12,10,7,4,13,7,8,8,6,8,8,6,11,9,9,9,7,11,10,10,8,8,8,9,9,13,13,7,4,20,10,13,4,13,13,10,7,7,10,10,17,12,12,11,11,12,11,5,D/WB/M/AM LC,1,1,1,15,17,1,1,20,1,1,1,16,1,16,1
317353,Cléo,1651,16/03/1983,33,0,0,0,0,159,60,1,1,1,1,2,1,1,1,2,2,1,5,5,11,9,6,8,6,5,4,6,7,5,6,11,10,16,9,5,11,11,11,1,15,10,13,9,10,11,16,15,8,7,9,14,16,20,12,8,10,7,8,13,5,14,12,8,11,13,12,2,2,S ,1,1,20,1,1,1,1,1,1,1,1,1,1,1,1
317359,Balú,1651,22/02/1985,31,0,0,0,0,188,81,3,2,3,4,1,1,2,3,3,2,2,8,8,7,8,9,8,12,9,10,12,12,9,11,10,13,12,9,10,9,10,10,10,7,10,8,12,13,12,10,11,14,15,8,11,12,20,12,13,8,12,7,8,12,13,12,9,6,14,9,14,8,D/DM/M C,1,10,1,1,1,1,16,1,1,20,17,1,1,1,1
317371,Silva,1651,06/08/1984,31,0,0,0,0,178,75,2,1,3,2,3,2,2,2,1,3,2,11,9,8,6,11,13,11,9,5,10,10,6,15,6,10,15,10,11,5,9,15,8,4,7,3,10,10,7,10,9,14,13,11,10,10,20,10,14,9,10,10,7,10,12,11,12,10,12,6,15,3,DM ,1,1,1,1,1,1,12,1,1,20,13,1,1,1,1
317372,Danilo Sacramento,1651,03/11/1982,33,0,0,0,0,180,68,1,2,1,2,3,2,3,1,2,1,3,9,10,10,9,9,14,9,9,7,8,11,8,8,13,5,7,8,11,10,12,9,15,13,7,9,5,14,13,10,12,7,11,20,12,12,9,12,11,11,7,10,3,11,10,12,10,12,12,12,12,13,M/AM LC,1,1,1,15,17,1,1,1,1,1,20,17,1,13,1
317377,Baré,1651,18/01/1982,34,0,0,0,0,191,79,2,2,2,2,3,3,1,1,2,2,3,5,5,11,12,11,8,13,13,3,4,9,5,4,11,12,12,7,11,9,8,9,3,11,7,13,3,8,6,9,8,14,14,13,12,10,20,10,14,10,5,13,7,6,9,7,14,12,11,12,3,3,S ,1,1,20,14,1,1,1,1,1,1,1,1,1,1,1
317460,Renato Frota,1651,25/11/1983,32,0,0,0,0,175,85,1,3,2,2,2,2,1,3,3,3,4,7,9,12,12,11,9,9,8,7,10,12,6,10,11,10,10,6,10,10,11,11,7,10,8,10,10,9,11,9,10,11,8,9,11,10,20,12,13,10,4,1,10,10,20,12,10,13,10,13,7,5,M/AM C,1,1,1,18,10,10,1,1,1,1,20,8,8,1,1
317529,Marcelo Ribeiro,1651,07/11/1981,34,0,0,0,0,177,0,4,3,1,1,1,3,1,3,2,2,3,7,12,8,11,8,8,7,7,5,6,8,11,3,10,7,10,9,10,9,5,8,12,11,15,9,8,7,7,5,6,8,8,20,13,6,16,9,7,11,8,8,8,8,14,10,8,14,12,10,6,1,M/AM/S LC,1,1,20,15,18,1,1,1,1,1,15,18,1,1,1
317670,Vítor,1651,29/07/1982,33,0,0,0,0,174,66,3,1,2,3,3,3,4,4,1,2,4,11,13,13,10,13,11,7,10,14,10,13,11,10,14,11,12,12,13,12,13,13,13,15,10,14,9,14,16,15,14,13,7,7,15,14,20,13,7,15,11,13,9,13,15,12,15,14,11,10,14,13,D/WB R,1,1,1,1,1,8,1,1,20,1,1,1,12,1,19
317709,Gérson,1651,29/03/1981,35,0,0,0,0,174,70,1,1,1,4,3,2,2,1,3,1,4,9,11,10,9,9,9,7,10,7,6,10,8,10,11,10,10,10,11,10,11,10,13,12,5,12,9,11,11,14,13,10,9,9,11,14,20,13,10,12,1,12,10,16,12,11,7,13,15,14,15,9,M RC,1,1,7,15,1,1,1,1,10,1,20,1,18,1,13
317728,Nunes,1651,21/01/1982,34,0,0,0,0,185,80,1,4,2,3,2,1,2,2,3,3,2,2,9,12,12,12,5,13,12,2,4,9,15,5,13,10,10,15,10,8,8,10,13,12,3,11,7,10,9,11,12,11,13,20,14,12,10,12,12,10,4,11,7,6,7,15,6,16,2,6,7,17,S ,1,1,20,1,1,1,1,1,1,1,1,1,1,1,1
317729,Richarlyson,1651,27/12/1982,33,2,0,0,0,176,72,2,2,2,1,3,3,3,3,4,1,1,7,11,10,9,12,10,10,11,10,11,12,5,11,11,13,11,16,11,9,10,9,12,13,15,10,12,12,13,13,14,9,8,20,16,13,4,14,8,12,14,11,8,15,7,10,13,10,13,8,6,12,D/WB/DM/M/AM LC,1,1,8,16,12,1,10,16,1,18,20,15,1,17,1
317736,Gabriel,1651,20/08/1983,32,0,0,0,0,190,77,1,1,2,3,1,3,3,3,2,1,3,4,2,4,3,7,6,14,2,3,14,6,3,14,3,6,11,13,12,11,10,13,11,9,13,11,11,12,12,10,11,13,14,20,10,10,7,12,14,11,11,12,5,5,11,12,14,11,13,10,12,13,D C,1,1,1,1,1,1,20,1,1,1,1,1,1,1,1
317738,Da Costa,1651,12/11/1983,32,0,0,0,0,186,81,14,12,12,8,13,14,12,15,7,12,14,7,3,3,2,6,9,8,1,3,1,9,1,1,10,9,9,13,12,12,11,12,13,7,8,2,13,11,10,9,14,10,14,7,13,8,20,13,10,13,4,12,3,11,8,13,16,14,12,12,12,6,GK ,20,1,1,1,1,1,1,1,1,1,1,1,1,1,1
317757,Neto,1651,07/02/1981,35,0,0,0,0,175,67,2,2,1,1,3,1,2,3,1,1,2,14,13,13,12,13,15,10,13,10,8,13,10,8,13,12,13,10,12,10,13,10,13,14,12,13,9,12,12,10,12,10,8,8,13,11,20,10,9,9,8,12,9,12,14,13,12,10,13,10,12,10,D/WB/M/AM RC,1,1,1,16,10,14,1,10,16,10,20,6,19,7,16
317900,Dênis,1651,28/12/1985,30,0,0,0,0,184,81,2,3,2,1,1,3,3,4,1,3,1,2,3,9,5,6,3,15,3,3,15,9,4,14,10,8,12,9,11,12,7,13,9,4,8,5,13,12,11,11,8,14,14,7,13,12,20,12,14,12,5,12,6,5,8,10,11,10,13,9,8,6,D C,1,1,1,1,1,1,20,1,1,1,1,1,1,1,1
317941,Edcarlos,1651,10/05/1985,31,0,0,23,0,185,79,2,2,3,1,3,2,1,3,1,3,2,1,6,10,11,10,7,14,7,6,12,10,10,13,10,13,13,15,12,12,7,11,15,6,15,8,11,13,13,13,12,12,13,7,14,13,20,15,14,12,13,13,4,5,13,12,14,14,14,12,12,4,D C,1,1,1,1,1,1,20,1,1,1,1,1,1,1,1
318082,Coquinho,1651,21/01/1980,36,0,0,0,0,182,82,2,3,1,3,1,1,1,2,4,1,3,4,6,8,11,11,10,11,12,7,11,11,12,11,11,11,11,11,12,11,10,11,11,12,14,11,12,11,11,10,11,11,10,12,13,11,20,10,11,14,1,10,7,13,10,8,17,12,14,14,16,3,DM/M C,1,1,1,1,1,1,1,1,1,20,18,1,1,1,1
318093,Tobi,1651,23/10/1978,37,0,0,0,0,179,78,3,1,3,1,2,2,2,2,2,2,4,3,6,8,5,9,6,11,5,5,12,10,9,11,7,16,11,16,8,10,8,8,11,7,15,8,11,14,12,10,11,12,9,8,14,9,20,12,13,13,14,12,4,16,11,11,7,11,11,7,10,12,D/DM C,1,11,1,1,1,1,19,1,1,20,14,1,1,1,1
318114,Eduardo Luiz,1651,31/01/1983,33,0,0,0,0,189,79,2,3,2,3,2,1,1,3,1,1,1,8,8,8,10,8,3,16,9,6,11,10,8,12,11,13,12,11,11,11,9,11,12,10,8,12,12,11,13,12,13,11,13,9,10,12,20,12,11,13,14,8,6,8,9,11,11,12,14,12,14,9,D C,1,1,1,1,1,1,20,1,1,1,1,1,1,1,1
318118,Pierre,1651,19/01/1982,34,0,0,0,0,172,67,3,2,1,2,1,2,3,3,1,1,1,6,7,11,6,12,6,10,9,7,15,10,11,16,11,17,16,18,14,15,10,14,17,8,15,10,13,14,17,13,15,13,7,7,13,13,20,14,11,12,13,14,6,11,11,14,18,15,19,8,14,6,DM/M C,1,7,1,1,1,1,1,1,1,20,17,1,1,1,1
318119,Naves,1651,12/02/1983,33,0,0,0,0,177,63,3,2,3,3,2,1,4,3,3,2,3,11,8,6,7,7,11,7,11,9,11,10,3,12,9,11,12,12,10,12,11,11,11,8,9,7,11,12,13,10,8,12,7,9,14,10,20,13,12,7,6,8,3,11,8,8,12,7,10,12,12,5,DM/M C,1,1,1,1,1,1,12,1,10,20,19,1,1,1,1
318125,Caio,1651,10/11/1980,35,0,0,0,0,167,61,1,1,1,1,1,2,3,2,1,4,2,4,11,12,10,12,12,5,12,2,3,12,10,3,12,12,9,10,10,9,12,11,12,9,6,12,6,10,11,13,13,7,1,10,13,13,20,11,4,12,10,12,7,14,9,13,15,16,12,13,14,7,M/AM LC,1,1,11,20,18,10,1,1,1,1,17,16,5,1,1
318126,Tita,1651,20/07/1981,34,0,0,0,0,165,70,2,1,1,3,3,3,3,1,1,2,2,15,16,14,14,14,15,5,14,5,4,14,14,6,15,8,11,8,12,10,14,13,10,15,10,12,7,8,9,10,12,7,4,10,13,10,20,7,7,12,8,12,7,12,20,12,12,12,13,7,13,6,M/AM RLC,1,1,14,17,20,15,1,1,1,1,1,19,15,1,1
318171,Gustavo Bastos,1651,05/10/1981,34,0,0,0,0,191,82,2,1,1,1,3,1,2,2,4,3,1,6,6,7,7,10,7,11,7,10,12,10,6,13,7,13,13,13,9,9,8,9,12,8,14,10,14,13,12,9,10,7,16,9,14,7,20,13,15,11,13,12,7,10,10,11,9,9,11,10,10,11,D/DM/M C,1,1,1,1,1,1,20,1,1,18,19,1,1,1,1
318178,Rogério,1651,14/03/1984,32,0,0,0,0,180,72,2,3,2,1,3,2,2,3,3,2,2,3,8,6,5,10,1,11,8,12,11,10,5,12,12,14,12,12,9,11,9,11,14,8,13,7,11,13,15,12,11,11,9,20,13,12,9,13,11,13,13,11,6,14,12,12,12,12,14,11,14,8,D LC,1,1,1,1,1,1,15,20,13,1,5,10,1,13,10
318179,Júlio Zabotto,1651,16/02/1983,33,0,0,0,0,183,78,2,3,3,3,2,1,3,3,4,2,3,8,12,11,8,12,5,11,7,5,5,10,3,5,12,8,8,7,8,6,9,12,15,14,11,12,4,6,13,13,13,12,12,10,14,13,20,12,11,9,9,9,7,9,8,11,7,15,9,2,10,8,M/AM RC,1,1,1,20,1,18,1,1,1,1,14,1,18,1,1
318180,Rafael Fefo,1651,15/02/1985,31,0,0,0,0,182,80,1,2,2,3,3,1,3,1,1,1,1,7,8,9,6,9,6,11,6,8,13,11,7,12,8,9,10,13,10,11,10,11,12,8,11,8,11,15,14,12,11,9,12,8,15,13,20,14,13,12,11,1,17,9,11,9,14,11,10,2,4,3,DM C,1,1,1,1,1,1,13,8,1,20,15,8,1,11,1
318182,Juliano,1651,06/06/1983,33,0,0,0,0,175,72,3,1,2,2,4,3,2,1,2,4,3,7,7,14,11,13,7,11,9,4,7,12,5,8,10,9,8,8,11,7,9,9,9,9,11,12,5,8,9,11,12,13,7,10,16,12,20,12,7,9,9,9,9,9,17,12,4,12,10,4,19,7,M/AM/S C,1,1,20,18,1,1,1,1,1,1,16,1,1,1,1
318189,Weslley Brasília,1651,07/05/1981,35,0,0,0,0,172,65,1,3,4,3,4,2,3,4,3,2,1,9,9,10,13,12,11,11,10,4,4,10,16,4,12,10,10,11,12,9,10,10,9,14,7,13,9,9,11,13,13,11,5,9,13,13,20,8,9,13,8,12,8,7,12,8,10,9,9,8,10,5,S ,1,1,20,1,1,1,1,1,1,1,1,1,1,1,1
318193,Leandro Chaves,1651,04/10/1983,32,0,0,0,0,175,70,4,3,3,1,2,1,2,2,1,1,3,13,12,13,10,12,12,6,12,10,7,12,7,7,13,9,9,11,10,10,12,11,10,9,6,11,9,12,10,13,13,7,6,20,13,13,7,10,7,9,8,12,10,9,7,13,11,11,8,1,1,6,AM LC,1,1,12,15,20,1,1,11,1,10,15,15,1,14,1
318198,Alexandre,1651,15/08/1983,32,0,0,0,0,178,70,2,3,1,1,2,4,2,3,1,1,3,15,11,14,9,14,15,7,15,7,4,13,12,5,15,12,13,14,12,13,13,12,14,15,5,11,3,5,13,11,13,8,7,15,7,12,20,12,8,12,4,8,5,12,12,10,8,5,4,8,8,3,AM RC,1,1,1,20,10,17,1,1,1,10,15,8,12,1,1
318210,João Paulo,1651,23/06/1984,32,0,0,0,0,180,77,1,2,1,1,1,3,2,2,1,3,2,2,2,6,7,6,7,14,7,4,14,6,3,14,7,10,14,10,8,12,6,14,10,3,12,8,14,8,9,13,10,9,8,8,11,10,20,8,11,10,5,10,10,10,8,11,11,12,11,7,10,2,D C,1,1,1,1,1,1,20,1,1,1,1,1,1,1,1
318249,Oziel,1651,10/08/1984,31,0,0,0,0,169,68,2,1,4,2,1,3,2,3,2,3,2,11,11,12,8,12,11,8,9,12,11,10,8,10,12,11,12,12,11,12,8,11,13,14,12,12,10,12,12,13,14,15,4,10,12,13,20,12,6,11,8,11,9,10,14,11,14,10,12,8,15,10,D/WB R,1,1,1,1,5,1,1,11,20,1,1,8,1,10,19
318475,Washington,1651,19/06/1985,31,0,0,0,0,202,96,1,3,1,2,3,2,1,3,3,2,3,9,8,10,9,10,8,15,7,10,6,11,11,9,8,12,10,14,9,11,10,11,12,10,12,9,10,11,10,7,11,15,18,8,15,8,20,10,15,12,9,12,9,14,12,11,13,11,12,7,11,8,S ,1,1,20,1,1,1,1,1,1,1,1,1,1,1,1
318488,Renato Cajá,1651,15/09/1984,31,0,0,0,0,173,70,3,1,1,1,1,4,3,3,1,2,1,16,13,14,14,15,14,5,16,4,8,15,13,7,15,11,13,14,13,11,15,14,12,14,12,13,8,13,10,12,13,13,7,20,12,11,8,12,9,10,9,13,4,5,9,15,14,12,9,9,7,14,M/AM LC,1,1,1,20,17,1,1,1,1,1,18,1,1,1,1
318496,Márcio Teruel,1651,11/03/1985,31,0,0,0,0,173,71,1,4,2,3,3,1,1,2,1,3,2,8,10,10,10,11,8,6,7,8,8,13,2,8,12,10,10,9,10,9,8,11,4,11,10,10,9,9,12,14,12,9,6,20,14,13,12,10,10,10,10,6,3,10,13,12,11,14,11,11,16,7,M/AM RLC,1,1,1,17,1,1,1,1,1,1,20,18,16,1,1
318498,Rafael,1651,24/03/1984,32,0,0,0,0,191,78,12,11,11,8,13,12,12,13,12,12,10,3,2,2,1,10,7,7,2,1,2,9,3,1,11,10,11,12,11,13,9,11,13,1,12,2,11,12,11,9,12,13,14,8,10,9,20,11,11,12,10,15,5,10,8,14,14,15,13,14,13,7,GK ,20,1,1,1,1,1,1,1,1,1,1,1,1,1,1
318509,Analdo,1651,23/02/1979,37,0,0,0,0,168,0,2,3,1,3,1,2,1,3,3,2,1,6,8,3,8,15,8,9,10,6,12,13,2,15,10,9,13,4,10,8,8,13,3,9,11,8,15,9,12,9,10,9,6,3,11,11,20,8,9,9,6,2,9,9,19,12,13,11,14,3,2,2,D/DM C,1,1,1,1,1,1,17,1,1,20,13,1,1,1,1
318673,Labilá,1651,29/12/1983,32,0,0,0,0,178,0,9,11,10,3,11,13,12,11,9,9,13,3,1,2,1,3,3,1,3,1,2,1,1,2,6,6,8,10,5,9,8,15,8,2,8,2,11,9,8,11,13,9,10,8,8,9,20,7,10,9,7,9,9,9,19,15,14,9,15,14,14,7,GK ,20,1,1,1,1,1,1,1,1,1,1,1,1,1,1
318693,Beto,1651,31/12/1980,35,0,0,0,0,177,73,2,4,3,3,3,2,3,2,1,3,3,7,5,9,13,12,6,10,9,4,11,9,7,5,10,9,12,7,11,6,8,12,9,9,9,9,9,6,9,12,12,8,7,10,14,13,20,14,13,9,6,9,9,9,12,10,9,11,12,9,6,8,S ,1,1,20,1,1,1,1,1,1,12,11,1,1,1,1
318747,Zé Antônio,1651,19/03/1984,32,0,0,0,0,180,83,2,1,2,2,1,1,1,2,3,4,2,7,10,11,10,12,12,11,13,8,11,12,10,11,12,13,11,13,12,9,11,12,14,12,14,10,11,11,11,11,10,11,9,10,12,10,20,11,12,11,11,13,5,13,5,11,10,14,12,9,10,10,DM/M C,1,1,1,7,1,1,1,1,10,20,19,1,8,1,9
318755,Daniel Bueno,1651,15/12/1983,32,0,0,0,0,186,78,3,3,1,3,2,3,1,3,3,1,1,5,5,11,7,12,3,13,13,4,5,7,11,7,13,11,11,10,9,7,10,9,7,12,3,13,10,13,12,11,15,8,10,10,13,10,20,9,12,11,8,12,10,7,2,7,3,8,1,9,5,20,S C,1,1,20,15,1,1,1,1,1,1,1,1,1,1,1
318758,Luiz,1651,07/02/1983,33,0,0,0,0,189,90,13,12,12,5,14,11,12,13,11,13,11,1,1,1,2,3,6,3,1,1,3,10,4,1,8,10,13,14,13,13,7,11,15,10,13,5,13,12,13,10,13,8,15,11,13,10,20,14,15,15,14,14,11,11,12,9,16,14,13,6,13,5,GK ,20,1,1,1,1,1,1,1,1,1,1,1,1,1,1
318769,Fabiano Gadelha,1651,09/01/1979,37,0,0,0,0,179,74,2,2,3,3,3,2,3,2,3,3,1,11,11,11,11,12,13,7,12,7,7,12,13,6,11,11,8,11,11,10,12,11,16,14,7,11,9,11,9,10,10,9,11,7,12,10,20,11,10,13,8,12,12,13,11,8,12,14,15,14,10,10,M/AM/S RC,1,1,17,20,1,18,1,1,1,12,15,1,16,1,1
318771,Élder Granja,1651,02/07/1982,34,0,0,0,0,181,73,4,3,2,1,4,3,3,1,3,1,1,12,10,11,10,12,13,7,12,12,6,11,12,7,11,7,10,7,11,11,11,11,8,15,10,12,7,9,8,10,12,8,8,9,12,11,20,9,7,13,11,13,14,14,12,16,6,10,7,10,11,16,D/WB R,1,1,1,12,9,13,1,6,18,5,10,7,14,8,20
318805,Marcinho,1651,20/07/1984,31,0,0,0,0,171,76,2,1,2,2,2,3,2,2,1,1,2,11,12,14,12,14,12,10,12,3,8,14,10,9,14,10,12,10,12,11,13,11,14,12,10,14,5,12,12,14,15,10,8,12,12,14,20,14,8,11,9,12,8,8,11,12,8,10,9,15,16,14,M/AM/S C,1,1,16,20,1,1,1,1,1,1,18,1,1,1,1
319185,Gladstone,1651,29/01/1985,31,0,0,11,1,183,82,1,1,1,1,1,1,1,1,1,1,1,2,7,9,5,7,13,13,9,10,12,9,9,12,8,18,10,12,9,9,8,9,15,9,14,8,12,13,14,9,9,9,11,8,12,9,20,13,13,10,16,13,15,9,9,13,1,17,11,7,8,7,D C,1,11,1,1,1,1,20,1,5,15,1,1,1,1,1
319214,Anselmo,1651,24/10/1980,35,0,0,0,0,182,76,2,1,2,2,3,2,2,1,2,3,3,8,10,12,13,10,8,15,9,3,6,10,12,6,12,10,11,12,12,10,12,10,10,14,7,13,13,11,11,12,13,10,11,14,13,13,20,12,14,13,5,13,5,12,12,11,5,11,10,14,13,10,AM/S C,1,1,20,18,1,10,1,1,1,1,11,1,5,1,1
319220,Roberto,1651,19/12/1985,30,0,0,0,0,177,75,3,3,1,1,3,3,4,3,3,3,2,6,11,13,12,13,6,12,10,2,8,12,13,10,13,12,9,12,13,11,13,12,16,14,6,13,9,12,13,13,13,13,8,10,13,13,20,12,10,11,11,12,13,12,14,12,11,10,10,3,15,1,AM/S R,1,1,20,13,11,17,1,1,1,1,1,1,1,1,1
319221,Filipe Luís,1651,09/08/1985,30,26,1,23,7,182,79,2,1,2,1,1,3,3,3,3,2,1,13,15,15,12,15,13,9,13,12,12,14,14,12,16,13,15,14,15,14,14,14,16,13,11,15,11,14,16,15,15,11,13,20,9,14,10,16,11,15,12,15,10,13,10,13,13,10,14,10,7,12,D/WB L,1,1,1,1,7,1,1,20,1,1,10,13,1,19,1
319254,Jajá,1651,28/06/1984,32,0,0,0,0,170,64,2,3,1,3,3,2,2,3,2,1,1,3,8,13,12,9,6,9,9,7,6,9,3,7,14,5,11,7,6,7,7,12,10,16,10,9,10,6,9,15,9,5,9,20,10,15,16,7,8,6,6,7,8,9,8,12,8,12,12,2,12,8,M/AM/S L,1,1,16,13,20,1,1,1,1,1,12,17,1,1,1
319263,Gustavo Papa,1651,20/07/1979,36,0,0,0,0,185,78,1,1,3,1,2,3,1,3,4,1,3,8,10,10,14,10,7,16,10,6,9,10,14,8,11,16,14,13,12,13,11,15,17,9,9,11,5,13,13,9,7,10,13,11,14,9,20,10,9,17,10,12,12,7,8,15,13,12,16,13,16,2,S ,1,1,20,1,1,1,1,1,1,1,1,1,1,1,1
319519,Diego Souza,1651,22/03/1984,32,0,0,8,2,184,79,3,1,1,2,2,3,1,3,3,4,3,6,9,12,9,12,11,9,13,5,9,11,10,9,13,10,11,12,9,9,11,11,14,15,12,13,10,12,14,14,14,15,12,20,16,15,4,13,13,12,8,11,5,16,15,11,16,9,11,12,17,11,M/AM LC,1,1,10,19,20,4,1,1,1,1,1,19,4,1,1
319607,Vanderlei,1651,01/02/1984,32,0,0,0,0,195,86,13,15,13,12,15,10,15,16,15,14,8,9,3,3,3,9,11,3,2,3,3,4,2,2,12,12,13,16,12,13,12,13,13,1,14,2,16,13,13,12,13,12,16,7,12,12,20,13,9,14,12,17,9,12,11,12,11,15,14,12,12,5,GK ,20,1,1,1,1,1,1,1,1,1,1,1,1,1,1
319615,Thiago Gasparino,1651,16/02/1986,30,0,0,0,0,178,67,1,3,1,3,3,3,1,2,3,2,3,6,10,10,8,10,1,11,8,12,11,11,4,16,10,10,9,11,9,10,9,8,11,2,13,10,12,11,11,13,13,11,12,7,14,13,20,12,10,11,10,6,5,10,20,12,11,10,10,9,16,6,D/WB RC,1,1,1,1,1,1,15,1,20,1,1,1,1,1,18
319617,Ademar,1651,08/01/1985,31,0,0,0,0,176,71,3,3,3,2,2,2,1,2,3,2,2,9,8,11,11,10,10,11,11,8,8,9,10,9,10,13,9,13,8,8,9,9,13,11,9,13,9,10,13,13,12,12,13,8,14,12,20,12,11,10,10,10,7,12,14,13,6,11,13,10,10,11,M/S C,1,1,18,10,1,1,1,1,1,1,20,1,1,1,1
319646,Wendel,1651,08/10/1981,34,0,0,0,0,177,70,3,1,2,2,1,1,1,3,1,1,2,7,10,10,6,10,6,8,5,12,11,11,9,11,10,14,11,13,10,9,10,11,17,8,10,11,12,14,14,12,12,10,8,7,16,12,20,16,10,13,11,11,6,17,8,10,15,14,14,13,14,7,D/WB/DM R,1,2,1,1,1,1,7,10,20,19,14,1,11,8,17
319656,Leandro Souza,1651,24/02/1986,30,0,0,0,0,187,80,1,1,2,1,3,4,1,1,1,2,3,4,5,4,2,3,4,14,2,4,13,7,5,13,6,12,11,13,10,11,9,10,12,11,12,4,12,11,11,12,13,10,14,7,13,14,20,12,14,11,12,10,7,1,11,12,13,11,13,12,10,10,D C,1,1,1,1,1,1,20,1,1,1,1,1,1,1,1
319679,David,1651,06/06/1981,35,0,0,0,0,188,0,11,12,12,3,13,10,12,13,10,7,10,5,3,1,1,2,7,2,3,3,3,5,2,1,4,9,12,11,9,15,10,9,12,3,13,3,12,11,10,5,10,11,13,7,16,7,20,8,13,10,8,9,9,10,15,11,11,12,15,4,3,2,GK ,20,1,1,1,1,1,1,1,1,1,1,1,1,1,1
319684,Roberto Lopes,1651,16/08/1983,32,0,0,0,0,181,80,3,2,4,1,3,1,1,1,2,2,2,5,7,8,7,9,5,8,8,9,12,9,8,12,8,14,11,14,10,12,10,10,13,11,11,11,11,12,12,11,12,9,11,9,12,13,20,13,14,10,12,10,8,7,15,12,11,11,14,10,10,6,DM/M C,1,1,1,1,1,1,1,1,1,20,17,1,1,1,1
319697,Roger,1651,18/02/1984,32,0,0,0,0,187,79,14,9,9,1,9,11,8,7,9,8,10,5,3,3,3,7,7,1,2,2,2,3,3,3,4,8,9,13,6,7,7,14,5,2,6,1,14,8,7,8,10,6,14,6,8,9,20,3,9,9,9,4,9,9,16,9,12,13,10,3,12,7,GK ,20,1,1,1,1,1,1,1,1,1,1,1,1,1,1
319708,Éber,1651,20/09/1981,34,0,0,0,0,191,85,1,2,3,3,1,2,3,1,2,2,2,10,10,10,12,10,10,14,11,5,6,8,10,7,11,9,10,15,7,12,9,11,5,14,13,8,13,12,11,9,11,11,12,13,14,11,20,12,14,7,16,11,7,4,4,11,10,15,8,5,6,4,S ,1,1,20,1,1,1,1,1,1,1,1,1,1,1,1
319745,Zelão,1651,12/11/1984,31,0,0,0,0,188,89,2,2,2,1,1,1,2,1,1,2,3,4,6,9,7,9,4,14,7,3,13,10,8,14,11,14,11,14,11,12,11,11,15,8,10,10,12,11,10,11,11,12,14,7,16,10,20,12,13,15,8,15,6,5,15,12,8,16,13,15,13,5,D C,1,13,1,1,1,1,20,1,1,1,1,1,1,1,1
319778,José Willams,1651,05/08/1983,32,0,0,0,0,170,60,4,3,2,2,2,2,2,1,1,1,3,9,10,11,9,10,9,5,8,8,10,10,9,11,10,12,9,11,7,8,7,7,13,13,8,10,9,10,10,13,12,8,7,20,13,12,8,12,6,10,9,11,8,13,11,14,12,13,11,11,10,10,D/WB/M/AM L,1,1,1,1,17,1,1,20,1,1,1,17,1,16,1
319779,Márcio Araújo,1651,11/06/1984,32,0,0,0,0,172,66,2,3,1,2,3,1,2,2,1,3,2,8,11,11,10,12,8,8,11,11,14,13,9,14,12,11,13,15,13,12,11,12,15,12,10,14,13,16,16,14,14,12,6,7,18,14,20,17,9,13,13,12,6,14,7,14,14,12,15,12,13,5,DM/M C,1,1,1,9,6,11,1,1,11,19,20,10,13,1,13
319962,Marcos Tavares,1651,30/03/1984,32,0,0,0,0,176,82,4,4,1,1,1,1,1,1,3,3,2,13,14,13,13,13,10,10,13,6,4,14,9,9,14,13,12,12,12,15,13,12,17,16,17,13,9,12,14,11,9,10,8,20,11,11,10,12,14,13,7,14,7,14,13,14,14,12,11,11,13,8,AM/S C,1,1,20,18,1,1,1,1,1,1,1,1,1,1,1
320072,Fernando Lombardi,1651,17/01/1982,34,0,0,0,0,184,78,1,3,3,2,2,1,1,3,3,1,1,2,3,4,6,8,5,14,8,4,13,12,6,13,10,10,12,11,10,10,6,11,12,1,8,5,12,10,12,12,11,14,12,11,12,11,20,8,13,13,4,11,10,10,15,12,11,11,12,6,14,6,D C,1,1,1,1,1,1,20,1,1,1,1,1,1,1,1
32008309,Clayton Soares,1651,24/11/1978,37,0,0,0,0,181,0,1,1,3,1,3,1,1,2,3,2,3,2,3,6,13,14,8,11,8,1,4,13,10,7,14,6,14,10,14,12,14,14,13,13,3,14,8,12,11,8,9,14,12,20,9,10,10,11,9,15,1,13,3,5,13,8,18,13,17,18,14,1,S C,1,1,20,15,1,1,1,8,1,1,12,1,1,1,1
320230,Renato Saldanha,1651,21/01/1984,32,0,0,0,0,183,77,2,2,3,3,3,3,3,1,3,2,2,4,1,2,5,7,3,11,1,1,10,6,1,11,8,9,10,9,7,8,1,13,1,8,10,4,13,6,7,9,11,13,13,10,13,9,20,5,14,9,9,9,9,9,20,12,9,12,11,1,11,7,D C,1,1,1,1,1,1,20,1,1,1,1,1,1,1,1
320231,Leandrinho,1651,07/11/1982,33,0,0,0,0,164,62,2,4,4,2,2,2,3,1,2,3,1,3,9,4,4,10,5,1,6,2,7,8,3,10,5,8,6,6,7,7,6,6,8,7,11,6,9,6,7,13,13,7,3,7,15,12,20,10,5,8,8,8,8,16,6,11,11,12,13,1,6,7,D/WB/M/AM RLC,1,1,1,17,1,1,1,16,19,15,20,1,1,15,18
320235,Stanley,1651,07/02/1985,31,0,0,0,0,176,70,13,9,9,3,6,13,7,12,8,9,10,5,3,3,3,4,7,1,2,1,1,2,4,1,5,9,11,11,7,8,6,13,8,2,11,2,10,7,6,12,10,7,8,8,8,11,20,4,6,9,8,9,9,9,13,10,11,10,12,7,8,8,GK ,20,1,1,1,1,1,1,1,1,1,1,1,1,1,1
320236,Danilo,1651,10/05/1984,32,0,0,0,0,185,75,1,1,2,1,2,2,3,3,3,1,3,4,7,8,10,11,3,15,9,14,14,9,10,14,10,16,13,17,12,13,8,14,13,11,15,7,15,14,13,12,10,14,13,9,15,13,20,14,14,13,14,14,7,10,13,14,14,15,12,5,7,14,D C,1,17,1,1,1,1,20,8,8,1,1,1,1,1,1
320237,Márcio Mossoró,1651,04/07/1983,32,0,0,0,0,170,67,1,1,2,3,2,3,1,1,3,1,3,14,12,14,13,15,12,4,12,8,5,15,11,5,16,17,16,10,14,14,16,14,17,17,12,16,9,13,13,11,14,8,4,12,14,9,20,10,7,13,16,16,11,12,7,15,15,14,17,12,14,7,AM/S C,1,1,17,20,10,10,1,1,1,1,12,1,1,1,1
320238,Bruno,1651,27/06/1984,32,0,0,0,0,196,89,12,11,13,6,10,11,14,14,13,14,13,2,2,2,4,7,2,7,4,5,7,8,6,9,7,11,12,12,12,11,5,12,13,8,12,4,15,11,12,8,11,13,18,3,14,9,20,12,14,11,6,14,7,3,12,13,19,8,18,12,15,11,GK ,20,1,1,1,1,1,1,1,1,1,1,1,1,1,1
320241,Francis,1651,30/04/1982,34,0,0,0,0,180,76,1,2,3,2,2,1,2,2,3,3,1,3,9,10,5,12,3,9,7,7,11,12,12,11,11,12,11,12,11,11,10,12,12,13,12,11,13,12,12,12,12,12,9,8,14,12,20,13,12,12,8,13,9,11,10,11,11,12,12,13,14,11,D/DM/M C,1,7,1,1,1,1,18,5,6,20,18,1,1,1,1
320259,Everton César,1651,03/09/1983,32,0,0,0,0,179,72,3,4,1,1,2,1,2,4,2,3,3,6,7,9,9,9,9,8,9,6,9,9,10,9,10,11,11,12,10,10,9,10,12,11,11,10,10,11,11,11,10,11,9,10,13,10,20,12,7,12,11,12,10,9,11,10,15,11,15,15,15,5,DM/M C,1,1,1,14,1,1,1,1,1,18,20,1,1,1,1
320282,Diego,1651,18/09/1983,32,0,0,0,0,171,73,1,2,2,1,2,2,3,1,2,1,3,13,14,13,7,7,15,5,6,13,11,12,5,11,12,11,13,12,11,13,12,12,12,12,10,14,12,13,13,14,13,11,7,20,13,13,10,13,11,12,11,13,8,10,8,11,15,13,12,9,10,10,D L,1,1,1,1,1,1,1,20,1,1,1,12,1,13,1
320284,Daniel,1651,16/04/1984,32,0,0,0,0,184,81,2,2,3,1,2,1,3,2,2,1,1,5,2,5,2,7,3,15,2,3,11,10,3,12,14,6,12,9,5,8,4,10,17,1,7,2,11,7,14,14,7,14,13,10,9,10,20,13,14,11,5,9,3,9,10,10,12,12,12,1,10,5,D C,1,1,1,1,1,1,20,1,1,1,1,1,1,1,1
320286,Marcus da Silva,1651,29/03/1984,32,0,0,0,0,182,72,1,1,1,1,3,3,1,2,1,1,3,7,10,12,10,13,8,11,10,6,4,11,10,9,14,7,9,11,8,9,12,9,10,13,8,12,9,10,12,14,12,11,11,7,13,12,20,11,7,9,5,11,10,11,7,13,13,12,11,6,12,5,M/AM/S RLC,1,1,20,18,15,18,1,1,1,1,7,10,18,1,1
320287,Rubens,1651,25/12/1984,31,0,0,0,0,178,76,3,3,1,2,2,2,2,1,2,2,3,6,11,11,10,10,5,9,13,6,10,12,11,10,10,12,11,7,10,6,12,11,14,11,7,12,11,11,12,12,12,10,9,5,12,13,20,13,11,7,14,8,6,11,11,12,13,9,11,11,12,8,M/AM RC,1,1,15,20,10,19,1,1,1,13,14,9,17,1,1
320291,Coutinho,1651,07/03/1984,32,0,0,0,0,173,73,3,2,4,2,3,2,1,2,3,3,3,10,10,11,10,11,10,9,12,9,12,12,9,12,12,14,11,13,12,11,10,10,15,13,13,11,12,12,12,12,12,9,6,7,15,12,20,13,10,10,16,13,11,11,11,14,14,12,13,11,14,6,DM/M C,1,1,1,10,1,5,1,1,12,20,19,1,13,1,13
320301,Ênio,1651,11/03/1985,31,0,0,0,0,188,92,2,4,4,3,1,2,2,4,3,2,1,3,1,1,1,7,1,10,4,5,7,7,3,8,4,9,13,9,7,9,2,13,16,6,11,4,8,6,7,5,5,16,17,8,14,10,20,7,17,9,9,9,9,9,11,12,10,10,12,1,12,3,D C,1,1,1,1,1,1,20,1,1,1,1,1,1,1,1
320305,Fabiano,1651,10/02/1985,31,0,0,0,0,171,0,1,2,3,3,1,4,3,3,2,3,2,7,6,7,3,9,4,4,7,7,9,9,6,15,9,8,13,7,7,6,8,11,15,8,8,6,9,10,16,10,9,8,3,20,11,13,9,14,7,8,4,8,8,8,13,9,10,14,10,3,10,1,D/WB L,1,1,1,1,1,1,1,18,1,1,1,10,1,20,1
320308,Rodrigo Tiuí,1651,04/12/1985,30,0,0,0,0,177,64,3,2,1,1,2,2,1,3,1,3,3,8,9,13,12,12,9,10,9,2,6,13,10,6,14,11,12,12,11,12,13,12,12,13,11,12,8,10,11,13,14,9,9,9,14,14,20,14,9,10,12,15,11,5,13,13,11,9,9,5,11,7,S ,1,1,20,1,14,10,1,1,1,1,1,1,1,1,1
320310,Gérson Magrão,1651,13/06/1985,31,0,0,0,0,181,78,3,2,3,2,1,3,2,4,1,3,1,12,13,13,11,11,12,5,11,9,10,13,11,10,14,8,11,11,11,13,13,13,12,9,11,13,10,12,13,13,13,12,6,20,13,13,8,13,11,10,8,10,12,12,11,10,9,11,13,10,11,12,AM LC,1,1,1,18,20,1,1,10,1,1,13,13,1,11,1
320311,Renan,1651,20/02/1985,31,0,0,0,0,165,0,2,2,2,1,8,4,3,16,15,1,2,7,7,9,9,11,7,4,10,1,11,12,6,9,11,9,11,3,9,6,14,14,5,11,12,11,9,8,12,13,10,7,1,10,14,12,20,11,7,9,7,9,8,9,12,10,4,10,11,3,4,7,AM C,1,1,1,20,1,1,1,1,1,5,15,1,1,1,1
320312,Lê,1651,18/12/1984,31,0,0,0,0,181,80,2,1,1,2,4,2,2,1,2,2,3,9,11,12,12,12,10,12,11,7,9,12,16,8,14,11,9,14,8,9,12,9,10,12,5,11,6,12,7,14,14,12,11,3,13,14,20,14,13,12,11,11,5,5,11,12,8,10,11,2,11,1,S ,1,1,20,10,1,1,1,1,1,1,1,1,1,1,1
320322,Vágner Leonardelli,1651,17/03/1985,31,0,0,5,0,183,70,4,3,2,3,4,1,2,1,2,2,1,3,4,8,8,10,3,10,10,12,9,12,9,10,10,11,12,15,9,9,9,10,14,7,11,8,12,9,12,12,12,7,12,20,15,10,9,12,7,10,11,11,6,5,7,11,15,12,12,13,14,11,D C,1,17,1,1,1,1,20,3,1,6,4,1,1,1,1
320325,Quintino,1651,13/04/1982,34,0,0,0,0,171,0,1,3,3,1,1,1,3,3,1,1,2,9,4,3,8,14,14,7,8,7,11,14,4,12,12,9,10,8,7,6,11,11,13,9,5,8,12,5,11,12,10,6,6,8,12,8,20,8,8,9,9,9,9,9,18,9,13,10,9,2,7,6,DM/M C,1,1,1,1,1,1,1,1,1,20,18,1,1,1,1
320362,Jádson,1651,05/10/1983,32,8,1,0,0,168,70,1,2,3,1,2,1,2,2,2,1,1,16,14,14,14,17,15,9,14,7,9,17,17,7,15,15,13,7,14,14,17,15,15,14,11,14,13,12,13,12,14,9,7,8,13,12,20,12,9,8,15,13,4,14,11,14,16,16,16,15,15,2,M/AM RC,1,1,1,20,13,16,1,1,1,1,18,13,16,1,1
320364,Alan Faria,1651,21/03/1983,33,0,0,0,0,190,81,13,8,9,4,12,13,7,13,9,15,12,1,3,2,3,1,5,1,2,2,3,1,3,2,5,7,7,14,2,8,6,11,9,2,13,2,10,7,6,12,9,4,14,20,14,11,16,2,10,9,7,9,9,9,11,11,10,13,12,1,14,2,GK ,20,1,1,1,1,1,1,1,1,1,1,1,1,1,1
320450,Fernandinho,1651,13/01/1981,35,0,0,0,0,161,62,1,2,2,2,3,3,2,2,3,1,1,8,6,12,15,12,7,10,10,5,9,11,3,10,12,9,11,8,6,10,10,13,9,13,5,13,10,8,10,15,15,5,3,1,10,15,20,12,5,9,9,8,16,9,7,10,10,10,10,9,1,8,M/AM/S C,1,1,17,20,1,1,1,1,1,1,19,1,1,1,1
320468,Raulen,1651,19/09/1983,32,0,0,0,0,177,70,2,3,3,2,1,4,2,2,3,1,1,10,12,9,8,9,9,10,13,12,11,10,4,11,9,12,9,13,9,9,9,11,18,10,9,10,12,12,12,13,11,9,10,8,14,13,20,13,10,12,11,11,12,10,12,16,12,12,12,14,11,7,D/WB/DM/M RC,1,1,1,1,1,1,1,1,19,18,18,1,10,1,20
320551,Luiz Carlos,1651,27/07/1982,33,0,0,0,0,185,83,1,3,3,1,4,3,2,1,3,2,1,9,10,12,10,12,10,8,9,3,9,13,6,11,13,10,12,10,11,12,13,12,7,12,5,8,12,12,15,9,12,11,12,11,8,10,20,11,11,11,10,10,5,10,10,9,10,11,10,11,11,8,AM C,1,1,1,20,1,1,1,1,1,12,15,1,1,1,1
320552,Anderson,1651,13/04/1988,28,8,0,0,0,176,69,1,1,3,1,2,3,3,3,1,4,1,13,13,13,8,15,13,7,3,8,8,15,15,12,15,14,13,14,9,9,14,10,5,14,7,13,10,16,13,14,13,18,8,20,5,14,11,11,17,12,10,16,15,9,14,10,13,18,6,11,15,8,M C,1,1,1,15,11,10,1,1,1,12,20,12,8,1,1
320553,Denílson,1651,16/02/1988,28,0,0,0,0,178,73,3,3,1,1,2,4,1,2,2,2,1,12,12,13,11,14,12,10,14,5,10,14,8,12,14,15,12,13,11,10,13,11,9,9,9,12,11,13,12,12,13,10,9,15,18,10,20,16,12,10,17,10,7,8,14,15,13,9,12,14,6,6,DM/M C,1,1,1,1,1,1,10,1,1,20,19,7,10,1,1
320554,Luiz Carlos,1651,24/05/1988,28,0,0,0,0,191,86,10,12,11,10,13,10,12,12,10,8,14,3,3,1,1,6,5,1,1,1,3,2,3,2,7,10,13,12,7,6,9,15,16,3,7,1,11,10,9,11,12,10,17,20,11,12,5,5,12,10,8,7,10,10,11,12,9,10,9,5,4,5,GK ,20,1,1,1,1,1,1,1,1,1,1,1,1,1,1
320556,Danilo Fernandes,1651,03/04/1988,28,0,0,0,0,189,86,13,14,11,10,15,13,14,16,12,10,13,7,3,2,3,8,12,1,1,2,1,12,2,1,13,11,14,16,13,12,12,12,15,2,11,3,12,1,15,13,14,14,16,10,12,12,20,13,15,13,7,12,11,12,15,9,12,10,16,12,8,6,GK ,20,1,1,1,1,1,1,1,1,1,1,1,1,1,1
320557,Cris,1651,24/01/1988,28,0,0,1,0,188,76,3,1,1,3,2,3,2,1,2,2,1,1,6,7,8,9,1,12,8,11,11,9,8,12,7,12,10,11,7,11,9,8,7,1,10,10,11,12,12,9,9,13,14,9,13,9,20,13,13,10,11,8,10,11,14,11,14,9,11,1,13,3,D C,1,1,1,1,1,1,20,1,1,1,1,1,1,1,1
320560,Bruno Simões,1651,04/07/1988,27,0,0,0,0,186,84,2,1,2,3,2,2,3,2,2,2,2,1,7,4,6,8,1,13,5,6,13,9,14,13,8,15,11,13,7,9,8,8,13,7,11,6,11,16,15,10,9,14,12,10,12,9,20,12,13,9,11,4,5,12,6,12,5,8,10,7,8,8,D C,1,1,1,1,1,1,20,12,1,1,1,1,1,1,1
320562,Leumir,1651,17/04/1988,28,0,0,0,0,174,0,3,1,3,3,2,2,1,1,3,3,3,9,13,12,8,9,10,8,8,12,10,11,9,9,11,11,8,12,7,10,7,8,13,11,7,11,9,9,11,13,12,10,7,7,13,13,20,14,9,14,8,12,6,11,14,13,12,13,13,7,13,13,D/WB R,1,1,1,1,1,9,1,11,20,1,1,1,12,10,19
320568,Renan,1651,02/05/1988,28,0,0,0,0,164,59,3,3,2,1,1,1,1,2,3,3,1,8,10,11,7,11,12,5,11,7,1,10,7,3,13,12,10,9,8,8,7,6,8,14,6,11,4,8,9,15,14,7,5,10,10,12,20,7,5,10,12,5,5,17,7,14,15,10,14,11,11,6,M/AM C,1,1,12,20,1,1,1,1,10,12,18,1,10,1,10
320569,Renato Augusto,1651,08/02/1988,28,11,4,3,0,186,91,2,1,1,3,3,1,2,3,3,2,3,14,12,16,14,16,11,7,13,8,7,16,12,7,17,8,13,8,12,13,15,14,14,16,12,15,7,15,14,13,14,11,12,14,13,14,20,14,12,13,3,12,13,15,16,8,13,14,14,10,11,6,M/AM RLC,1,1,10,20,15,18,1,1,1,1,18,14,15,1,1
320570,Kerlon,1651,27/01/1988,28,0,0,7,8,167,66,1,2,3,2,4,2,1,1,2,2,2,14,14,15,12,12,15,7,12,5,7,13,13,9,15,12,11,8,11,6,13,12,9,15,5,12,5,9,8,13,13,6,6,7,3,12,20,9,8,5,7,10,20,13,6,9,5,11,6,6,10,14,AM/S C,1,1,18,20,1,5,1,1,1,1,13,1,1,1,1
320576,Igor Pessanha,1651,14/06/1988,28,0,0,50,37,180,79,1,3,2,1,2,3,2,3,2,3,2,7,9,11,10,10,7,9,9,2,4,8,12,4,11,9,10,12,9,8,9,9,16,12,10,13,4,8,8,13,11,9,8,10,14,13,20,10,11,8,9,4,13,9,7,12,10,13,11,1,8,2,AM/S C,1,1,20,18,1,1,1,1,1,1,1,1,1,1,1
320577,Lenny,1651,23/03/1988,28,0,0,0,0,171,68,1,1,1,3,1,2,1,1,1,2,3,2,9,14,8,12,9,6,6,6,4,10,14,5,15,14,10,11,7,6,12,9,8,18,2,13,6,9,12,15,15,5,4,8,7,14,20,11,5,10,5,12,17,12,7,12,5,7,7,5,16,15,S ,1,1,20,8,11,14,1,1,1,1,1,1,9,1,1
320587,Ricardo Lobo,1651,20/05/1984,32,0,0,0,0,177,73,1,2,2,1,2,1,1,1,1,3,1,4,7,8,13,12,5,12,8,3,4,8,12,3,10,14,11,14,10,9,8,10,12,14,6,13,4,13,11,12,11,12,13,10,13,11,20,11,10,7,8,11,8,5,12,12,14,12,8,14,14,15,S ,1,1,20,1,1,1,1,1,1,1,1,1,1,1,1
320608,Eduardinho,1651,29/11/1983,32,0,0,0,0,176,72,1,1,2,1,3,3,1,2,1,3,3,10,10,11,7,12,11,5,11,1,5,11,5,7,11,12,6,1,5,6,9,10,13,13,4,12,7,13,15,14,12,8,6,10,15,14,20,13,10,14,13,14,9,17,10,13,12,10,14,10,14,6,M/AM C,1,1,7,20,1,1,1,1,1,1,16,10,10,1,1
320642,Vinícius Frasson,1651,31/08/1984,31,0,0,0,0,183,73,3,3,3,2,2,2,2,3,3,1,1,8,6,9,10,9,8,8,10,2,8,9,14,7,11,9,9,11,9,9,11,11,8,14,12,12,10,14,10,9,11,8,9,14,9,10,20,9,9,8,9,3,7,9,8,14,3,5,9,11,16,15,AM/S C,1,1,18,20,1,1,1,1,1,1,15,1,1,1,1
320648,Geílson,1651,10/04/1984,32,0,0,0,0,184,79,2,3,1,3,2,1,3,3,3,3,3,2,6,8,12,9,8,13,10,5,8,9,11,8,8,12,13,13,11,11,7,7,13,11,7,12,6,11,12,12,10,12,12,10,16,12,20,12,14,11,5,13,10,10,14,14,11,12,14,7,12,10,S ,1,1,20,10,1,1,1,1,1,1,1,1,1,1,1
320755,Thiago Couto,1651,24/10/1979,36,0,0,0,0,183,0,1,1,2,3,2,1,1,3,1,2,2,9,5,4,6,7,5,15,5,4,14,9,3,14,5,4,13,10,9,8,5,15,10,7,12,6,14,5,9,14,12,10,7,1,15,12,20,11,11,10,15,9,10,10,17,11,9,10,13,4,14,1,D C,1,1,1,1,1,1,20,1,1,1,1,1,1,1,1
320759,Marcelinho,1651,28/09/1978,37,0,0,0,0,172,68,3,2,2,1,1,1,2,2,2,2,2,11,11,12,11,13,12,7,11,5,4,13,12,6,13,7,11,10,12,11,12,12,15,14,5,13,8,11,9,8,11,14,6,7,14,8,20,8,5,13,10,12,12,12,11,15,10,14,14,14,14,11,AM/S RC,1,1,20,18,11,17,1,1,5,1,13,7,14,1,8
320763,Abuda,1651,28/03/1986,30,0,0,0,0,175,73,1,2,4,3,2,3,2,2,1,4,1,5,6,12,12,12,5,13,11,5,4,9,12,4,14,9,8,10,11,5,8,7,11,14,6,12,4,7,10,13,13,10,6,10,12,12,20,4,10,10,9,14,6,8,5,14,5,7,8,13,13,12,S ,1,1,20,10,1,1,1,1,1,1,1,1,1,1,1
320766,Júnior,1651,28/02/1986,30,0,0,0,0,182,80,3,2,2,2,2,3,2,1,2,3,3,11,10,11,10,12,13,10,12,2,11,11,13,10,12,10,9,12,10,12,14,8,12,14,7,7,9,13,10,10,10,7,9,10,14,9,20,13,12,11,11,10,11,13,11,11,13,14,6,12,4,15,DM/M C,1,1,1,12,1,1,1,1,1,20,18,1,1,1,1
320767,Leo Matos,1651,02/04/1986,30,0,0,0,0,182,77,1,3,3,3,1,2,2,4,1,1,2,12,14,12,13,11,10,15,13,8,9,10,9,12,12,12,11,11,11,12,9,11,16,11,11,12,11,12,13,14,12,15,12,8,14,15,20,17,15,14,13,10,5,17,11,12,8,9,17,13,10,8,D/WB/M R,1,1,1,1,1,14,1,14,20,1,1,7,19,10,18
320772,Guilherme Siqueira,1651,28/04/1986,30,0,0,0,0,184,76,3,3,1,3,2,2,2,4,3,3,3,14,16,15,10,15,10,10,12,8,11,14,18,11,16,10,14,11,15,13,12,13,16,16,10,14,13,14,13,12,13,14,10,20,10,14,6,13,12,13,10,18,17,12,14,16,15,15,16,14,14,15,D/WB L,1,1,1,1,1,1,1,20,1,1,1,12,1,19,1
320774,Dinélson,1651,02/04/1986,30,0,0,0,0,166,63,3,2,1,2,2,2,3,3,2,2,2,13,13,12,10,9,14,8,12,4,5,12,14,5,12,11,12,10,10,10,12,10,8,15,8,11,5,11,9,12,11,8,6,8,10,11,20,12,7,9,10,10,14,11,11,12,13,7,11,8,13,15,AM C,1,1,1,20,12,12,1,1,1,1,15,1,1,1,1
320809,Catê,1651,08/03/1979,37,0,0,0,0,180,75,2,2,3,3,2,2,1,4,1,1,1,12,9,10,8,10,9,10,8,10,6,13,14,4,12,10,11,12,8,10,11,11,8,8,6,10,8,6,8,10,10,11,11,8,10,10,20,9,11,8,6,11,8,11,10,13,9,8,8,6,7,10,AM/S RLC,1,1,17,20,16,17,1,1,1,1,14,7,10,1,1
320823,Brito,1651,21/09/1982,33,0,0,0,0,179,72,2,2,2,1,2,1,1,4,2,2,1,14,15,15,13,13,14,10,13,7,8,13,16,7,14,10,12,10,11,11,14,12,13,14,17,12,8,11,11,10,11,11,8,20,12,11,5,10,8,12,6,12,7,11,14,12,16,12,16,12,13,6,M/AM LC,1,1,10,17,18,14,1,1,1,10,18,20,10,1,1
320979,Luís Ricardo,1651,21/01/1984,32,0,0,0,0,184,76,1,3,3,1,1,3,3,1,3,1,2,9,14,14,12,12,4,13,11,11,13,12,8,8,13,10,13,11,12,12,14,12,12,13,13,13,13,13,13,14,14,14,12,7,13,14,20,13,12,13,10,12,10,14,18,12,11,10,11,11,14,8,D/WB/M/AM R,1,1,1,1,1,17,1,1,20,1,1,1,17,1,17
320987,Esley,1651,15/04/1979,37,0,0,0,0,176,70,2,3,2,2,3,1,3,1,1,4,1,11,10,12,10,11,10,8,11,6,8,12,13,7,11,11,9,11,11,10,9,11,11,14,11,12,7,9,10,13,11,10,7,11,14,12,20,13,11,12,10,11,9,14,12,13,9,11,11,6,12,9,DM/M/AM C,1,1,13,20,11,11,1,1,1,17,18,8,8,1,1
320999,André Cunha,1651,08/04/1979,37,0,0,0,0,179,71,4,2,3,1,2,2,1,2,1,2,1,7,10,11,9,11,7,10,10,11,10,11,11,10,11,13,10,12,10,10,10,10,13,12,11,11,10,12,11,10,12,12,9,8,10,10,20,10,9,12,10,11,7,18,13,11,11,12,11,13,12,4,D/WB/M/AM RC,1,1,1,20,10,17,1,10,19,1,10,10,17,10,18
321029,Laécio,1651,07/03/1981,35,0,0,0,0,181,70,3,1,1,2,2,3,2,3,2,4,1,7,11,12,11,13,10,11,10,8,6,12,12,6,13,10,11,10,12,11,11,11,9,12,5,14,8,11,12,13,14,10,10,8,13,13,20,13,9,10,10,8,7,12,11,12,5,10,10,14,13,11,S ,1,1,20,10,11,14,1,1,1,1,1,1,7,1,1
321044,Éder Monteiro,1651,21/09/1983,32,0,0,0,0,183,77,1,2,1,2,1,2,3,1,2,3,2,6,6,6,6,8,6,13,7,10,13,8,10,12,7,14,12,12,11,11,6,10,12,5,9,3,12,11,12,10,9,12,14,10,12,9,20,13,12,10,12,12,7,8,11,12,11,12,11,8,6,6,D C,1,1,1,1,1,1,20,1,1,10,1,1,1,1,1
321081,Fred,1651,03/10/1983,32,39,18,0,0,185,90,4,2,3,2,3,4,3,2,4,2,1,7,9,12,16,15,12,16,13,7,6,14,16,6,13,15,16,14,15,12,13,13,13,14,16,13,11,14,14,11,10,13,14,17,7,10,20,11,14,12,14,16,12,5,2,12,18,13,8,9,11,12,S ,1,1,20,1,1,1,1,1,1,1,1,1,1,1,1
321095,Cléber,1651,09/07/1983,32,0,0,0,0,185,80,3,3,3,3,3,3,3,1,1,1,1,7,7,7,8,10,10,16,10,10,14,9,10,13,10,13,11,14,12,12,9,10,13,6,11,7,14,14,13,11,11,15,14,8,13,10,20,14,13,12,9,11,8,7,12,12,10,13,12,9,13,4,D C,1,18,1,1,1,1,20,1,1,14,8,1,1,1,1
321111,Tiago Cavalcanti,1651,05/09/1984,31,0,0,0,0,182,81,1,2,1,1,1,2,2,1,1,3,1,5,11,12,12,12,5,10,11,2,3,10,15,3,13,9,12,13,12,8,9,9,11,13,4,9,5,7,10,13,12,12,10,9,13,13,20,11,12,13,10,12,10,8,12,13,7,12,11,13,12,7,S ,1,1,20,1,1,1,1,1,1,1,1,1,1,1,1
321116,Gilsinho,1651,13/04/1981,35,0,0,0,0,172,72,3,1,1,2,3,3,3,3,1,2,3,5,6,7,9,15,8,5,13,5,10,15,2,6,13,9,10,8,8,9,15,15,4,7,8,10,9,9,13,8,10,9,8,9,8,9,20,10,7,9,9,9,9,9,9,10,12,12,10,1,9,3,M C,1,1,1,1,1,1,1,1,1,1,20,1,1,1,1
321157,Ciel,1651,31/03/1982,34,0,0,0,0,178,72,2,3,2,1,1,1,1,3,3,1,2,13,12,13,11,12,14,9,10,1,4,11,13,5,13,15,10,13,11,8,11,10,14,17,3,13,6,6,9,13,14,8,8,11,13,13,20,11,8,14,8,15,7,15,10,11,12,15,5,4,6,16,AM/S RLC,1,1,20,17,18,19,1,1,1,1,12,11,10,1,1
321191,Valdiram,1651,30/10/1982,33,0,0,0,0,174,71,1,1,3,1,2,2,2,3,3,1,2,9,9,12,11,11,10,11,10,10,5,9,12,7,12,11,8,13,8,10,11,7,7,13,5,12,8,6,6,14,13,12,7,9,7,15,20,13,12,10,9,13,16,11,4,6,11,15,1,11,4,20,S ,1,1,20,5,1,9,1,1,1,1,1,1,1,1,1
321204,Fabio Bahia,1651,02/11/1983,32,0,0,0,0,170,71,2,2,4,1,2,1,3,1,4,1,1,5,11,11,8,10,9,7,8,10,13,10,10,12,12,13,12,13,11,11,10,10,15,12,13,13,11,13,14,13,12,7,4,9,15,13,20,12,6,12,10,12,6,18,12,12,8,13,15,8,13,7,D/WB/DM/M RC,1,1,1,12,7,9,1,5,18,19,20,11,15,8,16
321224,Marco Antônio,1651,09/11/1984,31,0,0,0,0,182,79,1,3,1,1,3,3,2,3,3,1,3,13,12,12,10,13,14,9,13,9,11,13,14,10,13,10,12,9,11,11,14,12,14,13,10,12,11,12,12,13,14,13,10,10,11,12,20,11,12,9,13,12,12,12,9,10,12,11,12,10,12,7,DM/M RLC,1,1,1,15,10,15,1,1,1,17,20,15,18,1,1
3300156,Élvis,1651,30/03/1979,37,0,0,0,0,172,68,2,2,2,3,4,1,2,2,2,1,1,9,11,12,10,11,8,10,5,5,11,12,8,7,10,5,11,10,7,10,9,10,17,9,6,10,8,10,9,13,13,8,11,20,11,10,9,10,8,10,7,7,12,7,7,11,4,9,6,11,10,12,M/AM LC,1,1,1,20,16,14,1,1,1,1,18,14,12,1,1
3300160,Rodrigo,1651,27/08/1980,35,0,0,0,0,181,75,2,1,1,3,3,2,1,3,1,3,3,5,9,9,8,11,13,13,13,8,14,12,13,14,11,15,13,15,14,14,11,13,12,15,16,11,14,12,12,12,12,14,14,6,15,12,20,13,14,15,13,13,14,13,7,14,11,16,12,10,8,10,D C,1,1,1,1,1,1,20,10,14,1,1,1,1,1,1
3300194,Diego Cavalieri,1651,01/12/1982,33,3,0,0,0,191,87,11,14,13,6,14,8,14,15,14,14,12,1,2,3,2,12,1,10,3,2,3,11,2,1,12,11,13,16,12,14,6,13,15,5,14,5,13,13,14,13,17,15,15,20,16,10,5,13,13,13,7,17,5,12,6,14,19,15,16,14,14,5,GK ,20,1,1,1,1,1,1,1,1,1,1,1,1,1,1
3300209,Mancini,1651,01/08/1980,35,6,0,9,0,183,87,2,1,2,3,2,3,3,3,1,2,1,14,12,12,11,12,13,4,13,13,6,11,14,8,13,10,12,9,10,9,12,10,7,15,12,12,7,9,9,12,11,9,8,14,5,11,20,7,9,6,12,12,15,15,17,8,12,10,5,15,15,7,AM/S RLC,1,1,19,20,18,18,1,1,1,1,1,1,1,1,1
3300213,Wendel,1651,08/04/1982,34,0,0,0,0,184,73,1,3,3,3,2,2,3,3,3,1,2,13,13,13,10,13,13,10,13,9,9,12,15,10,13,10,12,12,12,11,13,12,12,13,12,13,9,12,12,13,13,11,11,20,13,13,13,14,11,13,10,15,10,18,15,16,12,11,16,12,12,6,M LC,1,1,1,1,15,10,1,15,1,1,19,20,10,10,1
3300229,Léo Lima,1651,14/01/1982,34,0,0,4,0,187,84,3,1,4,2,2,1,3,1,3,3,4,10,10,14,11,14,12,11,13,7,10,14,14,10,15,11,11,11,14,10,13,12,13,18,11,11,11,12,12,10,10,8,14,8,13,10,20,12,14,11,11,13,10,15,8,13,11,13,17,13,13,16,DM/M/AM RLC,1,1,10,19,17,16,1,6,8,18,20,14,15,6,8
3300234,Paulão,1651,06/05/1982,34,0,0,0,0,188,88,1,1,3,2,3,2,3,3,2,3,3,2,4,6,7,8,9,14,7,8,13,6,9,11,8,13,9,9,11,13,7,12,15,6,10,6,13,13,13,9,6,15,12,7,13,11,20,13,14,15,12,13,12,8,10,12,14,11,13,14,14,5,D C,1,1,1,1,1,1,20,1,1,1,1,1,1,1,1
3300237,Rodrigão,1651,20/11/1980,35,0,0,0,0,188,82,1,2,2,1,3,2,3,4,3,1,1,3,1,3,2,7,4,12,5,1,12,7,5,11,6,4,11,10,3,8,3,12,9,4,8,6,12,6,7,9,14,7,13,20,11,11,6,11,13,7,10,11,10,10,12,13,10,11,11,1,16,7,D C,1,1,1,1,1,1,20,10,1,1,1,1,1,1,1
3300310,Cicinho,1651,24/06/1980,36,16,1,0,0,172,68,2,2,1,2,3,3,2,4,2,4,4,15,17,12,9,14,10,7,9,12,8,14,9,11,14,11,13,13,12,12,14,13,15,16,10,14,7,12,9,11,11,10,6,9,14,10,20,10,8,14,13,16,8,12,5,16,13,16,10,8,12,13,D/WB/M R,1,1,1,1,1,13,1,1,19,1,1,1,16,1,20
3300405,Marlon,1651,13/09/1982,33,0,0,0,0,185,82,3,2,2,3,2,4,3,4,3,3,4,3,5,1,5,7,1,13,5,1,6,4,1,10,6,9,13,9,7,10,2,13,9,8,9,6,13,6,7,13,8,7,14,10,14,13,20,14,15,9,9,9,9,9,9,11,14,10,9,9,12,1,D C,1,1,1,1,1,1,20,1,1,1,1,1,1,1,1
3300416,Cássio,1651,12/08/1980,35,0,0,0,0,186,79,13,12,13,6,13,15,11,16,15,12,14,5,2,3,3,8,10,4,1,3,1,10,3,1,8,11,11,13,12,14,8,10,14,2,13,3,15,12,14,11,14,10,14,4,12,13,20,11,13,13,11,13,10,11,12,11,17,11,16,18,16,6,GK ,20,1,1,1,1,1,1,1,1,1,1,1,1,1,1
3300480,Jorge Wágner,1651,17/11/1978,37,0,0,0,0,178,73,3,1,2,3,2,1,1,1,2,4,1,12,12,10,10,13,12,6,11,4,9,12,15,9,12,10,11,8,12,8,10,12,17,12,13,12,11,11,10,9,10,11,8,20,12,9,14,11,10,14,7,12,9,13,11,12,11,15,11,11,16,5,M/AM LC,1,1,1,20,18,1,1,12,1,10,18,19,1,14,1
3300564,Leonardo Silva,1651,22/06/1979,37,0,0,0,0,192,80,1,2,1,3,2,3,1,3,2,1,1,12,8,11,9,13,4,17,5,5,15,13,12,15,13,15,16,16,14,14,13,13,15,5,16,10,16,14,15,10,10,13,17,8,16,9,20,12,13,11,11,17,8,6,12,12,11,14,16,10,14,6,D C,1,1,1,1,1,1,20,1,1,1,1,1,1,1,1
3300632,Lugão,1651,30/03/1978,38,0,0,0,0,187,84,13,9,13,6,12,13,12,11,6,10,7,7,3,2,2,4,9,1,1,3,3,1,2,3,4,10,13,15,6,13,7,12,11,3,10,2,12,8,7,13,12,8,15,10,11,12,20,5,7,15,9,17,6,10,20,12,10,9,9,5,9,4,GK ,20,1,1,1,1,1,1,1,1,1,1,1,1,1,1
3300665,Germano,1651,21/03/1981,35,0,0,0,0,177,78,2,2,2,1,1,1,1,3,4,1,1,7,9,10,8,11,7,12,10,8,14,12,13,13,11,15,12,14,14,13,11,12,15,8,13,11,13,14,15,13,13,13,11,20,16,12,10,14,12,14,13,12,8,11,11,13,14,13,16,8,14,10,DM/M C,1,6,1,1,1,1,9,11,1,20,18,11,1,8,1
3300692,Rodrigo Souto,1651,09/02/1983,33,0,0,0,0,183,79,2,3,1,2,1,3,1,2,2,2,4,7,11,11,10,11,8,12,12,13,12,13,9,10,12,10,12,11,9,10,12,12,14,12,12,11,10,12,11,11,12,9,10,13,12,11,20,12,9,11,10,12,5,11,11,11,11,13,10,9,11,11,DM/M C,1,1,1,4,1,1,1,1,1,20,17,1,1,1,1
3300707,Jeda,1651,15/04/1979,37,0,0,0,0,176,75,3,1,2,3,4,3,2,2,1,1,1,9,10,10,9,10,5,11,9,9,1,11,11,5,11,10,10,12,12,9,11,10,14,16,8,11,9,11,8,10,10,9,9,10,16,10,20,9,9,12,6,12,7,13,15,8,14,14,19,14,12,5,S ,1,1,20,10,1,10,1,1,1,1,1,1,1,1,1
3300732,Marcos,1651,21/06/1976,40,0,0,0,0,187,88,13,12,10,9,11,13,12,13,13,12,12,9,1,3,2,1,11,1,2,2,2,9,3,3,3,11,13,11,4,11,9,14,12,3,15,3,12,10,9,9,11,5,12,10,7,8,20,10,14,11,11,3,11,11,15,13,16,15,13,14,14,5,GK ,20,1,1,1,1,1,1,1,1,1,1,1,1,1,1
3300795,Diego,1651,11/05/1979,37,0,0,0,0,188,88,13,11,11,3,13,12,12,14,12,14,11,3,1,3,2,8,6,7,3,2,1,10,2,2,10,8,11,13,10,10,7,11,13,2,7,3,12,12,13,8,10,13,12,20,14,9,4,11,12,11,3,12,7,10,13,11,16,12,18,18,18,4,GK ,20,1,1,1,1,1,1,1,1,1,1,1,1,1,1
3300799,Chicão,1651,11/07/1981,34,0,0,0,0,180,68,3,2,1,2,1,3,1,2,3,2,2,4,9,11,12,11,6,12,14,5,11,13,11,11,13,11,11,13,11,13,11,13,14,11,16,11,12,12,12,11,13,8,9,10,13,12,20,13,7,15,12,13,8,10,11,15,11,15,17,13,15,14,DM/M C,1,1,1,7,1,1,1,1,1,20,18,1,1,1,1
3300941,Márcio Hahn,1651,03/07/1977,38,0,0,0,0,179,78,1,1,2,2,4,1,1,3,2,2,2,5,9,9,11,10,8,11,13,11,12,12,8,10,10,15,12,19,7,13,9,11,14,12,12,10,14,16,14,12,13,8,10,8,12,11,20,12,9,13,12,11,10,15,10,8,14,13,16,12,12,10,DM/M RC,1,1,1,1,1,1,7,1,6,19,20,1,17,1,12
3300948,Mauro,1651,30/10/1977,38,0,0,0,0,197,80,10,11,9,6,12,9,12,13,13,11,12,5,1,3,1,5,7,1,2,1,2,3,3,3,10,10,7,16,10,9,6,11,11,2,16,1,12,4,14,13,11,10,15,6,14,12,20,12,12,11,10,10,10,10,11,9,11,13,14,15,14,8,GK ,20,1,1,1,1,1,1,1,1,1,1,1,1,1,1
3300959,Fausto,1651,21/03/1979,37,0,0,0,0,179,75,1,2,1,2,3,4,2,1,1,2,2,2,9,11,9,10,9,11,11,10,12,12,12,11,10,13,10,13,10,12,9,11,18,11,15,10,12,12,11,11,11,10,9,8,13,11,20,10,11,15,10,12,10,15,13,12,14,15,15,10,8,7,DM/M C,1,1,1,11,1,5,12,1,10,20,19,1,10,1,10
3301000,Tiago Bernardi,1651,12/02/1979,37,0,0,0,0,186,79,3,1,1,3,2,2,2,2,1,1,1,6,5,6,6,8,9,14,8,9,12,10,5,11,12,10,14,13,11,12,7,5,12,14,14,8,10,15,15,11,8,16,15,4,16,11,20,14,14,5,13,10,5,18,11,11,8,12,13,11,10,12,D/DM C,1,1,1,1,1,1,18,1,1,20,1,1,1,1,1
3301003,Gustavo,1651,19/02/1982,34,0,0,0,0,186,84,4,3,3,1,2,3,2,2,3,2,3,1,7,6,8,6,6,15,6,6,14,10,9,13,10,11,13,15,13,9,9,11,13,10,13,11,12,13,13,11,11,8,14,11,14,11,20,13,14,12,14,12,3,13,5,13,10,10,13,11,11,14,D C,1,11,1,1,1,1,20,1,1,1,1,1,1,1,1
3301017,Roberto,1651,01/07/1979,37,0,0,0,0,193,91,11,13,15,3,14,6,13,14,9,14,6,1,1,1,3,6,4,1,1,1,1,1,5,1,11,13,10,11,13,11,10,13,11,2,14,3,11,11,14,10,9,13,13,8,14,10,20,15,13,12,11,14,4,10,11,4,18,16,15,14,14,6,GK ,20,1,1,1,1,1,1,1,1,1,1,1,1,1,1
3301089,Fábio Júnior,1651,22/11/1977,38,3,0,0,0,186,76,3,3,3,3,3,1,3,1,2,2,1,4,9,10,13,11,11,12,10,2,3,10,14,5,13,10,12,9,12,13,11,12,10,14,6,14,7,12,13,11,11,13,11,8,13,11,20,10,13,12,6,15,8,10,13,13,15,12,10,13,12,8,S ,1,1,20,12,5,5,1,1,1,1,1,1,1,1,1
3301144,Biro Biro,1651,23/06/1974,42,0,0,0,0,179,0,1,2,1,3,2,2,1,3,2,4,3,6,8,11,7,11,9,3,6,1,4,14,1,8,14,8,6,1,10,7,13,7,4,13,15,8,5,8,11,12,10,6,7,20,15,11,5,7,5,8,8,2,8,8,11,9,11,11,10,11,7,8,M/AM LC,1,1,7,20,17,8,1,1,1,1,18,16,7,1,1
3301164,Warley,1651,13/02/1978,38,2,0,0,0,180,73,2,1,3,1,4,3,1,15,3,1,2,7,13,12,11,13,9,10,10,1,4,11,9,4,14,12,9,12,9,7,9,8,14,14,6,13,7,8,6,9,9,6,10,11,12,11,20,10,8,12,5,10,12,11,14,10,12,11,13,14,16,11,AM/S RLC,1,1,20,16,19,18,1,1,1,1,1,1,1,1,1
3301167,Adriano Gabiru,1651,11/08/1977,38,2,0,0,0,175,67,2,1,3,2,1,2,4,3,1,2,1,5,12,12,10,12,11,4,11,4,3,13,11,5,13,4,9,7,8,7,11,10,16,14,5,9,7,9,8,11,10,8,5,10,13,11,20,10,7,11,13,17,16,15,11,11,10,11,8,12,18,18,AM C,1,1,6,20,14,14,1,1,1,1,15,8,11,1,1
3301195,Fumagalli,1651,05/10/1977,38,0,0,0,0,176,72,1,1,2,1,2,3,1,3,3,1,1,13,12,10,13,12,14,8,11,4,4,12,17,4,12,10,12,11,11,8,11,12,11,14,12,14,8,10,11,12,13,9,7,10,13,12,20,10,9,12,11,13,11,14,16,13,10,16,12,8,12,13,M/AM/S RC,1,1,18,20,1,15,1,1,1,1,18,1,10,1,1
3301214,Gil,1651,13/09/1980,35,4,1,0,0,172,68,4,1,1,1,1,1,3,2,3,3,1,9,10,13,8,13,9,8,10,8,1,12,11,1,13,9,9,8,7,8,10,8,15,14,6,10,1,11,7,12,12,4,3,20,10,14,8,12,7,10,18,14,13,11,12,11,16,14,14,13,11,13,AM/S LC,1,1,20,15,18,1,1,1,1,1,10,11,1,1,1
3301221,Danilo,1651,11/06/1979,37,0,0,0,0,186,80,1,3,2,3,2,2,4,3,3,3,1,7,15,13,13,16,6,15,14,8,12,15,9,11,16,12,13,15,15,13,16,16,15,15,14,13,13,15,16,8,8,16,15,20,6,9,15,11,12,14,11,16,13,14,11,12,13,16,13,10,12,10,M/AM RLC,1,1,13,20,19,16,1,1,1,1,16,10,9,1,1
3301242,Júlio César,1651,03/09/1979,36,87,0,0,0,186,79,15,13,15,14,15,14,16,15,12,14,12,1,1,5,1,12,1,10,1,1,1,12,1,1,12,8,14,17,14,13,6,14,15,7,13,2,15,14,14,7,13,13,15,20,15,8,5,15,12,13,2,10,12,1,15,11,15,12,17,18,16,8,GK ,20,1,1,1,1,1,1,1,1,1,1,1,1,1,1
3301243,Luiz Alberto,1651,01/12/1977,38,1,0,0,0,186,84,2,4,2,3,3,2,4,3,3,1,2,5,11,8,9,6,7,15,7,5,11,9,10,12,5,15,9,14,12,10,6,11,18,5,16,9,11,13,12,10,4,12,13,9,18,10,20,8,12,14,14,13,11,6,12,13,11,16,12,10,8,7,D C,1,1,1,1,1,1,20,1,1,1,1,1,1,1,1
3301249,Juan,1651,01/02/1979,37,80,8,0,0,182,74,1,2,4,1,2,1,3,2,1,2,2,6,7,9,7,13,6,16,7,6,16,14,10,16,15,12,15,14,13,11,10,12,15,10,12,6,14,15,12,10,11,13,13,8,7,11,20,12,15,10,7,16,16,10,15,12,14,14,15,14,16,2,D C,1,10,1,1,1,1,20,1,1,1,1,1,1,1,1
3301276,Araújo,1651,08/08/1977,38,3,1,0,0,172,62,3,3,1,1,2,3,2,1,3,2,3,9,11,11,11,10,8,10,10,8,3,10,11,4,10,8,11,12,10,12,9,10,16,12,11,12,4,12,12,12,11,6,6,20,12,11,12,11,6,13,7,14,13,10,8,11,18,19,15,10,20,12,AM/S L,1,1,20,13,17,10,1,1,1,1,10,13,5,5,1
3301283,Reinaldo,1651,14/03/1979,37,0,0,0,0,183,77,2,2,1,2,3,1,3,3,3,2,2,6,9,10,12,12,9,12,11,8,5,11,13,5,12,11,13,11,12,10,9,9,12,13,13,13,12,11,12,10,11,11,10,13,8,11,20,9,11,13,11,13,10,13,14,12,11,12,6,12,7,11,S ,1,1,20,12,8,12,1,1,1,1,1,1,1,1,1
3301294,Ronaldinho Gaúcho,1651,21/03/1980,36,99,34,21,16,182,80,2,3,3,2,2,3,1,3,3,2,1,15,17,18,12,18,19,11,15,7,4,16,17,4,20,8,14,9,12,9,20,16,8,20,13,15,4,9,7,9,9,12,11,13,7,9,20,7,12,10,15,9,13,14,16,8,14,14,6,8,15,10,AM RLC,1,1,10,20,19,15,1,1,1,1,12,12,5,1,1
3301316,Hilton,1651,13/09/1977,38,0,0,0,0,180,78,1,3,1,1,3,3,1,2,1,1,2,5,9,11,7,12,7,15,10,9,14,16,10,14,12,12,16,14,15,13,11,14,16,6,15,9,17,15,12,9,11,15,11,8,11,8,20,12,14,15,12,14,8,10,15,15,14,14,18,13,13,8,D C,1,16,1,1,1,1,20,1,1,1,1,1,1,1,1
3301317,Lúcio Flávio,1651,03/02/1979,37,0,0,0,0,175,69,1,3,1,1,1,3,1,3,2,4,1,13,13,12,13,15,15,9,14,8,10,14,15,8,16,9,13,11,13,11,15,10,16,12,16,13,9,10,10,9,10,12,8,15,11,9,20,11,7,11,8,10,11,10,12,13,14,18,13,8,20,11,M/AM C,1,1,1,20,1,1,1,1,1,1,17,1,1,1,1
3301327,Souza,1651,04/02/1979,37,0,0,0,0,176,77,3,3,1,4,2,3,3,2,1,3,2,12,12,11,9,11,12,8,11,12,8,12,11,7,11,15,10,9,9,9,10,9,12,12,5,11,8,11,10,12,11,8,6,11,12,11,20,10,8,10,14,11,7,14,9,10,12,11,13,13,5,14,M/AM RC,1,1,1,20,11,18,1,1,10,14,16,11,16,1,10
3301328,Mazinho,1651,10/08/1978,37,0,0,0,0,180,75,3,2,1,3,2,3,2,3,2,1,3,4,4,7,7,7,12,11,10,4,13,10,3,11,8,12,9,13,7,9,8,9,15,10,9,8,13,8,12,9,9,10,10,20,12,11,7,10,10,12,11,10,9,9,15,11,14,10,12,11,11,10,D/DM C,1,12,1,1,1,1,20,1,1,16,4,1,1,1,1
3301420,Alessandro,1651,21/09/1977,38,3,0,0,0,173,68,1,3,2,4,3,3,1,3,1,2,2,12,10,10,10,11,12,12,11,11,13,13,5,12,12,15,13,14,6,11,6,12,16,5,14,9,12,11,13,11,9,10,7,15,14,12,20,10,11,12,12,8,13,7,14,8,9,8,11,7,13,12,D R,2,1,1,1,1,1,10,5,20,1,1,1,4,1,13
3301444,Carlos Alberto,1651,24/01/1978,38,0,0,8,0,170,66,3,2,3,1,3,2,2,2,3,3,3,8,10,12,11,10,9,11,11,12,13,12,13,13,11,14,13,14,12,11,9,10,14,12,12,11,14,14,12,8,11,13,5,7,13,8,20,10,11,14,12,16,11,14,11,11,12,14,15,9,13,11,DM/M C,1,1,1,7,1,8,1,1,10,20,19,1,11,1,11
3301461,Rafael,1651,03/03/1982,34,0,0,0,0,187,80,13,12,15,13,12,17,14,15,9,10,11,8,2,1,2,9,11,2,3,1,3,8,3,2,9,10,12,13,11,9,7,9,10,7,9,5,15,8,12,11,15,14,16,5,13,10,20,12,12,8,3,13,12,11,13,9,14,10,15,9,14,8,GK ,20,1,1,1,1,1,1,1,1,1,1,1,1,1,1
3301493,Magno Alves,1651,13/01/1976,40,3,0,0,0,176,72,2,3,2,2,2,3,3,3,2,1,2,5,8,12,14,14,10,14,12,3,4,11,13,5,13,14,13,13,14,14,12,12,16,17,12,15,6,7,13,11,13,13,8,16,14,12,20,10,10,16,6,14,6,13,14,13,16,16,15,9,11,13,AM/S RC,1,1,20,19,10,15,1,1,1,1,1,1,1,1,1
33024494,Guilherme,1651,20/07/1991,24,0,0,0,0,179,79,2,3,2,2,1,2,2,1,1,3,1,3,6,13,10,14,4,10,5,2,4,10,6,5,15,11,10,11,8,9,8,11,9,12,5,13,4,9,11,14,12,11,10,20,14,14,11,9,9,14,10,9,4,10,11,16,13,11,17,12,10,2,D/WB/M L,1,1,12,1,14,1,1,18,1,1,1,16,1,20,1
33025476,Cassiano,1651,02/11/1979,36,0,0,0,0,176,0,3,1,4,1,2,2,2,3,3,1,3,6,7,6,5,8,7,7,7,3,7,8,6,9,7,7,7,10,8,6,9,9,9,8,11,7,9,8,10,7,7,8,8,20,10,7,14,8,6,7,10,8,11,14,10,9,9,8,7,10,12,2,DM/M C,1,1,10,14,14,12,12,14,12,18,20,14,12,14,12
33031784,Denis,1651,29/12/1989,26,0,0,0,0,189,74,2,2,3,2,2,3,3,1,2,3,2,3,6,12,10,9,6,12,8,5,6,9,8,6,6,7,8,8,8,8,8,11,14,8,5,8,11,11,9,11,13,15,17,14,10,9,20,13,15,5,3,5,5,5,14,12,12,13,12,12,15,8,S ,1,1,20,1,1,1,1,1,1,1,1,1,1,1,1
33031851,Daniel Caumo,1651,08/03/1989,27,0,0,0,0,184,80,1,2,1,2,3,3,1,3,1,3,2,5,5,5,12,12,2,10,5,1,3,5,10,2,12,8,5,2,12,4,8,9,9,13,12,10,6,5,7,12,11,6,11,13,9,12,20,12,5,9,8,1,5,9,15,12,10,10,11,5,6,4,AM/S C,1,1,20,20,1,1,1,1,1,1,1,1,1,1,1
33048608,Diego Assis,1651,14/09/1987,28,0,0,0,0,165,65,1,2,3,3,3,1,2,1,3,2,1,10,9,14,12,14,12,10,8,5,8,14,12,8,15,10,11,9,11,12,15,11,16,16,4,13,5,12,11,13,14,12,4,12,11,12,20,12,6,11,7,18,10,13,18,16,17,15,14,14,13,2,M/AM/S C,1,1,18,20,1,1,1,1,1,10,18,1,1,1,1
33048936,Dudu,1651,05/04/1991,25,0,0,0,0,178,75,2,1,1,3,2,1,1,1,3,3,2,8,9,11,7,12,11,7,9,6,7,11,8,7,12,8,10,8,12,9,11,9,2,12,6,10,8,10,10,12,11,9,7,20,9,12,10,10,7,11,7,9,9,9,12,11,12,8,12,7,13,6,D/WB/M LC,1,1,1,14,12,1,1,16,1,10,20,18,1,16,1
33051278,Filipe Monteiro de Mello,1651,13/04/1991,25,0,0,0,0,180,65,1,3,2,2,1,2,2,4,2,1,2,9,9,11,10,12,9,8,9,7,8,10,4,10,12,9,10,11,9,9,10,11,11,11,9,12,7,5,8,9,10,10,10,12,9,8,20,10,8,10,4,3,9,10,12,10,8,11,11,4,1,5,DM/M C,1,1,10,12,8,8,1,1,1,20,18,12,12,1,1
33051279,Tiago dos Santos Moura,1651,10/09/1991,24,0,0,0,0,168,0,3,3,1,1,1,2,1,2,1,3,1,7,12,9,6,11,4,5,6,1,6,9,1,6,9,8,6,7,6,7,7,8,1,9,6,5,6,6,8,9,8,6,3,10,10,10,20,11,4,8,6,4,8,8,18,12,12,11,11,1,8,3,D/M/AM RL,1,1,1,1,18,20,1,17,17,1,1,14,18,10,1
33051669,Lucas dos Santos,1651,22/05/1991,25,0,0,0,0,172,73,1,3,2,3,1,2,1,3,4,1,3,7,8,9,8,8,9,5,9,5,5,8,9,5,13,7,8,8,8,8,9,8,10,13,5,9,9,5,10,9,10,11,5,20,9,9,14,8,8,13,6,10,10,10,11,9,9,10,11,3,13,6,AM/S RLC,1,1,19,20,18,18,1,1,1,1,15,15,15,1,1
33055465,Thiago,1651,04/05/1992,24,0,0,0,0,181,0,1,1,2,1,3,2,2,1,3,2,1,9,7,11,8,10,6,7,7,9,5,10,9,5,10,7,10,8,8,8,11,8,10,11,12,11,5,8,9,11,11,8,9,12,9,11,20,10,9,7,9,4,12,11,11,13,10,11,12,1,15,5,AM/S RLC,1,1,19,16,20,18,1,1,1,1,1,1,1,1,1
33056329,Lucas Kaufmann,1651,26/03/1991,25,0,0,0,0,172,0,1,3,2,4,4,1,1,3,3,2,3,9,9,10,10,10,9,8,13,5,8,9,8,5,10,9,9,8,11,9,9,9,8,11,14,10,7,9,9,10,12,8,9,20,10,11,14,10,9,8,9,11,8,9,14,9,7,10,10,10,9,9,AM RLC,1,1,15,20,17,16,1,1,1,1,1,1,1,1,1
33056404,Juan Carlos Palmeira,1651,06/07/1990,25,0,0,0,0,179,0,1,2,1,1,1,2,3,2,3,2,1,7,9,12,6,13,6,8,6,6,6,8,6,7,10,9,7,5,12,8,5,13,9,10,4,10,4,7,8,8,12,5,4,11,10,13,20,13,8,9,9,9,9,9,15,14,11,11,12,8,10,4,AM/S L,1,1,17,1,20,1,1,1,1,1,1,12,1,1,1
33056658,Lucas Pessanha,1651,20/07/1991,24,0,0,0,0,180,0,2,3,3,3,1,2,2,1,1,2,2,5,6,13,12,9,6,14,7,4,3,5,3,5,12,8,10,6,7,7,11,11,3,9,7,11,7,6,7,10,12,7,7,8,13,11,20,7,7,9,8,7,8,7,10,11,11,13,10,6,15,7,S ,1,1,20,1,1,1,1,1,1,1,1,1,1,1,1
33062925,Carlos Braz,1651,04/11/1980,35,0,0,0,0,186,0,2,1,2,3,3,3,3,3,1,3,3,5,1,9,5,13,2,4,8,4,7,11,1,4,11,5,8,5,6,6,7,13,8,9,12,10,7,7,9,7,8,6,8,7,6,7,20,6,6,10,7,5,8,8,14,6,14,13,12,5,8,2,M/AM C,1,1,1,16,1,1,1,1,1,1,20,1,1,1,1
34013985,Henrique,1651,20/08/1982,33,0,0,0,0,187,82,3,4,3,2,3,2,2,1,3,2,3,5,8,7,5,9,9,14,8,9,13,7,7,10,8,15,12,13,8,10,5,10,14,5,12,7,9,10,11,10,7,12,13,6,12,8,20,12,13,11,15,12,9,6,9,10,9,11,13,12,12,6,D RC,1,1,1,1,1,1,18,1,20,1,1,1,1,1,10
35014059,Danilo,1651,29/11/1983,32,0,0,0,0,181,77,4,1,3,1,2,1,1,3,1,1,3,7,5,9,5,13,7,7,12,6,7,13,5,6,13,10,11,5,5,6,8,13,8,13,9,10,8,9,8,9,11,8,7,16,14,12,20,8,6,7,10,10,18,10,7,12,10,10,11,5,8,8,AM C,1,1,5,20,1,1,1,1,1,2,15,1,1,1,1
3503440,Athos,1651,29/06/1980,36,0,0,0,0,178,70,1,1,1,2,2,1,1,4,1,2,2,9,12,11,10,15,9,4,11,9,10,13,5,11,11,10,14,7,11,12,9,11,14,8,9,10,10,8,11,12,10,7,9,10,14,14,20,11,13,12,3,12,10,16,11,12,12,10,11,4,15,6,M/AM RC,1,1,1,20,1,13,8,1,10,12,15,1,18,1,12
36000320,Rogério,1651,19/11/1984,31,0,0,0,0,178,75,1,1,3,3,1,2,1,3,1,1,1,15,11,15,8,13,14,12,14,6,6,13,16,7,15,6,12,5,9,8,14,10,8,14,10,13,9,9,10,10,12,12,8,15,11,11,20,11,10,7,8,14,7,8,12,14,14,13,14,13,14,3,AM RLC,1,1,14,20,17,16,1,1,1,1,14,10,10,1,1
36011295,Wagner Ribeiro,1651,14/11/1987,28,0,0,0,0,182,74,2,3,3,1,3,3,2,4,1,1,1,10,13,12,12,10,11,10,12,6,7,13,8,8,13,8,12,7,10,8,13,16,8,10,9,15,11,8,8,9,10,12,10,10,5,8,20,9,8,8,5,10,10,10,7,12,11,8,14,12,13,3,M/AM C,1,1,1,20,1,1,1,1,1,1,18,1,1,1,1
36019496,Diego Lima,1651,30/09/1988,27,0,0,0,0,178,77,1,2,1,2,2,2,1,1,2,2,4,13,12,13,9,11,10,6,8,6,7,13,13,6,14,7,10,7,10,10,12,11,8,15,6,12,7,10,7,14,13,10,8,13,10,12,20,10,8,10,10,3,9,9,8,11,11,14,10,7,5,6,M/AM C,1,1,1,20,1,12,1,1,1,10,16,1,10,1,1
36019515,Luiz Miguel,1651,28/08/1985,30,0,0,0,0,176,70,2,1,3,1,1,2,2,3,2,2,2,11,10,12,10,10,12,9,9,8,5,11,12,8,11,10,11,7,8,7,11,7,10,12,8,10,7,6,8,11,12,10,8,10,12,11,20,10,10,8,12,11,7,10,11,8,9,9,9,8,4,4,AM RLC,1,1,5,17,20,20,1,1,1,1,8,10,12,1,1
36024075,Anderson Gonzaga,1651,29/12/1983,32,0,0,0,0,182,75,1,2,1,2,2,3,3,2,1,3,2,11,12,13,12,11,12,11,9,5,5,13,13,5,13,8,11,8,12,6,11,12,10,12,12,12,6,11,7,12,12,11,10,20,8,10,8,11,9,9,7,8,11,10,8,12,5,10,13,1,5,4,S ,1,1,20,10,1,1,1,1,1,1,1,1,1,1,1
36037015,Bruno,1651,13/01/1991,25,0,0,0,0,174,75,2,3,3,4,3,1,2,2,2,4,1,11,13,9,8,11,9,8,7,6,7,5,4,8,10,5,7,3,10,9,7,13,4,10,9,9,7,8,8,13,13,9,7,20,6,13,12,13,9,10,5,1,3,10,10,11,12,13,12,1,19,7,M/AM RL,1,1,12,1,1,20,1,1,1,1,1,17,1,1,1
36042260,Wanderson,1651,07/02/1994,22,0,0,0,0,164,65,4,3,2,3,2,2,2,3,2,1,2,13,12,15,10,13,12,6,12,6,5,12,13,6,14,9,10,8,8,6,13,8,13,13,4,12,7,7,10,14,15,7,6,20,12,14,5,11,8,9,12,12,7,11,14,16,7,12,6,4,7,18,M/AM RLC,1,1,14,16,20,17,1,1,1,1,10,16,14,1,1
36045567,Leandro,1651,24/01/1994,22,0,0,0,0,183,77,2,1,2,3,2,1,1,2,3,1,1,6,9,10,6,12,12,12,12,13,12,10,8,13,11,16,10,14,7,9,8,8,15,9,6,7,11,11,14,10,10,12,13,8,13,12,20,13,14,9,15,12,4,14,12,14,15,16,12,6,11,8,D/DM C,1,1,1,1,1,1,20,1,10,19,14,1,1,1,1
36063366,Bruno Chalkiadakis,1651,05/04/1993,23,0,0,0,0,176,72,2,3,3,3,1,1,2,1,3,2,2,12,13,14,12,14,12,8,13,6,7,13,10,6,13,8,11,10,11,8,13,9,8,13,6,12,8,7,12,11,12,9,7,20,12,10,10,9,8,9,6,10,8,8,20,16,7,7,4,11,12,12,M/AM RLC,1,1,14,20,17,16,1,1,1,1,16,10,10,1,1
36078770,Gabriel,1651,12/04/1990,26,0,0,0,0,188,82,1,3,3,1,1,1,3,2,2,2,2,6,6,10,10,10,7,10,11,6,6,9,5,7,11,9,12,12,13,7,10,16,13,9,8,15,7,11,11,10,11,12,14,20,17,14,7,11,13,9,10,1,7,14,6,12,7,10,10,3,12,10,S C,1,1,20,15,14,1,1,1,1,1,1,1,1,1,1
36080230,Felipe de Paula,1651,17/01/1988,28,0,0,0,0,182,0,3,1,1,1,3,2,2,3,3,3,1,10,13,12,8,13,8,2,8,6,6,6,2,8,14,9,6,6,6,7,7,10,13,13,12,8,6,7,12,13,12,6,8,20,10,12,1,8,8,9,3,1,9,9,14,16,9,13,12,12,5,6,M/AM L,1,1,10,14,20,10,1,1,1,1,1,18,1,1,1
36090328,Cadu,1651,06/04/1992,24,0,0,0,0,171,66,1,2,2,3,3,3,1,3,4,3,3,13,12,12,9,13,14,6,13,4,4,9,16,4,10,10,7,6,9,7,11,10,10,13,4,12,4,5,8,11,12,7,6,20,12,12,3,8,7,8,8,10,3,7,13,10,14,11,14,7,8,4,M/AM L,1,1,1,14,19,10,1,10,1,1,10,20,7,14,1
36111583,Leandro Moris,1651,13/02/1986,30,0,0,0,0,181,85,2,3,2,1,2,3,4,1,2,2,3,4,1,12,11,11,4,6,6,1,3,5,6,1,6,8,9,6,9,4,10,12,8,8,12,8,6,5,6,12,10,3,6,8,13,12,20,5,7,7,8,6,5,8,17,11,12,10,11,11,10,3,AM/S C,1,1,18,20,1,1,1,1,1,1,14,1,1,1,1
36113593,Da Costa,1651,17/07/1981,34,0,0,0,0,173,73,3,3,2,2,3,1,2,1,3,2,2,12,8,11,10,9,8,8,8,7,6,10,12,3,10,8,7,11,8,7,6,7,9,9,12,10,6,7,10,11,12,8,7,7,15,9,20,8,7,8,14,13,8,8,20,10,9,11,14,8,8,6,M/AM/S C,1,1,17,20,1,1,1,1,1,1,18,1,1,1,1
36126814,Caio Guazzelli,1651,02/06/1997,19,0,0,0,0,171,0,1,4,1,3,3,3,2,3,2,1,3,7,12,11,10,10,4,2,7,1,5,10,5,7,10,7,7,2,7,4,5,6,8,12,10,2,5,7,10,13,13,6,4,20,9,13,5,6,4,5,8,4,8,8,14,11,13,10,10,9,12,6,AM RLC,1,1,10,20,17,18,1,1,1,1,14,14,14,1,1
36127498,Thiago,1651,15/08/1994,21,0,0,0,0,167,63,2,2,1,2,3,2,3,3,3,2,1,10,8,11,6,10,11,6,9,6,7,14,1,6,10,8,10,6,8,5,9,11,8,11,7,6,7,8,12,10,12,7,6,5,14,9,20,8,6,8,8,1,8,8,18,14,7,10,10,9,3,8,AM C,1,1,10,20,14,7,1,1,1,1,14,10,6,1,1
36127816,Higor Vidal,1651,20/09/1996,19,0,0,0,0,172,67,1,3,3,2,3,1,2,2,2,2,1,12,10,12,12,13,12,7,13,1,6,13,9,6,13,7,11,8,10,8,12,10,2,12,7,14,7,12,10,12,13,7,6,20,10,11,8,10,6,10,10,6,9,10,13,13,11,9,12,6,11,7,M/AM C,1,1,1,20,1,1,1,1,1,1,16,1,1,1,1
36130470,Alexandre Talento,1651,14/05/1996,20,0,0,0,0,181,82,3,3,1,3,2,4,1,3,3,2,3,7,7,10,10,15,12,9,11,5,5,12,11,8,11,8,5,7,9,7,11,13,5,10,10,10,9,8,9,10,8,12,10,20,9,10,3,9,13,8,8,8,8,8,20,12,11,11,12,7,4,6,AM C,1,1,14,20,10,10,1,1,1,1,14,7,6,1,1
36130480,Ranielson,1651,05/05/1992,24,0,0,0,0,170,63,1,1,2,3,2,1,1,2,3,2,3,4,3,6,4,11,4,2,7,4,5,5,1,4,7,8,7,6,4,5,9,11,7,8,6,7,4,6,10,12,11,4,1,12,10,12,20,11,3,8,8,8,8,8,16,9,11,11,13,2,14,3,M/AM C,1,1,1,20,1,1,1,1,1,1,16,1,1,1,1
36130482,Eduardo,1651,09/05/1997,19,0,0,0,0,158,0,1,1,2,2,4,3,3,1,2,1,3,11,13,10,3,12,7,5,7,5,4,6,3,5,9,8,7,3,4,6,4,7,5,8,6,7,4,7,11,11,11,7,2,20,13,11,7,12,5,8,6,3,8,8,13,11,10,13,11,9,4,6,M/AM RL,1,1,1,14,20,19,1,1,1,1,10,16,16,1,1
36516422,Jaílson,1651,21/01/1991,25,0,0,0,0,170,67,1,2,3,2,1,2,2,3,2,2,3,7,12,12,7,11,8,9,7,12,11,12,8,12,13,9,12,8,12,13,10,12,14,10,9,14,11,14,13,15,14,13,6,5,13,15,20,13,11,13,8,11,11,10,15,12,12,11,11,6,5,5,D/WB R,1,1,1,1,1,1,1,1,20,1,1,1,1,1,17
37002625,Everton,1651,08/06/1983,33,0,0,0,0,177,74,3,1,3,3,3,2,2,2,4,1,4,10,8,13,14,10,13,13,12,1,3,13,13,3,16,7,13,12,12,11,11,11,13,13,10,11,4,11,11,11,11,10,9,10,14,12,20,12,11,15,6,12,5,11,14,15,17,14,14,16,17,3,AM/S L,1,1,20,14,17,12,1,1,1,1,1,1,1,1,1
37045865,Junior Lima dos Santos,1651,12/01/1996,20,0,0,0,0,178,0,1,2,2,2,3,1,3,2,1,2,3,6,10,9,12,10,6,13,6,5,5,7,7,3,10,9,6,6,7,4,6,12,4,12,7,9,4,6,8,12,11,7,5,20,6,12,9,9,7,8,5,9,9,9,14,10,12,12,12,10,11,8,AM/S L,1,1,20,1,18,1,1,1,1,1,1,1,1,1,1
37064124,Vinicius,1651,07/12/1999,16,0,0,0,0,175,0,2,3,2,3,2,2,3,3,4,2,1,5,5,9,11,13,5,5,6,1,3,13,4,4,8,8,4,7,4,1,12,11,8,8,2,8,3,7,11,13,13,2,4,9,8,12,20,6,6,8,8,6,5,6,18,11,10,10,12,1,8,8,AM C,1,1,1,20,1,1,1,1,1,1,1,1,1,1,1
38003456,Diego,1651,09/03/1988,28,0,0,0,0,178,79,2,1,2,1,1,1,1,3,2,1,3,12,12,13,10,14,13,7,12,10,10,12,12,10,14,9,11,11,12,12,13,11,13,15,8,13,8,11,11,12,14,13,9,20,12,12,10,13,14,13,9,14,8,10,13,12,13,13,11,16,12,8,M/AM L,1,1,10,14,20,14,1,8,1,1,1,16,12,8,1
38006046,Lucas,1651,06/05/1989,27,0,0,0,0,176,70,3,3,2,1,2,1,2,3,1,2,3,10,12,8,9,14,7,7,9,1,7,10,7,4,12,6,11,7,9,8,7,10,3,11,13,9,7,8,9,14,14,7,6,9,15,14,20,8,7,9,9,9,9,9,16,13,12,13,14,1,16,3,M/AM RLC,1,1,14,20,15,15,1,1,1,1,17,17,17,1,1
38006047,Vinícius,1651,12/08/1989,26,0,0,0,0,175,0,1,1,3,2,3,1,2,3,3,3,3,7,11,14,11,15,7,9,8,6,6,10,7,6,18,9,7,13,8,8,7,6,15,15,2,10,4,5,5,10,10,7,9,20,8,10,10,9,7,11,7,16,4,12,10,9,13,14,14,10,16,4,AM/S RL,1,1,20,13,20,17,1,1,1,1,7,8,7,1,1
38015782,Robson de Sousa,1651,20/01/1986,30,0,0,0,0,160,0,2,4,4,3,1,2,3,2,3,3,2,7,7,4,3,12,5,7,7,6,9,9,4,12,9,6,7,8,9,8,6,9,5,9,13,6,9,9,9,14,13,9,1,8,12,12,20,10,6,9,9,6,7,9,12,11,11,10,10,3,3,5,D/WB R,1,1,1,1,1,7,1,1,20,1,1,1,7,1,17
38015869,Thiago Ribeiro da Silva,1651,23/01/1985,31,0,0,0,0,173,0,1,1,3,2,2,1,2,3,2,2,1,5,10,9,4,14,6,5,6,4,7,9,4,9,10,9,7,8,9,9,8,14,3,9,4,9,8,8,9,14,8,3,7,10,12,12,20,6,11,9,9,9,8,9,14,9,12,12,9,1,15,1,D/M/AM RC,1,1,7,17,10,17,1,1,16,7,7,7,20,1,13
3801659,Fábio Bilica,1651,04/01/1979,37,0,0,16,2,187,80,1,3,3,1,2,1,2,3,3,1,3,6,7,7,6,10,11,12,10,10,13,10,10,12,8,15,14,14,14,7,10,10,14,12,14,9,12,11,13,6,7,14,12,10,11,7,20,10,14,10,15,14,8,7,14,13,7,10,12,1,2,10,D/DM C,1,10,1,1,1,1,20,1,1,19,1,1,1,1,1
38017473,Azevedo,1651,23/06/1991,25,0,0,0,0,169,66,1,3,3,3,1,2,2,3,3,3,1,9,11,15,12,14,11,8,12,10,4,10,14,5,14,6,11,7,9,10,8,11,13,16,9,10,6,7,8,12,14,6,7,11,6,13,20,8,5,12,7,14,10,6,15,8,12,12,10,10,10,10,AM RLC,1,1,15,15,15,20,1,1,1,1,5,5,5,1,1
38017474,Bernardo Frizoni,1651,12/03/1990,26,0,0,0,0,177,66,3,2,3,3,1,1,1,2,2,1,1,7,12,9,7,9,6,6,2,1,9,9,5,12,9,9,7,5,9,9,9,11,9,3,10,8,7,8,9,14,14,8,6,20,13,14,8,11,7,9,9,1,9,9,11,11,10,12,11,10,16,3,D/WB L,1,1,10,10,13,1,1,20,1,1,1,15,1,18,1
38017703,Pedro Petrazzi,1651,15/09/1990,25,0,0,0,0,180,80,3,2,2,2,1,1,1,4,2,2,2,10,10,10,7,12,7,5,8,4,10,12,12,12,12,13,10,10,11,12,12,10,12,11,10,11,11,13,13,13,12,11,8,10,11,11,20,11,11,10,14,10,6,9,10,13,7,8,16,12,12,7,DM/M LC,1,1,1,1,1,1,1,1,1,18,20,15,1,1,1
38033025,Renan,1651,09/09/1989,26,0,0,0,0,187,0,1,2,4,1,2,1,1,2,1,1,2,4,3,8,12,12,4,12,1,1,4,2,5,2,8,6,4,6,9,4,5,9,6,9,10,11,4,4,6,12,12,5,6,8,12,12,20,11,7,8,6,8,8,8,11,12,9,11,10,3,8,6,S ,1,1,20,1,1,1,1,1,1,1,1,1,1,1,1
38034286,Fabio Nascimento de Oliveira,1651,03/09/1987,28,0,0,0,0,183,78,1,3,3,3,1,2,3,2,1,1,3,4,5,4,6,10,6,10,4,7,10,10,5,10,9,6,10,10,8,11,6,10,3,2,7,7,10,9,9,15,10,9,7,20,9,13,10,11,12,9,7,9,9,9,17,14,12,12,12,5,5,4,D/WB LC,1,1,1,1,1,1,18,20,1,7,7,7,1,17,1
38034671,André Luís,1651,08/06/1993,23,0,0,0,0,182,77,1,1,1,1,3,3,3,1,1,3,4,6,7,12,13,10,6,10,8,1,6,4,6,4,13,9,7,4,10,8,9,11,9,13,5,13,6,6,8,12,12,3,10,12,8,10,20,7,5,6,9,9,7,9,12,12,11,11,10,9,3,3,AM/S C,1,1,20,17,10,10,1,1,1,1,1,1,1,1,1
38034912,Junior Joaz Lopez Da Silva,1651,24/09/1989,26,0,0,0,0,178,0,4,2,1,4,3,1,2,3,1,1,1,6,6,11,13,13,6,13,7,5,6,7,9,3,13,9,10,8,11,5,3,11,9,13,7,10,7,6,7,13,13,5,5,8,7,13,20,10,9,9,5,1,9,9,13,11,11,12,8,1,11,7,S ,1,1,20,1,1,1,1,1,1,1,1,1,1,1,1
38034952,Júnior Celso,1651,03/10/1991,24,0,0,0,0,170,0,4,1,3,2,2,1,3,2,3,2,1,7,6,6,4,8,5,8,5,6,9,8,7,14,4,8,9,8,7,6,6,10,8,3,13,7,9,8,8,15,11,8,7,20,15,15,10,10,7,8,5,5,8,8,13,10,11,11,13,10,5,8,D L,1,1,1,1,1,1,10,20,1,1,1,1,1,13,1
38037055,Tanque,1651,18/07/1991,24,0,0,0,0,186,0,3,3,3,2,3,1,2,2,1,2,1,3,1,12,12,12,4,9,5,3,2,4,4,1,7,4,11,3,7,5,4,12,4,8,6,9,4,4,6,12,11,5,10,10,8,11,20,11,9,8,5,5,8,8,18,12,10,10,11,9,10,4,S ,1,1,20,1,1,1,1,1,1,1,1,1,1,1,1
38037257,Myke Bouard Ramos,1651,30/10/1992,23,0,0,0,0,185,83,2,2,3,1,3,2,1,3,2,3,1,7,6,13,13,11,7,13,7,3,3,3,10,1,13,6,10,4,11,8,6,12,2,13,12,11,6,6,8,13,12,5,11,15,11,13,20,9,9,10,10,9,9,10,10,11,9,9,10,1,3,2,S ,1,1,20,1,1,1,1,1,1,1,1,1,1,1,1
3900275,Zé Ricarte,1651,10/11/1981,34,0,0,0,0,174,0,4,1,3,3,1,4,3,3,4,3,2,7,7,5,9,15,8,4,10,3,10,13,4,15,12,4,12,9,9,9,8,9,9,9,8,9,13,9,13,11,10,9,5,7,15,10,20,9,8,9,9,3,7,9,9,11,11,10,10,10,14,8,DM/M C,1,1,1,1,1,1,1,1,1,20,18,1,1,1,1
39007514,Ismael Gaúcho,1651,07/10/1984,31,0,0,0,0,190,85,2,2,2,2,3,3,3,2,2,1,1,7,7,14,10,14,7,14,9,3,7,9,4,4,13,9,12,7,9,8,8,14,2,12,7,12,6,7,9,8,10,8,16,10,13,10,20,11,12,9,9,7,5,9,10,12,10,8,10,10,5,2,S C,1,1,20,15,1,1,1,1,1,1,1,1,1,1,1
40004878,Luciano Sobrosa,1651,25/07/1979,36,0,0,0,0,186,0,2,1,1,1,3,1,1,4,4,3,3,5,3,2,2,6,7,12,5,1,8,7,12,12,5,13,8,15,6,6,5,8,5,4,17,3,11,15,14,7,11,10,13,9,13,7,20,17,13,13,9,15,12,6,17,11,13,12,16,5,16,12,D C,1,1,1,1,1,1,20,1,1,8,7,1,1,1,1
40023686,Ennio,1651,05/11/1984,31,0,0,0,0,176,0,3,3,2,3,1,2,2,1,2,1,2,5,8,10,8,10,6,6,3,1,6,8,5,5,13,8,7,4,8,7,10,11,2,12,4,8,5,7,8,10,9,7,8,6,11,12,20,13,9,8,8,5,8,8,8,10,10,10,8,12,6,8,M/AM RC,1,1,11,20,13,17,1,1,1,1,16,12,15,1,1
40028806,Vinícius,1651,08/08/1993,22,0,0,0,0,184,0,2,1,2,2,3,1,3,1,3,2,3,2,4,10,13,13,5,13,5,1,5,4,5,1,13,8,8,2,6,6,2,4,8,13,13,13,6,5,6,13,13,6,10,1,14,13,20,5,9,6,6,8,5,8,14,11,11,12,10,1,9,1,S ,1,1,20,1,1,1,1,1,1,1,1,1,1,1,1
41000909,Fabiano Beltrame,1651,29/08/1982,33,0,0,0,0,184,74,3,2,2,2,3,1,1,2,3,1,1,7,5,2,6,7,9,11,7,5,10,8,5,10,6,6,11,10,8,11,6,12,8,3,14,8,11,9,11,12,8,10,11,9,13,9,20,9,11,9,7,9,9,9,8,10,12,10,11,1,8,7,D C,1,1,1,1,1,1,20,1,1,1,1,1,1,1,1
41002185,Antônio Teles,1651,02/09/1982,33,0,0,0,0,182,80,1,4,3,3,1,3,3,4,1,2,3,7,2,3,3,14,7,7,13,1,8,12,4,10,12,9,10,5,9,9,10,11,7,1,14,8,10,8,13,8,7,6,7,8,12,6,20,14,7,9,6,8,6,9,18,11,11,14,11,1,2,2,M C,1,1,1,10,1,1,1,1,1,13,20,1,1,1,1
41005232,Lexe,1651,30/08/1977,38,0,0,0,0,191,0,3,2,1,4,3,1,1,3,1,1,2,6,6,6,14,7,6,8,8,4,6,13,6,7,9,8,8,6,10,7,11,9,5,8,1,12,7,7,8,8,10,7,15,7,11,11,20,9,12,8,6,8,8,8,19,13,11,11,11,5,14,8,AM/S C,1,1,16,20,1,5,1,1,1,1,1,1,1,1,1
41039970,Wallace da Silva,1651,13/06/1984,32,0,0,0,0,167,73,1,2,1,3,3,4,2,1,2,1,3,6,4,14,14,13,6,14,7,2,6,7,6,5,9,8,11,7,13,4,7,11,5,8,9,10,6,6,7,8,9,7,3,8,12,13,20,5,11,8,7,8,7,8,19,12,12,9,11,8,9,8,S ,1,1,20,1,1,1,1,1,1,1,1,1,1,1,1
41053214,Helder Lobato Ribeiro,1651,18/07/1988,27,0,0,0,0,190,83,3,2,1,1,2,1,1,1,2,3,3,1,4,1,1,2,5,13,4,1,13,7,1,13,4,9,11,9,7,9,5,13,9,8,5,5,9,6,7,13,11,7,15,8,13,10,20,5,10,9,6,7,9,9,10,10,13,10,11,4,13,7,D C,1,1,1,1,1,1,20,1,1,1,1,1,1,1,1
41053226,Ivan Carlos França Coelho,1651,06/12/1989,26,0,0,0,0,177,69,2,4,3,3,3,3,1,3,2,3,3,3,2,12,12,9,4,12,5,3,4,5,4,4,8,8,12,6,8,4,4,10,7,9,10,12,5,4,6,12,12,5,3,8,6,12,20,11,4,8,8,1,8,8,10,10,12,12,10,5,6,6,S ,1,1,20,1,1,1,1,1,1,1,1,1,1,1,1
42004614,Cristiano dos Santos,1651,12/03/1982,34,0,0,0,0,183,0,1,3,3,2,3,3,2,1,1,3,3,2,8,10,12,10,2,12,5,2,2,10,10,5,10,11,11,10,10,8,7,12,15,10,14,11,7,11,11,8,8,10,10,11,11,10,20,5,10,11,6,14,5,11,9,12,10,10,9,2,10,6,S ,1,1,20,1,1,8,1,1,1,1,1,1,1,1,1
42016109,David Gomes,1651,05/09/1988,27,0,0,0,0,176,73,4,3,2,3,3,1,3,1,1,3,3,8,4,9,11,7,8,11,9,1,3,8,8,3,11,12,10,8,11,10,10,8,10,14,5,10,3,8,11,11,10,9,9,13,12,12,20,11,7,13,3,12,1,3,15,10,10,10,12,12,15,5,AM/S RL,1,1,20,1,15,20,1,1,1,1,1,1,1,1,1
42083029,Marcus Vinicius,1651,11/08/1994,21,0,0,0,0,185,0,2,1,2,1,3,3,1,1,1,2,3,9,13,10,4,12,5,4,7,3,5,10,1,7,10,8,3,5,6,5,6,4,8,12,12,7,5,7,12,13,9,7,12,7,8,10,20,9,9,8,6,2,8,8,8,11,11,11,10,7,8,6,AM RL,1,1,1,14,20,18,1,1,1,1,14,14,14,1,1
43000104,Douglas Packer,1651,13/03/1987,29,0,0,0,0,178,66,2,2,2,3,2,1,1,3,3,1,2,10,9,11,7,11,11,6,10,10,5,13,9,6,13,12,9,10,10,10,13,9,11,16,7,7,6,14,10,10,12,9,7,10,15,9,20,11,10,15,3,18,3,14,12,13,12,6,15,11,18,3,M/AM RL,1,1,8,12,17,15,1,1,1,1,10,14,20,1,1
43002869,Gabriel Sacilotto,1651,18/03/1983,33,0,0,0,0,184,75,2,1,2,2,3,1,2,1,1,1,1,9,10,9,8,12,14,11,11,7,9,12,16,12,14,15,12,13,10,10,11,12,12,11,15,12,8,13,11,12,11,10,10,4,18,11,20,12,13,15,13,12,14,14,14,14,12,8,13,12,10,6,M C,1,1,1,7,1,1,10,1,1,12,20,1,1,1,1
43006826,Marcus Diniz,1651,01/08/1987,28,0,0,0,0,181,80,1,2,3,1,2,3,1,4,3,3,2,10,9,11,6,10,8,15,9,9,13,12,10,13,9,16,12,13,12,12,8,13,11,5,11,11,12,12,12,10,10,13,11,20,10,12,6,12,13,12,13,10,13,10,10,11,8,9,11,7,10,12,D C,1,1,1,1,1,1,20,1,10,1,1,1,1,1,1
43007163,Sodinha,1651,17/07/1988,27,0,0,0,0,174,98,4,3,2,1,1,2,1,4,4,1,1,16,13,16,11,6,15,8,15,9,6,15,15,6,16,12,13,10,7,12,14,15,12,17,4,12,15,8,13,10,7,10,8,20,10,10,8,10,12,11,3,16,12,13,15,6,10,11,5,12,11,10,AM RC,1,1,10,20,1,17,1,1,1,1,13,1,13,1,1
43008068,Dimas,1651,30/09/1984,31,0,0,0,0,179,83,2,1,2,4,3,2,3,1,2,1,2,3,6,10,11,10,8,8,9,2,1,9,10,2,11,7,11,9,10,9,9,9,4,12,13,11,4,9,10,10,10,10,8,5,12,10,20,11,10,14,4,13,5,9,13,13,9,10,9,1,13,2,AM/S L,1,1,16,10,20,10,1,1,1,1,1,1,1,1,1
43017715,Lucas Finazzi,1651,18/08/1990,25,0,0,0,0,179,73,1,2,1,4,2,2,2,2,1,1,3,7,10,10,4,11,9,10,10,10,9,10,8,10,10,10,11,11,8,11,11,10,12,10,6,8,11,10,10,11,11,13,9,10,10,11,20,13,10,7,8,11,10,8,13,10,8,11,10,9,12,7,DM/M C,1,1,1,1,1,1,1,1,1,16,20,1,13,1,1
43017911,Jefferson Arroz,1651,17/01/1988,28,0,0,0,0,178,75,1,2,3,1,1,1,3,3,2,2,2,4,9,8,5,7,6,6,5,5,7,8,4,13,8,7,7,8,8,7,6,13,9,9,8,7,8,7,8,13,13,7,5,20,14,13,10,13,8,9,9,9,9,9,15,10,12,11,11,12,5,3,D/WB/M L,1,1,1,1,14,1,1,20,14,11,10,16,10,18,12
43017920,Diego Farias,1651,10/05/1990,26,0,0,0,0,173,66,2,2,1,4,1,1,3,2,2,3,1,11,13,14,12,12,10,7,12,4,4,13,12,8,14,9,10,12,11,11,12,11,10,14,7,12,8,10,11,14,15,11,6,11,14,14,20,15,12,11,8,13,3,12,15,12,10,11,12,10,9,2,AM RLC,1,1,12,15,18,20,1,1,1,1,1,9,9,1,1
43020627,Sérgio Cruz,1651,22/08/1988,27,0,0,0,0,184,80,3,1,3,3,3,3,2,3,1,3,3,7,7,12,13,7,6,9,6,3,2,7,7,6,14,6,8,9,11,10,9,8,9,8,8,10,7,6,6,14,11,9,11,10,8,14,20,12,14,7,7,10,5,8,10,10,10,8,9,12,9,4,S C,1,1,20,15,1,1,1,1,1,1,1,1,1,1,1
43020651,Caio De Cenco,1651,05/05/1989,27,0,0,0,0,189,79,1,2,3,3,3,2,2,2,3,2,2,7,11,12,11,13,5,13,8,3,3,11,11,3,14,12,11,12,11,8,8,10,17,14,8,12,5,11,11,12,11,14,14,20,13,12,9,10,13,13,7,14,3,8,18,16,12,10,15,7,10,10,S ,1,1,20,12,11,12,1,1,1,1,1,1,1,1,1
43020922,Fabinho,1651,09/10/1988,27,0,0,0,0,166,0,3,2,1,2,3,3,2,2,3,2,3,5,7,13,10,11,8,8,8,8,8,12,6,5,12,5,7,5,8,9,10,9,6,7,14,12,6,8,7,7,8,7,7,8,5,7,20,7,7,6,4,5,7,7,9,5,8,6,6,7,6,9,AM C,1,1,1,20,1,1,1,1,1,1,12,1,1,1,1
43037069,Wellington Feliciano,1651,27/06/1990,26,0,0,0,0,178,0,2,3,1,1,1,1,2,2,3,1,3,5,7,11,13,11,1,13,7,4,6,7,4,1,9,7,9,8,9,7,7,8,1,9,4,10,7,6,8,13,9,7,5,20,15,12,5,12,6,9,5,9,9,9,15,10,10,11,7,6,10,5,S ,1,1,20,1,1,1,1,10,1,1,1,1,1,10,1
43038539,Luan Menegaz,1651,05/08/1992,23,0,0,0,0,182,80,3,4,2,2,3,3,1,3,2,3,1,7,4,5,4,6,5,10,5,5,10,6,4,10,5,12,10,9,6,8,5,9,4,6,6,4,11,12,13,10,10,13,13,7,8,9,20,9,13,6,6,4,5,8,19,11,10,13,13,11,8,4,D C,1,1,1,1,1,1,20,1,1,10,3,1,1,1,1
43039014,Felipe,1651,30/09/1990,25,0,0,0,0,171,67,1,1,2,2,2,2,2,2,1,3,3,11,9,13,8,15,12,3,11,3,10,13,13,10,14,8,11,4,7,8,13,11,10,16,5,12,3,10,10,13,15,11,6,16,8,13,20,13,7,9,11,10,10,11,8,12,8,9,11,14,7,10,M/AM C,1,1,8,17,12,13,1,1,1,13,20,13,12,10,10
43040888,Yago Del Piero,1651,14/01/1994,22,0,0,0,0,175,65,1,1,1,1,1,1,1,1,1,1,1,11,10,11,9,11,10,5,8,5,5,12,11,6,12,9,9,7,11,9,11,11,13,13,6,10,8,10,9,11,12,9,7,6,11,10,20,9,7,11,7,13,7,12,16,13,12,13,12,12,12,9,DM/M C,1,1,1,13,1,1,1,1,1,18,20,1,1,1,1
43041214,Basso,1651,14/04/1989,27,0,0,0,0,186,85,1,1,3,2,1,3,3,3,1,4,3,8,6,6,5,10,6,13,6,2,14,9,4,14,7,10,9,10,8,6,6,11,10,1,9,8,14,8,9,14,14,9,12,20,9,14,9,12,10,10,14,7,10,10,14,12,11,14,10,9,17,7,D C,1,1,1,1,1,1,20,13,10,1,1,1,1,9,6
43044221,Vicente,1651,18/02/1989,27,0,0,0,0,176,70,3,3,3,3,2,1,1,1,1,3,2,5,7,7,4,8,5,8,5,2,10,11,5,11,10,14,12,15,10,15,9,11,18,9,10,5,12,11,11,12,11,10,5,9,15,10,20,12,7,14,14,14,7,15,20,9,15,17,16,13,12,4,DM/M C,1,1,1,12,1,1,10,1,1,19,20,1,1,1,1
43049837,Antonio Serpico,1651,10/12/1990,25,0,0,0,0,188,72,3,3,2,1,2,1,1,3,1,3,3,7,8,6,7,8,5,9,6,6,9,8,5,9,9,12,9,10,9,9,9,9,15,6,10,4,9,9,9,9,9,9,8,5,13,9,20,9,9,11,12,13,14,5,13,11,14,11,11,12,9,14,D RC,1,1,1,1,1,1,20,1,15,1,1,1,1,1,15
43052610,Ryder Matos,1651,27/02/1993,23,0,0,0,0,179,71,1,1,1,1,2,3,3,2,2,1,2,8,11,13,11,13,9,9,10,7,5,11,10,8,14,10,11,10,11,11,12,12,13,13,7,13,8,10,13,15,15,11,10,7,12,15,20,12,8,12,10,12,4,15,10,13,13,12,15,13,12,3,AM/S RLC,1,1,19,18,20,18,1,1,1,1,1,1,5,1,1
43052620,Marcos Miranda,1651,06/03/1992,24,0,0,0,0,192,85,13,13,13,8,13,13,10,13,12,13,13,1,1,3,3,5,6,6,1,2,2,7,1,2,4,16,12,12,5,6,10,11,11,11,7,9,8,7,13,10,13,10,12,9,13,13,20,15,15,8,12,2,5,10,13,11,12,11,13,12,13,5,GK ,20,1,1,1,1,1,1,1,1,1,1,1,1,1,1
43052902,Ronaldo,1651,08/04/1990,26,0,0,0,0,178,78,2,1,1,1,3,1,3,3,3,2,4,9,8,9,4,15,13,9,10,5,8,15,9,12,14,11,12,14,13,13,10,13,11,14,4,8,11,12,9,10,11,12,8,10,14,11,20,12,10,10,8,13,12,10,12,10,12,10,13,13,10,2,DM/M C,1,1,1,13,1,1,1,1,1,18,20,10,10,1,1
43057418,Adriano da Matta,1651,12/07/1988,27,0,0,0,0,173,70,3,1,2,2,3,3,2,2,3,2,2,7,11,11,9,12,7,7,6,1,5,10,1,5,13,10,9,7,8,8,8,13,3,13,7,9,8,8,10,13,13,8,4,12,15,13,20,13,6,10,9,10,10,10,16,12,10,8,10,7,13,4,M/AM RC,1,1,8,20,10,20,1,1,1,1,16,10,19,1,5
43061476,Jonatas Moro,1651,27/03/1987,29,0,0,0,0,177,74,2,3,2,2,3,2,2,3,2,3,1,4,10,9,6,5,4,7,7,5,6,10,3,7,10,10,10,10,10,10,10,10,10,8,4,10,10,10,10,13,10,11,7,5,18,10,20,12,6,10,10,12,14,8,16,6,12,10,12,15,5,3,D R,1,1,1,1,1,1,1,1,20,1,1,1,1,1,15
43062081,Raphael Carminati,1651,27/12/1985,30,0,0,0,0,183,71,1,1,4,1,3,2,4,2,1,1,1,6,5,9,13,6,8,11,6,3,4,5,13,5,7,9,9,10,12,12,9,12,15,13,8,10,8,9,11,11,11,10,11,5,13,10,20,12,10,11,10,11,13,4,17,11,13,14,16,13,11,3,S ,1,1,20,1,1,1,1,1,1,1,1,1,1,1,1
43066651,Diego Simões,1651,18/01/1991,25,0,0,0,0,175,73,2,3,1,2,1,3,4,2,2,3,1,4,4,10,11,12,1,6,6,1,4,12,3,5,12,8,9,4,8,5,10,11,2,13,4,6,5,5,7,12,12,3,6,4,9,12,20,11,4,8,7,4,3,8,15,10,12,12,12,9,13,7,AM/S C,1,1,16,20,1,1,1,1,1,1,1,1,1,1,1
43068480,Victor da Silva,1651,04/01/1995,21,0,0,0,0,180,75,3,2,2,1,2,1,2,1,4,2,1,7,10,14,12,13,12,8,9,8,4,12,12,4,14,6,11,11,10,11,12,12,11,11,6,11,4,11,12,13,13,10,7,11,9,11,20,9,7,11,8,11,16,11,13,13,10,11,11,9,2,5,AM/S LC,1,1,19,20,15,11,1,1,1,1,10,1,1,1,1
43069211,Alan Empereur,1651,10/03/1994,22,0,0,0,0,186,82,1,2,1,1,2,1,1,3,1,2,1,9,9,7,6,10,12,13,9,8,13,10,9,12,9,12,13,12,11,10,9,10,15,10,12,11,13,11,12,13,10,13,13,20,12,12,7,12,13,11,13,14,10,14,11,13,10,13,11,11,7,5,D LC,1,1,1,1,1,1,20,17,1,1,1,1,1,8,1
43069213,Beckham,1651,06/12/1994,21,0,0,0,0,183,82,2,3,3,1,2,2,3,3,3,3,1,10,8,16,4,13,10,8,9,7,4,10,8,6,15,6,7,5,7,4,9,8,9,16,5,10,6,3,6,12,15,8,9,5,7,13,20,6,9,6,8,3,9,8,12,10,11,12,11,15,14,3,AM/S RLC,1,1,20,20,17,17,1,1,1,1,1,7,7,1,1
43069926,Emerson Marcelina,1651,24/02/1991,25,0,0,0,0,180,0,2,1,1,2,1,3,1,1,1,1,4,6,5,7,9,14,8,10,6,8,9,9,6,14,10,10,12,9,8,9,8,14,8,3,7,9,10,5,8,14,14,10,8,12,14,14,20,6,8,10,6,8,7,10,11,11,11,10,10,5,6,5,D/DM/M C,1,1,1,1,1,1,19,1,1,20,19,1,1,1,1
43071998,Adriano,1651,16/02/1994,22,0,0,0,0,178,72,2,1,3,4,3,3,2,3,1,2,1,9,12,13,12,8,12,8,6,4,5,9,12,6,11,8,10,11,9,12,10,10,8,10,9,14,13,14,8,15,13,12,11,8,12,12,20,12,13,8,11,8,9,8,7,8,11,9,10,14,11,12,S ,1,1,20,1,1,1,1,1,1,1,1,1,1,1,1
43072701,Vinicius,1651,23/01/1992,24,0,0,0,0,196,88,12,7,5,1,12,12,9,12,7,7,10,2,2,2,2,1,5,1,3,2,1,1,1,3,1,9,9,14,6,7,5,12,9,2,11,1,11,6,5,12,9,3,16,9,6,11,20,4,14,9,4,9,9,8,11,13,10,11,11,7,6,1,GK ,20,1,1,1,1,1,1,1,1,1,1,1,1,1,1
43072703,Jefferson,1651,25/02/1990,26,0,0,0,0,193,86,3,3,3,4,3,1,1,2,3,3,3,5,7,11,7,9,6,13,5,4,11,8,8,10,9,9,9,11,9,10,8,9,11,6,14,15,10,11,12,9,13,13,13,5,17,11,20,13,14,11,13,12,8,9,13,12,12,10,10,14,10,9,D C,1,1,1,1,1,1,20,1,14,11,1,1,1,1,1
43073353,Daniel Ferreira,1651,21/09/1991,24,0,0,0,0,178,74,3,2,4,3,3,3,2,2,3,3,2,6,10,8,10,7,4,5,4,4,6,10,12,6,11,9,7,10,7,9,11,12,2,7,3,11,9,12,11,12,10,5,4,20,10,15,6,5,10,10,7,4,7,9,16,13,13,12,10,8,14,2,AM L,1,1,1,14,20,13,1,1,1,1,1,1,1,1,1
43077732,Thiago Biazetto,1651,20/03/1995,21,0,0,0,0,180,0,2,1,1,2,3,1,2,1,3,3,2,5,2,8,13,13,5,10,6,1,5,6,7,1,8,8,9,3,8,6,5,7,8,8,10,7,4,5,6,13,13,6,6,8,12,13,20,6,8,8,8,8,8,8,20,12,11,10,11,3,8,4,S ,1,1,20,1,1,1,1,1,1,1,1,1,1,1,1
43078072,Fabinho,1651,28/04/1991,25,0,0,0,0,176,66,2,2,3,2,1,2,1,3,3,2,2,13,14,13,6,12,13,4,11,4,6,12,10,5,12,9,9,6,5,8,11,8,7,14,5,12,7,11,11,16,16,9,7,9,12,15,20,9,6,10,7,13,10,9,16,11,14,13,5,14,14,10,M/AM RL,1,1,13,13,20,17,1,1,1,1,1,17,13,13,1
43078223,Caio Eltink,1651,02/01/1993,23,0,0,0,0,185,0,1,3,1,1,2,2,2,1,2,1,1,12,14,10,14,10,9,11,6,6,6,9,8,5,9,9,10,5,8,3,9,12,5,9,9,11,8,8,9,7,12,5,8,9,16,10,20,6,10,9,9,3,6,9,16,10,10,10,12,5,9,3,S RL,1,1,20,12,15,15,1,1,1,1,1,1,1,1,1
43079440,Adriano,1651,14/01/1986,30,0,0,0,0,190,83,3,3,1,2,3,3,3,3,2,3,2,3,5,6,11,9,4,13,8,3,3,10,10,3,9,12,7,8,13,8,6,8,13,11,5,10,8,11,12,7,7,12,14,5,12,9,20,11,11,9,7,10,6,5,12,8,8,4,10,10,8,6,S C,1,1,20,15,1,1,1,1,1,1,1,1,1,1,1
43079508,Carlos França,1651,01/01/1980,36,0,0,0,0,189,87,3,1,2,2,3,3,2,3,2,2,3,7,6,8,14,14,7,10,8,5,3,7,7,3,13,9,7,8,11,8,7,9,2,12,12,11,7,7,8,13,9,7,14,8,13,9,20,8,12,7,9,7,9,9,11,9,11,11,11,7,7,7,S ,1,1,20,1,1,1,1,1,1,1,1,1,1,1,1
43080624,Rodrigo Ely,1651,03/11/1993,22,0,0,2,0,188,83,2,2,3,1,3,3,1,1,2,1,1,2,4,6,3,12,8,13,4,10,14,13,6,13,12,12,14,12,13,14,11,12,14,4,11,8,13,14,13,12,12,14,15,8,14,13,20,13,13,14,13,6,7,5,16,15,15,12,13,14,14,4,D C,1,1,1,1,1,1,20,1,1,1,1,1,1,1,1
43086984,Robert,1651,09/05/1992,24,0,0,0,0,188,0,1,3,3,3,2,3,3,3,4,1,3,8,12,10,11,12,4,7,7,4,5,7,3,3,12,9,11,2,12,7,7,9,6,13,6,8,4,6,7,12,10,7,6,20,11,12,10,12,8,9,5,3,9,9,9,8,11,12,11,12,7,2,M/AM/S L,1,1,20,10,18,12,1,1,1,1,1,18,1,1,1
43090247,Wilson Cruz,1651,01/10/1985,30,0,0,0,0,187,78,3,1,1,2,2,2,2,3,2,1,3,6,2,12,13,13,6,13,7,6,4,6,5,1,13,9,10,8,9,7,6,8,9,13,6,12,6,6,7,13,10,7,11,5,12,11,20,7,10,9,9,1,6,9,8,10,12,12,12,13,2,5,S ,1,1,20,1,1,1,1,1,1,1,1,1,1,1,1
43090503,Maicon,1651,10/03/1993,23,0,0,2,0,184,77,2,2,2,2,2,3,2,3,2,1,3,6,12,15,10,10,6,4,9,6,8,10,8,9,12,10,11,9,13,11,12,10,13,12,11,11,11,12,11,15,13,11,6,6,11,14,20,13,11,11,8,10,11,12,9,12,10,9,13,12,14,10,D/M/AM R,1,1,1,1,1,17,1,1,20,1,1,1,16,1,15
43090560,William,1651,05/01/1992,24,0,0,0,0,181,76,4,4,2,2,3,1,3,2,3,2,2,5,3,12,9,9,6,13,7,5,4,7,7,4,12,8,12,1,10,7,7,10,3,9,9,11,7,6,7,10,9,7,11,7,9,9,20,8,10,8,5,8,8,8,18,10,9,11,13,1,7,1,S ,1,1,20,1,1,1,1,1,1,1,1,1,1,1,1
43092931,Cristian,1651,17/12/1990,25,0,0,0,0,190,75,2,1,3,1,1,3,3,1,2,2,2,5,6,1,7,8,7,10,9,1,9,9,5,10,8,9,7,9,7,6,6,14,3,7,5,7,10,7,9,14,13,9,15,10,11,13,20,10,10,9,13,9,9,9,20,13,13,10,12,9,9,5,D C,1,1,1,1,1,1,20,1,1,15,10,1,1,1,1
43093277,Willyan,1651,17/02/1994,22,0,0,0,0,169,62,3,1,3,1,3,3,2,3,1,2,3,12,12,15,10,13,10,4,11,5,5,14,12,6,15,11,11,10,11,9,14,9,9,15,6,12,7,9,11,14,14,14,5,9,11,14,20,11,8,8,4,12,4,10,10,11,10,11,12,8,12,12,M/AM RLC,1,1,14,15,15,20,1,1,1,1,16,10,13,1,1
43093492,Gustavo,1651,14/11/1991,24,0,0,0,0,174,70,1,3,3,2,2,1,1,4,3,3,4,7,13,13,13,12,12,8,10,7,7,12,12,6,12,11,10,10,10,10,11,11,10,10,8,12,10,12,8,12,13,9,7,20,10,13,5,11,10,9,10,13,10,12,8,12,11,9,12,15,8,4,AM/S RL,1,1,20,1,20,17,1,1,1,1,1,1,1,1,1
43093493,Everton França,1651,07/04/1995,21,0,0,0,0,171,0,3,1,3,3,3,3,1,2,3,3,2,10,14,15,13,10,9,4,9,9,8,9,9,7,10,6,12,10,11,8,10,8,11,14,6,14,8,7,7,15,12,7,7,5,12,14,20,8,8,9,7,9,9,9,9,11,10,9,9,9,6,14,D R,1,1,1,1,1,1,1,1,20,1,1,1,1,1,1
43104734,Diego Lorensi,1651,27/01/1990,26,0,0,0,0,181,80,2,4,2,4,3,3,1,1,3,1,2,8,8,11,9,14,12,9,11,3,9,12,3,12,10,10,10,9,10,9,12,14,1,8,1,10,9,10,6,14,14,8,6,15,11,14,20,6,8,10,5,10,10,10,20,11,10,10,12,9,11,6,DM/M C,1,1,1,10,1,1,1,1,1,19,20,1,1,1,1
43108033,Jonatan Lucca,1651,02/06/1994,22,0,0,0,0,184,77,1,2,3,2,2,2,3,1,2,3,1,3,3,11,9,9,3,12,8,3,12,12,5,13,12,15,10,14,9,9,10,8,6,8,8,7,9,14,14,13,12,12,12,20,12,13,10,10,11,8,15,10,5,9,8,9,11,10,11,1,4,4,DM/M C,1,1,1,1,1,1,1,1,1,20,17,1,1,1,1
43115043,Matheus Gaucho,1651,23/08/1992,23,0,0,0,0,173,70,3,1,3,3,1,1,3,1,2,1,3,9,9,9,9,9,8,9,9,9,6,11,10,7,9,9,9,9,9,9,11,9,7,9,9,9,11,9,9,10,10,9,7,10,9,10,20,10,8,9,9,9,9,11,16,10,10,12,10,9,9,7,AM LC,1,1,1,20,18,1,1,1,1,1,12,1,1,1,1
43123219,Francisco Sartore,1651,06/07/1995,20,0,0,0,0,171,67,2,2,2,2,3,2,1,1,3,3,2,8,10,12,10,10,3,9,10,9,7,12,8,6,12,10,11,11,9,9,12,8,7,13,8,10,9,11,12,14,13,9,6,8,12,10,20,11,9,8,7,8,14,11,20,11,9,10,12,6,6,7,AM RL,1,1,1,8,19,20,1,1,1,1,1,1,1,1,1
43124230,Jackson da Silva,1651,27/07/1996,19,0,0,0,0,179,0,2,1,3,4,3,2,2,2,3,3,2,5,8,8,6,12,1,1,6,5,5,10,1,6,13,8,4,4,6,6,7,7,11,6,12,5,1,7,11,13,13,6,3,5,10,13,20,6,6,8,6,8,8,8,12,11,11,8,11,11,9,2,M R,1,1,1,1,1,1,1,1,1,1,1,1,20,1,1
43124631,Leonardo Dias Consulin,1651,23/06/1994,22,0,0,0,0,180,75,1,4,1,2,3,1,2,2,2,1,2,6,4,7,8,13,6,4,10,1,8,13,4,8,12,6,9,7,4,7,12,10,8,7,8,5,8,7,12,13,10,7,9,20,16,10,8,7,6,9,8,5,8,9,7,10,14,11,14,13,1,5,M C,1,1,1,14,1,1,1,1,1,1,20,1,8,1,1
43125455,Maicol Cavalcante,1651,29/01/1994,22,0,0,0,0,177,0,2,1,2,1,3,2,3,3,2,2,2,10,13,13,6,11,7,2,8,1,6,8,1,7,12,9,7,4,8,7,9,10,9,12,7,8,5,7,12,13,12,5,8,8,8,11,20,8,6,9,9,9,9,9,7,12,12,9,11,7,1,4,AM RLC,1,1,1,20,15,16,1,1,1,1,1,1,1,1,1
43152190,João Zanotti,1651,02/05/1997,19,0,0,0,0,188,0,12,8,7,7,11,12,8,12,5,8,5,5,3,1,3,1,7,1,3,1,3,1,3,3,1,7,6,9,4,12,4,12,8,2,10,2,9,5,4,11,8,5,11,5,10,12,20,4,7,8,8,3,7,7,19,10,10,10,11,3,3,6,GK ,20,1,1,1,1,1,1,1,1,1,1,1,1,1,1
43155222,Guilherme Mazzoleni,1651,26/02/1996,20,0,0,0,0,176,0,3,2,2,3,1,2,1,3,2,3,3,6,2,3,6,12,6,6,10,6,9,12,3,12,10,8,8,7,5,8,7,13,3,4,12,7,10,8,10,8,10,7,6,1,8,13,20,8,5,8,8,6,8,8,7,11,14,12,11,2,1,6,DM/M C,1,1,1,1,1,1,1,1,1,20,18,1,1,1,1
43159595,Lucas Pardini Niccioli,1651,25/05/1995,21,0,0,0,0,184,78,1,3,1,2,1,1,1,2,2,2,3,6,2,14,12,14,6,10,6,1,6,7,4,3,14,9,8,3,12,7,7,6,5,13,13,13,5,7,8,14,14,7,7,1,7,14,20,6,9,9,9,8,4,9,20,10,11,10,13,13,14,8,S ,1,1,20,1,1,1,1,1,1,1,1,1,1,1,1
43159666,Curcio,1651,06/08/1993,22,0,0,0,0,183,78,2,2,1,2,3,2,1,1,3,2,1,8,11,10,7,7,7,10,8,6,11,11,7,10,12,11,10,10,10,10,10,10,10,7,9,11,10,10,10,12,10,12,10,20,11,12,6,12,11,9,5,7,8,11,20,9,13,12,9,1,9,4,D/WB L,1,1,1,1,1,1,1,20,1,1,1,13,1,20,1
43163154,Geancarlo,1651,16/05/1991,25,0,0,0,0,174,74,1,2,3,1,1,3,1,1,3,2,3,8,7,7,2,10,7,5,8,7,9,12,5,8,7,10,9,2,6,8,11,11,2,6,7,5,7,11,12,11,11,11,7,9,9,11,20,9,8,6,5,6,7,5,14,9,11,12,11,12,4,4,M RC,1,1,1,1,1,13,1,1,1,1,20,1,17,1,1
43167367,Dos Santos,1651,08/07/1990,25,0,0,0,0,183,75,2,1,3,1,2,1,2,3,3,1,2,5,5,13,11,13,6,13,7,1,5,7,6,3,13,7,10,8,13,6,5,12,1,13,7,11,6,6,8,13,12,4,9,5,13,13,20,12,6,9,9,9,9,9,15,11,10,11,14,4,16,4,S ,1,1,20,1,1,1,1,1,1,1,1,1,1,1,1
43167538,João Carrer,1651,24/02/1996,20,0,0,0,0,185,0,2,1,3,1,3,3,1,3,2,1,2,5,6,5,8,14,7,6,14,1,6,11,4,11,10,9,6,5,9,6,10,9,4,9,11,9,5,8,6,12,13,8,14,20,9,14,8,7,9,9,8,1,4,9,13,10,13,14,9,1,9,6,DM/M C,4,1,1,1,1,1,1,1,1,18,20,1,1,1,1
43167850,Hadriel,1651,01/03/1995,21,0,0,0,0,186,0,2,2,2,1,3,3,4,2,1,1,2,1,1,1,2,5,1,8,1,3,8,9,1,11,1,8,11,6,2,12,3,13,4,7,9,3,12,5,6,13,9,6,11,9,12,12,20,6,10,8,8,5,8,8,19,11,14,10,12,4,16,4,D C,1,1,1,1,1,1,20,1,1,1,1,1,1,1,1
43192191,Matias Antonini Lui,1651,09/04/1998,18,0,0,0,0,178,0,1,1,1,2,1,2,3,3,2,1,2,5,4,1,2,13,5,5,7,2,6,12,1,11,13,8,8,7,3,7,13,13,8,1,11,4,7,7,11,13,10,6,6,9,8,10,20,6,6,8,8,4,8,8,17,12,9,11,9,4,7,2,DM/M C,1,1,1,5,6,1,1,1,1,20,18,8,1,1,1
43206283,Tulhão,1651,22/05/1995,21,0,0,0,0,190,88,1,1,1,1,2,3,2,3,4,1,2,1,2,1,2,7,1,11,4,1,13,5,3,13,5,9,7,9,5,12,5,11,4,8,1,3,13,6,7,13,12,7,14,20,10,12,5,7,10,9,6,9,9,9,16,13,10,13,12,1,12,7,D C,1,1,1,1,1,1,20,1,1,1,1,1,1,1,1
43206284,Leonardo Albanesi,1651,08/03/1996,20,0,0,0,0,184,78,1,2,3,1,1,3,1,1,1,4,1,5,7,10,6,13,5,2,4,1,3,9,4,7,11,8,5,7,4,7,12,12,8,11,6,5,3,7,11,12,10,7,9,5,8,13,20,7,7,8,8,3,8,8,12,13,13,10,13,10,8,6,AM LC,1,1,1,20,17,1,1,1,1,1,1,1,1,1,1
43210124,Odair,1651,14/11/1992,23,0,0,0,0,180,0,2,2,3,2,2,2,1,1,1,3,2,9,13,13,7,9,5,1,7,3,5,7,5,3,12,8,6,7,8,5,8,8,3,12,7,7,5,7,10,13,13,3,5,9,9,13,20,6,8,8,8,5,8,8,15,10,9,12,10,2,7,5,M/AM RC,1,1,1,15,1,20,1,1,1,1,1,1,20,1,1
43212340,Leonardo De Paula,1651,27/05/1998,18,0,0,0,0,178,0,3,1,1,3,1,1,2,2,1,3,2,6,6,9,14,11,6,14,7,2,4,3,8,1,11,7,9,4,8,7,7,9,2,10,3,5,5,6,7,13,7,7,6,2,4,11,20,8,8,7,8,5,8,7,8,11,12,10,11,9,6,7,S ,1,1,20,1,1,1,1,1,1,1,1,1,1,1,1
43212582,Mauro Pize,1651,22/06/1996,20,0,0,0,0,180,75,3,2,3,1,1,2,1,3,3,2,1,3,2,2,6,9,6,4,11,5,7,6,1,11,11,8,9,7,4,6,9,12,5,7,1,5,11,8,11,14,10,7,9,20,10,12,5,7,7,8,6,5,6,8,11,13,12,11,11,7,8,2,DM ,1,1,1,1,1,1,1,1,1,20,10,1,1,1,1
43218073,Filipe,1651,13/01/1997,19,0,0,0,0,179,0,3,4,3,2,1,1,3,2,3,3,1,7,3,5,4,8,4,15,7,1,15,6,1,15,6,8,8,8,8,10,1,15,3,2,2,4,11,7,8,9,8,8,10,1,11,7,20,9,6,8,8,3,8,8,8,11,11,12,14,7,3,1,D C,1,1,1,1,1,1,20,1,1,1,1,1,1,1,1
43269494,Victor Enrique De Souza,1651,19/03/1997,19,0,0,0,0,176,75,2,3,3,4,1,2,4,1,3,2,2,2,4,12,3,10,2,2,3,1,1,4,1,3,9,6,3,1,4,3,4,10,5,10,8,3,1,5,9,11,12,3,7,5,9,12,20,4,2,6,6,6,4,6,19,13,10,9,11,4,9,3,AM L,1,1,1,1,20,1,1,1,1,1,1,15,1,1,1
43270490,João Bolizan,1651,29/12/1997,18,0,0,0,0,189,82,6,9,11,1,13,10,6,13,8,8,10,4,3,3,1,1,6,1,1,2,2,1,2,2,1,8,4,10,6,8,5,13,2,2,7,3,7,6,5,13,7,6,8,5,4,12,20,1,8,6,8,8,8,8,9,13,10,11,12,7,16,3,GK ,20,1,1,1,1,1,1,1,1,1,1,1,1,1,1
43271175,Elluan Martins Gomes,1651,18/01/1999,17,0,0,0,0,172,0,3,1,2,1,3,2,1,2,2,2,3,1,2,10,12,11,4,12,2,1,1,5,8,3,9,4,5,6,8,5,3,4,8,10,1,12,2,4,4,12,12,5,3,10,9,12,20,4,6,7,4,8,8,6,17,12,9,14,11,9,8,5,S ,1,1,20,1,1,1,1,1,1,1,1,1,1,1,1
43271208,João Romani,1651,18/04/1999,17,0,0,0,0,185,0,1,2,4,2,1,2,2,4,1,4,1,2,3,13,13,13,5,12,6,1,2,6,3,1,9,8,4,1,10,2,6,7,8,9,11,11,3,5,6,13,8,6,7,8,11,12,20,11,6,8,1,7,8,6,12,12,10,11,10,2,7,5,S ,1,1,20,1,1,1,1,1,1,1,1,1,1,1,1
43273092,Matheus Coloritti,1651,12/10/1997,18,0,0,0,0,173,0,2,3,1,2,4,1,3,2,1,1,3,4,8,8,7,14,6,5,8,1,8,9,3,8,14,6,5,1,10,6,12,12,7,4,1,6,6,7,10,14,11,7,4,5,13,13,20,6,4,8,3,8,7,8,18,12,12,12,10,9,10,4,M RC,1,1,1,1,1,1,1,1,1,1,20,1,18,1,1
43273512,Giovanni Amoroso,1651,11/12/1997,18,0,0,0,0,175,68,3,1,1,2,3,3,1,2,2,1,4,6,5,14,14,14,6,9,4,1,4,7,2,3,9,8,10,7,6,7,2,10,8,8,7,10,4,6,7,14,14,7,5,1,4,14,20,6,7,8,7,6,3,7,9,10,13,12,14,9,4,4,S ,1,1,20,1,1,1,1,1,1,1,1,1,1,1,1
43275052,Felipe Ianni Basilio,1651,07/03/1991,25,0,0,0,0,180,73,2,2,2,3,1,3,1,2,2,1,1,2,4,12,12,11,4,11,4,1,3,5,8,1,7,8,9,1,9,4,1,8,4,8,13,12,2,4,5,12,12,5,5,20,10,12,12,8,7,8,7,6,8,8,19,12,14,11,9,6,10,5,S ,1,1,20,1,1,1,1,1,1,1,1,1,1,1,1
43300630,Manes,1651,23/09/1997,18,0,0,0,0,172,0,3,2,2,2,2,2,3,3,1,2,1,4,6,4,5,11,6,6,8,3,8,7,2,13,9,8,8,7,8,6,5,12,4,8,10,5,8,8,11,14,11,4,4,8,15,13,20,7,5,7,8,5,8,7,11,9,13,15,11,1,4,2,DM ,1,1,1,1,1,1,1,1,1,20,13,1,1,1,1
43310886,Lucas Colleoni,1651,12/03/1998,18,0,0,0,0,172,0,1,1,1,1,1,3,2,1,2,1,3,9,11,9,8,13,4,9,5,3,1,6,1,1,12,7,7,5,4,6,3,7,4,12,9,7,4,5,6,13,8,6,6,20,9,10,10,5,3,7,5,7,6,7,14,10,13,10,10,2,3,2,AM/S L,1,1,17,1,20,1,1,1,1,1,1,1,1,1,1
43316792,Kallebe Gallo,1651,15/01/1993,23,0,0,0,0,183,0,3,1,4,1,3,2,2,2,1,2,2,1,1,7,11,11,1,11,2,1,1,2,7,1,10,3,3,1,8,2,2,9,6,12,7,11,1,1,2,11,7,1,6,6,6,10,20,1,5,6,6,6,6,6,18,10,11,13,12,1,11,5,S ,1,1,20,1,1,1,1,1,1,1,1,1,1,1,1
43321416,Paulo Cesar,1651,03/02/2000,16,0,0,0,0,169,0,2,2,1,3,1,3,1,2,1,2,2,5,3,5,1,7,2,6,4,1,6,3,1,12,6,6,6,6,6,9,6,12,3,6,9,4,4,6,6,13,6,4,8,3,8,9,20,8,6,6,6,4,6,6,11,12,10,12,12,11,7,1,D R,1,1,1,1,1,1,1,1,20,1,1,1,1,1,1
43323063,Thiago Lopez,1651,24/02/2000,16,0,0,0,0,176,0,2,1,2,1,1,2,3,1,1,3,2,6,4,3,1,8,4,7,2,5,6,5,1,12,7,7,5,3,5,10,7,9,7,7,7,2,9,7,7,15,10,7,8,20,9,11,1,5,6,3,7,7,7,5,13,12,12,11,11,10,5,5,D L,1,1,1,1,1,1,1,20,1,1,1,1,1,1,1
43325935,Gustavo Elia,1651,10/08/1994,21,0,0,0,0,175,0,2,2,1,1,3,2,3,1,3,3,3,3,3,5,3,13,1,7,6,4,8,5,6,14,8,7,4,4,8,6,7,12,4,6,5,5,8,8,8,14,13,8,5,7,8,13,20,9,6,8,8,8,8,8,17,11,11,11,10,6,10,8,D/WB R,1,1,1,1,1,1,1,1,20,1,1,1,1,1,19
43333132,Gabriel Alleoni,1651,07/09/1992,23,0,0,0,0,190,80,1,2,2,2,3,2,1,3,1,2,1,5,3,10,13,13,5,13,5,5,5,5,4,2,12,8,10,6,6,5,3,9,8,12,4,12,5,5,6,13,10,6,11,2,13,12,20,5,8,8,6,8,6,8,11,11,10,12,12,7,14,7,S ,1,1,20,1,1,1,1,1,1,1,1,1,1,1,1
43343419,Renato Barbosa,1651,30/05/1998,18,0,0,0,0,185,0,3,1,2,3,2,1,2,1,1,1,1,2,1,1,1,7,3,14,4,1,10,6,1,14,3,8,9,8,4,7,2,14,4,1,7,5,14,6,7,9,7,7,12,10,11,6,20,11,7,8,8,8,8,8,12,11,13,10,12,11,11,7,D C,1,1,1,1,1,1,20,1,1,1,1,1,1,1,1
45002656,Josimar,1651,16/08/1987,28,0,0,0,0,184,82,1,3,2,1,2,3,3,1,1,1,1,5,7,14,12,11,7,10,8,6,4,8,10,7,13,10,12,11,11,11,11,13,6,11,3,13,5,10,10,14,13,12,8,20,11,12,11,11,13,10,1,9,9,10,8,11,12,9,10,2,4,6,S ,1,1,20,1,1,1,1,1,1,1,1,1,1,1,1
45002696,Leandro Love,1651,03/12/1985,30,0,0,0,0,180,75,1,1,2,3,2,1,3,3,4,1,2,3,8,13,13,11,10,11,10,7,5,10,12,4,11,10,11,11,11,11,9,10,12,13,9,12,7,10,11,13,14,11,8,10,10,14,20,12,11,12,10,10,8,8,17,11,8,11,11,10,11,10,S ,1,1,20,1,1,1,1,1,1,1,1,1,1,1,1
45002700,Marcos Antônio,1651,11/06/1988,28,0,0,0,0,171,70,1,2,3,2,2,2,2,3,1,3,1,13,12,11,11,11,13,5,15,9,12,13,5,12,11,13,11,13,11,7,9,9,12,13,10,12,10,12,11,14,13,12,6,20,13,15,5,13,14,10,12,7,8,10,9,11,11,12,11,10,17,13,DM/M C,1,1,1,1,1,1,1,10,1,20,18,10,1,10,1
45006332,Rafinha,1651,30/06/1987,29,0,0,0,0,172,75,1,2,1,2,2,1,3,2,2,1,3,5,9,11,10,10,6,11,10,2,4,11,12,9,12,16,9,14,11,12,12,10,6,13,4,12,5,12,12,13,14,12,11,20,14,14,11,14,14,9,8,9,6,6,10,10,10,11,14,9,12,1,AM/S L,1,1,20,1,17,1,1,1,1,1,1,1,1,1,1
45007769,Cristiano,1651,19/09/1979,36,0,0,0,0,181,78,2,2,2,3,4,1,1,2,2,1,3,4,3,2,3,5,2,14,6,1,14,7,1,14,5,8,9,8,5,7,6,14,6,2,6,5,9,6,7,11,6,7,7,9,9,10,20,4,9,7,6,4,8,8,10,13,10,10,11,9,2,1,D C,1,1,1,1,1,1,20,1,1,1,1,1,1,1,1
45008455,Gustavo,1651,07/07/1984,31,0,0,0,0,181,76,2,3,2,1,1,1,1,1,1,2,2,10,7,7,9,14,14,7,12,1,9,10,8,7,13,9,9,7,11,8,11,8,5,12,6,14,9,9,12,10,12,10,10,6,12,11,20,8,10,9,6,3,7,9,9,12,10,13,10,7,7,8,M/AM C,1,1,7,17,1,1,1,1,1,1,20,1,1,1,1
45013553,Dudu,1651,04/06/1982,34,0,0,0,0,179,70,1,2,1,3,2,1,3,3,3,1,2,6,4,3,7,14,2,6,7,1,9,10,1,7,13,6,10,4,6,5,9,8,8,8,7,11,7,8,12,9,7,7,7,7,8,8,20,12,8,8,7,8,7,8,18,10,10,11,11,5,10,3,M C,1,1,1,1,1,1,1,1,1,1,20,1,1,1,1
45016349,Gilton Ribeiro,1651,25/03/1989,27,0,0,0,0,188,74,1,3,2,3,3,2,1,3,3,3,2,6,11,8,7,11,4,7,9,9,11,10,5,11,10,10,14,11,8,15,7,8,10,5,11,14,12,10,10,13,13,10,12,20,12,14,11,14,11,10,10,10,10,10,7,11,12,13,11,5,9,5,D L,1,1,1,1,1,1,1,20,1,1,1,1,1,15,1
45016409,João Sales,1651,09/06/1986,30,0,0,0,0,183,75,3,3,2,1,2,3,2,1,3,2,3,6,4,13,13,13,6,10,7,5,6,7,7,4,12,9,12,7,7,6,5,10,3,12,7,11,6,6,8,13,10,7,10,10,6,11,20,12,10,9,5,9,9,9,13,10,14,10,10,7,15,3,S ,1,1,20,1,1,1,1,1,1,1,1,1,1,1,1
45025024,Alex Henrique,1651,20/03/1985,31,0,0,0,0,178,72,1,4,1,1,1,1,1,3,1,3,3,10,11,12,12,11,12,8,11,9,4,12,13,4,11,10,10,12,11,9,12,12,2,10,9,12,11,10,11,13,12,9,7,11,11,12,20,14,10,11,9,11,8,12,12,10,11,10,10,8,13,7,AM LC,1,1,10,18,20,1,1,1,1,1,15,14,1,1,1
45025062,Dodo,1651,28/06/1990,26,0,0,0,0,178,83,2,2,1,2,2,4,2,3,3,4,1,2,3,13,13,12,5,13,2,1,5,6,6,2,12,5,6,3,11,4,6,12,1,12,4,11,5,5,6,13,13,6,6,4,12,13,20,6,6,8,8,7,6,8,12,9,12,10,12,12,9,7,S ,1,1,20,1,1,1,1,1,1,1,1,1,1,1,1
45028559,Fagner,1651,24/08/1990,25,0,0,0,0,178,80,2,3,2,2,2,2,1,3,3,1,3,3,2,13,13,13,6,12,7,1,5,7,4,1,13,9,8,4,8,6,5,9,6,13,14,12,5,6,7,13,13,9,8,9,12,13,20,7,11,9,9,3,4,9,15,9,8,12,9,1,13,5,S ,1,1,20,1,1,1,1,1,1,1,1,1,1,1,1
45030348,Thales,1651,20/02/1989,27,0,0,0,0,185,80,3,2,2,3,3,3,4,3,3,4,1,4,4,9,12,7,4,10,5,3,3,5,5,2,11,8,9,5,10,5,1,7,8,12,2,10,4,4,6,12,12,5,11,9,10,12,20,11,12,8,6,8,8,8,18,10,10,10,9,9,5,2,S ,1,1,20,1,1,1,1,1,1,1,1,1,1,1,1
45035269,Lucão,1651,14/09/1991,24,0,0,0,0,186,80,2,2,2,1,3,3,2,3,1,1,2,6,4,13,13,13,6,13,7,2,6,7,7,2,13,9,9,7,6,7,7,9,9,13,9,13,6,6,7,13,13,7,12,8,9,13,20,11,9,9,3,9,9,9,17,12,12,11,10,5,13,3,S ,1,1,20,1,1,1,1,1,1,1,1,1,1,1,1
45035564,Igor Sartori,1651,08/01/1993,23,0,0,0,0,176,75,1,3,1,1,2,3,3,3,2,1,1,12,11,10,12,9,13,12,13,1,7,11,13,6,9,6,8,8,11,10,10,9,10,10,5,11,7,11,10,15,11,13,7,8,15,13,20,11,10,10,6,12,6,10,15,10,10,9,10,12,14,10,AM/S RL,1,1,20,1,16,18,1,1,1,1,1,1,1,1,1
45038692,Heberty,1651,29/08/1988,27,0,0,0,0,173,73,1,3,1,2,1,2,1,2,3,2,1,9,8,14,13,12,13,9,10,6,4,8,13,8,13,7,13,13,14,11,12,14,11,15,4,13,4,9,12,15,14,7,10,20,12,14,8,12,11,13,7,11,11,11,20,10,11,11,12,6,10,8,AM/S RLC,1,1,20,18,17,16,1,1,1,1,1,1,1,1,1
45052598,Renato,1651,19/12/1992,23,0,0,0,0,173,67,4,3,2,2,2,1,1,2,1,1,4,1,2,13,13,13,6,13,7,1,6,7,11,5,11,9,8,5,13,7,5,10,1,11,12,13,7,6,7,13,13,7,6,10,6,13,20,5,6,9,3,7,9,9,14,11,11,8,12,3,10,7,S ,1,1,20,1,1,1,1,1,1,1,1,1,1,1,1
45061585,Osmar,1651,10/08/1987,28,0,0,0,0,180,78,2,3,3,2,1,3,1,2,2,1,3,6,4,13,13,13,6,13,6,4,6,6,5,1,13,2,9,6,9,7,5,11,8,13,13,12,7,6,7,13,12,7,8,10,9,13,20,8,9,9,9,9,7,9,9,11,12,11,12,1,7,2,S ,1,1,20,1,1,1,1,1,1,1,1,1,1,1,1
45061590,Fernando Andrade,1651,08/01/1993,23,0,0,0,0,182,80,3,2,1,2,2,2,3,2,1,3,1,8,8,12,12,11,8,11,8,6,6,10,9,6,12,11,10,10,12,9,8,12,12,12,7,13,7,8,11,14,14,14,11,5,13,13,20,11,11,10,7,10,4,11,14,13,10,14,12,10,10,6,AM RL,1,1,15,1,19,20,1,1,1,1,1,2,12,1,1
45067300,Lucas,1651,02/02/1989,27,0,0,0,0,188,85,2,7,6,7,6,8,6,12,7,7,6,3,3,2,2,1,5,1,3,3,2,1,2,1,1,7,4,13,2,6,3,11,6,2,12,2,6,4,3,10,7,4,11,1,8,7,20,2,6,6,7,7,7,7,18,13,11,12,12,1,14,1,GK ,20,1,1,1,1,1,1,1,1,1,1,1,1,1,1
45079041,Williams,1651,11/08/1994,21,0,0,0,0,185,80,1,1,1,1,3,1,2,2,1,2,3,1,2,1,1,5,1,12,1,2,11,4,4,7,2,6,11,8,5,9,3,13,7,3,2,4,6,5,5,12,12,5,11,20,10,13,9,8,11,8,8,8,5,8,18,11,11,13,10,11,10,8,D C,1,1,1,1,1,1,20,1,1,1,1,1,1,1,1
45087113,Caio,1651,19/04/1994,22,0,0,0,0,173,69,2,1,2,3,3,3,3,2,3,2,1,11,14,14,10,14,9,11,10,7,9,11,5,6,14,11,9,7,7,8,11,13,2,13,9,11,8,10,10,14,14,11,6,11,12,14,20,14,7,11,7,8,9,11,15,13,13,11,10,1,6,2,AM/S RL,1,1,17,1,19,20,1,1,1,1,1,1,1,1,1
45090780,Mateus Santos,1651,11/09/1994,21,0,0,0,0,167,69,2,2,3,3,3,2,2,1,2,1,1,7,11,13,10,11,3,10,6,9,11,11,5,15,11,10,9,10,10,9,5,7,2,1,10,8,11,10,10,13,14,7,4,13,13,13,20,12,5,10,7,5,10,10,10,11,9,11,12,12,14,6,D/WB RL,1,1,14,1,10,14,1,16,20,1,1,8,13,15,19
45101007,Dudu,1651,24/02/1996,20,0,0,0,0,172,67,3,1,1,2,2,1,2,2,1,3,1,6,5,13,13,13,4,13,7,2,3,7,6,5,8,7,8,6,11,4,2,7,4,9,11,5,6,6,7,13,13,3,5,9,8,13,20,5,7,9,9,9,8,9,15,10,13,12,9,5,15,6,S ,1,1,20,1,1,1,1,1,1,1,1,1,1,1,1
47000139,Ferreira,1651,24/08/1984,31,0,0,0,0,192,83,1,2,1,3,2,2,3,2,2,3,1,7,8,9,7,9,10,14,8,8,12,9,9,14,9,13,12,14,9,11,7,11,5,8,12,6,11,7,8,11,10,14,14,8,13,12,20,11,12,10,9,12,7,9,16,12,12,11,13,1,11,4,D C,1,1,1,1,1,1,20,1,13,1,1,1,1,1,1
47014918,Nathan Junior,1651,10/03/1989,27,0,0,0,0,185,80,1,2,2,3,2,2,1,2,1,3,3,5,5,11,13,12,6,12,8,3,5,10,18,5,12,9,9,10,11,11,8,10,12,12,5,10,6,8,10,16,14,10,12,10,12,15,20,12,12,8,3,11,6,10,13,10,11,14,16,8,14,8,S ,1,1,20,13,1,1,1,1,1,1,1,1,1,1,1
47017253,Camilo,1651,21/07/1988,27,0,0,0,0,171,71,2,1,3,1,3,3,2,1,3,3,1,10,11,13,15,14,14,12,13,12,7,13,16,7,14,5,12,12,13,13,13,14,11,14,6,14,9,12,14,14,13,14,8,12,13,13,20,12,8,13,4,13,14,11,15,6,7,11,12,8,15,11,AM/S L,1,1,20,1,16,13,1,1,1,1,1,11,1,1,1
47025111,Lucas Pessanha,1651,30/04/1991,25,0,0,0,0,181,0,2,1,3,1,2,1,2,2,1,3,1,3,2,9,12,11,2,12,5,1,3,5,7,1,7,8,9,6,10,2,5,5,5,8,6,12,5,4,5,12,12,5,6,20,8,12,9,9,6,8,8,7,4,8,11,8,12,12,13,7,1,8,S ,1,1,20,1,1,1,1,1,1,1,1,1,1,1,1
47037057,Geraldo,1651,20/03/1991,25,0,0,0,0,184,85,3,3,2,2,3,3,2,3,1,3,3,6,3,13,12,9,6,13,7,3,6,4,5,4,13,9,13,2,9,7,7,8,9,13,11,13,7,6,7,13,10,7,10,10,11,11,20,7,9,9,7,9,9,9,17,11,12,12,12,6,18,5,S ,1,1,20,1,1,1,1,1,1,1,1,1,1,1,1
47042207,Gilmar,1651,28/03/1990,26,0,0,0,0,174,0,3,1,1,2,2,3,2,1,3,2,3,7,4,10,10,13,7,8,9,2,7,12,5,6,14,7,10,8,10,6,8,12,4,13,7,14,7,8,9,14,13,8,5,10,10,13,20,13,6,9,8,7,7,9,14,8,11,12,9,4,12,1,AM C,1,1,13,20,1,1,1,1,1,1,15,1,1,1,1
47044811,Jean Silva,1651,13/01/1990,26,0,0,0,0,187,86,3,1,2,1,3,1,2,2,3,2,3,9,7,10,13,8,9,13,9,5,9,8,12,6,10,5,11,11,9,9,10,15,8,8,1,10,9,9,9,8,7,13,14,11,14,10,20,8,12,12,9,9,9,9,11,15,3,15,7,7,15,15,S ,1,1,20,1,1,1,1,1,1,1,1,1,1,1,1
47056881,Lekão,1651,17/01/1993,23,0,0,0,0,169,60,1,3,2,3,1,1,3,1,3,2,2,10,13,9,7,12,7,7,6,2,9,9,5,13,9,4,11,8,9,8,7,11,2,9,11,8,8,8,9,13,14,8,5,10,8,14,20,7,5,9,9,1,7,9,17,10,10,11,12,4,1,2,D/WB R,1,1,1,1,1,15,1,1,16,1,1,1,1,1,20
47068049,Fernando Augusto,1651,25/07/1993,22,0,0,0,0,164,0,3,1,1,2,2,2,3,3,2,3,3,5,8,9,4,11,5,9,7,3,12,11,5,13,12,7,11,10,10,12,9,17,9,10,4,10,11,8,7,11,11,10,4,20,11,8,10,9,7,9,9,2,9,9,10,11,11,10,8,12,9,8,D LC,1,1,1,1,1,1,15,20,1,1,1,1,1,1,1
47068052,Lucas Ferreira Cardoso,1651,07/04/1994,22,0,0,0,0,189,0,2,1,1,2,1,1,1,3,2,1,4,8,10,16,15,9,5,10,8,2,7,11,3,9,11,4,9,9,9,9,8,3,3,7,6,11,9,6,9,10,11,4,15,10,10,12,20,12,8,9,5,1,9,9,14,11,15,11,9,6,14,1,AM/S RC,1,1,18,20,13,15,1,1,1,1,10,1,1,1,1
47068885,Patrik Oiaran,1651,22/08/1995,20,0,0,0,0,186,72,2,1,3,2,4,1,2,1,3,1,4,7,10,14,10,14,10,7,10,7,5,14,8,5,14,10,10,10,11,8,14,10,2,14,8,12,5,10,8,13,10,10,10,10,12,12,20,8,10,8,8,8,8,10,20,12,10,10,11,1,6,7,AM RLC,1,1,13,20,17,17,1,1,1,1,1,13,13,1,1
48037280,Bruno Da Cruz,1651,27/05/1996,20,0,0,0,0,182,76,2,1,1,3,1,3,2,3,1,3,3,8,9,14,10,14,8,8,8,1,6,14,2,6,10,8,7,5,6,7,10,11,6,9,2,9,3,9,13,14,12,9,7,5,16,14,20,12,6,10,6,9,6,10,17,12,14,12,11,1,2,3,AM C,1,1,1,20,10,13,1,1,1,1,1,1,1,1,1
51001085,Rodrigo Folle,1651,24/02/1984,32,0,0,0,0,184,78,1,2,3,2,3,1,1,3,1,3,2,8,8,5,6,10,5,11,6,3,12,8,2,10,8,10,12,10,13,12,8,14,10,2,9,7,14,14,13,11,12,10,13,20,12,9,10,13,13,13,4,10,7,10,10,12,11,11,11,1,15,2,D LC,1,1,1,1,1,1,20,16,1,1,1,1,1,13,1
51041859,Murilo Neto,1651,10/10/1992,23,0,0,0,0,179,72,2,3,3,2,2,3,2,4,2,3,1,7,5,13,14,11,7,13,8,6,7,4,7,3,13,5,7,6,10,6,8,7,4,10,5,10,8,7,8,14,14,8,9,9,13,14,20,7,9,11,9,7,5,9,10,12,11,12,12,7,13,6,S ,1,1,20,1,1,1,1,1,1,1,1,1,1,1,1
51049838,Jonatha,1651,04/02/1995,21,0,0,0,0,170,68,2,2,1,1,2,2,3,3,2,2,3,6,7,13,13,13,3,13,7,3,5,7,6,4,11,9,12,2,9,7,6,11,7,11,7,8,7,6,7,13,12,7,5,8,6,10,20,6,6,9,6,9,8,9,15,11,9,10,9,4,6,7,S ,1,1,20,1,1,1,1,1,1,1,1,1,1,1,1
51064109,Ramón da Silva,1651,27/02/1992,24,0,0,0,0,185,81,1,1,1,1,2,3,1,1,3,1,2,4,2,12,12,10,4,10,5,2,3,5,2,1,12,8,10,1,7,3,2,12,3,13,3,11,4,4,5,12,12,5,6,8,13,12,20,10,8,8,8,8,6,8,9,13,8,10,11,12,11,1,S ,1,1,20,1,1,1,1,1,1,1,1,1,1,1,1
51064112,Yan dos Santos,1651,24/03/1997,19,0,0,0,0,186,75,2,3,3,2,4,1,2,3,3,1,3,9,13,9,5,12,7,6,4,6,3,7,3,2,13,8,8,6,6,5,4,11,6,12,1,5,6,8,12,13,13,7,13,2,13,12,20,11,8,8,5,8,7,8,9,13,10,10,14,7,10,8,AM R,1,1,1,1,1,20,1,1,1,1,1,1,1,1,1
51064113,Igor Goularte,1651,08/07/1996,19,0,0,0,0,185,76,1,2,1,1,1,2,1,3,2,2,1,1,5,9,13,13,4,11,6,4,4,6,5,2,10,8,9,6,6,3,5,8,2,10,12,13,4,5,6,13,12,2,11,8,8,9,20,7,7,8,8,8,8,7,20,11,12,10,12,3,11,8,S ,1,1,20,1,1,1,1,1,1,1,1,1,1,1,1
5116917,Rincón,1651,31/05/1987,29,0,0,0,0,188,80,2,1,3,4,1,3,1,3,1,1,3,5,6,9,6,12,8,13,9,7,13,11,8,12,12,12,12,13,11,10,9,11,14,8,10,9,11,12,13,12,11,15,14,10,15,13,20,13,15,13,13,11,12,14,15,14,12,10,14,14,14,5,D C,1,1,1,1,1,1,20,1,10,12,1,1,1,1,10
5261305,Clodoaldo,1651,25/11/1978,37,0,0,0,0,187,86,1,2,1,1,1,2,2,1,3,2,1,4,7,7,12,11,9,12,10,7,7,11,6,8,11,13,13,13,13,12,11,11,13,8,11,13,10,14,13,11,12,12,14,20,15,12,7,11,15,13,10,10,9,7,12,15,11,13,14,13,14,7,S ,1,1,20,1,1,1,1,1,1,1,1,1,1,1,1
5270625,Rodrigo Teixeira,1651,16/06/1978,38,0,0,0,0,187,82,3,1,2,3,1,2,2,1,1,3,3,10,8,10,12,10,10,14,13,6,7,11,5,7,9,14,13,14,10,12,7,13,12,13,8,12,7,7,12,14,7,15,14,13,4,8,20,7,15,8,14,12,13,1,16,13,5,12,8,8,8,11,S ,1,1,20,1,1,1,1,1,1,1,1,1,1,1,1
53070852,Vini Dantas,1651,14/09/1989,26,0,0,0,0,183,79,3,2,1,3,1,2,1,3,3,1,3,5,7,13,12,12,10,10,10,5,4,12,13,4,16,9,13,9,12,11,12,11,11,10,4,14,10,9,12,8,9,13,10,9,12,9,20,11,13,10,6,8,9,11,12,11,9,9,10,9,12,7,AM/S RL,1,1,20,13,17,20,1,1,1,1,1,10,13,1,1
53094974,Neydson da Silva,1651,28/10/1996,19,0,0,0,0,186,72,9,6,5,1,9,10,13,17,14,15,12,6,3,3,2,8,9,2,1,2,3,8,3,3,8,15,7,14,4,6,3,7,13,16,5,4,8,14,18,9,16,8,14,8,8,9,20,11,11,14,19,12,3,9,10,13,13,14,13,12,11,6,GK ,20,1,1,1,1,1,1,1,1,1,1,1,1,1,1
53124589,Marlinho,1651,24/03/1994,22,0,0,0,0,164,58,1,1,3,4,1,1,3,2,1,1,3,13,15,10,9,11,9,7,10,9,7,8,4,7,11,9,10,12,8,10,8,10,11,13,7,9,7,11,9,12,9,8,7,20,11,11,10,11,7,12,10,10,10,10,12,12,11,10,12,11,11,8,AM/S R,1,1,18,11,11,20,1,1,1,1,1,1,15,1,1
5319706,Zé Leandro,1651,14/05/1985,31,0,0,0,0,181,75,2,1,3,1,3,1,2,1,2,3,2,4,8,9,4,10,7,5,9,1,11,10,2,12,10,9,11,12,6,9,4,14,14,2,6,6,10,9,13,12,9,8,9,10,9,12,20,8,6,12,9,9,8,14,16,9,10,9,11,6,8,3,D/DM/M C,1,1,1,1,1,1,16,1,14,20,18,1,1,1,1
535614,Anderson,1651,30/01/1980,36,0,0,0,0,182,78,1,1,2,4,2,2,2,2,1,3,3,6,10,4,10,5,3,10,13,6,4,8,14,9,11,11,6,7,10,4,5,6,10,10,6,11,8,7,9,10,11,8,9,8,13,9,20,10,12,8,2,5,14,6,12,5,4,3,7,14,12,2,S ,1,1,20,1,10,10,1,1,1,1,1,1,1,1,1
54001873,Elton Souza,1651,09/05/1985,31,0,0,0,0,187,80,1,3,2,2,2,3,3,1,2,1,2,1,1,11,13,8,5,10,12,3,4,10,13,3,7,9,11,4,7,8,8,14,4,9,9,8,7,7,10,14,13,6,13,10,9,14,20,13,11,11,9,12,3,9,11,12,10,10,13,3,11,3,AM L,1,1,15,1,20,1,1,1,1,1,1,1,1,1,1
54001875,Leandro,1651,26/06/1985,31,0,0,0,0,180,77,3,3,2,2,3,1,1,1,2,3,2,11,13,9,13,13,8,10,10,7,9,12,16,10,13,7,12,9,13,12,13,11,9,10,10,11,11,16,13,11,12,12,10,8,12,12,20,11,9,14,8,8,7,12,14,10,7,14,16,12,9,6,D/DM RC,1,1,1,13,13,13,1,10,17,20,15,10,15,1,15
54003012,Márcio Tinga,1651,12/08/1985,30,0,0,0,0,180,70,4,2,2,3,4,1,3,1,2,2,3,4,9,12,9,11,7,10,10,7,11,12,9,11,12,13,10,11,11,9,10,10,14,13,7,12,10,13,11,12,13,8,9,10,13,13,20,11,8,13,11,12,6,16,14,13,9,13,7,9,13,9,DM/M/AM C,1,1,1,18,12,9,1,1,1,17,20,8,5,1,1
55002159,Júlio César,1651,13/12/1983,32,0,0,0,0,178,79,2,2,3,3,1,1,2,2,2,3,4,10,10,9,9,11,9,10,8,8,10,10,10,10,12,11,9,10,8,9,9,8,11,10,9,13,10,12,13,10,11,13,11,10,11,10,20,9,13,9,9,8,10,11,15,10,10,9,10,10,9,12,DM/M C,1,1,1,7,1,1,1,1,1,17,20,1,1,1,1
55002250,Edmar,1651,19/04/1982,34,0,0,0,0,175,72,2,2,1,2,1,2,2,1,1,2,2,9,12,13,7,11,9,7,8,5,8,11,7,9,14,8,10,12,11,11,11,10,8,12,8,11,8,14,13,13,14,6,8,20,11,12,5,12,8,10,4,11,5,6,13,12,9,12,11,12,12,5,D/AM L,1,1,1,1,20,12,1,17,1,1,1,15,10,14,1
55002344,Kaká,1651,16/05/1981,35,0,0,0,0,186,74,1,1,2,1,3,1,1,1,1,2,1,6,8,7,5,11,7,14,11,12,14,9,8,12,8,16,12,16,12,8,8,8,15,6,11,9,14,14,14,8,9,16,15,11,16,8,20,12,15,12,12,13,7,10,14,13,11,14,17,12,12,7,D C,1,10,1,1,1,1,20,1,1,12,8,1,1,1,1
55002350,Anilton Júnior,1651,10/07/1980,35,0,0,0,0,185,77,2,1,1,2,3,1,1,3,3,3,3,7,7,8,9,10,11,14,10,12,12,10,10,13,11,13,13,13,12,13,8,10,14,7,12,10,10,13,12,8,9,14,13,4,13,9,20,10,13,12,10,11,6,11,13,12,14,13,15,11,10,8,D C,1,1,1,1,1,1,20,1,2,1,1,1,1,1,1
55002365,Josy,1651,18/03/1983,33,0,0,0,0,184,79,3,1,4,1,2,3,3,1,2,1,2,3,8,7,13,12,7,13,6,7,5,8,13,5,8,10,12,12,12,8,10,10,11,9,7,11,12,11,11,12,10,9,14,20,10,12,10,11,14,8,6,8,5,6,12,10,8,9,10,11,12,11,S ,1,1,20,1,1,1,1,1,1,1,1,1,1,1,1
55002386,Adriano,1651,14/10/1985,30,0,0,0,0,180,75,1,3,3,1,1,3,2,3,1,3,2,11,12,11,11,13,11,8,10,7,6,11,9,5,12,8,13,9,12,10,11,11,4,14,7,12,5,6,6,7,8,10,8,8,11,7,20,8,8,9,7,7,8,8,7,12,12,13,12,2,9,8,S ,1,1,20,10,10,10,1,1,1,1,5,1,1,1,1
55002404,Paulo Vinícius,1651,12/08/1984,31,0,0,0,0,186,82,2,3,4,1,2,2,2,2,1,3,3,7,8,7,8,8,9,16,8,10,14,9,10,13,9,16,12,13,11,13,7,12,15,7,11,8,14,15,14,9,9,14,14,8,15,10,20,12,14,14,12,12,12,10,14,13,7,13,14,13,14,6,D C,1,10,1,1,1,1,20,1,12,8,1,1,1,1,6
55003165,Yannick Pupo,1651,17/06/1988,28,0,0,0,0,173,72,3,2,2,1,1,3,2,3,3,2,1,6,4,14,10,11,8,8,10,4,6,14,4,7,10,10,11,9,11,9,11,9,13,7,4,11,7,8,12,13,13,11,12,10,11,12,20,8,11,10,8,9,10,10,12,17,13,14,13,9,9,3,AM C,1,1,1,20,1,1,1,1,1,1,10,1,1,1,1
55008189,Diego Mourão,1651,03/10/1982,33,0,0,0,0,193,89,1,3,3,3,2,3,3,3,2,3,2,5,5,8,12,12,7,14,9,4,4,11,10,6,11,9,12,10,12,11,10,12,11,8,8,10,13,10,12,9,10,14,15,6,13,10,20,10,14,11,4,11,9,7,16,11,10,11,12,9,11,10,S ,1,1,20,1,1,1,1,1,1,1,1,1,1,1,1
55008462,Robert,1651,10/04/1984,32,0,0,0,0,168,62,2,3,3,1,1,3,2,3,2,4,1,10,10,11,8,13,10,4,8,4,4,11,11,4,12,10,7,10,10,7,11,10,11,13,4,11,7,9,9,12,13,5,2,8,12,13,20,11,2,12,8,10,8,10,12,12,10,11,14,13,14,8,AM RLC,1,1,10,16,20,15,1,1,1,1,10,11,5,1,1
55008724,Cardoso,1651,11/09/1984,31,0,0,0,0,190,85,3,1,3,3,3,3,4,3,3,1,1,10,11,9,8,9,12,13,10,11,12,11,10,13,12,10,10,10,12,11,10,10,12,10,8,12,11,11,11,11,11,7,15,20,12,12,7,12,14,11,10,10,6,13,15,11,13,11,13,13,13,7,D LC,1,1,1,1,5,1,17,20,1,5,1,10,1,12,1
55009666,Victor Golas,1651,27/12/1990,25,0,0,0,0,192,89,12,11,11,5,12,12,12,14,7,9,9,8,2,3,2,8,10,2,3,1,3,8,4,3,6,5,13,13,11,10,7,10,14,3,10,2,13,11,6,10,12,13,14,7,12,9,20,10,12,13,4,10,10,10,12,12,11,8,12,14,14,6,GK ,20,1,1,1,1,1,1,1,1,1,1,1,1,1,1
55010076,Lucas Klysman,1651,15/06/1990,26,0,0,0,0,184,77,1,1,4,1,3,3,3,1,3,1,2,8,8,10,12,10,8,10,8,5,4,8,11,5,11,11,11,11,5,7,8,7,15,8,6,12,8,8,11,11,12,11,12,11,13,11,20,11,11,8,10,4,6,9,13,11,10,12,12,7,7,11,S ,1,1,20,1,5,5,1,1,1,1,1,1,1,1,1
55010242,Marco Aurélio,1651,07/08/1986,29,0,0,0,0,177,74,2,2,3,1,1,2,1,3,3,2,4,9,10,11,11,12,8,8,11,7,5,11,9,7,10,11,11,11,9,9,10,9,11,13,9,12,9,9,10,13,13,11,7,8,11,13,20,9,8,9,6,10,13,12,13,11,12,11,13,14,14,6,AM/S R,1,1,20,14,13,17,1,1,1,1,1,1,1,1,1
55011649,Alípio,1651,07/06/1992,24,0,0,0,0,174,68,2,3,1,1,1,3,1,2,3,2,3,8,10,14,10,14,6,6,8,4,6,11,12,6,12,8,12,11,9,7,11,11,9,16,3,13,5,8,12,15,16,8,7,5,11,15,20,13,5,12,6,12,8,8,12,16,9,12,8,9,12,6,AM/S R,1,1,19,12,14,20,1,1,1,1,10,8,14,1,1
55011679,Luiz Alberto,1651,02/11/1982,33,0,0,0,0,181,82,3,1,2,1,1,3,2,2,2,1,1,5,7,4,6,8,4,14,5,10,12,10,10,12,10,14,12,12,12,12,9,12,12,7,12,9,12,11,12,7,9,13,11,4,13,9,20,13,13,11,11,10,6,10,13,11,12,11,13,14,14,6,D C,1,1,1,1,1,1,20,1,7,1,1,1,1,1,1
55012134,Michel Bertasso,1651,06/03/1985,31,0,0,0,0,183,77,2,1,1,1,3,2,1,2,3,1,1,8,10,8,8,11,9,11,9,10,10,9,10,12,11,11,11,11,10,10,8,10,12,10,7,12,10,12,11,13,12,12,11,5,12,13,20,12,12,9,9,9,11,10,12,11,12,12,13,13,13,5,D R,1,1,1,1,1,1,10,10,20,1,1,1,1,1,10
55012136,Baiano,1651,23/02/1987,29,0,0,0,0,178,72,2,2,2,2,2,2,2,3,3,1,1,11,13,12,8,13,11,9,12,12,12,12,12,13,13,12,14,12,12,14,9,14,13,11,8,14,13,14,15,13,13,13,8,8,13,13,20,15,11,16,10,13,10,9,12,12,11,12,12,12,12,5,D/WB R,1,1,1,1,1,1,1,13,20,1,1,1,10,1,17
55012765,Sandro,1651,13/03/1983,33,0,0,0,0,187,84,2,3,3,2,2,3,1,2,1,2,2,3,3,2,12,7,6,14,5,3,11,9,7,13,5,13,12,12,11,10,10,11,12,9,10,10,13,11,12,12,8,12,12,5,13,11,20,11,12,10,15,12,5,4,13,13,8,10,11,11,11,11,D C,1,1,1,1,1,1,20,1,1,1,1,1,1,1,1
55012977,Renato Neto,1651,27/09/1991,24,0,0,0,0,188,83,1,1,1,2,1,1,1,3,2,4,2,10,10,12,8,13,10,10,10,8,10,13,10,12,13,13,12,12,14,13,13,14,14,12,11,12,10,14,12,12,12,14,13,8,14,12,20,15,15,12,14,14,5,13,12,14,9,14,10,8,10,1,DM/M C,1,1,7,14,7,11,1,1,1,17,20,1,10,1,7
55013070,Michel,1651,22/08/1986,29,0,0,0,0,182,82,3,2,1,2,2,3,3,1,3,1,3,12,13,13,14,13,11,13,15,4,4,12,12,4,13,10,11,11,12,11,11,11,11,13,10,11,7,11,8,10,10,15,12,20,5,10,8,12,15,9,7,12,9,7,14,14,13,12,8,4,12,6,S ,1,1,20,14,5,5,1,1,1,1,1,1,1,1,1
55013921,Gleibson,1651,24/01/1981,35,0,0,0,0,185,75,3,3,1,1,3,1,1,3,3,3,1,6,10,12,10,13,7,10,9,3,7,12,7,10,9,9,12,8,9,11,11,14,13,9,10,12,9,9,11,9,11,13,11,5,13,13,20,10,12,13,10,4,7,10,16,12,16,12,11,8,10,1,M/AM RC,1,1,1,20,10,17,1,1,1,1,16,1,1,1,1
55014132,Paulo Roberto,1651,04/07/1985,30,0,0,0,0,185,80,3,2,3,2,1,2,3,2,3,3,1,4,6,13,13,13,6,10,7,1,5,7,6,6,8,5,11,8,7,6,8,8,11,9,11,12,6,7,8,13,10,7,12,10,10,11,20,13,9,9,9,8,9,9,19,15,11,12,11,1,18,8,AM/S C,1,1,20,18,12,12,1,1,1,1,1,1,1,1,1
55014140,Bobô,1651,20/03/1982,34,0,0,0,0,184,77,2,2,1,4,1,3,1,4,3,1,1,3,5,13,12,13,6,13,7,3,4,6,4,5,11,5,10,8,9,7,7,10,3,11,10,10,7,9,12,13,9,7,13,20,12,12,4,13,14,9,9,9,4,8,17,11,11,13,8,6,1,4,S ,1,1,20,7,10,10,1,1,1,1,1,1,1,1,1
55014298,Gabriel,1651,01/09/1984,31,0,0,0,0,187,0,1,1,2,2,2,1,2,1,3,1,3,4,1,1,1,7,4,14,3,1,10,7,1,13,5,8,11,8,7,10,2,14,8,3,12,3,11,6,7,8,8,7,10,8,11,8,20,5,9,8,4,8,3,8,12,11,11,11,13,5,8,1,D C,1,1,1,1,1,1,20,10,10,1,1,1,1,1,1
55014356,Jamerson,1651,22/05/1981,35,0,0,0,0,182,0,1,2,3,2,2,2,2,2,1,3,3,5,7,10,13,9,8,9,11,1,1,8,9,2,10,10,5,8,10,8,8,11,9,9,4,11,3,8,8,9,10,7,10,5,9,9,20,9,10,8,8,9,5,4,11,10,13,12,9,10,8,7,S ,1,1,20,1,1,1,1,1,1,1,1,1,1,1,1
55014382,Carlos Jesus,1651,27/02/1987,29,0,0,0,0,188,78,3,3,3,1,2,2,1,1,1,1,3,5,4,1,7,8,3,14,7,2,14,5,4,14,4,9,12,9,8,10,4,7,12,7,4,7,12,7,8,14,12,8,12,9,10,14,20,8,9,4,9,9,6,9,6,13,6,11,14,12,11,3,D C,1,10,1,1,1,1,20,1,1,5,1,1,1,1,1
55014412,Gustavo,1651,15/02/1986,30,0,0,0,0,199,94,12,8,9,6,12,9,8,12,9,7,5,2,3,2,1,5,7,2,2,3,2,5,2,2,4,5,6,14,7,11,3,10,12,2,11,3,9,4,3,9,7,6,11,2,10,9,20,4,11,9,7,8,8,8,11,11,13,10,13,14,9,7,GK ,20,1,1,1,1,1,1,1,1,1,1,1,1,1,1
55017365,Assis,1651,04/10/1989,26,0,0,0,0,187,83,13,11,10,12,12,10,9,14,11,9,9,5,3,1,3,4,9,1,3,3,3,2,3,1,8,11,13,12,11,12,11,12,11,2,11,3,12,12,11,11,12,13,14,6,14,11,20,14,12,13,7,11,5,11,15,13,12,11,9,8,12,6,GK ,20,1,1,1,1,1,1,1,1,1,1,1,1,1,1
55021414,Carlão,1651,01/08/1986,29,0,0,0,0,190,84,1,1,1,2,1,3,3,2,2,1,3,8,9,11,12,11,9,13,11,8,8,9,13,7,11,11,11,12,13,13,10,11,13,12,10,11,9,10,11,11,11,15,14,8,13,11,20,11,15,11,7,13,12,11,11,13,12,12,14,11,14,7,S ,1,1,20,10,1,5,1,1,1,1,1,1,1,1,1
55022054,Pedrinho,1651,15/11/1986,29,0,0,0,0,170,63,2,1,1,1,1,3,3,1,3,3,2,8,10,12,14,9,8,9,13,5,6,11,6,5,11,10,10,6,9,9,10,10,12,10,7,11,7,9,10,13,13,9,4,20,7,14,10,10,9,9,10,10,10,10,9,10,9,11,10,10,13,6,AM/S RL,1,1,20,10,19,17,1,1,1,1,1,15,14,1,1
55022084,Tiago Alencar,1651,30/07/1986,29,0,0,0,0,187,86,3,1,2,3,3,1,1,1,3,3,3,7,4,5,2,8,3,12,7,6,14,8,1,14,4,10,12,10,9,12,5,14,10,1,10,8,14,8,9,14,13,9,8,6,17,12,20,7,8,10,10,10,10,10,15,9,9,11,12,4,16,8,D C,1,1,1,1,1,1,20,1,1,1,1,1,1,1,1
55022121,Romário,1651,06/09/1989,26,0,0,0,0,180,76,2,2,3,3,2,1,3,1,3,1,3,6,8,11,12,11,10,10,9,6,5,10,13,7,11,9,11,10,11,11,10,11,8,11,8,11,11,11,11,12,11,11,8,5,11,13,20,11,9,11,4,14,3,11,12,12,10,11,10,5,13,6,S ,1,1,20,10,7,10,1,1,1,1,1,1,1,1,1
55022235,Wesllem,1651,21/04/1985,31,0,0,0,0,178,72,4,2,3,2,2,2,1,3,2,2,1,9,13,10,10,13,6,6,6,2,6,5,7,7,10,9,9,8,13,12,7,13,13,10,14,8,6,7,8,13,10,7,7,7,6,12,20,8,6,9,9,9,9,9,15,9,9,11,9,11,9,9,AM RL,1,1,12,10,17,20,1,1,1,1,8,14,15,1,1
55022380,Altaír Júnior,1651,19/08/1993,22,0,0,0,0,169,60,4,3,1,2,3,2,1,4,2,3,2,9,12,13,8,13,8,6,7,3,6,9,8,6,11,8,6,6,10,5,7,5,9,14,7,12,4,6,9,13,13,6,4,5,12,12,20,7,6,5,7,9,6,9,14,12,13,12,8,1,6,7,AM RL,1,1,1,1,20,19,1,1,1,1,1,10,7,1,1
55022445,Diego Lopes,1651,03/05/1994,22,0,0,0,0,171,64,2,2,2,3,1,1,1,3,3,1,2,13,14,14,13,16,10,6,11,5,6,13,13,6,15,12,11,12,13,10,13,11,12,16,6,12,7,8,13,13,15,8,6,13,9,12,20,12,7,11,11,14,7,7,13,14,12,13,7,8,10,6,AM C,1,1,10,20,13,13,1,1,1,1,1,1,1,1,1
55023691,Itto,1651,21/07/1988,27,0,0,0,0,178,80,3,2,3,2,2,1,3,2,2,2,3,5,9,7,5,7,10,13,12,14,11,10,8,11,8,11,10,8,10,11,8,7,14,7,8,7,11,10,12,11,10,10,9,20,10,11,10,10,12,10,6,9,6,15,12,14,13,13,13,12,10,1,D RLC,1,1,1,1,1,1,15,20,17,1,1,1,1,1,1
55023694,Ragner,1651,14/11/1988,27,0,0,0,0,176,75,2,1,1,4,1,3,1,2,1,2,1,7,10,13,10,7,8,5,8,7,6,11,7,6,12,9,8,10,10,9,9,10,15,8,6,9,7,8,11,12,10,8,7,20,8,12,10,10,9,9,6,9,5,5,11,14,14,13,16,13,13,7,AM RLC,1,1,5,20,17,15,1,1,1,1,13,13,1,1,1
55023799,André Cecim,1651,30/01/1991,25,0,0,0,0,180,75,3,3,1,1,1,2,1,1,3,2,1,6,4,6,4,10,6,6,8,4,6,10,6,12,10,9,9,8,5,8,12,9,5,7,4,8,13,8,12,13,13,8,7,20,12,13,5,8,8,9,9,9,9,9,11,12,10,10,11,9,9,1,DM/M C,1,1,1,1,1,1,1,1,1,19,20,1,1,1,1
55023820,Léo Bahia,1651,07/01/1986,30,0,0,0,0,187,78,3,2,1,3,3,1,3,1,1,1,1,2,4,2,3,7,5,11,3,4,12,10,5,10,8,12,11,11,9,13,8,12,15,7,10,6,12,11,12,10,10,11,10,10,10,10,20,11,12,11,3,10,2,1,18,16,13,16,15,13,15,6,D C,1,15,1,1,1,1,20,1,10,1,1,1,1,1,1
55023835,Diego Galo,1651,14/01/1984,32,0,0,0,0,185,81,1,3,2,2,4,3,1,1,1,1,1,2,3,7,2,10,2,13,2,10,14,11,8,14,11,10,12,14,11,14,9,13,12,5,10,4,14,13,12,12,11,14,14,9,12,13,20,12,13,14,8,11,8,10,14,14,8,13,12,10,12,8,D C,1,5,1,1,1,1,20,1,5,8,1,1,1,1,1
55023856,Leo Tomé,1651,17/09/1986,29,0,0,0,0,170,65,1,2,2,3,3,2,1,2,3,1,1,10,12,12,7,11,9,6,10,6,10,13,10,9,13,11,9,10,13,11,12,12,13,10,8,11,10,11,11,11,12,10,6,20,10,12,6,13,11,11,4,10,9,7,12,13,15,11,14,13,15,3,M LC,1,1,1,15,10,5,1,1,1,1,20,15,10,1,1
55023998,Fidélis,1651,14/06/1989,27,0,0,0,0,188,92,1,1,2,1,2,3,3,1,3,3,2,7,8,10,10,12,8,14,11,7,6,8,12,6,12,9,11,10,12,11,8,8,11,10,8,8,13,12,10,9,9,15,14,20,13,10,12,13,17,10,8,10,8,6,13,11,13,11,14,14,14,5,S ,1,1,20,7,1,1,1,1,1,1,1,1,1,1,1
55024926,Guilherme,1651,21/05/1991,25,0,0,0,0,174,70,2,4,1,1,2,1,2,3,1,3,2,12,13,14,8,14,14,6,12,8,7,16,13,10,14,12,13,15,7,9,13,10,15,17,11,14,8,12,13,14,14,10,6,20,10,11,8,13,8,14,14,12,12,13,14,15,8,12,10,8,10,14,M/AM RLC,1,1,1,20,15,19,1,12,1,10,17,15,10,10,1
55024945,Matheus Bissi,1651,19/03/1991,25,0,0,0,0,188,85,1,2,3,4,3,1,2,3,3,2,4,6,6,9,7,10,7,10,7,8,10,10,6,10,10,10,9,9,10,13,10,9,14,8,8,8,12,9,10,10,10,13,14,7,11,10,20,11,13,12,8,14,10,8,13,12,11,13,12,13,10,1,DM ,1,1,1,1,1,1,14,1,1,20,1,1,1,1,1
55024962,Rafael Amorim,1651,30/07/1987,28,0,0,0,0,194,89,4,3,2,1,1,2,3,3,1,2,1,7,8,9,5,9,8,11,5,5,13,14,7,12,13,12,11,11,13,15,7,12,10,5,12,8,13,12,12,10,10,15,15,20,15,11,5,12,15,13,12,10,4,5,10,11,10,11,12,15,10,8,D C,1,1,1,1,1,1,20,1,1,1,1,1,1,1,1
55027791,Thiago Freitas,1651,13/04/1987,29,0,0,0,0,185,83,1,1,2,2,1,3,3,3,3,2,3,3,6,7,8,11,4,7,8,7,8,14,1,14,14,9,8,8,9,8,9,9,7,9,14,8,12,8,13,11,8,9,14,7,10,10,20,11,10,13,9,6,5,9,14,11,11,9,10,1,20,8,DM/M C,1,1,1,10,1,1,7,1,1,20,20,1,1,1,1
55027814,Júnior Paraíba,1651,01/01/1988,28,0,0,0,0,182,86,3,2,2,1,2,3,3,1,2,3,2,11,11,9,12,12,10,13,11,10,7,11,11,7,11,12,10,12,10,10,11,10,12,11,10,13,11,11,8,12,12,13,14,8,13,12,20,12,14,12,10,11,17,12,12,13,12,13,11,12,13,9,AM RC,1,1,10,20,13,17,1,1,1,1,10,7,7,1,1
55027875,William Vinícius,1651,17/08/1987,28,0,0,0,0,190,80,1,4,1,1,2,2,3,2,1,2,3,4,4,3,5,8,3,11,7,1,13,8,4,13,6,10,9,9,8,8,7,13,10,4,8,3,13,7,8,13,10,8,12,5,14,12,20,13,8,10,3,4,10,10,19,10,11,9,15,2,8,5,D C,1,1,1,1,1,1,20,1,1,1,1,1,1,1,1
55027955,Rômulo,1651,18/06/1992,24,0,0,0,0,176,70,1,2,2,1,1,2,1,2,2,3,3,7,12,11,6,11,5,1,4,3,5,4,2,5,11,5,7,1,7,6,8,12,9,12,5,6,5,6,11,12,11,4,3,5,13,12,20,12,5,9,9,9,3,9,12,8,12,10,11,9,4,4,AM L,1,1,1,1,20,13,1,1,1,1,1,13,7,1,1
55030216,Fabrício,1651,26/12/1984,31,0,0,0,0,183,81,2,1,2,1,1,1,3,2,2,4,2,1,8,7,14,8,4,15,10,1,1,8,10,8,10,10,10,10,13,9,9,8,13,8,8,14,12,12,11,8,8,10,11,8,11,9,20,11,10,11,5,9,5,7,20,15,15,14,17,15,15,1,S ,1,1,20,5,1,5,1,1,1,1,1,1,1,1,1
55030275,Alisson,1651,31/01/1986,30,0,0,0,0,189,83,3,2,3,1,2,3,1,3,2,2,2,12,13,14,11,12,13,11,12,8,5,13,12,6,12,10,7,6,10,10,12,11,12,8,10,13,9,10,12,13,13,7,10,5,12,10,20,12,13,11,8,10,6,9,10,10,16,8,10,10,12,8,AM RL,1,1,13,13,20,19,1,1,1,1,10,1,1,1,1
55030276,Juan Castro,1651,14/02/1989,27,0,0,0,0,185,80,5,7,9,7,12,12,8,12,6,8,7,5,3,2,1,1,7,1,3,1,3,1,2,2,1,8,5,14,3,7,4,10,8,1,11,2,6,5,4,10,10,5,8,8,14,9,20,4,5,8,8,8,7,7,7,11,9,10,11,6,6,5,GK ,20,1,1,1,1,1,1,1,1,1,1,1,1,1,1
55032961,Clebinho,1651,22/06/1986,30,0,0,0,0,168,60,1,2,1,2,1,2,1,2,2,1,3,9,9,13,9,9,9,6,6,3,4,10,8,4,9,9,11,11,11,11,10,10,13,14,10,15,6,9,9,15,15,3,3,7,12,14,20,12,4,11,9,12,13,10,8,10,10,12,9,4,15,4,AM/S RL,1,1,20,13,17,17,1,1,1,1,1,1,1,1,1
55033270,Índio,1651,10/12/1990,25,0,0,0,0,179,74,2,2,3,2,1,3,1,4,1,2,1,5,8,10,13,13,5,13,7,1,5,7,5,2,13,8,11,2,7,7,7,9,12,13,2,10,5,5,7,13,13,3,5,6,11,13,20,11,6,8,8,3,5,8,15,11,12,10,10,12,1,2,AM/S R,1,1,20,7,10,17,1,1,1,1,1,1,1,1,1
55036023,Leandro Souza,1651,23/02/1987,29,0,0,0,0,189,83,1,2,1,2,1,1,3,2,3,2,2,8,9,12,13,12,8,13,9,7,7,11,13,5,13,10,13,9,12,11,10,12,12,12,10,11,8,8,11,11,11,13,12,10,9,11,20,12,14,13,8,12,7,7,16,13,8,12,14,11,12,8,S ,1,1,20,1,1,1,1,1,1,1,1,1,1,1,1
55041542,Leandro Turossi,1651,03/02/1992,24,0,0,0,0,190,80,6,6,7,1,12,10,5,10,5,7,9,3,2,1,2,2,7,1,2,3,1,2,1,2,1,3,5,14,5,8,4,13,7,2,12,2,4,5,4,10,7,5,13,8,7,7,20,4,8,7,7,6,7,7,18,10,12,9,7,6,4,1,GK ,20,1,1,1,1,1,1,1,1,1,1,1,1,1,1
55041572,Cilmar,1651,24/02/1992,24,0,0,0,0,175,68,2,1,1,2,3,2,2,2,1,1,2,10,12,7,6,11,7,4,6,1,3,4,2,4,10,7,7,5,4,3,4,9,5,11,12,6,4,6,11,12,12,6,5,12,11,11,20,6,4,8,6,5,6,8,8,11,11,9,11,11,5,5,AM RL,1,1,7,7,17,20,1,1,1,1,1,1,1,1,1
55041604,Jander,1651,08/07/1988,27,0,0,0,0,183,78,3,1,2,2,4,3,2,3,2,3,1,12,13,12,11,12,11,9,13,8,8,12,12,10,14,12,13,12,12,12,13,14,13,12,10,12,11,13,13,12,12,13,12,20,15,12,6,12,13,12,10,12,7,16,12,11,11,11,11,12,12,8,D/AM L,1,1,1,12,16,12,1,20,1,5,13,10,1,13,1
55041957,Marcelo Tchê,1651,11/03/1988,28,0,0,0,0,181,78,2,1,3,1,2,1,3,3,1,3,1,7,7,7,5,14,4,9,7,8,7,10,1,12,10,9,9,9,6,10,7,11,3,9,13,7,11,9,9,15,15,9,11,10,12,15,20,7,10,9,12,9,8,9,17,13,11,12,11,1,6,8,D RL,1,1,1,1,1,1,1,15,20,1,1,1,1,10,15
55042077,Carlos Eduardo,1651,04/01/1993,23,0,0,0,0,178,71,2,3,2,2,1,3,2,3,1,3,3,13,9,12,9,11,13,7,8,7,5,13,11,6,12,7,10,8,9,11,12,12,9,13,7,12,8,10,9,11,13,10,8,5,10,12,20,12,9,11,6,11,5,8,12,7,10,8,10,11,10,4,AM RL,1,1,1,13,20,17,1,1,13,1,13,1,1,1,1
55042167,Jô,1651,19/09/1988,27,0,0,0,0,170,69,2,3,1,2,2,1,1,2,3,3,1,9,11,14,8,13,8,7,8,7,4,12,12,5,14,10,11,7,8,10,11,8,13,16,5,12,5,11,12,16,15,10,6,8,14,14,20,9,6,9,13,10,9,8,12,12,8,11,6,6,5,10,AM RL,1,1,12,14,20,17,1,1,1,1,1,1,1,1,1
55042918,Rony,1651,28/06/1985,31,0,0,0,0,188,85,3,3,1,3,1,1,3,3,1,3,1,2,3,5,7,7,3,14,2,2,13,8,1,13,6,12,11,9,9,9,5,9,11,5,12,3,12,8,12,7,7,14,13,9,6,5,20,8,14,9,9,9,7,2,12,10,13,11,11,10,12,9,D C,1,1,1,1,1,1,20,1,1,1,1,1,1,1,1
55045812,Weliton,1651,08/12/1989,26,0,0,0,0,184,79,3,4,1,2,3,1,1,3,1,1,3,5,4,4,4,6,4,13,5,8,12,7,6,11,5,13,11,13,8,11,7,6,12,6,14,6,12,12,12,9,7,11,13,10,12,10,20,11,12,11,5,11,5,6,13,11,9,10,11,12,13,5,D C,1,1,1,1,1,1,20,1,7,7,1,1,1,1,1
55045817,Cléber,1651,26/05/1990,26,0,0,0,0,191,82,13,11,15,8,9,9,10,14,9,10,9,2,3,2,2,5,4,5,1,1,2,5,2,3,3,12,8,10,5,7,6,7,14,1,14,1,9,10,10,6,11,8,12,4,12,6,20,8,13,9,9,1,7,9,12,10,12,12,14,16,17,14,GK ,20,1,1,1,1,1,1,1,1,1,1,1,1,1,1
55045850,Walnei,1651,07/11/1983,32,0,0,0,0,191,86,1,2,1,1,2,1,3,3,3,3,3,4,1,1,3,6,2,7,3,1,13,5,1,10,5,8,7,8,4,6,1,13,8,1,12,3,9,5,6,7,8,6,14,9,12,9,20,9,8,8,8,3,8,8,19,11,11,10,13,11,12,4,D C,1,1,1,1,1,1,20,1,1,1,1,1,1,1,1
55045978,Kanu,1651,05/03/1992,24,0,0,0,0,184,79,1,2,2,1,1,3,2,1,2,3,3,1,1,2,1,6,1,10,1,1,10,6,2,13,2,8,9,8,6,9,4,10,6,1,12,3,13,5,6,13,12,6,8,9,14,13,20,11,11,8,7,8,8,8,13,10,11,10,11,1,11,4,D C,1,1,1,1,1,1,20,1,10,1,1,1,1,1,1
55045980,Rômulo,1651,01/11/1992,23,0,0,0,0,178,78,2,3,4,4,1,3,2,2,3,3,2,1,4,13,13,8,6,13,7,3,5,6,7,3,6,5,11,6,10,5,5,12,4,9,1,13,4,6,7,13,9,7,7,9,10,12,20,10,8,6,4,6,9,9,14,12,12,9,11,5,3,4,S ,1,1,20,10,10,10,1,1,1,1,1,1,1,1,1
55047155,Rafael Batatinha,1651,09/02/1990,26,0,0,0,0,182,74,1,2,3,2,4,3,1,3,3,2,3,9,10,13,12,12,8,8,7,6,5,11,9,5,12,8,11,9,12,10,12,11,11,11,10,13,6,9,11,14,13,13,10,7,12,14,20,11,10,10,10,11,6,10,12,13,10,11,13,11,11,8,AM/S RL,1,1,18,12,16,20,1,1,1,1,3,11,13,1,1
55057659,Ederson,1651,17/08/1993,22,0,0,1,0,186,83,14,15,11,8,15,20,15,15,17,3,13,6,9,11,3,11,8,8,12,3,1,13,12,1,12,11,14,16,13,14,12,14,16,3,6,1,14,13,13,13,13,13,13,20,15,12,2,13,13,16,4,16,10,13,18,14,12,16,16,9,13,4,GK ,20,1,1,1,1,1,1,1,1,1,1,1,1,1,1
55058505,Gustavo Silva,1651,28/01/1992,24,0,0,0,0,186,80,12,10,12,1,14,12,10,14,9,9,9,3,2,1,1,7,5,1,2,1,2,2,3,2,2,8,7,14,8,9,7,14,7,3,10,3,9,8,7,13,7,7,13,9,12,11,20,7,11,8,9,7,9,9,20,10,10,11,11,9,16,2,GK ,20,1,1,1,1,1,1,1,1,1,1,1,1,1,1
55058507,Maurício,1651,28/03/1993,23,0,0,0,0,163,58,3,2,1,3,2,1,1,2,2,3,3,7,7,5,9,13,7,7,11,4,10,12,6,13,12,16,12,9,9,9,13,13,6,7,8,9,13,9,12,13,13,9,1,10,12,13,20,7,6,10,11,4,7,10,20,11,12,12,9,7,3,5,DM/M C,1,1,1,10,1,1,1,1,1,17,20,1,1,1,1
55058851,Gabriel,1651,18/06/1988,28,0,0,0,0,170,65,1,3,1,2,3,2,2,1,1,2,2,7,11,12,7,11,7,7,9,13,13,10,12,14,13,14,12,14,11,13,11,12,17,14,10,9,11,13,14,14,12,14,7,8,14,13,20,12,13,13,12,10,9,9,15,13,13,14,14,8,8,6,D R,1,1,1,1,1,1,1,1,20,1,1,1,1,1,15
55059069,Rafael,1651,07/05/1994,22,0,0,0,0,186,84,3,4,3,1,3,3,2,2,1,2,2,1,1,1,2,7,4,13,2,1,13,7,1,13,4,9,10,8,6,7,6,13,7,1,9,6,13,6,7,10,12,7,10,20,13,13,9,6,8,9,9,9,7,9,7,10,10,12,10,13,3,2,D C,1,1,1,1,1,1,20,1,1,1,1,1,1,1,1
55059295,Cleyton,1651,24/02/1990,26,0,0,0,0,171,68,1,1,3,1,1,3,1,2,1,1,2,14,14,13,12,12,13,6,14,8,6,14,13,7,14,9,12,11,11,10,12,10,12,10,8,12,10,10,11,13,12,10,8,7,12,13,20,12,7,9,7,9,8,11,11,13,11,10,13,11,10,10,AM RC,1,1,1,20,1,18,1,1,1,1,15,1,15,1,1
55060173,Victor Luís,1651,23/06/1993,23,0,0,0,0,180,76,1,2,3,3,1,3,1,2,2,4,2,12,13,13,13,13,12,6,10,8,14,12,10,13,13,11,14,11,11,13,13,12,15,13,10,13,13,14,14,14,14,13,10,20,12,14,8,14,10,15,12,12,10,12,19,12,12,12,13,13,13,1,D/WB L,1,1,1,1,1,1,1,20,1,1,1,1,1,16,1
55060432,Bruno Torres,1651,09/06/1988,28,0,0,0,0,176,74,2,1,3,1,1,1,3,3,3,2,1,6,8,13,8,13,3,6,6,4,6,13,1,7,13,13,9,12,7,7,13,11,5,13,7,8,5,7,12,13,13,7,6,20,14,13,10,12,5,9,14,3,9,9,8,10,12,11,11,3,16,5,M/AM LC,1,1,10,20,18,13,1,1,1,1,17,10,1,1,1
55061607,Hebert,1651,23/05/1991,25,0,0,0,0,189,85,4,2,3,3,1,1,4,2,2,2,1,6,8,7,9,9,9,12,7,9,12,10,10,13,10,9,11,9,11,11,9,10,12,9,9,9,11,10,12,10,10,14,15,20,12,11,8,13,15,12,9,11,7,10,20,10,10,10,11,2,8,8,D C,1,1,1,1,1,1,20,1,1,1,1,1,1,1,1
55061732,Anderson Santos,1651,06/01/1993,23,0,0,0,0,190,73,3,2,2,3,2,2,4,2,2,3,1,3,4,5,5,8,1,11,6,1,11,7,6,14,8,14,11,12,11,11,6,9,3,7,9,8,9,10,11,10,10,11,13,12,15,10,20,11,11,12,8,4,5,9,10,12,14,12,12,12,13,5,D C,1,1,1,1,1,1,20,1,1,1,1,1,1,1,1
55061769,Marlon,1651,12/08/1994,21,0,0,0,0,190,86,8,11,10,3,14,11,11,14,10,5,13,3,2,1,1,3,4,1,3,3,2,1,1,1,5,6,7,12,6,11,8,14,3,1,5,2,8,7,8,14,12,4,16,8,10,14,20,5,10,10,7,10,10,10,12,11,13,12,9,7,1,1,GK ,20,1,1,1,1,1,1,1,1,1,1,1,1,1,1
55061939,Hygor,1651,05/01/1989,27,0,0,0,0,180,78,1,2,2,3,3,2,2,1,1,1,3,8,6,7,7,14,7,8,10,1,10,7,3,14,13,10,14,9,9,10,11,12,10,2,11,8,13,6,11,10,14,9,9,12,6,14,20,7,7,9,14,10,10,10,19,12,11,12,11,3,15,8,DM ,1,1,1,7,9,10,1,1,1,20,12,1,7,1,1
55062043,Marcelo Goiano,1651,13/10/1987,28,0,0,0,0,176,69,1,3,1,4,2,3,2,1,2,3,2,8,14,12,6,13,12,7,13,11,11,13,12,13,14,11,13,12,12,14,10,13,14,11,8,15,11,12,14,15,14,10,7,12,14,14,20,15,8,15,8,13,6,14,14,10,13,14,15,12,15,5,D/WB RL,1,1,1,1,1,1,1,20,20,1,1,1,1,15,17
55062049,Platiny,1651,02/10/1990,25,0,0,0,0,178,73,2,1,3,2,2,1,2,3,4,1,2,6,8,13,14,12,8,12,10,7,5,10,11,4,13,9,12,9,13,12,10,13,13,15,9,13,10,10,10,13,13,12,11,8,13,13,20,12,11,11,5,15,7,10,14,14,14,12,13,15,15,7,S ,1,1,20,7,13,13,1,1,1,1,1,1,1,1,1
55062095,Renato,1651,29/10/1992,23,0,0,0,0,185,77,2,1,1,3,2,3,2,2,2,3,1,9,11,11,9,12,9,11,10,9,12,11,9,12,11,12,12,12,12,11,10,11,9,11,7,11,12,14,13,13,13,10,13,9,13,13,20,13,11,11,13,11,9,12,9,11,11,10,12,10,3,3,DM C,1,1,1,1,1,1,1,1,5,20,15,1,1,1,2
55062112,Deyverson,1651,08/05/1991,25,0,0,0,0,189,82,1,1,3,1,3,3,1,1,1,1,1,7,8,11,14,12,10,16,11,6,5,10,12,6,12,17,14,18,13,10,9,12,15,13,8,14,8,12,16,12,14,12,15,20,15,15,10,14,14,12,14,13,9,6,12,16,10,13,11,6,6,6,S ,1,1,20,5,5,1,1,1,1,1,1,1,1,1,1
55062670,Wellington,1651,21/11/1992,23,0,0,0,0,179,75,3,4,2,2,1,1,3,2,2,1,3,7,11,14,10,12,5,12,10,4,3,10,7,5,13,7,8,7,8,8,10,11,6,16,6,12,7,6,8,14,14,8,8,9,14,14,20,11,12,4,7,10,9,7,13,11,13,12,13,3,11,3,AM RL,1,1,13,7,20,20,1,1,1,1,1,1,1,1,1
55062922,Leo Pinheiro,1651,27/01/1991,25,0,0,0,0,192,81,12,9,8,1,10,9,2,12,6,8,6,2,1,3,2,2,7,1,1,1,3,1,3,1,1,8,7,14,5,9,4,12,8,3,13,3,8,5,4,10,13,5,14,9,9,11,20,4,11,8,6,7,5,8,20,10,10,9,8,5,11,8,GK ,20,1,1,1,1,1,1,1,1,1,1,1,1,1,1
55063059,Alemão,1651,07/12/1992,23,0,0,0,0,170,66,1,1,3,2,3,3,3,3,1,1,2,6,10,12,7,10,6,2,8,3,2,11,7,4,13,8,10,11,12,11,12,11,13,14,5,12,7,10,11,14,13,8,4,6,12,14,20,10,6,12,8,12,8,14,12,13,10,12,14,18,14,9,M/AM RL,1,1,10,8,17,20,1,1,1,1,1,17,20,1,1
55063071,Perdigão,1651,17/07/1991,24,0,0,0,0,185,73,2,1,1,1,3,2,2,1,1,2,3,8,11,14,13,12,11,8,8,5,6,12,6,7,14,8,12,11,13,14,10,14,10,16,8,14,12,12,13,14,14,12,9,9,11,14,20,12,11,14,7,14,5,7,11,13,10,11,13,10,11,2,AM RL,1,1,13,10,20,20,1,1,1,1,1,10,13,1,1
55063173,Diogo Alves,1651,19/10/1988,27,0,0,0,0,188,84,2,1,1,2,3,3,3,2,3,3,1,4,1,12,12,10,4,12,5,1,1,5,3,1,9,4,8,6,8,3,3,7,12,10,6,12,4,4,6,12,10,5,8,20,8,12,9,10,6,8,8,6,6,8,8,14,10,11,11,11,16,10,S ,1,1,20,7,7,7,1,1,1,1,1,1,1,1,1
55063335,Wallyson,1651,16/02/1994,22,0,0,0,0,183,77,1,4,3,1,3,1,1,1,3,1,2,12,12,12,11,12,10,8,12,6,8,13,12,9,13,12,13,13,12,11,13,12,12,12,8,10,13,14,15,12,13,12,12,20,12,12,10,10,12,13,7,10,6,13,6,15,10,13,14,7,2,4,DM/M C,1,1,1,12,1,1,1,1,1,20,20,1,1,1,1
55063398,Farley,1651,14/01/1994,22,0,0,0,0,174,64,2,3,1,3,3,1,3,3,2,4,3,8,9,13,8,13,8,4,10,4,5,12,12,6,14,8,11,8,9,11,13,10,12,12,6,12,6,14,12,14,14,10,8,5,11,13,20,12,8,8,7,7,7,12,10,13,7,10,11,14,13,3,M/AM RC,1,1,1,20,14,17,1,1,1,1,16,10,14,1,1
55065238,Guilherme Lopes,1651,23/08/1992,23,0,0,0,0,181,0,1,3,3,2,1,3,3,1,1,2,2,6,7,9,8,14,7,7,8,4,5,12,2,5,14,9,8,4,9,5,8,12,2,13,11,11,8,8,10,14,12,8,10,1,7,13,20,8,6,9,9,9,4,9,14,10,13,10,11,4,10,1,AM C,1,1,1,20,7,7,1,1,1,1,10,1,1,1,1
55065241,Uillian Correia,1651,27/09/1989,26,0,0,0,0,183,78,3,3,3,2,4,2,2,3,3,2,1,12,11,12,12,14,6,10,13,4,12,14,11,13,14,14,14,12,13,10,12,13,5,11,10,12,13,13,14,14,12,12,11,7,13,13,20,13,12,13,12,13,6,13,12,11,8,12,13,1,14,6,DM/M C,1,1,1,14,7,7,1,1,1,19,20,10,10,1,1
55065263,Robson Terra,1651,08/09/1992,23,0,0,0,0,188,86,3,2,3,4,1,2,2,1,1,2,1,3,6,6,6,9,6,6,5,1,8,8,4,13,5,9,6,7,7,7,6,13,10,3,10,2,10,7,11,13,9,7,13,6,10,12,20,13,10,9,1,9,6,9,10,13,12,11,14,4,8,4,D/DM C,1,1,1,1,1,1,20,1,1,20,7,1,1,1,1
55065268,Bruno Agnello,1651,07/12/1985,30,0,0,0,0,165,0,3,2,2,1,1,3,1,2,3,1,1,5,9,13,10,15,5,5,10,4,9,15,5,9,15,8,9,10,13,7,15,12,7,13,9,11,10,10,14,15,14,7,1,20,12,15,2,11,7,9,10,5,9,10,15,13,12,12,12,2,5,1,AM C,1,1,1,20,7,7,1,1,1,1,7,1,1,1,1
55065299,Renan,1651,11/04/1989,27,0,0,0,0,177,74,1,3,1,1,1,1,2,1,4,3,4,10,9,10,7,9,12,8,9,7,10,11,9,11,10,12,14,13,13,14,9,9,12,11,8,11,9,14,14,12,12,10,9,7,13,12,20,11,9,12,13,15,10,15,19,8,9,12,11,8,5,1,M/AM RC,1,1,1,17,13,15,1,1,10,13,20,13,13,1,13
55066875,Rafael Silveira,1651,22/02/1990,26,0,0,0,0,189,84,3,3,4,3,1,3,2,3,1,3,2,8,11,11,13,11,7,11,11,1,5,9,6,6,11,8,10,6,8,10,8,11,9,11,14,11,5,13,10,11,11,14,14,6,8,11,20,8,13,11,10,13,9,9,8,10,12,10,12,6,10,8,S ,1,1,20,10,12,12,1,1,1,1,1,1,1,1,1
55067142,Sidney,1651,10/02/1988,28,0,0,0,0,175,73,1,2,4,3,3,2,1,3,1,1,2,4,2,3,6,10,5,5,3,2,7,11,3,13,11,8,7,7,6,8,9,9,6,8,7,5,8,7,11,9,10,6,7,16,12,13,20,13,11,7,8,8,8,8,9,7,12,11,12,9,10,2,DM ,1,1,1,1,1,1,1,1,1,20,10,1,1,1,1
55067167,Sandro Lima,1651,28/10/1990,25,0,0,0,0,186,82,3,3,3,1,3,1,4,1,1,3,2,10,11,8,13,13,7,11,10,5,10,9,5,9,12,13,12,11,12,10,8,12,13,8,14,12,5,11,12,10,11,10,12,10,11,11,20,8,13,10,5,10,6,11,14,13,11,13,10,3,5,2,S ,1,1,20,1,7,7,1,1,1,1,1,1,1,1,1
55067599,Rodrigão,1651,11/12/1985,30,0,0,0,0,191,85,12,11,10,3,11,9,7,12,7,4,6,3,2,2,2,4,8,2,3,2,3,3,3,3,3,7,8,13,6,10,4,11,4,2,8,1,9,5,10,9,10,7,12,7,12,8,20,6,10,8,8,8,8,8,18,11,11,12,11,1,14,1,GK ,20,1,1,1,1,1,1,1,1,1,1,1,1,1,1
55067686,Márcio,1651,07/01/1993,23,0,0,0,0,187,80,2,1,2,1,3,3,1,2,2,3,1,4,3,4,5,10,6,11,5,10,12,12,8,12,8,7,12,12,11,11,9,12,10,7,8,7,12,12,11,8,8,12,7,10,11,7,20,11,11,13,5,11,8,6,8,10,11,10,12,2,10,5,D C,1,1,1,1,1,1,20,1,1,1,1,1,1,1,1
55067786,Victor Massaia,1651,09/02/1992,24,0,0,0,0,190,85,3,4,1,3,3,1,2,3,3,1,3,4,6,11,4,9,3,11,4,6,13,12,4,12,12,12,12,14,12,14,9,10,14,10,12,6,14,11,13,12,12,11,14,6,16,14,20,13,15,13,11,13,4,11,16,13,12,13,15,11,13,8,D C,1,1,1,1,1,1,20,1,1,15,7,1,1,1,1
55067815,Jefferson,1651,21/10/1994,21,0,0,0,0,185,86,3,2,1,1,1,4,1,2,3,3,1,4,5,11,13,13,6,10,4,1,6,5,9,1,11,9,6,6,9,6,6,6,9,11,10,11,6,6,7,8,12,7,12,9,12,13,20,7,14,9,8,8,5,9,9,10,11,10,10,5,10,4,S ,1,1,20,1,1,1,1,1,1,1,1,1,1,1,1
55068249,Allan,1651,20/03/1990,26,0,0,0,0,178,69,3,1,1,1,1,3,3,2,3,3,3,8,10,13,5,10,5,4,7,2,5,8,2,7,10,8,6,3,6,4,7,4,8,10,11,7,6,7,10,13,13,6,5,8,9,13,20,5,5,8,6,8,5,7,19,11,13,12,12,5,4,2,AM RLC,1,1,10,20,17,17,1,1,1,1,14,7,10,1,1
55069023,André Tonon,1651,30/03/1992,24,0,0,0,0,170,67,2,3,2,2,1,1,3,3,1,3,1,2,7,10,7,13,5,4,7,1,5,11,1,5,12,8,7,2,6,6,10,7,2,10,12,7,4,6,7,13,10,6,3,20,10,11,5,11,4,8,8,3,8,8,10,12,11,12,10,11,19,6,AM RLC,1,1,1,18,20,19,1,1,1,1,14,13,13,1,1
55069345,Michael Araújo,1651,27/02/1993,23,0,0,0,0,181,80,2,2,4,1,2,3,1,4,2,1,3,10,10,13,10,13,12,8,13,3,5,13,6,3,13,5,5,14,11,8,13,11,4,10,7,11,8,8,8,12,13,10,7,9,9,11,20,8,6,8,1,8,3,3,13,12,11,10,9,3,11,8,M/AM RLC,1,1,1,15,17,20,1,1,1,1,17,10,10,1,1
55069628,Rafa,1651,04/03/1993,23,0,0,0,0,185,84,3,3,2,1,4,2,1,1,2,1,1,1,1,1,1,1,1,7,1,1,3,1,1,9,1,5,4,4,1,2,1,11,5,1,2,1,11,1,1,11,9,1,8,8,3,8,20,2,4,5,5,5,4,5,18,12,13,11,10,4,14,7,D C,1,1,1,1,1,1,20,1,1,1,1,1,1,1,1
55069632,Daycson,1651,10/05/1994,22,0,0,0,0,173,73,1,2,2,2,1,2,2,1,2,2,1,6,5,7,6,11,6,6,6,4,4,12,4,8,9,11,10,10,6,8,10,10,5,7,5,3,11,13,11,13,10,7,11,13,12,12,20,6,11,8,6,8,7,8,16,9,11,10,10,1,17,2,DM/M C,1,1,1,1,1,1,1,1,1,19,20,1,1,1,1
55069634,Kaic,1651,20/05/1993,23,0,0,0,0,183,0,1,1,2,3,1,3,3,3,1,1,4,3,3,5,3,12,1,2,8,1,3,5,1,2,8,7,5,5,6,4,9,6,7,9,10,8,4,5,10,12,10,4,6,14,7,9,20,5,7,7,7,7,7,7,8,13,13,11,11,10,8,3,AM C,1,1,1,20,1,1,1,1,1,1,13,1,1,1,1
55069636,Bruno Lima,1651,04/04/1994,22,0,0,0,0,178,73,2,2,1,2,1,1,1,3,1,2,1,9,13,11,7,9,5,6,5,4,3,6,4,5,10,8,6,4,4,5,6,9,3,10,8,7,5,4,7,13,12,3,8,8,14,12,20,8,4,8,8,8,8,8,9,14,12,10,9,4,12,6,AM RL,1,1,13,1,17,20,1,1,1,1,1,1,10,1,1
55069803,Diego Gonçalves,1651,22/09/1994,21,0,0,0,0,182,75,1,1,1,3,3,1,3,1,2,3,3,10,11,12,13,13,10,13,13,5,5,10,12,6,13,10,13,10,12,9,11,10,8,14,7,13,6,10,10,12,11,11,12,10,12,12,20,11,12,10,5,10,7,12,10,10,10,14,11,7,10,11,AM/S R,1,1,20,13,13,17,1,1,1,13,13,1,1,1,1
55069804,Rafael Fernandes,1651,15/01/1993,23,0,0,0,0,186,80,2,1,4,4,3,1,3,1,2,3,1,1,5,6,3,4,1,11,5,1,14,4,5,12,7,5,12,9,8,9,4,12,9,1,10,6,6,7,8,14,14,8,8,10,16,14,20,11,10,9,8,7,5,9,16,13,12,10,9,3,12,7,D C,1,1,1,1,1,1,20,1,1,1,1,1,1,1,1
55069820,Amilton,1651,12/08/1989,26,0,0,0,0,172,68,2,3,3,1,2,3,1,3,4,1,1,9,13,13,11,12,8,9,10,6,5,11,10,7,12,15,11,16,10,10,12,10,16,14,6,12,5,10,15,16,14,17,9,9,13,15,20,12,13,13,9,12,3,11,14,12,7,14,10,12,10,11,M/AM RL,1,1,12,1,15,20,1,1,1,1,1,15,20,1,1
55069821,Diego Medeiros,1651,28/03/1993,23,0,0,0,0,185,72,3,2,3,2,3,3,3,1,3,1,3,12,12,14,11,13,10,8,11,5,5,13,10,7,15,8,11,8,12,8,12,11,11,13,5,8,8,10,11,14,12,13,10,11,12,14,20,11,11,12,8,8,7,11,10,11,12,13,13,11,13,9,AM RL,1,1,5,1,18,20,1,1,1,1,1,1,1,1,1
55070234,Murilo,1651,08/03/1995,21,0,0,0,0,179,74,3,3,1,1,2,3,1,3,1,2,3,8,10,12,10,11,8,8,7,8,4,11,6,6,12,11,10,12,9,9,8,9,12,11,8,12,8,9,11,13,12,9,9,12,12,13,20,12,9,10,10,10,10,10,13,11,10,12,12,2,2,1,AM/S RL,1,1,19,5,19,20,1,1,1,1,1,5,5,1,1
55070278,Lucas Alves,1651,28/01/1996,20,0,0,0,0,177,63,1,2,1,2,3,3,2,1,2,4,3,5,9,9,2,13,7,7,6,3,9,12,1,14,14,5,10,8,5,6,7,11,9,8,10,7,11,8,9,14,11,4,4,10,14,14,20,8,6,8,6,9,9,9,16,14,10,13,12,8,1,2,D/WB/DM/M R,1,1,1,1,1,12,1,1,20,16,14,1,16,1,19
55070289,Matheus Pereira,1651,05/05/1996,20,0,0,0,0,175,69,3,2,1,4,1,3,2,3,3,4,1,12,13,15,12,14,12,6,13,6,6,14,13,6,17,8,10,9,14,11,14,12,10,17,8,13,6,10,11,15,15,12,7,20,12,14,8,13,10,13,3,13,4,11,16,16,10,14,8,12,13,13,AM RLC,1,1,13,19,19,20,1,1,1,1,5,12,10,1,1
55070658,Zílio,1651,23/07/1989,26,0,0,0,0,183,74,1,3,2,1,1,2,3,1,2,1,2,11,11,11,11,11,11,8,10,10,6,11,13,6,12,7,8,6,10,10,12,11,12,9,12,12,9,11,11,9,9,12,7,7,11,8,20,9,9,10,10,14,8,10,13,12,8,13,12,12,14,5,AM C,1,1,7,20,7,10,1,1,1,1,15,7,7,1,1
55070662,Peu,1651,23/03/1984,32,0,0,0,0,182,76,3,2,1,2,2,2,2,3,2,1,1,4,4,1,8,11,1,4,3,3,12,7,6,15,9,4,10,10,7,12,4,10,2,7,10,8,10,8,9,15,11,8,7,20,10,11,9,7,8,9,8,8,5,9,10,7,11,9,11,6,4,4,D L,1,1,1,1,1,1,1,20,1,1,1,1,1,10,1
55070665,Genílson,1651,01/08/1990,25,0,0,0,0,175,0,1,2,2,3,1,2,3,3,2,1,2,6,5,7,8,13,6,6,12,1,6,13,2,7,13,5,7,4,6,6,7,13,9,13,12,8,7,6,10,13,10,7,8,20,13,12,9,9,6,9,9,9,9,9,12,8,11,12,13,2,11,6,AM C,1,1,1,20,1,1,1,1,1,1,15,1,1,1,1
55070668,Ismar,1651,06/09/1990,25,0,0,0,0,186,0,2,1,3,1,1,2,3,3,1,2,2,5,4,2,7,13,5,5,5,3,8,12,2,10,13,8,9,7,7,6,8,11,5,6,14,6,10,7,9,13,13,7,12,9,11,13,20,10,7,8,8,8,8,8,8,9,11,10,12,4,1,6,DM/M C,1,1,1,1,1,1,1,1,1,20,19,1,1,1,1
55070670,Felipe Martins,1651,12/11/1990,25,0,0,0,0,185,70,1,2,3,3,2,1,3,3,1,4,2,10,11,12,11,11,12,12,14,6,4,12,12,5,13,13,8,11,8,8,8,8,14,13,6,11,6,8,10,12,12,13,13,20,14,13,5,9,13,7,7,8,8,10,8,12,9,8,11,9,14,7,AM/S L,1,1,16,1,20,13,1,1,1,1,1,1,1,1,1
55070908,Marcus Barros,1651,26/02/1995,21,0,0,0,0,175,65,3,1,1,3,4,2,2,1,1,3,2,6,8,10,10,12,4,8,8,5,4,8,9,4,10,9,9,8,7,10,8,9,14,8,6,10,8,11,12,11,12,11,8,9,14,12,20,7,8,10,7,9,4,12,12,14,10,10,15,17,14,10,D/AM R,1,1,1,1,1,20,1,1,17,1,1,1,13,1,13
55070911,Kaká,1651,20/05/1991,25,0,0,0,0,176,70,1,3,1,3,3,1,3,1,2,1,1,12,11,13,10,12,12,6,12,7,6,14,12,7,14,7,12,6,11,11,14,13,13,13,8,13,10,13,10,12,14,12,7,8,11,13,20,13,6,10,8,10,13,12,8,15,10,14,11,14,14,12,M C,1,1,1,15,1,6,1,1,1,1,20,1,1,1,1
55070957,Jefferson,1651,11/01/1990,26,0,0,0,0,174,0,3,2,2,1,3,2,1,3,3,2,3,3,3,4,4,12,1,1,5,1,10,7,2,5,12,7,7,3,7,3,10,8,4,7,11,4,5,5,9,12,12,4,3,1,12,12,20,12,7,7,7,6,7,7,12,10,11,12,11,1,16,3,M C,1,1,1,1,1,1,1,1,1,1,20,1,1,1,1
55071332,Bahia,1651,01/02/1994,22,0,0,0,0,176,74,3,1,1,2,3,2,3,3,2,1,2,4,6,10,5,10,4,3,5,4,2,10,4,5,10,6,7,9,5,4,9,10,4,12,13,11,4,10,6,11,9,9,5,8,8,11,20,11,5,7,6,7,7,7,20,12,11,12,15,8,9,3,AM RL,1,1,13,1,20,17,1,1,1,1,1,13,13,1,1
55072306,Jefferson,1651,14/04/1993,23,0,0,0,0,190,86,1,2,2,3,3,3,2,1,2,3,3,4,7,8,10,8,7,13,11,3,12,8,10,13,8,16,14,17,8,15,7,8,15,11,13,8,14,16,16,10,8,13,15,8,8,11,20,16,17,16,12,10,10,13,14,12,10,12,12,7,10,6,DM C,1,1,10,10,1,1,15,1,1,20,15,1,1,1,1
55072311,Dalbert,1651,08/09/1993,22,0,0,0,0,181,74,1,1,2,3,1,3,3,2,3,2,2,12,13,12,8,13,11,9,11,13,10,12,9,12,13,16,12,14,13,11,11,13,13,12,8,14,10,11,14,14,14,12,11,20,13,15,8,15,12,14,13,11,10,10,13,15,10,12,12,12,13,5,D/WB L,1,1,1,1,7,1,1,20,1,1,1,13,1,19,1
55074152,Bruno Santos,1651,07/02/1993,23,0,0,0,0,183,79,2,2,2,1,1,3,2,2,2,2,1,7,11,12,7,12,8,7,5,11,9,11,8,11,13,13,12,13,11,10,10,11,12,8,8,12,9,11,13,15,14,10,8,8,12,15,20,12,10,11,9,10,14,11,8,8,11,12,13,10,13,5,D R,1,1,1,1,1,1,1,1,20,1,12,1,1,1,12
55074155,Wesckley Moura,1651,12/05/1990,26,0,0,0,0,192,86,3,3,2,1,2,3,4,1,1,4,1,1,1,1,3,3,1,12,1,1,9,5,1,12,1,8,4,8,5,7,4,12,1,1,10,1,8,4,5,10,9,5,11,8,9,9,20,8,8,8,6,8,7,8,9,11,11,10,14,1,4,8,D C,1,1,1,1,1,1,20,1,1,1,1,1,1,1,1
55075687,Felipe Barbosa,1651,23/05/1991,25,0,0,0,0,187,78,2,3,1,3,2,2,2,3,2,1,1,2,2,8,12,10,2,3,3,1,1,3,4,1,5,5,4,4,5,3,1,5,3,6,10,4,2,2,3,11,8,3,7,10,12,8,20,2,7,6,6,6,5,6,13,9,12,11,11,4,13,1,S ,1,1,20,1,1,1,1,1,1,1,1,1,1,1,1
55076421,Thiago,1651,26/03/1986,30,0,0,0,0,185,76,1,1,1,2,2,1,3,3,1,2,2,6,8,12,12,12,3,12,5,2,2,4,5,4,11,9,9,6,10,6,7,9,9,12,11,8,6,5,7,12,12,6,10,9,10,12,20,7,8,9,9,9,9,9,19,12,11,10,11,6,5,1,S R,1,1,20,1,1,15,1,1,1,1,1,1,7,1,1
55076912,Marcos,1651,03/02/1990,26,0,0,0,0,186,83,1,1,1,1,3,2,3,3,1,3,3,5,4,7,4,9,4,10,4,3,11,8,7,12,9,14,10,10,4,11,4,11,12,8,14,8,11,12,12,10,10,14,12,3,15,12,20,10,14,10,13,11,2,11,6,6,14,6,13,12,15,4,D/DM C,1,1,1,1,1,1,20,1,1,16,10,1,1,1,1
55076917,Adão,1651,21/01/1988,28,0,0,0,0,184,76,1,1,2,1,2,3,1,1,3,3,1,7,12,11,11,5,4,10,4,4,4,3,6,4,6,6,5,4,12,5,6,7,2,8,11,10,3,5,6,12,12,5,4,15,13,12,20,8,8,8,6,8,8,8,13,10,13,12,10,4,4,6,AM/S L,1,1,20,1,19,13,1,1,1,1,1,10,10,1,1
55078574,Iago,1651,22/05/1992,24,0,0,0,0,188,85,3,2,2,3,1,2,1,3,3,2,3,5,6,8,4,9,5,13,6,9,13,9,6,12,8,13,12,11,10,10,5,9,11,5,8,6,8,12,12,13,12,13,15,10,13,14,20,13,13,9,12,7,10,14,7,10,12,8,13,13,14,8,D C,1,1,1,1,1,1,20,1,10,10,1,1,1,1,1
55079026,João Olavo,1651,01/04/1991,25,0,0,0,0,186,85,1,2,2,3,2,1,3,1,3,3,3,9,11,8,11,12,9,12,11,3,2,8,10,8,10,13,10,11,10,11,8,10,9,6,7,12,10,12,13,8,8,11,11,10,14,9,20,13,13,12,6,9,7,3,8,13,4,11,9,5,16,3,S ,1,1,20,14,1,1,1,1,1,1,1,1,1,1,1
55079787,Rafael Santos,1651,19/02/1994,22,0,0,0,0,182,85,3,7,5,4,12,8,5,13,7,7,10,2,3,1,3,1,5,1,2,1,1,1,3,2,3,3,5,12,5,11,4,13,7,2,9,2,9,5,4,10,7,5,7,8,8,8,20,1,8,7,7,7,7,7,9,12,12,9,11,5,2,4,GK ,20,1,1,1,1,1,1,1,1,1,1,1,1,1,1
55079799,Nakata,1651,07/04/1990,26,0,0,0,0,178,73,3,1,3,3,2,4,3,2,1,3,3,11,11,10,7,13,12,7,10,6,8,10,1,10,10,7,9,7,8,7,10,9,3,10,11,7,6,13,8,9,10,11,7,20,10,9,12,6,6,8,8,6,8,8,10,10,11,9,12,1,11,1,D/M LC,1,1,1,1,10,1,1,16,1,14,20,14,1,10,1
55079802,Derick,1651,01/09/1993,22,0,0,0,0,172,67,1,4,1,3,1,1,1,2,2,1,1,7,10,11,8,8,6,5,8,5,8,8,6,9,11,11,9,11,9,10,9,8,13,13,6,8,9,10,10,15,13,12,7,20,15,14,6,13,8,9,10,15,5,15,13,15,10,10,12,15,10,10,D/AM RL,1,1,13,1,20,17,1,17,1,1,1,13,7,13,1
55079822,Gabi Aquini,1651,04/04/1995,21,0,0,0,0,185,70,3,3,1,2,2,3,2,3,1,1,2,9,9,10,10,10,8,10,3,4,6,8,3,6,8,6,12,8,9,6,8,8,3,7,6,6,8,9,13,12,12,11,8,3,15,12,20,11,10,8,6,8,10,8,8,11,11,11,14,1,12,1,S ,1,1,20,1,1,1,1,1,1,1,1,1,1,1,1
55079878,Felipe Abreu,1651,31/08/1993,22,0,0,0,0,171,64,1,1,2,3,3,3,3,3,3,3,1,6,11,12,9,12,7,6,8,3,5,11,7,5,9,6,8,5,8,9,9,9,9,13,4,12,9,8,9,13,13,8,8,20,12,14,5,10,7,11,8,11,12,10,12,13,9,10,10,9,13,12,AM RL,1,1,11,1,18,20,1,1,1,1,1,1,1,1,1
55079894,João Loureiro,1651,08/12/1992,23,0,0,0,0,170,72,2,2,1,1,2,2,2,3,1,2,2,7,12,7,3,10,5,5,5,5,7,6,1,7,10,8,5,7,7,4,7,8,7,10,6,6,7,6,7,13,13,6,2,16,13,13,20,10,5,8,5,4,8,8,14,11,14,11,11,3,19,5,D/M/AM R,1,1,1,1,1,17,1,1,20,13,13,1,17,1,13
55081466,Dhiego,1651,23/01/1996,20,0,0,0,0,182,80,3,2,1,2,2,4,3,2,3,1,1,1,2,4,4,9,4,3,12,1,9,12,3,8,8,8,6,11,6,5,7,9,14,1,1,3,4,6,10,12,10,10,8,16,13,12,20,12,11,8,6,8,8,8,14,8,9,11,10,11,8,7,M C,1,1,1,14,1,1,1,1,1,1,20,1,1,1,1
55081968,Jouberth,1651,03/03/1991,25,0,0,0,0,178,0,1,3,1,4,2,1,2,1,2,2,1,1,1,12,11,12,3,12,3,1,3,4,5,1,8,5,9,5,9,4,3,5,7,9,13,8,3,3,6,12,10,4,5,7,11,11,20,10,6,7,7,7,6,7,9,12,11,15,8,10,14,4,S ,1,1,20,1,1,1,1,1,1,1,1,1,1,1,1
55081980,Alan,1651,04/01/1993,23,0,0,0,0,177,70,3,1,1,2,4,1,1,2,1,2,1,12,13,12,8,11,8,8,9,12,10,10,6,11,12,10,11,15,11,11,7,11,12,12,5,14,9,12,12,14,11,8,8,20,17,14,9,10,7,11,8,6,6,10,15,14,14,10,11,1,13,2,D L,1,1,1,1,1,1,1,20,1,1,1,1,1,1,1
55082004,Douglas Cordeiro,1651,12/04/1995,21,0,0,0,0,176,76,2,3,1,2,3,1,3,3,1,3,1,7,6,5,7,14,7,7,10,6,10,14,5,14,14,6,8,8,7,9,12,14,6,9,9,8,8,9,6,14,11,9,7,5,13,9,20,5,7,9,8,7,4,9,19,12,12,12,14,3,10,8,DM/M C,1,1,1,1,1,1,1,1,1,20,17,1,1,1,1
55082745,Dário Júnior,1651,11/09/1991,24,0,0,0,0,180,77,3,3,3,2,2,1,4,3,1,1,2,8,12,13,10,13,6,9,9,6,7,8,8,5,11,5,12,2,13,8,9,11,12,11,11,10,6,8,5,13,13,8,7,9,4,13,20,9,5,10,10,8,9,10,11,14,11,9,12,6,10,4,AM/S RLC,1,1,20,17,20,20,1,1,1,1,1,10,10,1,1
55082789,Hismael,1651,08/08/1991,24,0,0,0,0,198,98,3,2,2,2,2,2,2,2,2,3,2,3,1,1,5,3,1,11,1,5,11,6,2,12,1,9,9,6,6,10,3,9,4,8,5,5,12,5,6,12,10,6,12,9,10,10,20,11,12,9,9,3,9,9,19,10,12,11,14,1,8,4,D C,1,1,1,1,1,1,20,1,1,1,1,1,1,1,1
55082804,Roniel,1651,02/06/1994,22,0,0,0,0,177,70,2,3,3,3,1,3,2,2,1,2,1,9,9,14,10,12,8,7,12,7,6,10,11,7,14,9,11,9,8,8,10,8,12,13,8,14,6,9,11,16,15,11,8,8,12,15,20,11,8,7,7,9,4,12,13,11,10,11,8,10,11,8,AM RL,1,1,7,1,20,19,1,1,1,1,1,12,12,1,1
55082969,Nené Leal,1651,08/06/1992,24,0,0,0,0,178,70,2,3,3,2,2,2,3,1,2,2,3,1,2,10,12,6,3,12,2,1,3,4,1,1,11,7,6,1,6,2,1,9,7,12,4,9,2,3,1,12,12,4,4,15,11,12,20,4,3,7,7,6,3,7,13,12,9,9,12,6,8,5,S ,1,1,20,10,10,10,1,1,1,1,1,1,1,1,1
55082999,Gilberto,1651,11/03/1994,22,0,0,0,0,194,85,1,1,1,1,2,3,1,2,3,3,4,4,6,1,1,8,1,14,4,1,11,8,3,12,7,6,12,9,6,10,3,10,1,1,11,7,14,7,7,14,10,6,13,10,8,12,20,5,13,9,9,7,6,9,7,10,13,12,9,5,17,6,D C,1,1,1,1,1,1,20,1,1,1,1,1,1,1,1
55083183,Bina,1651,17/10/1990,25,0,0,0,0,177,69,2,3,3,3,3,4,1,2,1,4,4,4,2,7,11,8,5,11,6,3,3,6,3,1,8,8,10,6,7,5,6,7,2,8,1,13,5,3,7,13,13,6,6,3,15,13,20,12,5,8,5,5,6,7,10,10,12,11,11,6,5,5,S ,1,1,20,1,1,1,1,1,1,1,1,1,1,1,1
55083184,Renan,1651,09/09/1990,25,0,0,0,0,172,73,3,2,2,3,4,1,3,2,2,3,4,10,10,11,4,12,13,8,13,8,7,11,5,9,11,11,10,9,10,10,11,15,9,13,12,9,10,11,10,12,11,10,7,20,11,12,5,9,9,4,9,1,9,9,13,10,13,11,10,7,11,6,D/WB L,1,1,1,1,1,1,1,20,1,1,1,1,1,18,1
55083185,Paulo Jorge,1651,28/05/1986,30,0,0,0,0,175,0,1,1,3,1,2,2,3,1,2,1,2,2,1,6,11,11,2,10,2,1,2,3,6,1,8,7,6,2,11,3,3,5,7,10,11,8,1,2,3,11,11,3,3,9,8,11,20,7,8,7,7,7,7,7,10,11,9,12,10,1,18,2,S ,1,1,20,1,1,1,1,1,1,1,1,1,1,1,1
55083186,Cláudio Souza,1651,15/07/1994,21,0,0,0,0,185,0,3,2,2,4,3,1,2,1,1,3,4,10,12,13,7,13,5,3,6,1,3,3,1,4,10,8,5,5,6,6,6,9,2,10,9,7,5,6,7,13,13,5,12,13,14,13,20,7,8,8,7,5,5,8,9,11,11,10,10,4,7,3,AM R,1,1,12,1,1,20,1,1,1,1,1,1,10,1,1
55083397,Caio Prado,1651,13/04/1995,21,0,0,0,0,179,73,1,2,2,1,1,2,2,2,3,2,2,6,6,7,3,12,3,6,12,3,8,12,7,12,8,9,8,4,7,4,9,10,6,9,13,7,9,6,10,13,12,8,5,5,14,11,20,7,7,5,8,8,6,6,8,12,9,11,11,11,19,8,DM ,1,1,1,1,1,1,1,1,1,20,13,1,1,1,1
55083803,Gleison,1651,23/06/1995,21,0,0,0,0,174,66,1,2,2,1,2,2,1,3,1,2,2,11,13,16,12,13,13,7,12,3,5,12,14,6,15,8,10,11,13,9,12,12,8,17,6,14,7,8,11,15,14,13,7,20,12,14,5,11,7,10,3,10,6,11,16,13,8,11,13,6,11,5,AM RL,1,1,5,1,19,20,1,1,1,1,1,14,14,1,1
55083804,Lucas,1651,23/01/1997,19,0,0,0,0,186,77,3,3,1,1,1,2,3,3,2,4,3,5,5,2,1,8,3,14,3,4,14,7,4,14,5,9,10,9,7,8,7,12,9,6,6,3,14,7,8,6,11,8,8,5,16,8,20,11,11,9,7,6,6,9,18,11,11,11,12,13,5,2,D C,1,7,1,1,1,1,20,1,5,1,1,1,1,1,1
55083807,Tiago Leonço,1651,11/11/1992,23,0,0,0,0,185,82,1,1,3,3,3,3,2,2,4,3,3,8,8,14,12,14,7,12,8,3,3,7,6,4,13,10,13,9,7,9,8,12,7,14,1,14,3,8,9,14,14,9,13,5,10,14,20,10,13,10,10,10,10,10,8,11,12,9,11,9,3,5,S ,1,1,20,1,1,1,1,1,1,1,1,1,1,1,1
55083813,Carlos David,1651,02/07/1996,19,0,0,0,0,180,74,1,1,4,3,2,3,2,3,3,2,2,12,12,7,12,11,13,11,13,10,9,12,14,9,7,7,10,10,11,12,12,13,13,12,12,12,11,11,10,7,6,9,10,20,12,9,9,11,12,11,7,12,4,12,8,13,15,15,12,10,12,2,DM/M C,1,1,1,7,10,1,1,10,1,20,20,1,1,1,1
5605749,Thiago De Lima Silva,1651,01/11/1983,32,0,0,0,0,180,74,1,1,4,3,3,3,2,3,1,1,3,2,10,12,8,11,12,8,8,2,2,10,15,1,14,9,11,8,10,10,8,11,9,14,13,11,11,6,9,10,11,10,11,20,11,10,15,10,8,8,9,13,9,8,18,14,12,8,13,7,12,6,AM/S RL,1,1,20,1,15,18,1,1,1,1,1,1,1,1,1
5629265,André Leonel,1651,18/05/1978,38,0,0,0,0,182,84,2,3,1,1,3,3,1,3,2,1,3,8,10,9,9,10,5,11,6,7,8,10,8,8,10,7,11,13,15,7,10,15,9,8,15,11,7,12,12,7,10,7,10,9,9,7,20,9,12,13,5,11,3,9,8,11,11,11,16,1,16,3,S ,1,1,20,1,1,1,1,1,1,1,1,1,1,1,1
5645862,Jefton,1651,03/01/1982,34,0,0,0,0,186,102,2,3,1,2,1,2,1,3,2,1,2,5,7,10,5,10,5,13,5,5,13,7,5,14,10,14,10,14,8,10,8,9,4,10,7,11,12,11,14,12,11,15,13,7,14,10,20,14,14,12,16,10,6,11,12,3,14,12,5,5,6,14,D/WB/DM R,1,1,1,1,1,1,13,1,17,18,10,1,13,1,20
5666398,Juliano Rangel,1651,04/04/1982,34,0,0,0,0,186,89,2,2,2,2,2,3,1,2,1,2,4,6,8,11,9,12,7,12,4,8,10,12,7,12,12,13,10,11,12,11,10,12,7,10,14,11,10,12,12,11,11,14,13,11,13,13,20,12,13,15,5,13,6,10,8,11,11,10,13,1,4,4,D C,1,1,1,14,1,1,20,1,1,1,1,1,1,1,1
5666399,Lucas Silva,1651,26/08/1984,31,0,0,0,0,186,67,4,3,2,1,3,3,2,3,3,4,1,9,13,13,12,13,8,16,8,8,11,14,6,12,14,11,11,5,13,13,10,13,11,12,14,13,8,12,14,13,13,13,11,8,9,12,20,13,7,11,11,11,11,11,14,9,15,11,14,12,13,9,AM RC,1,1,10,15,1,20,1,1,1,1,12,1,15,1,1
5666436,Carlos Regis Araújo,1651,12/10/1982,33,0,0,0,0,167,65,1,1,3,2,1,1,2,3,1,3,1,8,3,9,10,14,8,5,10,1,7,14,4,10,14,10,11,7,11,13,11,12,2,13,12,12,10,9,10,13,8,9,5,10,13,10,20,14,6,10,10,10,5,10,11,11,12,8,13,7,15,5,AM C,1,1,1,20,1,1,1,1,1,1,12,1,1,1,1
57005995,Ricardo Gomes,1651,18/07/1981,34,0,0,0,0,179,85,3,2,1,1,3,1,3,1,1,1,4,5,6,9,6,10,7,11,8,4,11,10,9,14,11,12,9,12,11,11,10,12,13,11,9,9,13,13,14,10,11,10,9,11,14,9,20,10,10,13,10,12,11,8,15,11,9,9,11,12,6,10,DM C,1,1,1,1,1,1,1,1,1,20,15,1,1,1,1
57009412,Roberto Ayza,1651,19/05/1981,35,0,0,0,0,172,63,1,2,4,2,2,2,1,4,2,2,3,11,12,10,9,13,8,8,9,7,8,11,10,3,11,9,10,11,11,9,11,7,2,10,4,11,11,12,12,14,11,9,8,5,10,12,20,10,10,10,9,11,8,10,9,11,11,11,11,1,12,5,AM/S RL,1,1,20,7,17,17,1,1,1,1,1,14,14,1,1
57027794,Dimas,1651,29/04/1987,29,0,0,0,0,175,70,3,2,3,3,2,4,3,3,2,1,2,6,8,11,15,15,8,11,9,1,8,9,6,4,11,8,7,8,10,9,7,14,6,9,7,14,9,8,9,15,15,9,7,1,11,15,20,8,8,9,9,9,6,9,15,9,13,12,11,9,3,5,S ,1,1,20,1,1,1,1,1,1,1,1,1,1,1,1
5703527,Jorginho,1651,01/10/1975,40,0,0,0,0,176,71,2,3,1,3,2,3,1,1,2,1,3,1,2,13,11,8,1,11,2,1,1,2,4,1,11,6,5,4,6,2,1,9,7,11,10,6,1,1,3,11,9,2,1,12,12,11,20,7,1,6,5,6,6,6,4,12,12,10,11,10,8,2,S ,1,1,20,1,1,1,1,1,1,1,1,1,1,1,1
57044722,Everton Luiz,1651,24/05/1988,28,0,0,0,0,173,68,2,2,1,2,4,3,3,2,1,2,1,6,6,10,4,12,4,8,11,11,14,12,10,15,12,16,13,16,12,12,11,11,14,12,11,10,13,13,15,13,13,13,6,8,14,13,20,15,14,12,15,12,7,11,11,13,13,12,13,12,12,10,DM/M C,1,1,1,1,1,1,1,1,1,20,18,1,1,1,1
57049826,Marcus Vinícius,1651,06/01/1986,30,0,0,0,0,180,74,3,2,2,1,1,4,2,2,1,1,3,7,7,5,9,14,12,8,12,5,9,11,6,8,14,5,12,9,10,9,11,14,6,5,9,10,9,10,12,14,14,10,10,9,6,14,20,8,7,10,5,3,10,10,16,12,8,8,11,9,3,2,DM/M C,1,1,1,1,1,1,1,1,1,19,20,1,1,1,1
57065107,Ygor,1651,27/07/1986,29,0,0,0,0,184,80,1,4,3,3,3,1,3,3,3,2,2,8,9,10,12,9,8,12,9,6,7,9,8,7,12,9,8,11,9,8,6,7,4,8,6,12,8,12,14,12,11,10,13,20,13,12,10,11,14,9,6,9,10,7,16,12,10,9,12,8,5,2,S ,1,1,20,1,1,1,1,1,1,1,1,1,1,1,1
57078182,Walace,1651,20/10/1989,26,0,0,0,0,183,80,2,2,1,1,3,2,3,1,3,3,3,10,9,9,8,10,8,11,8,9,11,10,10,10,11,11,12,12,11,11,11,11,2,8,9,11,11,10,11,9,10,10,12,5,10,11,20,11,11,12,5,10,7,11,8,11,10,11,13,4,20,6,D RC,1,1,1,1,1,1,20,7,15,1,1,1,1,1,1
57078189,Lorran,1651,18/09/1989,26,0,0,0,0,181,80,1,1,3,2,1,1,3,1,1,3,3,8,13,11,8,13,5,5,8,2,5,9,6,7,12,9,13,6,8,8,7,12,3,11,14,8,7,8,11,14,10,8,11,9,9,13,20,8,6,9,9,9,9,9,11,10,9,9,14,4,13,4,M R,1,1,1,1,1,15,1,1,1,1,1,1,20,1,1
57086392,Felipe Tchelé,1651,01/03/1991,25,0,0,0,0,176,72,1,2,3,3,2,2,1,1,3,1,3,4,1,8,12,12,4,10,1,1,1,4,6,1,12,6,8,6,5,3,3,12,8,13,6,12,2,4,6,12,12,3,5,8,9,12,20,11,9,8,4,8,7,8,12,13,10,12,10,8,17,4,S ,1,1,20,1,1,1,1,1,1,1,1,1,1,1,1
57089698,Guilherme,1651,01/04/1990,26,0,0,0,0,179,76,3,1,1,1,3,4,3,3,3,2,2,9,13,10,6,12,12,6,12,14,13,13,10,14,12,14,14,13,12,14,11,11,13,11,7,13,13,12,12,13,12,13,9,20,13,13,7,12,11,12,12,10,12,12,14,13,11,12,13,13,5,5,D/WB L,1,1,1,1,5,1,1,20,1,1,1,7,1,18,1
5710091,Henrique Dias,1651,23/05/1984,32,0,0,0,0,171,67,3,3,1,3,3,1,3,3,1,1,3,9,10,12,9,9,3,8,8,8,3,12,11,5,11,9,12,10,9,8,10,9,12,12,5,13,6,11,12,13,12,8,6,12,6,13,20,13,4,4,8,16,13,18,15,12,13,11,14,13,11,7,AM/S RLC,1,1,20,17,17,17,1,1,1,1,1,1,1,1,1
5720202,Paulinho,1651,14/07/1982,33,0,0,0,0,175,66,1,3,3,3,1,2,4,3,2,1,2,8,12,13,7,10,8,5,9,14,12,13,6,12,13,11,9,10,9,13,13,10,12,9,13,11,13,13,11,11,10,10,7,10,13,10,20,8,9,13,5,12,8,10,10,12,10,10,11,12,8,5,D R,1,1,1,1,1,1,1,1,20,1,1,1,10,1,13
5720391,Gil Bala,1651,18/10/1980,35,0,0,0,0,174,75,2,3,3,3,1,1,3,2,3,1,3,10,9,12,11,11,11,8,10,7,4,12,3,8,14,9,11,14,9,7,13,13,10,14,6,7,6,9,12,9,10,7,4,20,15,12,8,9,9,8,9,12,9,9,6,11,10,7,8,9,11,6,AM C,1,1,10,20,11,1,1,1,1,1,15,8,1,1,1
5723483,Eduardo,1651,05/08/1980,35,0,0,0,0,178,67,3,3,3,3,1,1,3,2,3,3,1,8,10,12,9,13,10,9,11,4,2,11,14,2,13,6,11,9,10,10,11,10,13,14,10,12,7,10,12,13,13,11,8,10,13,12,20,11,10,12,6,17,10,8,12,13,13,12,13,15,15,7,AM/S C,1,1,20,18,10,13,1,1,1,1,1,1,1,1,1
5727066,Raffael,1651,28/03/1985,31,0,0,0,0,174,69,1,3,2,2,3,2,2,2,1,2,1,11,12,17,13,18,13,9,12,4,6,14,14,9,17,14,12,6,12,10,14,14,8,18,4,17,9,15,16,14,17,8,7,16,12,12,20,14,7,13,4,11,4,10,12,10,15,9,13,13,18,5,AM/S C,1,1,20,16,10,10,1,1,1,1,8,10,10,1,1
5728322,Adriano Pimenta,1651,14/11/1982,33,0,0,0,0,170,64,2,1,1,3,3,1,1,1,3,2,2,9,10,11,10,11,11,6,11,4,5,12,12,4,11,13,11,12,11,11,12,11,13,13,7,12,9,10,11,11,13,14,5,20,12,10,11,10,5,13,9,12,9,12,16,12,14,14,14,13,14,10,AM LC,1,1,6,20,17,13,1,1,1,1,15,14,6,1,1
5762360,Fábio Silva,1651,28/02/1980,36,0,0,0,0,188,84,1,3,3,2,1,1,3,2,2,3,2,7,8,7,3,8,4,13,9,4,8,7,3,14,8,14,8,12,7,7,9,7,7,2,9,9,15,9,9,11,7,7,14,12,17,11,20,14,15,10,9,6,3,10,14,11,11,10,10,4,9,8,D RC,1,1,1,1,1,1,20,12,15,1,1,1,1,1,14
5790150,Jairon,1651,21/04/1981,35,0,0,0,0,181,83,3,3,1,2,2,1,1,3,3,3,3,5,5,11,14,13,5,9,6,1,3,12,4,11,12,8,11,7,8,4,10,11,8,12,12,10,5,5,6,11,10,6,10,9,8,13,20,5,8,8,5,8,8,12,13,10,12,10,12,9,19,1,S ,1,1,20,1,1,1,1,1,1,1,1,1,1,1,1
58035735,Anderson Mineiro,1651,15/04/1986,30,0,0,0,0,179,79,2,3,3,1,3,3,4,2,4,3,2,6,6,10,13,13,6,13,7,2,5,8,8,3,11,9,12,8,12,7,5,8,8,11,7,10,6,6,8,13,13,7,6,11,7,13,20,13,7,9,9,9,6,8,12,10,11,12,8,1,4,3,S ,1,1,20,13,1,1,1,1,1,1,1,1,1,1,1
59004172,Wallace,1651,29/10/1986,29,0,0,0,0,183,72,1,4,4,3,1,2,2,3,1,1,3,13,14,11,10,12,13,7,12,9,12,12,10,11,14,12,12,10,13,13,11,13,13,10,4,10,9,10,13,13,12,13,12,20,13,13,7,12,8,14,8,14,7,6,12,11,12,10,10,9,12,4,D/WB/M L,1,1,1,1,10,1,10,20,7,1,1,16,1,19,1
59013010,Douglas Ferreira,1651,07/10/1985,30,0,0,0,0,187,74,2,3,1,2,1,3,1,1,1,1,3,6,6,2,7,12,7,9,6,3,11,10,4,13,8,10,9,9,8,8,5,13,9,10,14,7,10,8,12,13,13,8,13,6,15,13,20,9,7,10,10,5,7,18,14,11,9,12,12,6,7,1,D/DM C,1,1,1,1,1,1,18,1,10,20,10,1,1,1,10
59027758,Diego Souza,1651,12/09/1988,27,0,0,0,0,171,70,1,4,3,2,3,3,1,2,1,3,2,7,4,12,8,10,5,4,14,5,5,11,5,7,9,7,6,6,6,4,14,14,5,9,10,8,6,8,11,14,13,8,5,8,10,10,20,14,6,9,9,9,5,9,19,11,10,12,13,1,15,4,AM C,1,1,1,20,1,1,1,1,1,1,15,1,1,1,1
59070137,Giancarlo,1651,14/05/1993,23,0,0,0,0,175,70,2,1,3,1,3,3,3,2,1,1,3,6,5,12,12,12,5,6,8,1,6,8,7,7,13,4,10,6,8,7,12,9,2,13,13,13,6,7,8,13,12,4,7,9,12,12,20,6,7,9,7,9,7,9,14,10,11,12,7,8,9,8,AM C,1,1,1,20,1,1,1,1,1,1,1,1,1,1,1
59093950,Lucas,1651,20/09/1993,22,0,0,0,0,200,92,3,3,3,3,1,3,2,3,2,2,2,5,3,13,13,6,5,10,6,2,4,1,2,1,6,8,10,7,6,4,4,11,3,8,12,12,4,5,6,11,9,6,17,8,12,10,20,5,13,8,7,1,4,8,10,12,12,13,12,6,11,1,S ,1,1,20,1,1,1,1,1,1,1,1,1,1,1,1
6001529,Elton da Costa,1651,15/12/1979,36,0,0,0,0,182,80,2,2,2,4,2,2,2,2,3,2,2,15,14,13,10,13,14,5,12,5,5,13,14,6,13,11,13,11,9,9,13,11,9,13,9,12,9,11,9,8,12,10,9,20,12,11,9,8,10,10,5,13,14,13,15,11,14,13,15,11,13,7,M/AM C,1,1,1,20,12,1,1,1,1,15,20,14,1,1,1
62026511,Cadú,1651,31/08/1986,29,0,0,0,0,177,67,1,2,2,4,2,1,1,3,1,2,3,12,12,14,11,14,11,7,14,6,9,14,17,6,14,11,8,10,13,12,14,12,12,15,12,13,7,11,12,12,13,10,7,16,11,12,20,10,7,14,9,15,8,10,14,14,13,12,11,12,10,7,AM RLC,1,1,1,20,17,15,1,1,1,1,15,15,15,1,1
62026512,Sávio,1651,01/11/1984,31,0,0,0,0,191,84,1,2,4,1,2,2,1,3,3,1,2,9,8,11,9,9,13,13,12,9,12,10,10,14,12,17,10,10,9,10,9,8,15,10,12,11,11,14,14,9,9,12,14,8,13,10,20,13,11,10,9,11,8,9,14,15,13,14,12,13,11,5,DM/M C,1,1,1,1,1,1,1,1,1,20,17,1,1,1,1
62079380,Thiago Galvão,1651,24/08/1989,26,0,0,0,0,185,78,3,1,1,3,1,2,2,1,3,4,2,9,10,13,11,11,8,9,11,7,2,11,12,6,13,13,7,8,10,9,11,9,14,12,10,12,5,11,12,13,13,10,9,20,16,12,8,11,9,14,10,12,9,9,11,11,11,12,12,10,10,9,AM/S RLC,1,1,20,16,15,15,1,1,1,1,1,1,1,1,1
62079382,Ricardinho,1651,02/06/1989,27,0,0,0,0,170,70,3,2,2,2,2,3,3,3,1,1,3,9,7,9,10,15,9,9,9,8,5,14,7,7,10,9,8,7,8,9,8,9,9,9,5,13,7,9,8,9,8,8,8,10,8,8,20,8,8,9,8,9,9,9,9,8,11,9,8,9,9,9,AM C,1,1,1,20,1,1,1,1,1,1,1,1,1,1,1
62162347,Magno,1651,29/01/1993,23,0,0,0,0,184,71,2,2,1,2,3,1,1,3,2,2,2,5,6,9,13,13,6,11,7,1,6,5,8,2,8,9,13,8,11,7,5,11,9,9,12,12,6,6,7,13,13,7,8,10,12,13,20,11,9,9,9,9,9,9,7,13,10,9,10,6,7,3,S ,1,1,20,1,1,1,1,1,1,1,1,1,1,1,1
62162352,Luís Gustavo,1651,05/07/1989,26,0,0,0,0,179,74,1,3,3,2,3,1,1,3,2,3,3,7,10,11,6,10,9,9,9,8,10,10,4,12,11,10,11,10,10,11,10,10,10,8,4,9,12,10,10,13,15,11,9,9,10,12,20,11,10,12,10,10,10,10,14,11,11,10,12,3,15,8,D R,1,1,1,1,1,1,1,1,20,15,1,1,1,1,15
63012128,Bolinha,1651,29/11/1990,25,0,0,0,0,185,0,1,3,3,3,1,3,3,1,2,3,3,9,13,13,9,9,6,7,8,6,4,8,3,5,13,9,9,6,4,8,8,10,9,13,1,7,5,7,8,13,12,8,8,20,8,13,10,8,9,9,4,8,9,9,16,9,10,12,10,9,10,7,M/AM L,1,1,14,1,20,1,1,1,1,1,1,17,1,10,1
63028929,Wesley,1651,26/11/1996,19,0,0,0,0,190,93,3,4,1,2,3,2,3,2,1,1,3,10,8,9,11,13,10,14,10,9,5,11,7,5,10,4,16,13,12,10,12,12,12,13,3,14,6,10,14,10,9,12,16,8,11,11,20,10,15,12,9,3,10,9,10,14,12,9,8,3,14,7,S ,1,1,20,1,1,1,1,1,1,1,1,1,1,1,1
63029285,Lorran Alves Duarte,1651,17/03/1995,21,0,0,0,0,196,0,4,1,3,3,3,2,3,1,2,1,1,6,5,3,8,12,6,5,10,1,11,8,1,14,7,8,5,7,4,7,9,13,5,8,9,8,4,8,4,7,12,8,13,20,15,12,9,7,11,8,8,8,8,8,13,12,10,12,11,1,12,5,DM/M C,1,1,1,1,1,1,1,1,1,17,20,1,1,1,1
63031233,Pedro Colina,1651,05/01/1998,18,0,0,0,0,167,63,2,2,1,1,3,3,2,1,2,3,3,7,5,10,14,14,7,9,9,7,4,12,8,8,11,9,6,8,6,8,10,7,6,10,3,9,4,8,6,13,12,9,6,8,7,14,20,9,7,8,9,9,9,9,10,12,8,9,9,5,16,4,AM C,1,1,15,20,1,1,1,1,1,1,12,1,1,1,1
65008645,Elton Morelato,1651,13/08/1988,27,0,0,0,0,187,0,1,2,3,2,2,1,2,3,2,3,3,7,3,13,13,13,7,13,6,1,6,8,4,3,10,10,13,5,7,8,6,13,2,10,13,13,6,7,8,13,13,8,7,20,15,13,10,8,8,10,3,10,9,10,11,11,9,12,10,1,7,7,S ,1,1,20,1,1,1,1,1,1,1,1,1,1,1,1
66012067,Wagner Querino,1651,31/01/1987,29,0,0,0,0,174,75,1,1,4,2,2,1,1,1,3,3,2,7,8,13,11,13,11,11,10,2,7,9,3,2,10,10,11,9,8,7,10,13,3,10,13,13,8,7,9,13,13,6,8,10,10,13,20,12,8,10,7,9,8,10,16,10,13,14,14,4,1,6,S C,1,1,20,15,1,1,1,1,1,1,1,1,1,1,1
66013602,Roniere,1651,23/04/1986,30,0,0,0,0,180,74,3,1,2,3,2,1,1,2,4,2,2,12,11,12,8,11,11,6,5,2,9,13,11,8,12,11,10,11,10,11,11,10,9,12,7,12,11,13,12,11,10,11,9,8,12,10,20,12,9,12,10,9,7,11,12,11,11,11,11,1,7,1,M C,1,1,1,1,1,1,1,1,1,1,20,1,1,1,1
661147,André Silva Batista,1651,17/04/1980,36,0,0,0,0,180,79,1,3,1,3,4,1,3,3,3,2,1,6,7,8,10,8,7,10,11,10,13,10,8,12,11,10,10,10,6,13,9,8,5,7,4,13,11,10,12,10,9,7,10,9,10,8,20,9,10,7,11,5,7,5,10,8,12,11,11,3,12,5,D C,1,1,1,1,1,1,20,1,1,1,1,1,1,1,1
663052,David Júnior,1651,19/07/1982,33,0,0,0,0,190,82,2,1,2,3,1,2,1,1,2,1,1,7,9,9,8,9,8,12,9,8,12,10,8,12,8,15,12,15,12,11,8,9,10,7,8,9,10,9,10,9,9,5,15,20,10,10,9,11,13,8,9,11,7,10,9,12,12,7,8,7,5,6,D LC,1,1,1,1,1,1,20,18,1,13,1,1,1,1,1
67006307,Addison,1651,20/03/1981,35,0,0,0,0,177,70,2,2,1,1,2,2,1,3,1,3,2,8,10,11,11,10,9,7,10,7,5,11,9,6,11,4,9,8,7,8,9,10,8,12,5,11,9,8,8,13,10,8,9,8,10,13,20,8,8,7,5,8,5,11,11,13,5,15,7,9,11,16,AM/S C,1,1,19,20,1,14,1,1,1,1,1,1,1,1,1
67100016,Rafinha,1651,12/02/1993,23,2,1,5,0,174,71,3,1,3,1,1,1,2,2,2,2,3,14,15,16,11,15,13,11,12,8,8,15,13,12,15,16,12,14,12,13,14,13,14,13,11,13,12,14,17,15,13,14,8,20,14,13,8,16,12,13,11,14,6,14,13,13,12,12,13,12,13,7,M/AM RLC,1,1,15,20,16,19,1,1,1,10,19,13,11,1,1
67126612,Bruno,1651,05/01/1991,25,0,0,0,0,178,72,2,2,2,2,1,1,1,3,3,1,2,6,8,10,12,10,8,12,11,9,6,8,6,5,11,9,11,12,9,8,8,11,9,10,10,12,6,9,13,12,12,9,10,8,7,13,20,11,11,9,9,9,7,9,13,12,11,11,11,5,6,7,M/AM/S R,1,1,18,1,1,20,1,1,1,1,1,1,16,1,1
67135736,Wanderson Miranda,1651,08/02/1990,26,0,0,0,0,178,75,3,1,2,1,1,2,2,3,2,3,2,7,8,7,7,10,11,8,12,9,11,11,8,13,10,13,13,14,14,11,8,11,10,5,8,6,13,13,13,10,9,13,8,20,12,11,5,14,13,14,6,9,15,8,15,13,12,10,11,5,15,8,DM/M C,1,1,1,1,1,1,1,1,1,20,17,1,1,1,1
67146260,Elton Martins,1651,04/11/1988,27,0,0,0,0,171,0,2,3,1,1,1,1,2,3,3,3,3,12,16,14,10,10,13,10,11,8,11,11,5,11,16,5,11,11,11,12,10,12,1,8,15,11,10,11,9,12,12,12,10,20,12,13,10,12,12,7,11,10,11,12,7,12,13,12,12,7,15,3,M/AM L,1,1,1,1,20,1,1,1,1,1,1,16,1,1,1
67153647,Léo Baptistão,1651,26/08/1992,23,0,0,0,0,184,73,2,1,2,2,2,1,2,1,2,2,1,9,12,15,12,14,11,11,12,5,5,13,12,5,15,10,13,10,13,13,14,13,15,16,9,15,5,12,11,14,13,10,12,15,10,15,20,13,11,12,8,9,13,7,16,14,10,11,14,10,8,7,AM/S RLC,1,1,20,15,17,18,1,1,1,1,1,14,13,1,1
67156533,William,1651,31/08/1987,28,0,0,0,0,178,73,4,1,3,4,1,1,3,1,4,4,1,6,6,13,13,13,6,10,8,1,5,9,2,6,13,5,10,8,7,7,10,12,6,11,9,12,7,7,8,13,13,5,5,8,15,13,20,12,9,9,6,4,9,9,11,10,12,12,11,2,11,3,AM/S C,1,1,18,20,1,1,1,1,1,1,1,1,1,1,1
67175051,Elbis,1651,26/12/1992,23,0,0,0,0,173,0,1,1,3,3,3,1,2,1,3,2,2,12,13,12,6,12,10,7,7,8,9,11,6,9,12,7,9,8,8,7,11,8,3,11,13,13,9,10,12,14,13,7,4,20,9,13,4,10,9,9,8,4,9,9,16,13,11,10,12,2,8,7,D/WB/M L,1,1,1,1,14,1,1,19,1,1,1,18,1,20,1
67179130,Patric,1651,10/06/1994,22,0,0,0,0,196,0,1,1,1,2,3,2,2,2,2,3,3,4,3,5,4,11,4,1,11,1,5,11,3,11,12,8,2,1,8,5,12,12,8,8,5,5,2,4,9,12,7,5,12,11,8,11,20,5,10,8,8,6,8,8,11,9,13,11,12,8,18,3,M C,1,1,1,1,1,1,1,1,1,1,20,1,1,1,1
67197138,Jean Carlos,1651,10/05/1996,20,0,0,0,0,185,76,1,1,2,1,3,2,2,1,1,3,1,9,10,12,8,11,9,6,8,3,4,10,8,5,12,9,11,6,10,7,9,14,8,14,1,10,8,10,13,12,12,6,4,9,13,12,20,10,8,10,10,9,5,10,20,11,11,9,9,12,16,2,M/AM RL,1,1,1,1,20,20,1,1,1,1,1,15,19,1,1
67197888,Allyson,1651,01/01/1994,22,0,0,0,0,184,0,3,2,3,2,3,2,2,1,3,2,2,7,9,10,13,9,7,12,8,6,6,9,11,6,10,14,10,14,9,8,9,10,4,11,10,12,8,12,12,11,9,12,12,10,12,12,20,11,12,11,10,10,8,10,8,11,11,14,9,11,16,4,S ,1,1,20,1,12,12,1,1,1,1,1,1,1,1,1
67210280,Gabriel Valente,1651,22/09/1994,21,0,0,0,0,175,0,2,2,1,1,3,3,2,3,1,3,3,5,5,7,5,13,5,1,7,5,5,13,3,5,13,8,6,5,8,6,13,8,8,13,4,3,5,7,11,13,9,6,8,8,10,10,20,7,3,8,8,8,8,8,18,11,10,10,10,7,9,3,AM C,1,1,1,20,1,1,1,1,1,1,1,1,1,1,1
67214327,José Ricardo,1651,04/09/1998,17,0,0,0,0,159,0,1,1,3,2,3,3,2,1,2,2,1,7,10,9,4,12,2,6,7,5,7,8,3,13,9,8,9,7,7,6,9,9,6,7,11,6,5,9,9,15,15,7,2,20,15,15,5,6,6,8,8,8,6,8,20,13,12,11,10,8,3,2,D/WB L,1,1,1,1,13,1,1,19,1,1,1,14,1,20,1
67216480,João Avelar,1651,05/03/1997,19,0,0,0,0,174,0,1,3,3,3,1,2,3,1,1,1,3,4,4,11,7,13,4,9,5,2,4,6,4,1,11,7,4,4,9,4,7,6,4,11,1,6,2,4,6,13,10,5,7,8,12,12,20,5,5,7,7,4,5,6,20,12,10,12,11,3,8,3,AM/S C,1,1,20,17,1,1,1,1,1,1,1,1,1,1,1
67217507,Jhoseppy,1651,17/06/1998,18,0,0,0,0,181,0,3,2,4,1,3,2,1,2,2,2,2,5,4,5,5,11,2,6,1,5,7,5,2,12,7,7,6,6,7,5,7,11,7,7,10,2,5,7,7,14,11,7,6,8,11,12,20,8,6,7,7,7,4,7,17,10,10,11,10,2,16,6,D/WB R,1,1,1,1,1,1,10,11,20,1,1,1,1,10,18
67228234,Gílson Júnior,1651,22/04/1994,22,0,0,0,0,187,82,1,2,4,1,1,3,2,3,1,1,3,4,4,5,1,9,1,12,3,2,13,9,1,12,7,8,10,9,8,11,7,10,3,1,13,6,11,7,5,14,10,8,10,20,10,13,5,6,11,9,8,2,9,9,13,12,13,10,11,1,4,5,D LC,1,1,1,1,1,1,20,15,1,11,1,1,1,10,1
67245455,Gabriel Silva,1651,09/01/1997,19,0,0,0,0,174,0,1,3,3,2,2,2,2,2,1,2,1,6,4,12,13,13,6,7,7,5,3,10,4,1,12,9,5,8,4,7,8,13,9,12,10,6,5,7,8,13,11,8,7,12,10,11,20,6,6,8,6,7,8,9,19,14,12,11,11,8,19,5,AM/S C,1,1,17,20,1,1,1,1,1,1,1,1,1,1,1
67245492,Felipe Sá,1651,29/05/1995,21,0,0,0,0,169,0,3,1,2,3,2,2,1,2,2,3,3,2,1,5,8,12,2,2,3,1,1,5,3,3,12,6,4,1,4,1,10,11,3,13,5,1,2,5,8,12,7,3,1,9,9,9,20,5,2,6,6,6,6,6,13,10,9,11,8,1,5,6,AM C,1,1,1,20,1,1,1,1,1,1,1,1,1,1,1
67245737,Lucas Silva,1651,12/02/1996,20,0,0,0,0,178,0,3,2,3,2,1,1,2,2,2,1,3,8,12,12,7,13,5,6,6,6,3,8,1,6,10,9,7,2,4,7,8,6,9,10,12,7,4,7,12,13,11,4,6,14,13,12,20,8,5,9,8,9,3,9,18,11,11,11,12,11,1,7,AM RL,1,1,1,1,18,20,1,1,1,1,1,15,15,1,1
67248163,Alex Dos Santos,1651,15/01/1999,17,0,0,0,0,195,0,8,6,9,1,13,11,5,13,8,7,9,6,1,3,2,2,8,1,1,2,2,1,2,1,2,8,8,13,5,8,5,11,8,2,7,1,5,6,4,9,8,6,14,8,9,7,20,2,11,6,8,8,6,5,8,12,11,13,14,11,13,7,GK ,20,1,1,1,1,1,1,1,1,1,1,1,1,1,1
67248411,Raí,1651,18/05/1998,18,0,0,0,0,172,68,1,1,4,1,1,1,2,2,3,1,3,8,10,13,14,12,8,10,11,3,6,10,7,5,13,5,8,7,8,7,13,13,15,10,4,14,8,9,10,14,15,12,6,11,13,14,20,10,6,10,5,10,6,12,15,12,14,11,9,1,11,3,AM/S RLC,1,1,20,18,16,15,1,1,1,1,1,1,1,1,1
68015254,Pablo Campos,1651,29/11/1983,32,0,0,0,0,191,93,2,2,1,1,3,1,2,1,3,1,1,7,6,8,12,10,7,13,14,5,4,8,17,5,12,15,11,15,14,14,9,11,16,12,5,13,10,12,17,8,9,13,13,10,12,8,20,12,15,17,7,15,5,6,17,13,8,14,17,13,5,4,S ,1,1,20,1,1,1,1,1,1,1,1,1,1,1,1
681900,Wellington,1651,11/08/1983,32,0,0,0,0,175,79,2,2,2,4,1,2,2,3,1,3,4,13,12,12,8,13,12,12,12,6,5,10,12,5,13,8,11,7,6,7,13,10,8,12,7,10,5,8,6,8,9,12,6,20,10,8,7,6,9,7,6,8,13,12,12,14,10,8,7,10,14,9,AM/S RLC,1,1,19,20,19,18,1,1,1,1,10,10,8,1,1
682616,Ricardo,1651,08/01/1976,40,0,0,0,0,171,0,4,3,1,1,8,1,4,9,3,2,3,8,11,9,10,14,7,5,11,10,10,10,17,5,9,8,10,11,14,13,7,9,4,12,9,11,8,13,20,9,11,8,10,4,13,9,20,15,12,3,18,7,19,5,11,9,6,1,3,7,2,4,S ,1,1,20,1,1,1,1,1,1,1,1,1,1,1,1
689927,Cleyton,1651,08/03/1983,33,0,0,0,0,175,70,2,4,1,3,3,3,3,1,1,3,1,13,12,15,11,16,14,12,13,5,5,14,15,6,15,8,11,7,12,11,14,10,8,15,10,12,5,12,8,12,14,11,7,12,11,11,20,10,8,11,12,14,6,10,12,14,7,11,12,9,10,11,AM C,1,1,1,20,1,12,1,1,1,10,15,1,8,1,1
6900021,Leandro,1651,13/08/1980,35,0,0,0,0,170,66,2,3,1,4,3,1,4,1,1,3,4,1,9,11,6,10,2,8,9,7,7,10,10,7,11,13,11,13,8,7,8,8,15,10,9,10,7,10,10,12,11,5,4,15,12,12,20,9,6,9,17,11,16,16,8,11,12,12,13,12,12,15,AM/S RLC,1,1,20,18,15,16,1,1,1,1,13,10,15,1,13
69000351,Talisson,1651,18/01/1989,27,0,0,0,0,170,71,2,1,1,1,3,2,3,3,2,3,1,5,8,11,5,9,4,1,1,4,4,6,1,3,4,8,6,2,5,2,3,7,7,8,4,5,4,6,10,12,12,5,1,20,12,12,8,12,5,8,4,1,8,8,13,11,9,10,11,1,8,6,AM L,1,1,1,1,20,1,1,1,1,1,1,15,1,1,1
6900076,Deda,1651,03/07/1975,40,0,0,0,0,183,72,2,2,3,3,3,2,1,3,3,1,2,5,6,5,7,12,11,8,9,3,10,10,4,7,8,11,7,8,7,9,11,11,11,10,15,8,8,11,10,9,10,3,8,7,18,8,20,12,12,14,17,12,9,9,6,12,5,11,11,11,9,12,DM/M C,1,1,1,1,1,1,14,1,1,20,16,1,1,1,1
6900103,Renato,1651,15/05/1979,37,28,0,0,0,177,71,2,2,1,4,2,1,3,1,3,1,2,7,8,12,12,14,11,12,12,13,14,16,13,13,16,6,13,10,13,12,16,14,17,13,14,14,14,14,14,10,11,10,11,11,16,11,20,13,13,13,7,13,10,12,9,15,14,12,14,13,14,13,DM/M C,1,1,1,10,1,1,1,1,1,16,20,1,1,1,1
6900134,Luís Fabiano,1651,08/11/1980,35,45,28,0,0,185,85,4,1,2,3,4,2,1,2,2,3,2,9,12,13,15,16,14,15,14,7,6,14,14,6,15,15,15,14,13,13,14,13,13,15,11,15,7,6,11,10,11,15,15,15,9,10,20,9,14,12,18,14,4,4,14,16,6,11,8,8,5,16,S ,1,1,20,1,1,1,1,1,1,1,1,1,1,1,1
6900143,Júlio César,1651,26/02/1980,36,0,0,0,0,179,76,1,3,2,3,2,3,1,1,2,2,3,12,11,13,12,12,12,10,15,6,4,12,18,4,15,9,12,12,12,10,12,12,11,13,7,12,5,11,9,11,11,12,8,20,14,11,5,11,12,12,10,15,9,12,15,10,15,14,14,13,12,12,AM/S RLC,1,1,20,19,16,17,1,1,1,1,5,10,7,1,1
6900144,Adiel,1651,13/08/1980,35,0,0,0,0,166,65,2,2,2,3,4,3,2,3,2,3,3,6,8,15,10,12,6,9,8,1,2,12,3,6,13,10,9,8,9,6,9,12,12,16,5,12,5,7,9,16,11,7,4,20,10,10,10,9,9,10,8,2,16,10,20,12,12,15,12,8,5,7,M/AM RC,1,1,14,18,1,15,1,1,1,10,20,1,15,1,1
69001477,Henan,1651,03/04/1987,29,0,0,0,0,182,75,1,2,2,1,3,2,2,2,2,2,1,8,6,13,12,11,8,13,9,4,6,9,4,1,14,10,11,5,10,9,9,11,10,13,12,14,13,8,11,11,11,12,13,10,12,12,20,12,10,10,8,2,7,10,15,12,10,12,12,3,7,3,S ,1,1,20,1,1,1,1,1,1,1,1,1,1,1,1
69001485,Henrique,1651,19/04/1985,31,0,0,0,0,178,0,3,3,2,1,2,2,3,3,2,2,2,6,8,8,4,11,6,6,8,1,8,11,3,9,7,8,9,6,6,8,11,13,2,8,11,6,8,8,10,13,10,2,8,9,15,11,20,6,5,8,5,7,8,8,15,11,12,11,10,1,5,5,M RC,1,1,1,1,1,1,1,1,1,15,20,1,17,1,1
6900149,Rodrigão,1651,14/06/1978,38,0,0,0,0,184,80,1,3,2,3,3,1,3,3,1,2,2,1,8,9,9,11,8,11,11,1,5,11,14,4,11,12,9,12,10,11,10,11,6,15,12,11,8,11,12,9,11,10,11,10,13,9,20,13,9,13,8,14,8,6,5,15,11,11,5,7,9,10,S ,1,1,20,1,1,1,1,1,1,1,1,1,1,1,1
69001565,Maicon,1651,08/09/1984,31,0,0,0,0,182,79,3,3,2,2,3,3,1,4,1,2,2,7,5,8,8,14,7,7,11,1,9,8,5,13,11,7,7,8,9,9,11,14,9,10,7,9,10,9,13,13,11,6,11,20,16,8,10,11,6,9,5,5,8,9,8,12,11,13,13,7,8,6,DM/M/AM C,1,1,1,19,1,1,1,1,1,19,20,1,1,1,1
69001576,Antônio Marcos de Azevedo,1651,23/11/1981,34,0,0,0,0,175,68,2,3,1,3,3,1,3,1,3,2,3,13,13,13,11,13,15,6,15,5,5,13,8,4,14,5,13,4,12,12,14,13,7,14,8,13,4,10,8,10,13,7,7,15,12,11,20,14,8,12,12,11,10,10,13,9,8,12,11,8,2,8,AM C,1,1,12,20,1,1,1,1,1,10,15,1,1,1,1
69001774,Silvio,1651,01/02/1985,31,0,0,0,0,183,79,1,3,3,2,3,2,2,1,1,3,1,5,10,13,11,12,5,11,13,5,7,12,11,8,14,8,13,11,12,11,11,12,12,9,8,13,12,12,14,12,11,12,12,8,10,12,20,11,14,11,5,12,9,10,15,12,10,12,11,14,12,7,AM/S LC,1,1,20,16,15,1,1,1,1,1,1,14,1,1,1
6900183,Nonato,1651,05/07/1979,36,0,0,0,0,178,83,3,2,1,1,3,1,16,1,1,4,3,1,7,9,13,11,5,12,12,1,1,11,14,2,11,9,10,12,12,6,11,11,10,16,3,12,7,8,9,14,9,12,8,10,12,10,20,10,13,13,12,13,10,8,14,16,14,13,6,12,10,17,S ,1,1,20,10,1,1,1,1,1,1,1,1,1,1,1
69002856,Christian Leite,1651,09/11/1985,30,0,0,0,0,184,80,5,6,8,5,13,11,12,11,7,8,10,4,1,1,3,2,9,1,2,2,2,1,1,3,3,7,9,12,7,10,3,14,3,2,4,2,10,8,6,11,16,8,8,10,5,13,20,7,7,9,9,9,9,9,11,13,10,11,10,13,2,1,GK ,20,1,1,1,1,1,1,1,1,1,1,1,1,1,1
69003779,Willian,1651,21/03/1986,30,0,0,0,0,185,82,1,3,3,2,2,1,3,3,3,1,1,6,8,8,5,11,8,8,9,12,9,12,1,9,11,9,7,7,7,10,11,15,6,10,11,8,10,10,14,11,8,14,13,20,14,11,8,10,13,14,8,4,9,9,7,9,9,12,10,3,2,2,D/DM R,1,1,1,1,1,1,7,1,18,20,10,1,7,1,1
69004818,Alex,1651,15/12/1988,27,0,0,0,0,173,71,1,1,1,1,1,1,1,1,1,1,1,11,12,13,8,11,9,8,12,5,8,11,10,9,12,5,8,7,9,8,13,9,8,14,7,13,10,10,11,14,13,13,7,20,11,13,10,10,6,10,2,8,10,7,11,9,9,9,13,13,15,6,M/AM LC,1,1,9,16,15,12,1,11,5,13,20,15,12,10,5
69005388,Mychell da Silva,1651,06/06/1989,27,0,0,0,0,177,0,3,2,3,1,1,1,2,2,2,1,2,7,8,10,14,12,5,9,7,1,7,12,6,7,12,5,9,6,6,6,11,13,9,11,14,12,8,8,7,14,9,8,4,9,13,12,20,8,7,9,6,9,6,9,19,9,15,10,12,12,9,3,AM C,1,1,15,20,1,11,1,1,1,1,10,1,10,1,1
6900550,Ceará,1651,18/06/1980,36,0,0,0,0,175,69,2,2,1,1,3,3,3,1,3,1,3,12,12,12,9,13,12,8,11,16,14,12,10,14,13,11,14,14,15,13,12,15,17,12,15,11,14,14,13,11,12,13,7,10,13,12,20,9,8,12,8,11,14,12,13,13,12,14,17,14,14,7,D/WB R,1,1,1,1,1,1,1,13,20,10,10,8,10,14,19
696809,Alexandre D'Acol,1651,18/07/1986,29,0,0,0,0,186,81,2,1,3,2,2,1,1,1,1,2,3,6,9,12,12,13,11,12,10,6,5,12,15,7,12,5,11,6,11,9,12,10,8,12,6,12,7,12,9,9,8,13,12,12,10,9,20,12,14,12,8,10,12,6,12,13,10,8,11,11,12,7,S ,1,1,20,14,1,1,1,1,1,1,1,1,1,1,1
70001562,Bobô,1651,09/01/1985,31,0,0,6,0,186,85,3,3,1,2,2,2,2,3,2,2,1,5,12,11,15,14,6,14,11,5,4,12,14,4,11,7,15,13,14,14,12,14,7,10,10,15,12,14,14,9,11,15,15,12,10,11,20,11,15,14,4,15,10,8,12,5,10,9,13,16,14,4,S ,1,1,20,10,10,10,1,1,1,1,1,1,1,1,1
7000866,Detinho,1651,11/09/1973,42,0,0,0,0,188,99,2,1,2,2,1,1,1,1,3,3,1,7,7,8,11,11,11,14,13,1,7,8,11,3,8,14,10,14,8,11,8,9,12,8,11,12,8,14,11,8,4,15,11,10,12,7,20,10,14,11,8,11,6,6,12,12,13,10,10,10,12,3,S ,1,1,20,1,1,1,1,1,1,1,1,1,1,1,1
70062865,Deyvison,1651,18/10/1988,27,0,0,0,0,186,83,2,3,2,3,1,2,2,4,1,1,2,5,6,10,4,12,5,12,6,7,13,11,3,14,11,14,14,14,11,14,9,9,13,8,11,9,12,13,13,11,11,15,14,20,13,11,10,13,14,11,12,11,13,10,11,13,12,11,15,13,15,6,D LC,1,1,1,1,1,1,20,16,7,1,1,1,1,1,1
70101054,Leandro Junio,1651,12/06/1997,19,0,0,0,0,177,71,3,1,3,2,3,1,3,2,1,4,1,7,12,8,6,8,6,6,2,2,5,8,1,10,13,8,6,5,3,6,6,9,6,12,4,7,6,4,7,14,14,4,7,20,12,13,5,11,5,8,6,8,8,8,12,12,10,11,10,5,13,5,D/WB L,1,1,1,1,15,1,1,20,1,1,1,15,1,18,1
71004145,Alan da Silva Souza,1651,09/12/1987,28,0,0,0,0,174,65,3,3,3,2,2,2,3,2,2,1,3,11,12,15,13,14,11,7,10,7,8,13,8,7,16,9,13,12,12,12,14,11,7,14,3,13,9,13,11,12,13,8,8,5,10,12,20,11,7,11,8,10,6,12,12,11,6,9,6,7,14,8,AM LC,1,1,10,20,17,14,1,1,1,1,14,10,7,1,1
71063496,Leonardo de Souza,1651,18/03/1992,24,0,0,0,0,174,70,3,3,1,3,2,1,1,3,3,1,3,13,12,13,11,14,14,5,13,5,3,13,9,7,14,13,10,12,10,8,13,12,8,14,5,13,8,10,12,13,14,11,7,10,12,14,20,13,9,11,8,11,9,12,12,7,13,11,11,7,8,11,AM RLC,1,1,14,18,20,18,1,1,1,1,13,14,13,1,1
71099630,Bruno Vieir De Souza,1651,12/08/1997,18,0,0,0,0,183,73,1,3,2,2,3,2,1,2,1,1,2,7,11,14,3,14,5,7,6,7,7,12,5,8,12,9,8,7,8,7,9,7,5,7,1,8,5,8,13,12,11,8,11,5,16,14,20,14,7,9,9,6,6,9,9,11,11,10,8,11,4,5,M R,1,1,1,1,1,1,1,1,1,1,1,1,20,1,1
717585,Preto,1651,12/06/1981,35,0,0,0,0,174,69,2,3,2,3,4,2,2,2,1,3,3,11,10,11,10,10,11,2,11,5,10,12,11,9,11,14,10,12,10,10,11,12,11,12,9,9,8,11,11,11,11,8,4,10,12,10,20,12,6,10,9,16,9,13,17,12,15,12,9,8,11,9,DM/M C,1,1,14,14,1,1,1,1,1,18,20,1,1,1,1
719823,Galdino,1651,18/11/1985,30,0,0,0,0,180,71,3,2,1,3,1,3,3,3,3,2,3,6,8,8,6,10,8,8,9,9,11,8,6,12,10,5,9,8,7,5,9,8,5,11,6,10,11,11,10,10,9,11,10,10,9,11,20,11,12,11,10,2,6,10,16,11,11,11,9,1,9,3,DM ,1,1,1,1,1,1,1,1,1,20,10,1,1,1,1
72005537,Cristiano,1651,25/05/1986,30,0,0,0,0,191,84,1,3,3,2,1,2,3,1,3,2,2,9,9,9,8,10,11,14,10,13,11,10,7,13,10,12,12,14,12,11,3,10,11,1,4,8,11,8,11,9,10,10,13,11,12,9,20,12,10,13,6,1,8,6,17,11,10,12,12,14,12,3,D C,1,1,1,1,1,1,20,10,10,1,1,1,1,1,1
72009424,Bruno Guarda,1651,06/02/1986,30,0,0,0,0,173,71,2,1,2,1,3,3,1,1,3,3,3,9,10,7,4,10,8,7,7,3,10,11,2,10,11,8,8,11,11,10,10,9,5,6,5,9,10,9,10,13,12,12,10,10,12,11,20,12,10,7,7,6,12,7,16,12,11,12,11,1,3,2,DM/M C,1,1,1,1,1,1,1,1,1,20,20,1,1,1,1
72016904,Sullivan Silva,1651,14/07/1988,27,0,0,0,0,186,84,2,3,2,2,3,2,3,3,3,3,1,9,10,12,9,8,9,8,7,7,5,8,7,6,11,10,7,9,10,8,10,7,1,16,6,10,6,9,10,11,9,12,11,20,11,12,13,10,12,9,9,9,6,9,20,13,11,13,10,12,18,7,AM/S L,1,1,18,1,20,1,1,1,1,1,1,13,1,1,1
72017660,Paulo Júnior,1651,23/01/1989,27,0,0,0,0,171,72,1,3,1,1,2,2,2,1,2,1,1,10,12,12,9,11,12,6,13,5,5,12,10,6,12,9,10,9,12,10,9,11,18,14,7,12,7,10,13,13,12,12,5,7,12,12,20,10,7,11,11,9,13,8,16,14,7,12,10,9,9,5,AM RC,1,1,13,20,13,20,1,1,1,1,10,1,13,1,1
72040238,Leo Fernandes,1651,21/12/1991,24,0,0,0,0,183,75,1,1,1,1,1,5,1,1,1,1,1,10,10,13,10,13,10,9,11,8,9,14,10,8,12,8,10,9,11,11,13,9,10,12,7,13,10,11,12,10,13,13,10,20,10,10,10,11,10,8,6,8,6,10,9,6,10,8,9,9,9,5,AM LC,1,1,7,20,20,7,1,1,1,1,7,13,7,1,1
72041411,Pedro Ribeiro,1651,13/06/1990,26,0,0,0,0,194,95,3,2,2,2,1,1,2,2,3,2,3,7,12,10,11,11,12,11,11,6,7,11,10,9,11,11,9,11,10,12,10,14,12,11,10,13,9,11,12,12,9,6,14,20,11,11,9,10,17,9,8,9,12,18,10,11,9,9,17,12,15,8,M/AM C,1,1,15,20,13,1,1,10,1,14,19,13,1,10,1
72044296,Lucas Baldin,1651,05/06/1991,25,0,0,0,0,176,69,3,3,4,1,1,1,1,1,3,2,2,6,5,8,8,13,6,6,6,3,8,11,2,9,11,7,11,7,7,5,9,8,4,11,10,8,13,7,10,13,13,9,7,8,10,13,20,13,8,9,5,2,6,9,7,11,13,12,11,4,14,6,M/AM C,1,1,1,20,1,1,1,1,1,15,18,1,1,1,1
72044636,Matheus Silva,1651,08/12/1996,19,0,0,0,0,188,90,3,3,4,3,2,3,3,2,2,2,2,5,6,7,4,10,5,11,9,7,12,9,5,11,9,10,9,12,9,10,8,7,9,3,3,7,10,11,12,9,9,9,14,9,10,10,20,10,16,11,8,5,11,8,20,9,10,12,11,3,11,3,D/DM/M C,1,1,1,1,1,1,18,1,1,18,20,1,1,1,1
72045933,Ivan Magalhães,1651,23/12/1993,22,0,0,0,0,186,85,1,1,1,2,1,1,2,3,3,1,1,6,8,9,6,10,8,11,8,5,9,11,6,12,10,9,11,12,10,10,7,9,8,8,8,9,11,10,10,9,11,12,11,20,11,10,7,11,12,8,10,7,10,8,16,14,9,11,9,1,11,7,D C,1,1,1,1,1,1,20,13,1,1,1,1,1,1,1
721757,Gilcimar,1651,19/03/1979,37,0,0,0,0,187,88,2,3,1,2,2,2,3,1,3,2,2,3,6,11,12,10,8,10,4,15,5,10,5,7,14,15,9,12,7,5,8,9,8,13,1,11,10,9,11,6,7,15,17,20,9,7,10,12,17,9,15,9,9,9,11,8,11,6,5,5,5,14,S ,1,1,20,1,1,1,1,1,1,1,1,1,1,1,1
726469,Paulo César,1651,05/01/1980,36,0,0,0,0,175,73,3,1,3,3,3,2,3,1,3,1,3,9,9,8,12,11,7,10,10,5,6,8,11,6,10,9,13,10,11,9,9,11,10,13,8,11,9,6,10,12,12,10,8,10,12,12,20,10,12,10,7,9,10,6,14,12,11,13,13,14,14,3,AM RL,1,1,15,5,17,20,1,1,1,1,1,1,1,1,1
726984,Cílio Souza,1651,15/04/1976,40,0,0,0,0,185,89,1,3,2,1,3,3,2,2,2,1,1,5,4,5,14,8,12,13,14,2,6,9,14,7,10,14,6,12,12,13,8,10,16,6,8,6,14,12,14,7,8,9,9,6,15,8,20,7,12,13,14,10,7,15,20,14,17,13,16,15,7,15,D/S C,1,1,20,1,1,1,17,1,1,15,15,1,1,1,1
727257,Leandro Netto,1651,07/05/1979,37,0,0,0,0,185,78,1,3,3,2,3,2,2,1,1,4,1,8,9,11,12,9,12,11,8,6,5,8,12,6,12,13,12,12,13,8,6,12,14,10,4,12,7,12,14,9,10,10,12,9,14,9,20,13,11,14,11,11,6,5,14,13,14,13,15,12,7,4,S ,1,1,20,10,1,10,1,1,1,1,1,1,1,1,1
727371,Igor,1651,19/02/1980,36,0,0,0,0,190,84,2,2,1,1,3,3,2,1,1,3,1,8,9,13,14,13,9,13,12,7,8,12,17,7,14,10,12,12,13,12,14,12,16,15,14,12,8,13,12,8,6,17,15,20,10,9,8,8,17,13,6,16,14,8,18,13,16,15,15,8,14,10,S ,1,1,20,1,1,1,1,1,1,1,1,1,1,1,1
728195,Fernandinho,1651,16/04/1981,35,0,0,0,0,172,70,1,3,1,3,3,1,1,12,1,2,1,12,12,12,11,13,13,5,13,14,12,13,14,11,13,11,12,11,12,10,11,11,16,14,14,13,9,12,12,12,12,14,6,20,13,12,8,12,7,11,8,12,10,15,11,10,14,10,10,12,10,11,D/WB/M LC,1,1,13,12,15,1,1,18,1,10,15,16,1,20,1
729008,Lenílson,1651,01/05/1981,35,0,0,0,0,186,82,1,1,3,3,3,1,3,1,1,1,3,9,12,13,12,11,6,7,13,6,10,12,13,11,12,14,11,10,10,10,10,10,9,11,12,13,12,11,11,9,11,13,13,20,14,9,10,11,13,11,8,12,7,12,12,14,12,15,13,14,8,11,M/AM LC,1,1,10,16,20,1,1,1,1,1,10,18,1,1,1
729376,Alex Garcia,1651,09/04/1979,37,0,0,0,0,179,68,1,3,2,4,2,4,1,2,3,1,2,10,11,12,7,10,9,7,10,10,7,12,13,11,12,10,11,10,11,11,11,11,13,13,8,11,10,9,9,11,11,9,9,2,12,12,20,11,10,15,6,13,8,10,13,15,8,13,16,14,15,6,D RL,1,1,1,1,1,10,1,15,20,13,13,14,15,10,10
732605,Ferreira,1651,10/08/1983,32,0,0,0,0,174,73,1,3,1,1,3,2,2,2,3,2,2,11,12,11,8,10,11,9,10,11,9,10,10,13,10,11,10,10,11,10,10,10,10,11,9,15,10,10,11,13,8,10,8,10,11,13,20,10,12,8,10,10,8,9,15,11,8,9,13,1,9,11,D R,1,1,1,1,1,1,1,5,20,14,1,1,1,5,10
732609,Zé Carlos,1651,24/04/1983,33,0,0,0,0,186,90,3,1,1,3,4,1,1,3,3,2,3,5,6,7,16,14,7,15,9,7,5,13,15,5,12,16,13,15,15,11,13,13,11,14,12,12,11,9,8,12,13,13,15,9,12,12,20,13,16,11,14,13,8,10,12,12,12,11,10,9,14,15,S ,1,1,20,1,1,1,1,1,1,1,1,1,1,1,1
734400,Mércio,1651,26/05/1980,36,0,0,0,0,176,72,1,1,3,1,4,3,3,3,2,4,2,11,12,11,8,13,13,7,11,8,11,14,13,11,13,17,10,11,9,12,13,13,12,13,14,10,13,12,12,11,11,12,10,11,10,11,20,12,13,11,14,12,12,12,13,12,11,10,17,15,11,5,M C,1,1,1,7,3,5,1,1,1,10,20,1,1,1,1
735087,Ezequias,1651,28/01/1981,35,0,0,0,0,180,69,1,1,1,1,1,1,1,1,1,1,1,8,7,6,7,7,7,12,6,7,11,6,8,11,9,13,11,11,9,11,9,9,13,10,10,11,10,12,11,11,11,12,10,20,12,11,6,11,10,11,8,12,8,10,14,12,13,11,10,11,11,6,D/WB LC,1,1,1,1,1,1,20,20,1,1,1,1,1,19,1
735519,Alan,1651,19/09/1979,36,0,0,0,0,180,77,1,1,3,2,3,3,3,1,3,3,2,14,15,15,13,13,13,10,13,6,6,14,16,7,15,10,10,11,14,13,14,14,12,16,15,12,12,11,11,11,11,12,10,12,14,11,20,10,12,12,8,13,8,12,12,11,12,13,10,11,12,3,M/AM RC,1,1,7,15,14,20,1,1,1,1,1,8,18,1,1
735631,Julio Cesar,1651,20/10/1979,36,0,0,0,0,182,82,1,1,1,1,2,2,2,2,1,3,3,6,10,15,12,12,8,12,8,8,6,11,13,5,13,12,12,11,12,11,11,12,15,15,6,12,5,11,13,14,13,11,12,12,14,14,20,12,12,13,7,8,11,10,16,15,13,13,12,14,13,7,AM/S C,1,1,20,17,1,1,1,1,1,1,1,1,1,1,1
735852,Joeano,1651,12/08/1979,36,0,0,0,0,174,72,3,2,3,3,3,2,3,3,1,3,3,5,8,13,14,12,9,13,12,5,5,11,13,4,13,13,13,9,12,11,10,14,14,13,6,13,5,13,7,9,13,11,10,5,12,9,20,10,8,11,9,12,6,6,16,15,14,15,11,15,13,4,S ,1,1,20,1,1,1,1,1,1,1,1,1,1,1,1
741553,Marcos António,1651,25/05/1983,33,0,0,0,0,187,87,1,1,1,1,1,1,1,1,1,1,1,5,7,9,8,9,9,15,10,12,14,9,7,14,9,14,12,11,13,12,9,9,15,5,12,8,13,12,12,10,10,14,15,5,13,12,20,15,16,12,16,12,7,6,9,14,13,15,10,10,15,8,D C,1,1,1,1,1,1,20,7,10,1,1,1,1,5,8
741829,Carlinhos Bala,1651,17/09/1979,36,0,0,0,0,162,64,4,3,1,3,3,2,1,3,3,2,3,12,10,12,11,12,12,8,10,4,4,11,13,5,12,7,9,14,12,11,9,13,14,16,12,13,5,8,13,10,13,5,2,9,14,10,20,9,5,14,7,15,7,14,15,13,10,15,11,7,12,12,AM/S C,1,1,20,16,11,14,1,1,6,1,12,1,10,1,13
741899,Cláudio,1651,17/08/1977,38,0,0,0,0,181,78,3,1,2,3,2,3,1,1,1,1,2,5,4,4,5,8,6,13,6,10,13,11,14,12,10,11,12,13,13,13,9,12,12,10,14,5,13,13,13,7,8,11,10,5,11,8,20,10,12,16,8,15,5,9,16,12,14,11,15,15,14,8,D C,1,12,1,1,1,1,20,1,1,1,1,1,1,1,1
744070,Éder Diego,1651,17/04/1985,31,0,0,0,0,180,74,2,1,3,1,2,2,1,3,2,3,3,11,10,12,9,10,8,7,11,3,7,15,10,7,13,10,9,11,13,10,14,13,11,13,5,13,9,10,12,10,11,11,6,20,12,12,5,10,9,10,3,11,7,13,10,11,11,10,13,11,11,3,M/AM C,1,1,1,20,1,1,1,1,1,1,20,1,1,1,1
746388,Edinho,1651,31/05/1982,34,0,0,0,0,177,77,1,1,2,1,4,1,4,3,1,3,1,9,9,5,11,14,9,9,12,9,9,14,9,11,14,8,12,7,11,9,11,14,6,13,9,12,9,11,13,13,13,11,5,11,13,14,20,14,8,11,6,11,11,11,5,10,10,11,14,5,9,8,M/AM C,1,1,1,20,5,5,1,1,1,1,17,1,1,1,1
746606,Júlio Madureira,1651,03/07/1982,33,0,0,0,0,170,74,3,2,3,1,1,3,1,2,2,2,2,6,3,13,12,11,7,9,8,4,7,4,5,2,14,9,12,3,7,5,8,14,9,13,10,13,8,6,8,14,14,8,9,10,12,14,20,8,10,9,9,3,9,9,13,11,13,8,11,4,18,1,S ,1,1,20,1,1,1,1,1,1,1,1,1,1,1,1
748232,Charles,1651,04/04/1984,32,0,0,0,0,180,75,1,2,2,1,4,1,2,2,3,1,1,10,10,14,15,17,10,14,14,7,6,8,12,5,17,13,6,13,13,12,11,13,14,11,12,15,3,14,12,12,18,10,12,13,12,13,20,13,14,11,7,13,8,12,13,15,14,12,14,12,11,5,S ,1,1,20,10,9,12,1,1,1,1,1,1,1,1,1
748982,Evaldo,1651,18/03/1982,34,0,0,0,0,184,80,3,1,3,1,4,2,1,2,3,1,1,9,10,11,8,11,11,12,11,13,10,12,10,13,12,11,12,13,12,13,9,11,13,8,10,12,11,13,13,12,12,13,12,20,12,12,6,11,12,13,9,10,7,10,14,13,13,12,14,13,14,5,D L,1,1,1,1,7,1,4,20,1,1,5,13,1,10,1
7500616,João Carlos,1651,01/01/1982,34,0,0,0,0,189,80,3,1,3,2,2,3,2,3,1,4,2,8,8,13,8,13,4,14,8,8,14,13,8,14,13,14,14,13,13,14,10,11,10,17,13,12,14,14,13,8,10,13,14,9,11,9,20,9,13,15,10,14,14,7,15,8,16,11,11,14,15,4,D C,1,1,1,1,1,1,20,7,1,13,1,1,1,1,1
75011360,Fernando Alves,1651,25/12/1981,34,0,0,0,0,170,78,3,1,2,4,3,1,3,2,1,3,2,11,12,13,12,7,5,8,10,4,3,10,12,3,10,7,12,10,9,10,11,10,5,9,8,12,6,11,9,12,12,10,9,20,11,12,9,11,11,11,9,10,8,8,19,12,10,10,11,2,14,8,AM/S C,1,1,16,20,1,1,1,1,1,1,1,1,1,1,1
75016161,Klever,1651,31/03/1988,28,0,0,0,0,179,0,2,3,1,1,1,2,1,1,1,3,2,4,4,8,8,13,6,6,7,6,6,12,3,8,8,9,7,8,11,5,13,12,9,8,5,10,7,7,12,13,13,7,5,8,10,13,20,13,7,9,5,7,9,9,13,11,10,12,13,3,15,4,AM C,1,1,1,20,1,1,1,1,1,1,13,1,1,1,1
75030303,Jorge Costa,1651,20/02/1987,29,0,0,0,0,185,0,3,2,3,2,3,1,3,2,2,2,3,6,6,10,13,13,6,11,7,1,6,7,5,1,9,7,10,4,8,7,5,13,6,9,9,13,6,6,8,13,12,7,9,1,10,11,20,12,8,9,5,9,9,9,12,11,11,10,12,1,13,4,S ,1,1,20,1,1,1,1,1,1,1,1,1,1,1,1
75037702,Sergio Santos,1651,04/09/1994,21,0,0,0,0,180,79,2,4,3,1,1,4,3,2,2,1,2,6,10,12,11,11,8,10,10,13,4,10,10,5,12,11,12,12,10,9,10,9,10,11,9,12,7,11,10,13,13,12,12,20,14,11,11,13,14,7,11,9,10,8,20,13,12,11,11,1,8,4,S ,1,1,20,1,11,1,1,1,1,1,1,1,1,1,1
75039112,Alisson,1651,14/02/1990,26,0,0,0,0,167,0,2,3,4,2,3,2,2,2,2,3,2,6,2,5,4,10,6,6,6,1,11,11,3,7,13,7,6,6,7,7,12,12,4,9,12,8,7,7,10,13,13,7,2,8,10,13,20,11,6,9,5,9,9,9,11,13,9,10,11,2,15,1,M C,1,1,1,1,1,1,1,1,1,1,20,1,1,1,1
75041436,Igor Ramos,1651,07/08/1998,17,0,0,0,0,171,0,2,3,3,2,1,3,3,3,3,3,2,7,7,10,4,14,7,3,8,6,5,11,4,5,14,9,5,4,6,4,8,6,3,8,2,3,6,8,11,14,11,8,8,20,15,14,18,10,5,9,9,4,9,9,13,10,10,12,12,8,20,4,M L,1,1,1,1,1,1,1,1,1,1,1,20,1,1,1
7522081,Alex,1651,13/09/1981,34,0,0,0,0,186,84,2,2,1,1,3,2,3,1,3,2,1,8,10,8,12,14,7,14,9,2,8,9,4,7,10,9,14,8,9,9,7,9,10,9,11,12,7,13,11,9,8,12,13,10,11,7,20,15,13,10,7,6,9,9,19,9,12,11,6,9,12,8,S ,1,1,20,1,1,1,1,1,1,1,1,1,1,1,1
7585380,Jhonnes,1651,22/04/1984,32,0,0,0,0,193,85,2,3,2,3,2,1,1,1,2,1,3,6,4,5,13,11,2,16,6,3,12,8,9,14,6,10,10,11,6,12,5,9,7,5,16,10,13,12,14,10,6,11,17,11,16,11,20,14,14,12,5,10,10,10,15,10,10,16,18,2,5,3,D C,1,1,1,1,1,1,20,1,1,10,1,1,1,1,1
7585381,Juninho,1651,15/03/1984,32,0,0,0,0,180,76,3,3,4,2,1,3,3,2,1,1,3,9,11,13,10,14,10,10,12,5,9,11,8,10,16,8,11,8,12,14,11,12,11,13,6,14,10,13,13,10,11,12,10,8,13,12,20,10,8,10,7,13,12,12,15,12,20,10,18,14,8,9,M/AM RC,1,1,12,20,9,15,1,1,1,1,17,8,8,1,1
76003506,Ricardo Pires,1651,22/09/1987,28,0,0,0,0,186,81,1,2,3,1,2,1,1,3,3,1,1,5,4,9,10,9,4,14,4,5,5,8,9,6,11,13,9,13,8,9,7,9,11,10,8,10,9,12,12,9,11,13,13,12,12,11,20,9,12,8,4,7,8,10,13,11,7,11,11,8,6,8,AM/S R,1,1,20,13,13,17,1,1,1,1,1,1,1,1,1
76023250,André Vieira,1651,07/12/1988,27,0,0,0,0,189,84,1,1,2,1,1,1,1,3,2,3,1,7,7,14,11,14,8,9,7,6,7,10,6,2,11,7,9,9,10,9,6,9,2,10,7,14,9,8,10,11,11,9,10,12,16,12,20,12,12,10,3,7,6,10,12,11,8,11,11,8,19,1,S C,1,1,20,15,1,1,1,1,1,1,1,1,1,1,1
76038496,Allan Soares,1651,13/03/1988,28,0,0,0,0,181,63,2,2,1,1,4,3,4,2,2,4,3,8,8,13,14,12,5,10,10,1,7,12,5,7,13,6,11,11,11,11,12,11,12,10,3,12,12,11,11,11,11,11,8,10,15,11,20,15,8,10,5,5,10,10,13,11,9,10,12,13,11,9,AM/S C,1,1,16,20,1,1,1,1,1,1,1,1,1,1,1
7642553,Dema,1651,28/04/1983,33,0,0,0,0,179,73,2,1,2,2,3,2,2,2,2,2,2,9,10,10,8,11,11,6,9,11,8,11,12,8,12,15,10,12,11,9,10,10,14,10,9,11,8,13,12,11,12,12,7,10,12,11,20,12,8,11,12,8,8,15,11,10,12,12,14,9,7,4,D/DM/M RC,1,1,1,12,1,11,1,12,19,20,18,5,13,14,14
7643161,Brasão,1651,01/01/1982,34,0,0,0,0,180,82,3,2,2,3,2,2,2,4,1,1,3,7,8,14,11,3,7,12,8,1,7,5,5,3,14,13,12,5,9,5,6,11,16,13,6,8,7,7,14,13,11,10,11,11,10,14,20,14,13,8,14,8,6,5,15,13,11,10,7,7,14,13,S ,1,1,20,1,1,1,1,1,1,1,1,1,1,1,1
77015817,Marcos Andreini,1651,20/08/1983,32,0,0,0,0,180,79,4,2,1,4,3,3,2,2,1,2,2,5,5,3,6,14,3,5,9,1,5,14,4,10,10,7,5,6,7,6,8,11,4,7,14,6,9,7,10,6,5,6,6,5,7,5,20,6,9,7,5,7,7,7,19,9,12,12,12,3,7,3,DM/M C,1,1,1,1,1,1,1,1,1,20,16,1,1,1,1
77016559,Smith,1651,07/05/1988,28,0,0,0,0,192,0,3,4,2,2,2,3,2,2,1,1,1,8,12,14,11,11,8,14,9,5,4,9,5,7,11,6,10,9,8,8,8,10,7,10,8,10,8,9,10,14,12,9,16,5,7,12,20,14,14,9,10,9,10,10,13,12,12,13,12,9,3,8,AM/S RL,1,1,20,1,17,17,1,1,1,1,1,1,1,1,1
77048251,Lucas Costa De Abreu,1651,14/05/1994,22,0,0,0,0,176,72,2,2,3,2,3,3,2,1,1,3,1,11,14,14,9,14,6,7,5,4,7,7,8,9,10,9,7,8,11,4,7,11,5,9,10,9,7,9,12,14,14,9,9,20,15,14,5,8,5,9,6,6,9,9,12,14,11,11,11,4,17,1,M/AM L,1,1,1,1,20,1,1,1,1,1,1,17,1,1,1
77050675,Jonas,1651,06/08/1987,28,0,0,0,0,180,80,2,3,1,1,1,3,1,1,1,3,2,9,11,13,5,10,7,7,9,7,8,9,5,9,13,10,9,8,9,9,10,13,10,13,9,9,9,8,11,13,13,8,10,20,9,13,5,7,6,10,10,10,10,10,15,12,11,12,11,6,10,8,M/AM LC,1,1,1,1,17,1,1,1,1,13,20,20,1,1,1
771837,Rodrigo Silva,1651,16/11/1982,33,0,0,0,0,185,78,3,2,1,2,1,2,1,3,1,4,3,10,10,13,10,13,8,14,9,5,3,12,8,7,16,10,8,6,12,9,9,12,10,10,3,14,7,12,6,11,13,11,13,9,8,13,20,9,8,14,3,8,2,5,16,15,11,8,12,9,9,5,S ,1,1,20,5,1,1,1,1,1,1,1,1,1,1,1
7742622,Anderson Silva,1651,12/05/1975,41,0,0,0,0,185,70,2,1,1,3,2,4,3,3,1,3,3,9,6,1,2,9,12,15,15,5,10,8,1,14,7,5,12,9,9,7,11,8,1,9,9,8,10,8,9,11,7,9,15,20,10,10,5,15,6,11,6,9,9,9,14,10,10,11,11,3,10,7,D LC,1,1,1,1,1,1,20,15,1,1,1,1,1,1,1
775575,Daniel Rossi,1651,04/01/1981,35,0,0,0,0,185,80,2,2,2,1,2,1,3,2,3,2,3,3,13,11,8,12,7,13,15,7,14,11,14,13,13,14,13,15,11,13,11,13,12,13,13,8,13,14,16,8,8,14,10,9,11,13,20,11,11,15,12,15,11,16,18,11,16,14,17,16,15,4,DM RC,1,1,1,5,1,1,10,1,15,20,15,5,5,1,15
778109,Juninho,1651,07/07/1982,33,0,0,0,0,174,75,3,4,3,1,2,3,1,3,3,1,3,11,5,13,10,12,9,6,10,8,9,5,4,4,14,10,11,9,11,12,11,11,10,12,12,9,5,7,12,12,14,7,7,20,12,12,10,10,6,9,9,9,9,9,11,13,11,12,13,9,10,4,M/AM/S LC,1,1,16,16,20,1,1,1,1,1,12,17,1,1,1
78003419,Anderson,1651,26/09/1986,29,0,0,0,0,182,68,3,3,2,2,1,2,2,1,2,2,3,13,15,12,10,15,15,9,13,2,2,15,3,3,14,7,11,6,12,9,14,12,2,12,8,8,8,7,3,6,13,10,9,20,11,10,7,6,10,8,11,9,11,10,11,12,11,11,8,3,5,7,AM RC,1,1,13,18,14,20,1,1,1,1,10,13,1,1,1
78011779,Cristiano Gomes,1651,20/02/1985,31,0,0,0,0,180,74,1,3,2,1,1,1,2,1,1,2,2,12,11,9,5,11,13,10,12,10,12,9,7,11,11,14,10,12,9,8,8,10,12,7,12,7,12,14,14,12,12,13,10,8,11,11,20,13,13,12,8,11,8,12,5,5,15,10,10,1,9,7,D/WB/DM R,1,1,1,1,1,1,8,12,19,20,1,1,1,1,17
78012509,Douglas Caetano,1651,06/01/1981,35,0,0,0,0,184,80,3,2,2,3,1,3,3,3,1,1,1,9,12,12,9,10,7,13,8,2,8,12,6,9,13,12,12,9,10,9,12,10,11,12,9,13,8,8,8,13,11,11,12,12,13,13,20,9,11,11,7,9,5,9,12,13,13,9,12,9,11,8,S ,1,1,20,9,13,13,1,1,1,1,1,1,1,1,1
78012937,Bruno de Oliveira,1651,06/10/1990,25,0,0,0,0,178,74,1,2,1,2,1,2,3,2,1,3,1,10,12,13,9,13,12,12,9,10,6,10,3,6,14,10,8,9,6,7,10,8,8,14,8,12,7,9,8,14,13,11,9,12,14,12,20,10,13,7,5,10,8,10,14,6,10,6,10,10,15,2,AM/S C,1,1,20,16,1,1,1,1,1,1,1,1,1,1,1
78018577,Vánger,1651,27/01/1987,29,0,0,0,0,170,67,3,1,2,1,3,3,4,2,1,2,3,11,11,13,10,12,10,9,11,6,5,10,9,5,13,7,7,8,10,7,10,7,13,13,5,12,5,8,10,13,16,5,5,15,12,13,20,11,5,9,7,10,8,13,7,12,10,10,9,5,8,12,AM/S RLC,1,1,19,16,17,20,1,1,1,1,1,1,1,1,1
78022469,Caue Fernandes,1651,31/07/1988,27,0,0,0,0,184,84,1,3,2,3,1,2,1,2,2,3,3,8,6,6,11,9,6,15,6,12,13,8,8,12,8,14,12,14,11,14,8,9,13,6,15,12,12,14,15,8,9,13,13,9,13,10,20,12,13,13,14,13,7,5,12,10,10,15,12,9,11,6,D C,1,1,1,1,1,1,20,1,1,1,1,1,1,1,1
78030540,Juninho,1651,29/06/1989,27,0,0,0,0,174,64,1,1,1,2,4,2,1,1,4,1,1,12,13,13,9,13,12,6,11,10,7,12,7,6,14,6,10,7,8,7,11,8,9,13,7,10,8,10,10,13,14,6,6,20,10,12,5,11,5,7,4,8,13,13,9,8,8,9,12,11,10,8,M/AM RLC,1,1,14,17,20,16,1,1,1,1,10,16,10,10,1
78035250,Ronaldo,1651,03/04/1987,29,0,0,0,0,190,80,3,3,2,2,2,1,1,1,2,4,3,6,6,10,7,11,2,14,7,6,12,12,9,12,9,17,12,13,10,12,10,9,13,7,13,8,12,12,13,10,10,13,15,9,13,12,20,9,13,11,15,11,14,11,20,10,12,10,12,12,11,9,D C,1,1,1,1,1,1,20,1,1,1,1,1,1,1,1
78037874,Janderson,1651,18/02/1989,27,0,0,0,0,175,75,1,2,4,1,2,4,3,1,1,3,1,13,13,14,12,15,12,10,10,3,6,12,12,6,14,7,10,9,8,7,11,11,7,14,7,12,6,7,7,14,14,6,7,11,7,12,20,10,7,7,6,8,11,10,8,13,6,8,7,12,12,10,AM RLC,1,1,11,20,15,17,1,1,1,1,1,1,1,1,1
78038723,Elton Souza,1651,20/02/1988,28,0,0,0,0,187,74,3,1,3,3,2,2,2,3,2,2,3,10,8,16,11,12,10,13,11,10,10,11,13,5,12,6,9,11,10,10,9,10,11,8,10,9,11,8,12,8,10,13,14,20,13,13,8,12,11,10,10,10,10,10,19,9,9,10,10,6,7,8,S ,1,1,20,1,1,1,1,1,1,1,1,1,1,1,1
78039303,Vinícius,1651,02/01/1987,29,0,0,0,0,193,91,3,2,1,2,2,1,3,3,3,1,1,6,8,8,4,10,4,13,6,3,11,9,4,10,10,10,10,13,9,9,7,10,14,7,9,6,11,12,11,10,10,13,14,8,5,12,20,12,13,10,14,9,7,10,18,12,11,10,12,8,14,2,D C,1,1,1,1,1,1,20,1,1,1,1,1,1,1,1
78043366,Murilo,1651,01/08/1991,24,0,0,0,0,177,74,2,3,3,1,2,3,3,3,1,1,2,10,14,12,8,10,13,8,6,8,8,10,4,4,13,10,10,2,10,9,10,14,4,13,9,9,7,9,12,13,13,12,8,20,17,12,12,14,9,10,10,6,5,10,14,11,11,11,13,3,11,8,AM L,1,1,1,1,20,1,1,8,1,1,1,15,1,10,1
78047774,Felipe Gedoz,1651,12/07/1993,22,0,0,0,0,177,74,3,1,4,2,3,3,3,1,3,3,2,14,14,15,12,15,16,10,16,10,10,12,14,8,15,3,12,9,10,7,11,10,9,15,7,11,11,10,10,14,14,10,8,8,13,11,20,12,13,8,4,10,6,15,18,8,8,8,11,14,13,6,AM RLC,1,1,8,16,19,20,1,1,1,9,14,14,14,1,1
78048249,Pablo Valim,1651,15/12/1992,23,0,0,0,0,182,68,2,3,2,2,2,2,4,2,3,1,2,10,12,13,12,14,11,6,13,4,8,11,9,10,14,10,14,7,11,11,14,9,6,14,8,12,9,11,7,13,14,8,10,20,10,11,7,10,4,10,10,7,8,10,4,11,4,4,6,8,7,16,AM LC,1,1,1,16,20,1,1,1,1,1,1,1,1,1,1
78063279,Emilton Pedroso,1651,28/03/1993,23,0,0,0,0,180,75,1,3,3,3,2,3,1,1,2,3,3,8,7,12,15,13,9,13,9,7,5,8,6,6,13,10,15,9,7,10,5,7,8,10,9,12,9,9,10,14,13,10,8,20,13,11,8,11,8,10,7,10,10,10,17,11,10,7,12,8,8,6,S ,1,1,20,1,1,1,1,1,1,1,1,1,1,1,1
78070934,Douglas Starnley,1651,11/02/1993,23,0,0,0,0,188,82,1,2,3,3,2,3,3,2,1,2,1,6,8,9,14,10,8,14,5,5,8,9,12,6,10,6,7,7,9,9,9,9,2,10,1,14,8,8,7,14,14,9,14,10,8,13,20,10,13,10,8,10,6,10,15,7,13,12,12,3,15,3,S ,1,1,20,1,1,1,1,1,1,1,1,1,1,1,1
78071619,Moisés Baiano,1651,25/09/1988,27,0,0,0,0,176,79,2,1,1,3,2,3,1,3,3,2,2,7,11,11,3,11,11,9,6,13,11,10,4,14,11,8,14,10,10,10,10,10,8,3,3,9,14,11,10,12,11,10,8,9,15,10,20,14,8,10,10,7,10,10,3,12,11,12,13,4,11,3,D/DM R,1,1,1,1,1,1,1,1,17,20,10,1,1,1,15
78078624,Wesley,1651,23/03/1994,22,0,0,0,0,183,71,1,3,3,1,2,1,3,3,2,1,1,4,4,13,13,13,6,13,5,1,3,3,4,1,12,9,10,6,11,7,5,7,4,12,11,10,7,6,8,13,9,2,11,9,16,13,20,12,9,9,9,9,9,9,19,12,10,10,9,1,2,8,S ,1,1,20,1,1,1,1,1,1,1,1,1,1,1,1
78079909,João Fonseca,1651,29/12/1991,24,0,0,0,0,181,78,3,1,4,3,1,1,2,1,2,2,1,5,5,3,6,10,6,6,13,2,7,11,1,13,12,4,10,3,4,5,10,13,9,6,14,4,13,7,12,13,9,6,10,9,9,13,20,10,9,9,9,2,9,9,12,3,10,11,13,2,12,4,DM ,1,1,1,1,1,1,1,1,1,20,1,1,1,1,1
78083945,Wagner de Paula Gomes,1651,19/09/1991,24,0,0,0,0,167,66,1,1,2,1,1,2,2,3,2,2,3,5,3,13,13,7,5,10,3,1,4,6,10,1,8,7,12,1,11,6,2,13,5,8,13,9,6,5,7,13,13,6,5,2,13,13,20,12,10,8,5,8,8,8,5,2,11,9,12,8,11,2,S ,1,1,20,1,1,1,1,1,1,1,1,1,1,1,1
78084014,Felipe Augusto Navarro da Silva,1651,17/11/1989,26,0,0,0,0,185,80,2,1,2,2,1,2,3,2,2,1,1,7,7,11,1,11,5,13,8,4,12,9,2,13,11,8,11,10,7,8,3,14,3,1,7,4,11,7,13,10,11,9,13,10,13,12,20,14,14,10,7,10,5,10,17,6,4,10,11,1,11,8,D C,1,1,1,1,1,1,20,1,1,1,1,1,1,1,1
78085198,Dudú,1651,11/07/1995,20,0,0,0,0,181,70,3,1,3,1,2,1,3,3,2,2,3,8,8,12,14,12,7,14,6,3,6,4,6,1,12,6,14,8,7,4,9,7,9,10,10,13,4,8,9,14,13,10,10,10,13,12,20,7,9,10,1,1,8,10,12,12,10,11,12,5,13,1,S ,1,1,20,1,1,1,1,1,1,1,1,1,1,1,1
78087504,Breno Caetano,1651,30/07/1998,17,0,0,0,0,172,63,1,2,3,1,1,3,2,1,1,3,2,8,8,12,10,14,8,7,9,1,4,14,3,7,13,10,7,9,7,6,12,14,2,13,1,10,7,9,9,14,11,9,7,10,15,11,20,7,6,10,10,6,8,10,19,12,12,12,12,3,8,3,AM C,1,1,14,20,1,1,1,1,1,1,1,1,1,1,1
785667,Dudu Cearense,1651,15/04/1983,33,11,0,16,7,185,83,2,3,3,4,1,3,1,1,1,1,2,10,10,12,12,13,11,15,14,10,13,14,13,12,14,14,12,9,12,9,13,12,12,14,15,12,12,10,10,13,11,14,14,12,12,13,20,11,14,13,14,10,11,12,12,16,15,14,12,11,12,9,DM/M C,1,1,1,14,1,1,1,1,1,18,20,1,1,1,1
785674,Jorginho,1651,04/12/1985,30,0,0,0,0,174,73,1,3,3,2,3,3,2,3,1,3,1,11,10,12,10,12,11,7,8,1,2,11,12,2,13,6,7,8,9,7,10,8,10,12,6,12,8,7,9,14,13,8,8,20,12,12,10,9,11,11,6,13,8,9,11,10,10,11,13,1,1,5,S R,1,1,20,10,10,15,1,1,1,1,1,1,1,1,1
79000311,Josias Cardoso,1651,07/11/1981,34,0,0,0,0,183,72,2,2,2,3,3,3,2,1,2,2,2,10,10,14,10,9,10,7,7,2,9,8,8,13,9,14,7,14,7,9,7,7,13,12,8,10,7,11,15,15,13,13,9,20,12,15,7,13,14,8,13,7,11,11,15,11,7,9,11,7,8,8,AM/S L,1,1,20,8,16,6,1,1,1,1,1,1,1,1,1
79010918,Adriano Garça,1651,30/03/1986,30,0,0,0,0,174,0,3,1,3,2,2,3,2,3,3,1,1,7,8,8,5,11,3,8,6,7,9,11,5,8,12,9,9,4,9,5,8,6,1,9,14,6,8,9,9,14,14,8,8,20,15,14,10,14,12,9,5,1,7,9,11,10,10,12,11,4,6,1,D L,1,1,1,1,1,1,1,20,1,1,10,12,1,15,1
79012655,Péricles Pinto,1651,04/11/1989,26,0,0,0,0,174,69,1,1,1,3,3,2,3,2,1,2,2,6,8,12,11,15,8,8,9,5,9,11,5,9,12,9,12,8,8,7,9,10,2,9,11,10,10,9,10,12,12,9,5,8,12,12,20,11,11,9,6,9,6,9,13,11,10,8,12,9,5,4,M/AM C,1,1,1,20,1,1,1,1,1,1,18,10,10,1,1
79012696,Gabriel Vieira,1651,05/02/1988,28,0,0,0,0,179,72,3,1,2,2,2,2,2,3,2,3,1,9,10,12,9,11,9,6,13,4,6,10,8,6,11,11,8,11,8,8,11,8,7,12,6,14,6,8,10,13,13,10,8,13,11,11,20,7,7,7,13,11,7,12,8,11,8,12,10,9,6,6,AM RC,1,1,6,20,10,19,1,1,1,11,12,7,12,1,1
79025290,Sergio Custodio de Oliveira,1651,13/04/1987,29,0,0,0,0,185,0,2,2,1,1,2,2,2,2,3,2,1,6,6,13,13,13,6,9,7,5,3,7,4,1,12,6,12,4,12,6,5,13,8,12,10,13,6,6,7,13,12,7,8,9,7,13,20,5,13,9,9,9,9,8,13,11,12,11,9,9,5,2,S ,1,1,20,1,1,1,1,1,1,1,1,1,1,1,1
79025493,Felipe Márcio Dallabrida,1651,14/05/1991,25,0,0,0,0,172,0,3,2,3,3,1,3,1,1,1,1,3,6,6,6,3,13,6,6,13,1,8,13,1,13,11,8,11,8,8,8,13,9,8,5,9,6,8,7,12,13,13,7,2,9,9,12,20,12,9,9,9,3,9,9,11,11,9,13,10,1,9,5,DM/M C,1,1,1,1,1,1,1,1,1,20,20,1,1,1,1
790487,Rychely,1651,06/08/1987,28,0,0,0,0,174,71,2,3,2,1,3,1,3,2,3,2,2,8,10,10,10,10,9,8,7,4,5,10,11,5,11,12,11,10,9,10,8,10,13,12,6,11,7,10,11,13,13,13,7,9,14,14,20,13,8,10,7,11,8,12,15,8,7,11,13,12,16,10,S ,1,1,20,10,10,10,1,1,1,1,1,1,1,1,1
7980000,Marcos de Paula,1651,19/12/1983,32,0,0,0,0,186,80,2,1,2,1,2,3,2,2,3,1,3,7,8,11,10,9,10,12,11,5,3,9,12,7,12,12,11,12,8,11,8,10,13,16,10,11,12,11,12,13,11,11,13,5,8,12,20,12,12,12,3,15,13,10,16,13,13,9,15,13,14,1,AM/S L,1,1,20,10,18,1,1,1,1,1,1,10,1,1,1
7980170,Rafael Bondi,1651,20/03/1981,35,0,0,0,0,180,80,1,2,3,1,3,2,1,3,3,3,3,12,13,12,12,13,11,8,12,5,6,14,10,11,14,12,11,10,12,12,13,12,17,15,14,13,10,13,12,10,8,11,9,20,13,11,8,12,11,11,3,12,6,14,15,12,13,16,11,10,12,9,AM LC,1,1,10,20,17,13,1,1,1,1,13,15,10,1,1
7980288,Adriano Mezavilla,1651,14/01/1983,33,0,0,0,0,184,80,3,1,1,1,3,3,2,3,1,1,1,4,6,7,9,10,5,13,11,2,13,12,10,13,11,16,12,14,13,11,10,12,14,9,14,11,13,14,12,10,9,14,12,9,12,11,20,13,13,14,15,10,14,13,15,13,13,14,13,8,9,8,DM/M C,1,1,1,1,1,1,12,1,1,17,20,1,1,1,1
7980290,Ferreira Pinto,1651,10/12/1979,36,0,0,0,0,179,81,1,2,2,3,1,2,3,2,3,3,3,9,11,9,9,10,6,6,6,5,3,10,8,5,11,16,8,13,9,11,9,11,15,11,13,11,6,11,11,11,11,11,6,9,11,10,20,9,10,10,7,13,11,9,17,15,13,13,18,18,10,15,M/AM R,1,1,12,1,10,19,1,1,1,1,1,10,20,5,12
7980777,Rodrigo Taddei,1651,06/03/1980,36,0,0,0,0,177,70,2,2,3,3,3,1,3,2,2,3,1,10,13,13,10,15,8,10,10,6,10,13,8,12,14,8,13,14,14,11,15,13,19,14,12,13,12,16,15,8,8,11,8,12,15,8,20,8,10,14,13,15,4,20,16,10,18,12,20,18,16,4,DM/M C,1,1,7,10,13,13,1,7,7,20,20,10,10,10,10
7980912,Toledo,1651,18/07/1981,34,0,0,0,0,175,76,2,2,3,2,3,3,2,1,2,1,2,9,9,10,9,9,4,9,9,1,2,10,6,8,9,4,8,5,7,5,11,6,14,9,18,10,4,9,9,11,11,5,9,10,3,11,20,14,9,6,5,10,6,11,14,13,10,10,10,15,5,8,AM RL,1,1,14,1,18,20,1,1,1,1,1,1,1,1,1
7982817,Guly,1651,31/12/1981,34,0,0,0,0,189,79,2,2,3,1,3,1,1,3,1,1,1,12,10,13,12,10,11,13,11,6,6,13,11,6,12,13,8,13,9,8,12,9,12,12,6,9,7,12,13,12,13,12,13,9,12,12,20,11,13,10,12,13,13,13,7,10,12,12,15,14,12,7,AM RC,1,1,15,20,10,15,1,1,1,1,12,10,14,1,1
7987008,Barreto,1651,12/07/1985,30,0,0,0,0,171,60,1,3,1,2,2,2,3,3,3,2,3,3,8,13,11,13,12,2,10,7,5,11,10,3,12,12,7,7,11,6,10,8,18,16,5,12,6,10,11,12,15,7,5,8,10,12,20,12,4,12,4,15,14,11,16,18,13,17,12,14,10,6,S RL,1,1,20,1,15,15,1,1,1,1,1,1,1,1,1
7987894,Renan Pippi,1651,23/01/1984,32,0,0,0,0,184,80,1,3,3,1,1,1,3,2,4,3,2,2,3,10,12,6,10,11,4,3,2,8,11,2,9,9,7,9,10,9,8,9,12,10,7,12,7,12,10,11,8,11,10,8,8,11,20,10,12,11,15,11,12,8,14,15,13,13,10,10,14,3,S ,1,1,20,1,1,1,1,1,1,1,1,1,1,1,1
7989222,Romulo Togni,1651,09/09/1982,33,0,0,0,0,183,76,2,1,2,2,2,2,3,2,3,2,3,13,13,10,7,13,13,7,13,8,7,14,12,8,14,12,13,11,14,13,14,13,11,11,13,11,12,12,12,10,10,10,8,10,11,10,20,10,9,8,12,12,10,10,14,11,14,6,13,10,18,5,DM ,1,1,1,1,1,1,1,1,1,20,1,1,1,1,1
7990846,Diego Silva Reis,1651,20/02/1986,30,0,0,0,0,186,77,2,3,3,2,1,1,3,1,2,3,3,9,10,12,10,14,11,11,9,4,2,11,9,4,11,10,9,12,10,8,11,11,12,13,9,12,9,8,5,11,10,12,11,7,14,12,20,11,12,12,7,11,6,9,12,14,11,11,13,13,6,7,AM/S C,1,1,20,18,13,14,1,1,1,1,1,1,1,1,1
80000975,Jorge Barbosa,1651,06/08/1979,36,0,0,0,0,165,69,3,1,2,3,3,3,3,2,3,1,2,12,14,16,11,16,10,10,11,9,8,8,6,10,16,10,12,5,8,10,11,11,10,13,5,11,10,11,11,14,15,10,4,1,16,14,20,9,8,10,10,10,4,10,19,12,10,12,11,8,9,3,AM RL,1,1,1,1,20,20,1,1,1,1,1,1,1,1,1
80010890,Milan,1651,03/05/1989,27,0,0,0,0,184,72,1,1,3,3,2,2,4,1,4,1,1,7,5,9,9,12,7,7,12,1,7,11,5,7,8,10,7,9,8,8,13,13,10,8,12,12,9,8,5,13,13,8,10,20,11,13,10,5,7,10,10,10,7,10,10,12,12,10,10,5,2,5,AM C,1,1,1,20,1,1,1,1,1,1,15,1,1,1,1
80013378,Fernando Cardoso,1651,20/11/1990,25,0,0,0,0,175,73,1,1,1,2,1,2,3,2,2,2,2,4,6,3,9,14,7,10,9,5,14,12,2,14,10,10,11,9,8,11,9,12,10,4,10,8,14,9,13,14,14,9,4,8,15,13,20,13,10,10,10,5,10,10,19,10,10,12,12,6,14,2,D/DM C,1,1,1,1,1,1,18,1,1,20,1,1,1,1,1
80013379,Ronailson,1651,05/04/1991,25,0,0,0,0,175,75,3,1,3,3,2,3,1,1,1,2,3,7,7,11,9,13,3,13,8,4,5,8,4,1,10,9,11,4,6,6,8,9,2,10,8,13,8,7,8,13,13,8,7,9,15,13,20,13,9,10,7,10,7,10,7,10,10,9,8,3,9,3,S ,1,1,20,1,1,1,1,1,1,1,1,1,1,1,1
80023664,Cleber Lucas,1651,19/11/1988,27,0,0,0,0,179,72,1,2,3,2,1,3,4,3,1,2,1,4,8,12,13,14,8,9,8,6,8,13,9,8,14,10,10,9,13,9,8,13,10,13,9,14,8,9,10,14,12,9,6,1,12,13,20,14,8,10,7,10,10,10,7,10,12,11,13,10,6,6,AM/S C,1,1,19,20,1,1,1,1,1,1,15,1,1,1,1
80030005,Pedro Dos Santos,1651,21/11/1991,24,0,0,0,0,176,69,2,1,3,3,2,1,1,3,2,3,2,7,4,9,8,13,7,1,11,1,8,13,5,7,13,10,9,7,9,8,12,12,4,13,11,10,8,8,11,13,13,8,5,9,11,13,20,7,5,10,8,10,9,10,7,9,14,12,12,9,3,4,M/AM C,1,1,1,18,1,1,1,1,1,1,20,1,1,1,1
8052251,Willer,1651,18/11/1979,36,0,0,0,0,172,69,2,3,1,2,3,3,1,3,3,2,1,11,11,13,8,11,14,8,8,7,7,12,12,7,12,12,9,11,9,11,12,9,6,11,4,11,8,8,9,12,13,7,5,10,12,12,20,10,7,13,13,9,7,14,7,9,10,11,4,14,9,15,M/AM/S RLC,1,1,20,20,18,17,1,1,1,1,16,12,11,1,1
8153132,Alves da Silva,1651,17/11/1983,32,0,0,0,0,173,77,1,3,2,1,1,2,3,2,2,2,3,10,10,12,12,12,8,6,8,10,8,10,10,5,13,10,10,14,11,10,7,10,11,8,13,10,6,8,14,14,12,8,5,20,8,14,8,10,10,14,10,9,8,10,16,10,14,11,8,11,13,8,AM/S LC,1,1,19,20,18,1,1,1,1,1,15,14,1,1,1
8190200,Tiago Bezerra,1651,17/02/1987,29,0,0,0,0,174,72,2,4,2,4,2,2,3,1,1,1,1,9,9,12,12,12,15,7,11,5,2,10,13,3,14,10,12,6,12,9,13,10,11,14,5,13,6,9,12,14,15,13,8,12,11,12,20,8,8,10,7,10,10,7,12,14,9,12,9,13,13,9,AM RC,1,1,12,20,14,19,1,1,1,1,1,1,1,1,1
830987,Massimo Zappino,1651,12/06/1981,35,0,0,0,0,188,83,13,14,11,20,14,11,13,14,8,10,11,5,2,2,3,8,10,2,2,1,2,7,2,3,5,18,12,14,12,10,9,11,15,3,10,2,11,9,9,8,12,12,15,5,11,9,20,8,12,13,10,11,3,10,13,13,16,14,11,8,5,6,GK ,20,1,1,1,1,1,1,1,1,1,1,1,1,1,1
83101739,Ian Pereira,1651,05/11/1996,19,0,0,0,0,175,74,3,2,1,4,2,1,1,3,2,1,1,3,7,3,4,11,1,7,3,3,3,5,3,9,7,8,7,8,6,9,4,10,4,8,1,5,5,7,7,14,13,7,5,5,14,14,20,8,5,8,8,6,7,8,10,11,11,11,11,2,9,2,D R,1,1,1,1,1,1,1,1,20,1,1,1,1,1,13
83102078,Eduardo,1651,21/02/1993,23,0,0,0,0,171,71,2,3,3,2,3,3,1,3,3,2,2,4,3,4,1,6,1,6,3,5,7,6,1,10,6,7,7,7,6,7,6,6,6,7,14,5,6,6,6,14,14,6,4,8,11,14,20,6,4,7,7,2,7,7,10,10,12,10,10,7,6,2,D R,1,1,1,1,1,1,1,1,20,1,1,1,1,1,1
83102826,Elisson Baiano,1651,29/10/1996,19,0,0,0,0,176,67,1,1,2,2,3,3,3,1,2,3,3,10,13,13,6,12,8,4,7,1,4,7,1,7,8,5,7,7,7,7,7,11,9,9,12,7,3,7,9,13,10,6,4,5,9,10,20,13,5,9,3,9,6,9,12,14,12,10,12,1,6,2,AM L,1,1,1,1,20,10,1,1,1,1,1,10,10,1,1
83103193,Matheus Clemente,1651,10/06/1998,18,0,0,0,0,179,65,3,2,1,3,1,3,1,3,1,4,3,10,10,11,9,11,11,4,9,4,5,11,12,5,12,8,7,7,12,8,12,12,8,11,7,10,7,11,9,11,12,8,8,10,10,11,20,9,6,11,7,9,6,4,11,12,8,11,12,11,18,10,M C,1,1,1,1,1,1,1,1,1,1,20,1,1,1,1
83103198,Murilo,1651,17/05/1996,20,0,0,0,0,186,85,2,3,3,2,2,2,1,1,1,2,3,6,5,8,6,13,4,6,8,1,6,10,3,7,12,9,9,8,4,7,11,13,2,12,10,8,8,7,8,13,12,3,11,20,11,12,2,7,10,9,9,4,6,9,10,12,8,12,12,5,10,8,AM C,1,1,1,20,1,1,1,1,1,1,13,1,1,1,1
83103580,André,1651,13/01/1989,27,0,0,0,0,177,74,2,2,2,2,1,2,2,2,1,4,2,7,7,10,9,10,8,7,9,7,5,10,9,5,10,14,5,6,7,10,9,11,4,8,9,9,8,8,12,8,9,8,8,13,10,7,20,9,8,8,11,10,8,9,15,8,12,10,11,6,15,8,M/AM C,1,1,13,20,1,1,1,1,1,1,17,1,1,1,1
83104457,Luís Felipe,1651,15/09/1994,21,0,0,0,0,167,66,1,3,3,1,2,3,1,4,2,1,1,3,3,2,7,8,3,1,2,1,3,6,1,2,12,7,2,2,2,4,12,11,7,13,12,2,4,5,10,12,12,4,1,7,13,12,20,9,2,5,7,6,7,7,7,11,10,14,12,5,7,3,AM C,1,1,1,20,1,1,1,1,1,1,1,1,1,1,1
83105481,Guylherme,1651,26/12/1995,20,0,0,0,0,184,79,3,1,3,1,4,2,1,2,3,1,1,3,1,9,12,10,3,12,4,1,2,4,7,1,12,7,8,4,6,2,2,4,7,13,12,10,3,3,4,12,11,2,9,8,13,12,20,2,8,7,7,7,6,7,12,13,12,11,11,1,9,1,S ,1,1,20,1,1,1,1,1,1,1,1,1,1,1,1
83106017,Renan Alves,1651,17/12/1992,23,0,0,0,0,183,0,2,4,1,1,1,4,4,2,1,4,3,6,8,8,7,10,13,12,12,11,13,10,13,12,10,13,11,11,8,11,6,11,12,6,10,6,12,12,11,10,9,13,12,7,10,9,20,9,14,10,10,9,8,7,9,10,9,14,11,11,6,3,D C,1,1,1,1,1,1,20,1,1,1,1,1,1,1,1
83107071,Ricardo Graça,1651,16/02/1997,19,0,0,0,0,182,70,4,2,1,2,1,1,3,3,1,2,2,3,1,1,3,7,6,13,1,1,13,7,3,13,6,7,7,9,4,6,4,13,6,5,10,5,13,6,7,13,12,7,10,5,16,12,20,8,9,9,9,8,9,9,14,9,10,9,10,1,5,1,D C,1,1,1,1,1,1,20,1,1,1,1,1,1,1,1
83107353,Raphael Mello,1651,22/07/1992,23,0,0,0,0,189,81,9,10,9,11,13,11,9,12,11,9,8,5,1,2,2,2,9,2,2,3,2,2,4,3,7,9,10,11,12,9,10,8,3,10,7,10,9,11,12,9,11,12,12,10,15,7,20,10,11,10,7,10,7,9,18,8,12,11,10,2,1,1,GK ,20,1,1,1,1,1,1,1,1,1,1,1,1,1,1
83107354,Léo Gama,1651,24/08/1993,22,0,0,0,0,175,77,1,3,3,3,3,2,3,3,4,2,1,6,6,12,13,13,3,13,7,2,5,7,6,1,13,6,6,8,9,7,6,10,9,13,1,13,4,6,7,13,11,2,8,10,11,11,20,6,6,9,7,9,9,9,10,12,12,9,10,5,16,3,S ,1,1,20,1,1,1,1,1,1,1,1,1,1,1,1
83107355,Rafael Goiano,1651,22/01/1990,26,0,0,0,0,188,84,4,3,1,1,2,3,3,1,1,3,1,3,5,3,11,11,6,13,5,6,12,13,10,13,5,10,12,9,11,11,12,10,5,9,12,11,13,11,10,12,12,8,12,5,12,11,20,10,13,12,9,10,4,5,10,10,9,14,11,9,14,2,D C,1,1,1,1,1,1,20,1,1,1,1,1,1,1,1
83107375,Erick,1651,01/03/1996,20,0,0,0,0,182,68,3,2,3,3,2,2,1,2,3,2,3,8,6,9,9,13,8,3,15,2,9,15,6,9,12,9,10,6,15,5,11,12,9,10,13,11,7,10,14,8,9,10,11,5,11,7,20,9,7,5,9,9,9,9,17,9,9,11,11,1,14,2,M/AM C,1,1,1,17,1,1,1,1,1,1,20,1,1,1,1
83107376,Kevin Douglas,1651,14/09/1994,21,0,0,0,0,187,81,12,7,9,2,12,14,9,14,6,6,14,3,2,3,2,3,5,1,3,2,3,1,2,1,2,9,7,11,6,10,7,12,5,3,11,1,9,8,7,11,6,8,10,5,12,9,20,4,9,7,8,9,9,9,16,9,10,9,11,1,12,7,GK ,20,1,1,1,1,1,1,1,1,1,1,1,1,1,1
83108002,Gedson,1651,06/10/1993,22,0,0,0,0,177,71,2,1,1,4,1,3,2,1,2,2,1,5,1,7,4,13,5,5,7,1,5,13,4,7,13,8,9,7,8,5,9,5,4,13,11,11,7,7,11,13,12,2,8,8,8,13,20,10,6,8,8,8,7,8,13,13,12,10,12,1,4,1,M C,1,1,1,15,1,1,1,1,1,1,20,1,1,1,1
83108048,Felipe Sousa,1651,07/02/1995,21,0,0,0,0,175,70,3,2,3,1,2,2,3,3,3,1,1,7,5,9,9,14,7,6,12,1,7,14,3,9,12,9,5,7,9,6,13,13,3,11,1,11,7,8,10,14,13,4,7,3,11,14,20,7,5,9,9,9,9,9,13,9,11,12,12,9,16,4,M/AM C,1,1,1,20,1,1,1,1,1,1,18,1,1,1,1
83108178,Aloísio,1651,03/05/1996,20,0,0,0,0,186,0,2,4,1,3,1,2,3,2,3,1,3,5,6,6,7,8,6,12,7,7,12,9,6,12,8,13,12,11,9,11,10,11,12,8,7,8,12,12,12,10,11,11,12,2,11,11,20,11,12,12,10,9,7,8,13,12,11,7,9,11,13,7,D C,1,1,1,1,1,1,20,1,1,1,1,1,1,1,1
83110552,Matheus Campos,1651,10/07/1996,19,0,0,0,0,178,72,2,1,2,3,2,2,1,2,1,2,3,2,5,4,6,10,1,4,7,1,6,14,1,10,14,7,6,5,7,6,10,5,5,7,4,6,5,6,10,7,11,6,5,6,11,9,20,6,5,7,7,7,6,7,17,12,14,10,11,1,17,2,M C,1,1,1,1,1,1,1,1,1,1,20,1,1,1,1
83111054,Lucas Tigrão,1651,16/01/1996,20,0,0,0,0,196,93,2,1,2,2,2,2,2,3,3,2,2,1,1,1,1,4,1,12,3,1,13,6,1,13,3,8,8,8,1,10,2,13,3,1,7,5,13,5,6,7,9,6,12,9,5,6,20,4,12,8,3,4,3,8,13,11,12,14,12,1,4,1,D C,1,1,1,1,1,1,20,1,1,1,1,1,1,1,1
83111067,Leo Araújo,1651,28/06/1992,24,0,0,0,0,185,79,1,3,4,3,1,3,1,2,1,2,3,1,1,1,2,8,1,14,2,7,8,7,3,14,7,9,9,9,8,10,2,14,7,1,1,5,9,7,8,14,14,8,14,15,13,14,20,7,7,9,9,2,8,9,13,11,9,10,13,11,19,7,D C,1,1,1,1,1,1,20,1,1,1,1,1,1,1,1
83111413,Leo Natel,1651,14/03/1997,19,0,0,0,0,175,68,3,2,1,3,2,2,1,1,3,1,4,8,8,11,9,10,8,7,8,4,3,10,5,4,11,8,7,8,9,7,9,7,8,12,6,11,7,10,10,12,11,8,8,7,12,12,20,8,6,8,4,6,6,8,8,12,10,11,12,8,13,8,AM RL,1,1,14,1,18,20,1,1,1,1,1,1,1,1,1
83111528,Douglas Aurélio,1651,27/03/1999,17,0,0,0,0,183,75,1,2,3,3,1,1,4,2,1,3,1,9,10,12,10,12,10,8,11,6,4,11,11,5,13,11,9,11,9,8,9,9,12,12,6,10,7,8,8,11,12,12,12,20,12,11,5,10,11,8,10,12,5,10,12,14,10,11,11,6,10,12,AM/S RL,1,1,19,1,20,18,1,1,1,1,1,1,1,1,1
83112101,Mateus,1651,17/10/1994,21,0,0,0,0,187,85,2,1,1,1,3,1,2,3,4,3,2,4,2,13,13,13,6,13,6,1,6,7,8,6,13,9,9,4,11,5,7,12,9,13,5,13,5,5,7,12,8,7,10,20,8,11,10,6,8,9,9,9,4,9,12,12,11,9,8,2,8,6,S ,1,1,20,1,1,1,1,1,1,1,1,1,1,1,1
83115499,Ronan Rodrigues,1651,16/11/1992,23,0,0,0,0,190,79,3,1,2,3,2,1,1,2,3,2,3,5,5,4,5,6,4,11,5,6,13,6,5,12,6,15,11,13,9,8,8,8,10,8,7,6,10,10,10,9,9,13,15,6,11,11,20,10,13,9,10,9,6,9,12,10,7,9,11,13,10,9,D C,1,1,1,1,1,1,20,1,1,1,1,1,1,1,1
83117170,Bruno Santos,1651,26/09/1989,26,0,0,0,0,186,82,13,5,10,4,13,9,7,13,9,9,8,6,3,2,2,1,9,1,2,2,1,2,1,1,1,7,11,9,2,6,6,13,2,3,10,1,10,7,6,12,14,7,13,9,11,13,20,6,7,8,6,3,7,9,19,11,11,11,12,3,16,4,GK ,20,1,1,1,1,1,1,1,1,1,1,1,1,1,1
83117181,Rafael Bode,1651,13/05/1994,22,0,0,0,0,186,79,12,7,6,6,12,12,7,12,8,8,7,3,3,2,3,1,3,1,3,3,1,1,3,3,2,8,7,11,5,9,4,12,8,3,1,3,6,5,4,9,13,5,9,1,14,12,20,4,8,8,3,2,6,8,9,10,11,12,11,5,6,2,GK ,20,1,1,1,1,1,1,1,1,1,1,1,1,1,1
83117200,Diego Félix,1651,10/03/1991,25,0,0,0,0,179,75,1,2,2,4,2,2,1,1,2,3,2,3,3,2,5,11,3,2,6,1,4,11,3,2,9,8,3,6,7,5,11,9,8,11,7,9,5,5,10,11,11,5,6,16,15,11,20,9,3,8,8,1,8,8,12,12,9,8,12,6,3,7,M/AM C,1,1,1,17,1,1,1,1,1,1,20,1,1,1,1
83117210,Marlon,1651,06/12/1994,21,0,0,0,0,170,68,2,3,3,1,3,3,3,1,1,3,1,8,10,13,13,12,5,7,2,3,5,6,4,5,11,8,6,6,8,6,4,10,4,11,1,9,5,6,7,13,7,6,1,5,8,10,20,11,4,8,8,8,8,8,13,10,11,10,10,7,4,1,AM/S RL,1,1,17,1,17,20,1,1,1,1,1,1,1,1,1
83117245,Jean Silva,1651,20/11/1992,23,0,0,0,0,185,82,3,3,3,3,1,3,1,3,1,3,1,9,12,12,5,11,5,4,4,3,3,2,3,2,8,7,5,1,5,4,4,8,7,9,8,5,1,4,5,12,10,4,8,8,8,9,20,6,8,7,7,3,7,7,7,10,9,10,11,6,18,5,AM R,1,1,12,10,13,20,1,1,1,1,1,1,1,1,1
83118956,Anderson Batista,1651,01/06/1995,21,0,0,0,0,180,72,2,2,1,2,1,2,2,3,3,4,1,3,1,5,5,7,1,3,5,1,3,7,1,4,11,4,5,5,3,1,12,6,3,12,5,1,5,4,6,12,11,2,5,13,4,12,20,11,4,7,7,7,7,7,10,12,10,9,10,9,12,1,AM C,1,1,1,20,1,1,1,1,1,1,12,1,1,1,1
83118958,Alisson,1651,29/07/1995,20,0,0,0,0,183,0,2,2,1,3,1,2,3,1,3,2,2,3,4,12,11,12,3,12,3,1,1,4,3,1,10,7,9,4,5,4,3,2,5,11,11,12,3,3,4,12,11,4,5,7,11,11,20,5,6,7,7,7,7,7,20,13,12,11,10,9,9,6,S ,1,1,20,1,1,1,1,1,1,1,1,1,1,1,1
83118967,Guilherme Terra,1651,08/02/1995,21,0,0,0,0,188,0,3,2,2,2,3,2,1,4,4,1,2,1,2,1,2,4,1,6,1,1,12,4,1,11,1,7,8,6,4,4,1,12,2,1,11,3,7,3,4,10,8,4,8,7,10,8,20,3,8,7,6,7,4,7,12,10,12,12,11,8,1,5,D C,1,1,1,1,1,1,20,1,1,1,1,1,1,1,1
83118970,Nicolas Raber,1651,31/01/1996,20,0,0,0,0,183,0,2,4,2,2,3,1,2,3,1,1,2,4,2,2,6,8,5,5,8,3,6,8,1,6,12,7,5,2,5,3,8,8,7,7,13,9,4,7,12,14,10,6,9,4,9,13,20,12,9,7,4,6,7,7,8,11,10,12,11,9,10,2,M C,1,1,1,1,1,1,1,1,1,1,20,1,1,1,1
83119372,Fábio Almeida,1651,07/07/1996,19,0,0,0,0,177,0,3,2,2,1,3,2,3,1,1,2,3,2,2,12,13,13,4,11,5,4,2,5,7,2,11,4,4,1,11,5,1,10,7,11,2,10,2,4,5,11,6,5,8,10,8,8,20,5,5,7,7,7,7,7,10,9,14,11,12,7,8,8,S ,1,1,20,1,1,1,1,1,1,1,1,1,1,1,1
83119391,Anderson,1651,09/09/1979,36,0,0,0,0,179,77,1,3,3,2,3,1,2,3,3,3,1,5,7,4,5,10,7,8,8,1,9,8,3,14,14,9,8,9,9,10,10,14,1,13,11,8,10,8,9,7,9,8,7,15,16,9,20,10,7,8,7,9,5,9,15,12,9,9,12,8,8,2,D/AM RC,1,1,1,18,1,10,1,1,20,1,1,1,10,1,10
83119400,Leandro,1651,04/01/1991,25,0,0,0,0,173,70,3,3,3,3,3,2,4,1,3,3,1,8,10,8,7,8,2,5,7,6,2,9,2,7,8,8,7,9,7,8,9,8,3,12,3,8,9,10,10,12,10,8,6,5,10,9,20,10,9,9,15,9,12,7,15,12,13,10,12,3,4,2,AM L,1,1,1,1,20,12,1,1,1,1,1,1,1,1,1
83121011,Bernardo Diniz,1651,14/02/1998,18,0,0,0,0,186,77,1,1,1,2,2,3,3,4,3,4,1,6,7,12,14,14,6,14,2,1,6,7,4,2,10,6,8,7,9,2,3,8,1,9,8,9,4,6,7,9,12,7,10,9,11,12,20,6,8,7,8,8,4,7,14,12,10,11,12,1,13,7,S ,1,1,20,1,1,1,1,1,1,1,1,1,1,1,1
83121758,Japa,1651,06/01/1994,22,0,0,0,0,182,69,1,3,3,1,1,1,1,2,2,4,1,4,2,5,5,11,4,2,10,1,5,12,1,11,6,7,7,6,1,8,7,8,3,4,13,4,10,6,10,13,8,5,8,8,9,12,20,6,5,7,7,3,7,7,8,9,13,10,11,10,15,6,DM ,1,1,1,1,1,1,1,1,1,20,1,1,1,1,1
83123850,Fabiano,1651,05/02/1992,24,0,0,0,0,181,75,2,2,1,2,1,2,1,2,4,3,1,1,1,10,7,9,3,12,4,1,3,1,2,1,7,7,6,1,7,1,4,9,7,8,11,8,4,3,6,12,12,4,4,20,10,12,10,10,7,7,7,4,7,7,14,9,10,11,11,2,1,6,S ,1,1,20,1,1,1,1,1,1,1,1,1,1,1,1
83134932,Jeisson Lima,1651,04/09/1994,21,0,0,0,0,193,85,11,9,9,12,9,12,7,13,8,12,10,3,1,2,3,5,2,4,2,1,3,8,3,2,7,9,9,8,9,10,7,7,12,9,7,8,9,8,10,8,10,10,11,8,15,9,20,10,11,10,8,8,8,8,12,13,10,10,15,17,19,8,GK ,20,1,1,1,1,1,1,1,1,1,1,1,1,1,1
83135551,Pedro Silva,1651,19/01/1996,20,0,0,0,0,187,81,1,2,1,1,1,3,4,1,3,2,1,4,4,3,1,7,5,10,7,1,13,8,1,14,6,8,9,6,5,6,4,13,8,6,4,6,14,5,8,8,10,7,8,20,10,8,8,4,9,8,7,8,7,8,17,10,9,13,11,3,7,8,D C,1,1,1,1,1,1,20,10,1,15,10,1,1,1,1
83136156,Cleiton,1651,28/07/1992,23,0,0,0,0,171,62,3,1,2,3,2,1,3,1,3,4,1,9,14,13,9,13,7,8,4,7,7,7,3,9,8,9,7,8,8,9,8,10,9,9,14,9,7,8,9,14,11,8,5,10,16,13,20,8,6,9,9,1,8,9,19,11,12,7,11,4,5,8,D/AM RL,1,1,13,1,20,20,1,1,17,1,1,13,10,1,13
83136160,Pedro Luís,1651,01/09/1992,23,0,0,0,0,185,77,3,4,3,3,2,2,1,3,3,2,1,1,1,1,2,5,4,8,1,1,12,5,3,12,1,7,11,7,5,7,2,12,3,1,7,3,12,4,5,9,8,5,12,9,14,11,20,3,7,8,5,8,8,8,16,10,14,10,10,5,11,1,D C,1,1,1,1,1,1,20,1,1,1,1,1,1,1,1
83136163,Guilherme,1651,29/09/1995,20,0,0,0,0,185,81,3,2,4,3,1,3,3,1,1,1,2,5,5,5,6,13,5,5,12,1,8,13,3,11,13,8,8,2,10,6,11,9,5,8,9,8,6,6,10,8,9,3,10,9,5,10,20,5,9,8,8,8,8,8,18,12,10,11,12,3,5,5,M C,1,1,1,1,1,1,1,1,1,1,20,1,1,1,1
83136164,Gustavo,1651,06/03/1995,21,0,0,0,0,169,60,1,1,3,1,2,1,4,2,3,3,1,9,11,8,1,13,6,3,2,6,8,7,1,14,9,8,7,8,6,7,8,7,2,8,7,5,7,7,8,14,14,7,7,8,9,14,20,8,5,8,8,7,8,8,14,12,9,11,12,1,11,7,D R,1,1,1,1,1,15,1,1,20,1,1,1,10,1,10
83137939,Marco Túlio,1651,30/04/1992,24,0,0,0,0,186,85,2,1,2,4,1,1,1,2,2,3,1,7,5,5,9,12,8,8,5,1,10,14,6,14,14,7,9,9,10,9,8,14,5,5,10,8,11,9,12,14,14,9,8,5,5,14,20,14,10,10,6,10,8,10,12,13,10,9,13,7,1,4,DM ,1,1,1,1,1,1,1,1,1,20,12,1,1,1,1
83137951,Wellyson,1651,19/02/1996,20,0,0,0,0,181,0,2,1,3,1,3,1,1,2,3,4,1,8,12,6,3,13,5,8,11,11,9,12,2,12,9,5,12,9,7,6,6,13,6,8,8,3,6,8,8,13,9,7,7,5,12,7,20,12,9,8,8,4,8,8,20,11,9,10,11,1,12,1,D R,1,1,1,1,1,1,1,1,20,1,1,1,1,1,1
83137984,Hudson,1651,21/11/1996,19,0,0,0,0,176,68,1,3,2,2,3,3,3,1,3,1,3,8,11,11,3,13,7,2,8,7,5,9,2,6,9,9,6,4,4,9,7,12,9,8,1,8,8,8,9,14,14,7,6,20,9,14,5,5,5,9,9,5,9,9,19,11,12,14,12,1,15,4,D/M/AM L,1,1,7,1,20,10,1,17,1,1,1,17,1,13,1
83138253,Alex Alcântara,1651,28/04/1995,21,0,0,0,0,175,64,1,2,2,2,1,1,3,1,2,2,3,7,9,14,13,14,7,9,8,5,7,8,6,2,10,7,8,5,12,6,7,12,9,9,11,12,7,8,9,11,14,8,6,6,7,14,20,10,5,9,7,9,9,9,11,14,11,8,10,9,12,2,AM/S RL,1,1,20,1,18,18,1,1,1,1,1,1,1,1,1
83138473,Guilherme,1651,24/02/1995,21,0,0,0,0,174,72,2,1,3,2,1,4,1,2,4,3,2,1,2,11,10,12,3,7,7,5,4,7,3,1,13,8,5,2,13,6,4,10,8,13,12,8,5,6,7,13,11,6,3,10,11,12,20,7,6,8,3,2,8,8,12,11,13,12,11,3,7,4,AM C,1,1,13,20,7,7,1,1,1,1,7,1,1,1,1
83139490,Ailton,1651,19/01/1996,20,0,0,0,0,187,79,2,2,1,2,3,1,2,3,3,1,1,4,6,2,1,9,1,6,1,5,4,6,1,9,5,7,6,7,4,5,3,9,2,6,1,2,9,6,7,9,12,4,14,5,10,14,20,11,8,7,7,6,7,7,13,12,13,10,13,9,9,2,D R,1,1,1,1,1,1,1,1,20,1,1,1,1,1,1
83139823,Murillo Pagliuso,1651,27/01/1992,24,0,0,0,0,193,80,1,3,2,1,3,3,2,2,2,3,3,3,1,12,12,11,3,9,4,1,1,1,6,1,9,7,4,3,9,3,2,8,1,10,6,12,4,3,4,12,11,4,13,5,11,12,20,5,11,7,7,7,7,7,10,12,9,9,11,4,5,2,S ,1,1,20,1,1,1,1,1,1,1,1,1,1,1,1
83139835,Diego,1651,17/12/1996,19,0,0,0,0,166,60,3,1,4,4,1,3,2,3,3,4,3,8,7,13,8,12,11,6,9,2,4,14,9,3,15,8,9,6,8,11,14,12,15,14,4,12,6,11,12,13,12,10,4,20,8,13,5,10,7,12,3,12,2,14,12,14,20,17,16,20,20,1,AM RC,1,1,1,20,7,20,1,1,1,1,13,1,13,1,1
83139843,Júlio Cézar,1651,05/01/1996,20,0,0,0,0,188,76,3,2,1,4,3,3,1,3,3,1,3,4,5,9,5,8,5,10,5,7,9,8,5,10,11,10,8,10,12,7,8,9,13,13,5,12,7,10,9,9,9,9,9,5,12,8,20,8,8,8,8,10,13,9,10,13,13,15,12,13,14,8,D C,1,1,1,1,1,1,20,1,1,1,1,1,1,1,1
83140084,Allef,1651,04/11/1994,21,0,0,0,0,175,68,1,1,3,4,2,3,1,2,4,3,3,8,9,12,13,11,9,10,11,8,7,12,11,8,13,12,11,10,12,9,10,9,2,14,9,11,10,11,12,12,13,9,9,5,11,11,20,12,10,10,13,10,8,10,12,11,11,11,12,8,15,1,S ,1,1,20,1,1,1,1,1,1,1,1,1,1,1,1
83140085,Leo Carioca,1651,21/04/1993,23,0,0,0,0,192,87,2,1,1,2,2,2,1,3,1,2,1,2,1,1,3,3,1,12,2,1,6,4,1,10,1,7,8,6,3,4,1,12,7,7,11,3,10,3,4,11,8,4,12,5,7,8,20,5,10,7,7,7,6,7,16,9,9,12,12,11,10,8,D C,1,1,1,1,1,1,20,1,1,1,1,1,1,1,1
83140086,Wendel,1651,12/02/1996,20,0,0,0,0,188,0,2,4,3,3,1,2,2,1,2,2,3,3,1,12,12,12,3,12,4,1,1,3,6,1,10,7,6,5,6,1,4,10,2,11,1,7,1,3,4,9,7,4,12,5,10,10,20,2,7,7,7,7,7,7,20,11,12,9,12,1,7,4,S ,1,1,20,1,1,1,1,1,1,1,1,1,1,1,1
83140113,Djone,1651,29/08/1988,27,0,0,0,0,182,82,2,3,3,1,2,1,2,3,4,4,2,2,1,3,4,4,2,12,2,4,11,4,1,11,4,9,8,10,8,11,3,9,1,7,4,4,9,8,11,5,7,9,6,5,9,3,20,9,14,7,13,10,10,3,9,13,13,12,8,1,11,1,D C,1,1,1,1,1,1,20,1,1,1,1,1,1,1,1
83148721,Adilson Bahia,1651,27/09/1992,23,0,0,0,0,177,74,3,2,4,2,3,1,1,2,2,2,1,12,14,8,9,9,9,8,12,7,12,11,5,8,10,6,12,6,10,10,11,10,7,10,12,11,9,10,14,13,12,10,6,20,14,13,10,15,8,10,3,9,6,10,15,9,9,12,11,4,17,7,AM LC,1,1,1,15,20,1,1,1,1,1,1,1,1,1,1
83148722,Claudio Falcão,1651,03/07/1994,21,0,0,0,0,184,73,3,2,2,3,3,1,2,1,1,3,2,7,4,4,8,8,7,8,6,4,8,8,1,13,9,3,12,8,7,6,8,12,5,4,1,6,12,8,13,14,12,8,10,10,10,11,20,8,7,9,7,5,6,9,15,13,9,12,12,10,11,7,DM ,1,12,1,1,1,1,12,1,1,20,1,1,1,1,1
83148973,Gabi,1651,07/07/1997,18,0,0,0,0,181,70,12,4,5,1,12,9,7,12,6,8,6,2,3,3,3,1,6,1,3,2,3,1,1,2,2,4,2,6,3,10,4,12,8,3,6,3,3,5,4,9,13,5,8,6,8,10,20,1,4,8,8,6,8,7,18,9,10,8,10,9,6,1,GK ,20,1,1,1,1,1,1,1,1,1,1,1,1,1,1
83149197,Igor Rocha,1651,21/09/1995,20,0,0,0,0,172,69,3,3,3,3,2,3,1,3,3,2,2,7,8,14,14,13,7,14,7,4,5,6,8,3,14,9,12,8,9,8,7,9,9,13,12,14,7,7,8,14,10,8,2,5,10,13,20,7,9,9,4,9,8,9,16,9,11,8,12,8,1,1,S ,1,1,20,1,1,1,1,1,1,1,1,1,1,1,1
83149508,Stephano,1651,17/09/1993,22,0,0,0,0,180,74,4,3,1,2,2,1,1,3,3,3,3,1,2,5,4,7,1,6,2,5,6,7,2,11,7,8,7,8,6,10,2,13,3,8,14,5,4,6,6,13,13,6,5,8,8,13,20,7,7,8,8,8,8,8,8,11,9,10,11,1,14,1,D R,1,1,1,1,1,1,1,1,20,1,1,1,1,1,12
83149703,Paulinho,1651,24/06/1997,19,0,0,0,0,172,65,3,1,3,2,3,3,3,2,3,3,3,5,7,11,9,8,7,9,8,7,8,9,8,7,8,8,9,7,8,9,8,6,3,14,7,8,9,9,7,11,11,9,8,4,13,11,20,8,5,8,8,8,5,9,19,9,9,11,12,3,5,6,AM RL,1,1,13,1,17,20,1,1,1,1,1,1,1,1,1
83149785,Mika,1651,06/05/1995,21,0,0,0,0,190,0,12,7,8,6,12,7,6,7,7,7,6,2,1,2,1,1,4,1,2,3,2,1,3,2,3,7,2,7,4,6,3,12,1,1,8,3,5,4,3,11,8,4,10,7,13,9,20,1,7,7,5,4,7,7,15,7,11,11,12,5,11,8,GK ,20,1,1,1,1,1,1,1,1,1,1,1,1,1,1
83150101,Carlos Augusto,1651,07/06/1990,26,0,0,0,0,175,69,2,2,1,2,1,2,2,4,1,1,3,2,4,5,3,10,4,4,6,3,6,12,1,12,10,6,6,5,6,6,9,12,3,8,9,4,8,6,9,12,12,6,4,15,7,12,20,7,3,4,4,8,8,7,8,10,12,9,13,1,8,5,DM/M C,1,1,1,1,1,1,1,1,1,20,17,1,1,1,1
83152890,Murilo,1651,12/05/1996,20,0,0,0,0,174,65,1,3,1,3,1,2,2,2,1,1,1,7,10,11,7,11,10,6,6,5,5,9,2,6,12,13,10,12,7,8,10,8,13,11,6,12,6,9,12,15,14,11,7,20,11,15,5,10,10,8,6,2,4,5,17,14,9,14,11,2,4,8,AM L,1,1,1,1,20,13,1,1,1,1,1,13,7,1,1
83152906,Yuri,1651,10/02/1995,21,0,0,0,0,186,80,3,4,3,2,3,3,4,2,2,2,2,6,6,9,9,10,5,12,5,8,11,10,8,12,12,15,12,13,11,10,8,8,14,5,8,9,11,10,11,12,10,14,13,5,13,12,20,12,11,9,15,8,5,10,4,14,4,4,6,11,7,15,D C,1,1,1,1,1,1,20,1,1,1,1,1,1,1,1
83152907,Allef Nunes,1651,09/12/1993,22,0,0,0,0,186,81,2,1,1,2,1,1,1,4,3,3,1,6,4,4,4,5,4,13,5,3,14,6,2,14,6,9,9,9,4,10,5,14,9,1,13,5,12,6,8,13,13,8,9,5,8,14,20,4,9,9,9,9,9,9,10,10,10,12,13,5,9,7,D C,1,1,1,1,1,1,20,1,1,1,1,1,1,1,1
83152908,Yan Victor,1651,18/09/1995,20,0,0,0,0,189,83,2,1,2,2,2,1,2,1,2,3,2,5,3,5,7,10,2,12,6,3,9,9,8,14,8,9,9,9,8,11,8,10,6,1,9,6,10,8,9,10,14,9,15,20,12,12,10,10,12,9,9,8,8,9,19,9,12,11,10,12,9,4,D LC,1,1,1,1,1,1,20,15,1,1,1,1,1,1,1
83152909,Danilo Rodrigues,1651,15/04/1996,20,0,0,0,0,178,70,1,4,2,1,2,2,3,3,2,1,2,9,13,10,7,12,7,5,7,6,4,8,4,5,11,7,7,7,6,2,8,11,9,11,5,8,6,7,8,13,13,7,7,20,10,13,5,9,7,9,9,6,5,9,20,14,13,10,10,7,2,7,AM L,1,1,1,12,20,1,1,1,1,1,1,1,1,1,1
83152910,Wenderson Galeno,1651,21/10/1997,18,0,0,0,0,182,72,4,3,3,1,3,4,3,1,1,1,4,7,8,14,11,11,5,6,12,4,4,10,3,5,12,11,10,9,7,8,8,9,15,15,4,12,4,5,11,17,15,11,12,3,12,16,20,11,10,10,5,12,6,4,16,14,12,13,15,9,13,6,AM RL,1,1,12,1,18,20,1,1,1,1,1,11,11,1,1
83152911,Bruno Henrique,1651,25/10/1992,23,0,0,0,0,186,83,4,1,3,2,2,1,3,1,1,2,1,4,4,10,12,10,6,12,8,5,5,8,8,5,11,12,10,11,8,11,9,9,11,8,8,13,8,10,12,10,10,16,12,6,15,11,20,11,15,9,9,6,6,9,12,12,8,10,12,9,10,2,S ,1,1,20,1,8,8,1,1,1,1,1,1,1,1,1
83152922,Guilherme Quichini,1651,15/12/1993,22,0,0,0,0,191,88,3,2,3,1,4,2,4,3,4,2,2,8,8,7,7,9,8,14,10,11,12,10,8,12,9,12,10,10,10,11,9,8,6,8,11,9,10,13,12,9,9,12,15,8,13,9,20,10,14,9,8,8,5,9,18,11,12,10,12,1,9,5,D C,1,1,1,1,1,1,20,1,1,1,1,1,1,1,1
83152923,Fabricio,1651,22/02/1995,21,0,0,0,0,180,75,2,1,1,3,3,1,3,2,1,2,2,7,8,12,14,11,7,8,8,5,4,9,7,5,12,12,11,10,12,10,9,12,9,13,7,12,8,9,9,12,11,10,8,20,12,12,5,9,9,12,8,10,5,12,10,9,12,11,11,1,11,5,S ,1,1,20,1,1,1,1,1,1,1,1,1,1,1,1
83152925,Rodrigo Henrique,1651,02/07/1993,23,0,0,0,0,183,0,1,3,1,2,2,4,3,3,2,2,3,8,6,10,15,15,8,13,8,1,7,8,4,2,11,8,11,7,10,8,9,11,7,9,13,12,6,8,9,14,10,9,12,5,16,12,20,10,10,9,6,9,9,9,8,11,10,12,9,4,4,8,S ,1,1,20,1,1,1,1,1,1,1,1,1,1,1,1
83152931,Muller,1651,13/02/1988,28,0,0,0,0,183,72,12,6,8,5,12,7,5,11,7,6,4,3,2,1,1,1,4,1,2,3,1,1,2,1,3,8,9,14,3,6,4,9,8,2,10,2,6,5,4,11,11,3,7,5,12,12,20,3,6,8,7,8,8,8,9,9,10,11,11,1,4,7,GK ,20,1,1,1,1,1,1,1,1,1,1,1,1,1,1
83153236,Gerson,1651,25/03/1996,20,0,0,0,0,182,72,2,2,3,1,3,3,1,2,3,3,2,3,8,12,12,12,3,10,5,1,1,5,5,2,9,7,2,5,4,5,3,8,2,10,6,5,4,3,5,10,7,5,4,20,9,9,6,7,5,7,5,7,7,7,18,13,11,11,11,3,9,1,AM/S L,1,1,20,1,17,1,1,1,1,1,1,1,1,1,1
83154619,Jackson,1651,02/02/1995,21,0,0,0,0,178,71,2,3,1,2,3,3,4,3,4,1,3,5,5,9,12,13,7,14,8,4,7,8,4,6,9,9,8,5,8,6,7,9,4,9,6,14,8,7,8,14,7,8,6,9,14,12,20,7,7,9,9,9,6,9,10,10,12,8,8,5,7,8,S ,1,1,20,1,1,1,1,1,1,1,1,1,1,1,1
83154620,Dentinho,1651,22/01/1996,20,0,0,0,0,178,69,3,2,1,2,2,4,4,2,1,1,1,6,3,10,13,13,5,13,6,5,3,7,9,3,12,6,7,8,11,6,6,4,2,12,8,10,3,6,7,13,7,7,4,8,16,12,20,7,6,8,9,9,9,9,8,11,9,10,11,10,15,7,S ,1,1,20,1,1,1,1,1,1,1,1,1,1,1,1
83154701,Felipe Silva,1651,28/04/1997,19,0,0,0,0,178,72,2,2,1,1,3,3,3,1,2,4,1,3,5,6,6,13,1,1,7,3,8,6,1,9,11,8,3,6,4,5,7,3,3,7,10,7,7,7,10,13,12,6,4,16,11,12,20,6,7,8,1,8,8,8,18,14,11,11,10,10,2,6,M C,1,1,1,1,1,1,1,1,1,1,20,1,1,1,1
83156853,Wendell,1651,13/06/1995,21,0,0,0,0,190,86,1,1,1,2,3,3,3,3,2,3,1,6,7,13,13,13,6,13,4,1,6,7,1,6,13,6,12,6,6,6,4,7,9,13,11,10,5,6,7,13,8,7,10,8,7,11,20,5,11,9,5,9,8,9,11,13,11,11,9,6,8,7,S ,1,1,20,1,1,1,1,1,1,1,1,1,1,1,1
83156854,Kennedy,1651,07/02/1995,21,0,0,0,0,181,78,2,3,1,1,1,4,2,1,2,4,1,2,2,3,1,8,1,14,1,2,7,7,1,13,7,8,7,8,5,8,5,14,1,3,1,6,8,7,7,11,10,7,6,8,8,12,20,11,6,7,8,8,7,8,7,10,13,9,11,7,3,6,D RC,1,1,1,1,1,1,15,1,20,1,1,1,1,1,1
83160149,Fabiano,1651,09/01/1991,25,0,0,0,0,171,61,1,3,2,2,2,1,1,3,2,1,1,5,7,11,10,9,5,7,9,5,3,9,5,4,12,9,7,8,7,8,8,7,8,9,7,7,7,8,9,12,12,8,5,5,14,12,20,7,5,9,8,8,5,12,14,10,12,10,12,9,15,7,AM RLC,1,1,1,20,17,17,1,1,1,1,1,1,1,1,1
83162378,Nathan,1651,20/08/1997,18,0,0,0,0,185,76,7,10,4,1,11,13,4,9,7,7,4,3,3,2,3,1,3,1,1,2,2,1,2,1,3,3,3,11,5,3,4,13,3,3,2,3,7,5,4,10,9,5,12,7,9,9,20,2,6,7,3,7,7,7,20,11,10,10,11,11,4,1,GK ,20,1,1,1,1,1,1,1,1,1,1,1,1,1,1
83162673,Henrique Rei,1651,30/09/1997,18,0,0,0,0,182,76,2,2,3,1,1,2,1,3,2,1,1,3,4,3,3,5,1,13,1,1,5,4,4,10,1,7,8,5,5,5,1,13,5,1,2,3,13,4,5,12,8,5,5,6,13,11,20,3,6,7,5,7,5,7,9,10,11,9,12,7,4,8,D C,1,1,1,1,1,1,20,1,1,1,1,1,1,1,1
83162868,Artur Júnior,1651,19/10/1995,20,0,0,0,0,171,65,3,3,2,3,3,2,3,3,3,1,2,7,9,12,7,9,6,4,8,4,5,10,8,5,12,9,10,7,10,9,13,11,5,17,7,13,7,10,9,13,12,10,6,20,15,12,3,8,5,10,6,10,6,12,14,10,15,8,12,14,7,3,AM RLC,1,1,13,17,20,20,1,1,1,1,1,1,1,1,1
83163726,Bruno Soares,1651,04/06/1993,23,0,0,0,0,176,70,3,2,2,1,1,1,2,3,1,1,3,9,12,10,6,9,5,2,5,3,3,7,4,3,8,8,7,5,6,3,4,12,8,9,13,6,5,6,10,12,11,5,2,20,12,12,8,5,4,8,7,6,8,8,11,11,9,12,13,1,8,2,AM LC,1,1,1,17,20,1,1,1,1,1,13,13,1,1,1
83163797,Deivid,1651,29/11/1996,19,0,0,0,0,175,65,2,3,1,1,2,1,2,1,4,3,1,5,9,12,7,12,5,5,7,5,3,6,2,5,10,7,6,5,4,6,7,5,7,9,11,7,4,6,2,14,12,6,8,20,8,13,2,6,7,7,3,5,7,7,14,9,10,12,11,1,5,1,AM RLC,1,1,13,17,20,17,1,1,1,1,1,13,1,1,1
83165327,Murilo,1651,25/11/1995,20,0,0,0,0,178,71,2,2,3,1,2,3,3,2,3,3,2,7,6,8,6,11,7,8,7,7,10,12,7,11,10,13,11,10,10,12,9,11,5,8,8,10,11,13,14,11,12,10,9,5,13,12,20,13,12,12,9,10,5,12,7,11,10,11,11,1,10,2,DM/M C,1,1,1,1,1,1,1,1,1,20,17,1,1,1,1
83167973,Lucas Salinas,1651,14/10/1995,20,0,0,0,0,170,61,2,1,2,1,2,2,1,2,2,3,2,2,5,7,7,13,5,5,9,1,6,8,5,4,13,8,6,4,6,5,13,13,8,13,1,3,7,7,12,13,11,7,1,20,10,11,9,7,3,8,4,8,8,8,13,10,14,12,11,5,6,2,M/AM C,1,1,1,20,1,1,1,1,1,1,17,1,1,1,1
83168024,Gil,1651,31/10/1998,17,0,0,0,0,185,0,4,9,7,1,6,6,8,10,7,4,11,3,3,1,2,1,5,1,2,3,2,2,3,1,3,5,4,11,1,7,4,13,2,3,11,1,6,5,4,12,6,5,13,6,12,7,20,1,6,7,7,7,5,7,11,13,13,10,12,2,9,6,GK ,20,1,1,1,1,1,1,1,1,1,1,1,1,1,1
83168040,Alexandre Pereira,1651,16/03/1997,19,0,0,0,0,193,86,3,1,3,3,3,4,4,3,1,3,3,5,5,9,7,10,8,14,10,7,12,11,5,12,9,12,12,12,5,8,8,10,14,11,8,9,10,10,10,9,9,9,12,5,12,10,20,10,11,10,10,10,12,9,12,13,10,12,11,11,12,12,D C,1,1,1,1,1,1,20,1,1,1,1,1,1,1,1
83168323,Vitor Hugo,1651,23/12/1994,21,0,0,0,0,184,87,2,2,3,1,3,3,1,1,3,2,2,8,8,7,8,14,8,8,13,4,12,14,1,14,11,10,8,8,10,9,11,14,10,1,10,9,11,9,12,10,10,6,8,5,12,10,20,8,10,10,4,4,7,10,16,11,10,12,11,4,8,4,DM C,1,1,1,1,1,1,1,1,1,20,15,1,1,1,1
83168648,Adilio Santos,1651,05/07/1993,22,0,0,0,0,178,72,1,1,3,4,1,2,2,2,2,3,1,12,14,14,6,9,8,5,7,7,7,9,1,6,14,9,5,8,10,8,7,12,4,13,12,8,6,8,11,13,11,8,9,20,15,11,5,8,7,9,9,4,9,9,8,12,10,10,10,5,1,8,AM L,1,1,1,1,20,13,1,1,1,1,1,13,10,1,1
83168649,Max Ferrer,1651,25/09/1995,20,0,0,0,0,193,89,7,9,10,2,13,10,11,13,9,5,7,5,3,2,3,1,7,1,2,2,1,2,1,1,3,5,5,10,6,9,6,13,8,2,6,1,9,7,6,12,13,4,14,5,12,12,20,1,10,9,7,2,9,8,11,11,10,10,10,8,11,7,GK ,20,1,1,1,1,1,1,1,1,1,1,1,1,1,1
83168666,Aloísio,1651,16/08/1997,18,0,0,0,0,181,74,3,2,3,1,1,3,1,2,1,4,2,2,2,1,1,4,1,12,5,1,10,4,2,13,5,8,8,8,3,6,2,12,8,1,6,4,6,5,6,12,10,6,10,5,11,11,20,7,8,8,5,8,5,8,11,14,13,11,12,1,13,1,D C,1,1,1,1,1,1,20,1,1,10,1,1,1,1,1
83168814,Fabricio,1651,29/03/1995,21,0,0,0,0,180,73,3,1,3,3,2,2,3,3,2,2,3,7,6,5,7,14,7,4,13,5,11,14,1,12,14,9,8,8,8,9,12,12,9,8,9,9,10,8,9,14,12,4,8,5,16,10,20,7,9,9,9,9,9,9,10,11,11,11,8,2,19,1,M C,1,1,1,1,1,1,1,1,1,15,20,1,1,1,1
83168996,Victor Veloso,1651,01/12/1996,19,0,0,0,0,183,79,3,3,1,2,2,3,1,1,4,2,3,5,7,10,11,10,9,10,10,5,8,10,14,8,10,13,10,12,10,9,10,9,3,11,8,12,11,11,10,10,10,10,10,10,10,10,20,11,10,10,12,14,5,12,14,11,11,10,10,2,11,3,S C,1,1,20,15,1,1,1,1,1,1,1,1,1,1,1
83169960,Gabriel Pajé,1651,04/01/1998,18,0,0,0,0,188,74,1,2,1,1,3,1,1,2,3,1,3,7,8,11,11,13,6,14,8,1,4,9,2,4,14,6,7,4,9,7,6,10,7,13,4,11,5,7,9,13,10,3,11,20,16,13,10,14,10,9,9,9,5,8,20,11,9,13,12,6,14,1,AM/S C,1,1,20,18,1,1,1,1,1,1,1,1,1,1,1
83170137,Matheus Leal,1651,01/05/1995,21,0,0,0,0,180,67,1,1,1,3,1,1,3,3,1,3,2,3,7,8,5,10,1,10,8,3,10,8,4,11,8,10,9,9,7,10,5,10,9,9,4,8,9,11,12,14,11,9,12,8,6,10,20,10,12,9,8,9,9,9,19,10,9,14,12,12,12,2,D LC,1,1,1,1,1,1,20,18,1,12,1,1,1,1,1
83171039,Marcos Thank,1651,16/12/1992,23,0,0,0,0,189,84,1,3,3,1,3,1,2,1,1,1,1,5,7,11,12,10,5,7,8,4,3,9,5,4,12,7,8,9,8,7,5,8,8,7,8,6,8,7,7,12,11,8,8,5,14,12,20,8,8,8,7,7,7,12,7,10,10,12,10,5,17,5,AM/S L,1,1,20,1,17,10,1,1,1,1,1,1,1,1,1
83171041,Charles,1651,02/07/1993,23,0,0,0,0,177,76,2,1,2,2,2,3,1,1,1,1,1,4,5,9,12,10,5,10,7,4,5,8,11,4,9,8,10,8,10,10,7,10,8,8,4,11,7,5,9,11,8,5,8,2,14,10,20,8,7,12,5,12,7,5,18,11,11,11,12,6,5,8,S ,1,1,20,1,1,1,1,1,1,1,1,1,1,1,1
83172438,Rodriguinho,1651,08/05/1995,21,0,0,0,0,187,78,3,1,1,1,1,3,2,1,1,3,3,3,8,7,5,12,4,4,1,1,5,4,1,6,11,8,6,6,6,6,3,5,5,12,10,5,6,5,6,12,12,5,12,20,10,12,8,7,6,8,7,4,8,8,18,13,14,10,11,1,14,1,D/AM L,1,1,1,1,20,1,1,17,1,1,1,13,1,13,1
83172459,Ba,1651,15/11/1993,22,0,0,0,0,183,76,2,3,3,3,3,1,2,2,2,1,2,5,1,13,13,13,5,13,5,2,4,4,6,1,10,7,11,3,9,5,6,10,3,10,14,12,5,5,6,11,9,6,8,1,11,10,20,8,9,8,8,2,8,8,10,12,13,12,11,4,8,7,S ,1,1,20,1,1,1,1,1,1,1,1,1,1,1,1
83172636,Filipe Mello,1651,26/08/1993,22,0,0,0,0,187,79,3,2,1,1,3,3,3,3,3,1,1,2,4,5,6,9,1,5,10,1,9,8,2,10,8,6,10,7,6,3,8,7,5,4,11,5,9,7,10,13,11,6,7,8,15,12,20,6,9,8,8,8,8,8,19,9,12,14,13,5,13,4,DM ,1,1,1,1,1,1,10,1,1,20,10,1,1,1,1
83173802,Caio,1651,27/03/1997,19,0,0,0,0,175,61,2,2,3,2,4,2,2,1,1,2,3,10,12,7,4,7,5,1,3,3,1,1,1,4,9,6,5,3,2,3,7,4,4,10,10,4,3,4,7,12,11,2,6,10,12,11,20,4,3,7,7,7,7,7,10,13,11,12,12,4,7,1,AM RL,1,1,10,1,20,20,1,1,1,1,1,10,10,1,1
83174697,Bruno Nascimento,1651,11/03/1996,20,0,0,0,0,186,82,2,1,3,3,2,2,1,1,1,2,2,11,12,10,8,9,11,10,11,11,9,12,9,9,10,11,11,10,13,11,10,11,7,9,8,10,11,11,12,12,9,10,11,20,12,12,10,11,12,10,8,9,6,15,18,12,11,11,11,3,9,1,D L,1,1,1,1,1,1,1,20,1,1,1,10,1,12,1
83176848,João Reis,1651,19/01/1996,20,0,0,0,0,194,88,2,1,2,3,2,2,2,1,2,3,1,3,4,5,3,9,2,2,7,1,9,12,1,7,13,7,5,5,6,4,6,7,5,7,9,3,6,5,7,11,10,5,12,8,12,10,20,6,12,7,7,7,7,7,13,13,9,12,13,4,1,4,M C,1,1,1,1,1,1,1,1,1,1,20,1,1,1,1
83176981,Pedro Kadri,1651,03/09/1995,20,0,0,0,0,188,88,2,3,4,3,1,3,3,1,2,2,2,7,6,7,8,12,4,9,8,5,10,11,4,14,9,5,7,8,7,5,9,14,5,3,4,7,10,8,11,12,11,8,11,10,13,11,20,7,8,9,9,9,9,9,15,11,11,12,12,1,16,8,D/DM C,1,1,1,1,1,1,20,1,1,20,13,1,1,1,1
83176988,Hudson,1651,12/03/1996,20,0,0,0,0,179,73,3,1,2,1,3,4,3,4,2,2,4,12,14,14,7,14,7,2,7,3,4,8,1,4,13,8,6,2,7,2,4,7,3,12,5,7,5,8,10,9,11,7,6,8,8,10,20,11,6,8,8,8,3,8,15,11,10,11,11,9,7,6,AM RL,1,1,1,1,17,20,1,1,1,1,1,13,13,1,1
83177003,Lucas,1651,07/06/1992,24,0,0,0,0,176,72,3,3,3,2,3,1,1,1,2,1,2,4,5,6,12,5,4,6,5,1,4,2,8,1,9,6,7,3,8,5,2,8,8,10,9,9,5,4,6,12,12,5,5,20,15,12,8,9,9,8,6,8,8,8,10,12,10,11,10,1,1,6,S ,1,1,20,1,14,1,1,1,1,1,1,1,1,1,1
83177311,Daniel Silva,1651,04/05/1997,19,0,0,0,0,177,84,1,2,1,1,3,2,3,2,3,1,1,3,8,6,9,11,3,7,7,2,3,7,9,5,10,10,7,8,10,9,8,11,8,6,2,8,11,6,10,9,7,10,11,9,12,8,20,13,13,8,8,3,8,7,11,12,13,12,11,8,17,8,S ,1,1,20,1,1,1,1,1,1,1,1,1,1,1,1
83177396,Vinicius Martyr,1651,21/07/1998,17,0,0,0,0,174,64,1,1,1,2,2,1,2,3,2,2,3,7,9,6,4,8,5,6,2,5,7,7,1,11,6,7,4,7,6,4,7,9,5,7,10,5,4,6,3,14,12,4,4,5,6,11,20,8,5,7,7,3,7,7,16,13,12,9,11,4,7,1,D R,1,1,1,1,1,1,1,1,20,1,1,1,15,1,1
83184858,Matheus Costa,1651,26/01/1995,21,0,0,0,0,188,80,2,3,3,1,1,1,2,3,3,3,3,3,6,4,6,7,5,13,5,4,11,6,3,10,4,10,7,12,7,9,5,8,4,2,10,8,12,6,8,13,13,7,9,5,8,13,20,4,8,6,9,9,9,9,11,11,10,8,11,7,14,7,D/DM C,1,1,1,1,1,1,20,1,1,16,1,1,1,1,1
83184971,Renan Godoy,1651,01/10/1996,19,0,0,0,0,178,71,3,2,2,3,3,3,3,3,3,4,3,5,5,2,3,14,4,4,8,1,7,12,3,9,11,5,4,4,6,5,12,8,5,1,5,4,4,7,10,11,7,6,7,9,9,9,20,6,5,7,7,7,7,7,18,13,10,11,12,9,18,2,M C,1,1,1,1,1,1,1,1,1,1,20,1,1,1,1
83184973,Sandro,1651,10/10/1991,24,0,0,0,0,184,74,2,1,2,3,3,3,1,1,2,2,3,7,9,8,6,9,2,8,1,7,9,9,3,12,7,9,7,9,9,5,6,10,6,4,9,7,9,8,9,14,14,8,9,20,16,14,9,10,7,9,7,9,8,9,13,11,8,11,13,11,17,4,D L,1,1,1,1,1,1,1,20,1,1,1,13,1,13,1
83185204,Wesley,1651,19/01/1999,17,0,0,0,0,172,65,2,2,1,3,3,1,2,4,2,1,2,4,4,9,13,9,4,8,6,1,1,5,2,1,5,1,8,3,7,4,7,5,7,7,5,9,2,4,6,11,10,6,2,16,13,13,20,3,5,7,7,7,6,7,12,12,11,13,12,4,9,3,AM/S C,1,1,20,19,1,1,1,1,1,1,1,1,1,1,1
83185398,Matheus,1651,06/06/1997,19,0,0,0,0,187,83,1,2,1,3,3,2,1,2,2,3,2,1,1,1,1,2,1,7,1,1,12,3,1,8,3,7,5,6,3,3,1,12,4,1,1,1,9,3,4,7,10,4,9,18,14,8,20,2,7,7,7,5,7,7,12,10,11,9,12,4,9,7,D C,1,1,1,1,1,1,20,1,1,1,1,1,1,1,1
83185572,Kainã,1651,31/05/1997,19,0,0,0,0,187,0,3,1,1,3,2,3,2,3,2,2,1,3,3,10,13,12,5,11,6,1,5,6,3,2,7,5,10,6,8,6,1,11,4,7,1,13,4,5,7,13,9,6,9,5,13,9,20,12,10,8,5,1,8,7,11,12,10,12,12,4,14,1,S ,1,1,20,1,1,1,1,1,1,1,1,1,1,1,1
83185573,Kevin,1651,31/05/1997,19,0,0,0,0,194,82,2,1,3,3,1,1,3,4,1,1,3,1,2,5,1,6,2,13,5,1,8,6,1,13,5,8,11,8,6,6,5,12,8,8,4,3,13,4,6,6,11,6,11,5,10,11,20,3,10,7,5,2,4,8,8,12,11,10,11,1,12,7,D C,1,1,1,1,1,1,20,1,1,1,1,1,1,1,1
83185577,Jadson da Silva,1651,16/06/1998,18,0,0,0,0,184,81,3,2,2,4,3,3,3,3,2,3,2,8,9,12,10,11,7,11,8,5,5,11,12,5,13,13,10,12,10,10,10,8,7,12,7,11,5,10,11,12,11,13,12,5,12,12,20,10,12,9,8,7,6,8,12,11,11,11,11,10,8,3,S ,1,1,20,1,1,1,1,1,1,1,1,1,1,1,1
83185579,João Lima,1651,25/02/1998,18,0,0,0,0,182,77,1,2,1,3,2,1,1,2,3,2,1,5,5,10,13,10,6,13,7,1,5,7,7,3,13,9,11,8,12,5,7,10,3,13,9,11,6,6,7,13,12,7,9,5,6,13,20,8,9,9,9,9,9,9,16,12,13,12,11,1,12,5,S ,1,1,20,1,1,1,1,1,1,1,1,1,1,1,1
83188457,Cauê,1651,24/10/1993,22,0,0,0,0,172,68,2,2,2,3,3,3,3,3,1,1,3,8,11,10,7,8,9,7,6,7,9,10,7,10,10,12,10,11,11,10,7,10,13,7,6,11,12,12,12,13,12,11,7,20,14,12,6,11,9,11,12,10,5,8,12,14,7,10,15,16,15,8,D L,1,1,1,1,1,1,1,20,1,1,1,1,1,1,1
83190675,Wendell,1651,10/11/1995,20,0,0,0,0,195,92,3,3,2,1,2,1,1,2,2,1,1,2,1,1,1,1,1,9,1,1,7,3,2,9,2,7,6,6,3,6,1,11,3,1,2,1,11,2,3,11,10,3,10,7,13,11,20,5,8,7,4,2,7,7,8,12,11,7,15,3,8,3,D C,1,1,1,1,1,1,20,1,1,1,1,1,1,1,1
83190761,Luiz Felipe,1651,20/12/1997,18,0,0,0,0,188,77,3,2,3,1,3,3,2,3,1,2,4,4,5,1,1,6,1,13,5,1,13,5,1,13,5,8,11,6,5,4,3,13,6,8,9,3,13,5,7,13,11,6,7,5,15,9,20,6,7,8,5,2,6,8,20,10,13,9,9,5,10,2,D C,1,1,1,1,1,1,20,1,1,15,1,1,1,1,1
83190981,Wallacy,1651,12/03/1998,18,0,0,0,0,186,79,3,2,1,2,1,3,1,2,4,2,1,5,5,13,13,12,5,13,6,2,2,6,4,1,13,8,6,7,10,3,6,10,8,13,10,13,1,5,6,11,10,6,7,20,8,13,5,6,9,4,6,5,8,7,9,10,9,13,10,6,15,1,S ,1,1,20,1,1,1,1,1,1,1,1,1,1,1,1
83191022,Rafael Murliki,1651,28/04/1998,18,0,0,0,0,172,66,3,3,3,1,2,2,2,1,1,3,3,3,4,6,1,8,1,7,5,6,7,7,1,13,6,8,7,8,7,4,2,14,8,7,9,3,7,7,7,12,8,7,7,7,7,11,20,8,5,8,7,8,8,8,10,9,12,11,10,8,12,2,D R,1,1,1,1,1,1,1,1,20,1,1,1,1,1,13
832415,Claiton,1651,07/09/1984,31,0,0,0,0,186,78,1,3,1,2,3,2,3,1,1,2,2,7,9,8,6,9,5,18,9,6,15,10,5,13,12,12,13,10,7,13,11,13,15,5,15,12,13,12,12,11,11,12,12,20,9,11,8,11,13,11,10,12,6,9,16,15,13,11,14,11,9,10,D C,1,1,1,1,1,1,20,10,10,1,1,1,1,1,1
832590,Fabiano,1651,18/01/1982,34,0,0,0,0,192,79,1,1,1,1,1,1,1,1,1,1,1,5,5,6,7,10,12,15,11,12,13,11,8,13,10,12,12,12,11,12,10,12,12,6,14,9,11,12,12,7,8,11,15,9,10,8,20,12,12,11,14,8,8,10,15,10,10,13,15,13,15,8,D C,1,1,5,5,1,1,20,10,10,10,10,1,1,1,1
836555,Neto Pereira,1651,04/01/1979,37,0,0,0,0,180,77,2,1,1,3,3,2,3,1,2,2,1,7,10,13,12,13,7,13,8,3,4,13,13,7,14,9,11,11,12,12,15,13,14,18,18,13,11,13,13,10,10,11,11,12,9,9,20,10,9,16,7,15,13,9,13,13,18,14,15,13,18,3,S ,1,1,20,14,1,1,1,1,1,1,1,1,1,1,1
836929,Joelson,1651,10/07/1983,32,0,0,0,0,180,70,1,1,1,4,1,2,2,3,3,1,2,7,9,11,5,7,5,12,6,4,4,13,12,5,13,10,10,8,6,9,12,9,15,13,6,12,10,11,10,10,11,7,11,6,11,13,20,13,8,10,9,8,13,13,15,13,11,14,12,10,7,5,AM RLC,1,1,1,20,15,17,1,1,1,1,1,1,1,1,1
836962,Ronaldo Vanin,1651,31/01/1983,33,0,0,0,0,180,72,1,4,3,2,1,2,1,2,2,3,2,6,10,12,2,9,10,3,3,2,9,10,3,9,12,11,9,8,7,9,10,9,9,11,4,11,11,11,9,13,11,7,8,7,11,14,20,12,7,13,5,8,7,11,16,12,13,11,13,18,16,5,D/WB/M R,1,1,1,1,1,14,1,1,20,1,1,1,18,1,20
837211,Felipe,1651,31/07/1984,31,0,0,0,0,188,75,1,2,2,2,1,3,1,2,2,2,1,10,11,11,7,10,10,15,6,14,13,10,9,13,10,14,13,14,13,13,11,13,12,6,12,9,14,13,15,10,13,14,14,20,7,11,9,13,12,12,15,12,16,11,9,12,12,7,11,10,10,11,D C,1,12,1,1,1,1,20,7,1,1,1,1,1,1,1
837915,Reginaldo,1651,31/07/1983,32,0,0,0,0,175,72,2,2,2,1,3,1,3,2,3,2,1,9,11,12,8,10,10,8,9,8,3,11,10,9,10,12,11,10,9,5,13,9,11,13,10,11,9,10,10,12,10,11,10,8,12,12,20,13,11,14,8,15,5,11,13,8,10,12,6,8,7,15,AM RLC,1,1,1,15,15,20,1,1,1,1,10,1,15,1,1
8406013,Wagner,1651,01/01/1978,38,0,0,0,0,178,73,3,1,1,3,3,3,1,2,1,3,2,13,8,13,14,13,14,12,13,6,10,12,7,11,12,12,10,8,12,12,13,12,12,12,11,10,13,9,13,8,10,12,9,19,11,8,20,11,10,12,10,12,9,9,13,14,12,13,12,13,11,10,AM C,1,1,15,20,12,12,1,1,1,1,15,1,1,1,1
84101436,Rapha,1651,07/08/1995,20,0,0,0,0,183,0,3,1,2,3,2,1,2,4,3,2,3,1,2,12,12,6,1,12,4,1,2,4,6,1,8,7,6,4,5,2,1,6,5,9,11,12,2,3,4,12,12,4,7,6,7,12,20,3,5,7,7,7,7,6,20,12,10,12,8,13,6,8,S ,1,1,20,1,1,1,1,1,1,1,1,1,1,1,1
84101555,Igor Bissoloti,1651,22/02/1996,20,0,0,0,0,182,80,13,10,7,1,13,11,7,13,7,7,7,4,1,3,2,1,7,1,3,2,2,1,3,1,2,7,3,12,5,7,4,11,4,1,1,3,8,5,3,6,5,5,5,7,9,3,20,1,7,6,7,5,7,7,14,13,10,11,13,1,10,6,GK ,20,1,1,1,1,1,1,1,1,1,1,1,1,1,1
84102120,José Victor,1651,05/08/1993,22,0,0,0,0,179,73,1,2,1,1,3,3,2,1,2,1,2,5,1,4,5,12,5,5,9,5,12,6,4,10,7,8,3,7,3,6,8,12,5,2,1,8,3,5,10,13,13,5,4,7,8,13,20,5,7,8,8,8,7,8,15,12,9,10,10,3,8,6,M C,1,1,1,1,1,1,1,1,1,1,20,1,1,1,1
84102343,William Ferreira,1651,04/03/1996,20,0,0,0,0,179,0,1,3,3,3,3,3,2,1,2,2,2,4,2,11,14,9,5,14,5,4,3,3,7,1,12,6,6,6,8,4,6,8,7,11,1,9,5,5,6,12,7,6,9,1,7,11,20,4,6,7,7,7,7,7,18,12,11,9,14,7,1,6,S ,1,1,20,1,1,1,1,1,1,1,1,1,1,1,1
84102483,Yuri,1651,13/04/1996,20,0,0,0,0,168,68,2,3,3,2,3,3,3,3,1,3,2,10,12,11,11,8,8,6,12,6,8,9,8,9,12,8,10,12,11,9,11,9,5,8,6,10,10,10,9,11,12,11,6,20,10,13,10,10,8,14,8,8,8,10,12,10,12,12,10,12,17,1,AM L,1,1,1,1,20,13,1,8,1,1,1,1,1,1,1
84104129,Muller,1651,15/11/1990,25,0,0,0,0,188,82,4,2,3,3,2,1,3,2,2,2,3,1,3,1,1,7,3,13,5,1,13,7,1,13,6,9,10,9,7,9,1,12,9,1,14,6,10,6,7,13,10,7,13,10,10,11,20,11,10,6,9,8,5,9,16,9,10,9,13,4,6,8,D C,1,1,1,1,1,1,20,1,10,1,1,1,1,1,1
84104131,Ítalo,1651,26/06/1987,29,0,0,0,0,167,64,1,3,1,1,1,3,3,1,3,2,3,8,12,11,14,10,6,10,8,4,4,9,7,5,9,12,9,10,8,8,10,11,5,10,6,8,8,7,11,10,8,8,6,13,9,11,20,7,7,7,6,7,4,9,19,10,10,11,11,6,16,1,AM/S R,1,1,20,1,13,17,1,1,1,1,1,7,10,1,1
84104699,Jota Júnior,1651,11/04/1990,26,0,0,0,0,189,0,3,3,3,2,2,1,1,2,2,3,3,1,1,1,2,5,2,10,1,3,6,5,1,12,3,7,5,3,4,8,1,12,2,7,13,3,8,3,6,12,10,4,6,7,14,9,20,10,8,7,7,7,7,7,13,13,12,9,11,6,14,1,D C,1,1,1,1,1,1,20,1,1,13,1,1,1,1,1
84104700,Paulão,1651,21/04/1994,22,0,0,0,0,194,0,3,2,2,1,3,1,3,3,1,3,2,1,1,1,1,3,2,12,1,1,6,4,1,11,1,7,8,6,3,7,3,11,4,7,8,3,8,3,4,11,7,4,14,15,8,8,20,7,8,7,5,3,7,7,12,10,10,13,9,6,11,8,D C,1,1,1,1,1,1,20,1,1,1,1,1,1,1,1
84104837,Bruno Bryan,1651,22/07/1994,21,0,0,0,0,183,75,2,2,1,3,2,1,2,3,3,2,1,5,7,9,12,9,5,8,8,4,3,8,9,3,10,9,11,7,8,10,11,11,8,14,4,12,7,8,9,11,11,10,8,5,15,12,20,10,9,14,6,10,7,13,17,11,10,10,11,1,7,2,AM/S L,1,1,20,1,17,13,1,1,1,1,1,1,1,1,1
84104993,Darlan,1651,17/05/1994,22,0,0,0,0,165,64,3,3,2,1,1,4,3,1,1,3,3,5,3,13,13,9,5,13,4,1,5,5,6,1,6,8,10,5,4,6,4,7,8,8,10,13,4,5,6,13,13,5,1,7,13,13,20,7,6,8,8,8,8,8,12,10,10,9,12,1,17,6,S ,1,1,20,1,1,1,1,1,1,1,1,1,1,1,1
84105445,Roberto,1651,24/04/1992,24,0,0,0,0,184,0,3,1,2,2,1,3,1,1,3,1,3,2,4,3,4,11,4,1,10,1,6,7,4,11,9,7,6,6,5,5,7,10,4,7,6,7,6,6,11,13,13,4,10,1,10,13,20,11,7,7,6,7,7,7,19,11,12,13,11,4,12,8,M C,1,1,1,1,1,1,1,1,1,1,20,1,1,1,1
84109364,Luquinhas,1651,28/09/1996,19,0,0,0,0,169,60,1,3,2,1,3,3,1,2,1,1,3,8,9,14,8,10,7,6,6,4,5,9,5,5,14,14,6,10,8,7,12,11,9,17,4,12,8,12,12,14,14,12,6,5,12,14,20,9,6,10,2,13,4,13,12,11,11,12,13,8,9,6,AM RL,1,1,13,1,19,20,1,1,1,1,1,13,13,1,1
84111289,Yan,1651,06/02/1992,24,0,0,0,0,182,0,2,3,3,3,2,3,2,3,2,3,3,2,3,1,2,6,4,4,5,1,9,10,1,12,6,8,9,7,5,4,6,12,6,8,12,4,8,6,10,12,12,5,8,9,8,12,20,11,5,8,6,3,6,8,15,12,11,12,11,8,15,8,DM C,1,1,1,1,1,1,15,1,1,20,1,1,1,1,1
84111314,Vítor Hugo,1651,18/01/1996,20,0,0,0,0,172,60,4,3,1,1,1,2,3,1,2,1,3,2,3,1,2,11,4,4,4,1,4,13,1,10,8,7,7,6,6,6,9,12,4,7,2,4,3,6,11,9,7,5,3,7,11,10,20,6,3,7,7,6,5,7,14,13,11,10,10,1,11,6,DM/M C,1,1,1,1,1,1,1,1,1,20,20,1,1,1,1
84111766,Jackson Souza,1651,19/12/1994,21,0,0,0,0,178,74,2,4,3,3,4,1,2,2,1,3,2,5,6,10,13,12,5,9,6,1,5,6,8,2,13,7,5,4,10,5,5,11,8,13,11,9,5,5,7,13,13,6,8,9,7,13,20,8,7,8,8,6,5,8,15,12,12,11,11,6,18,5,AM/S R,1,1,20,1,13,17,1,1,1,1,1,7,7,1,1
84112274,Wellington Medrado,1651,26/10/1990,25,0,0,0,0,180,74,2,1,3,2,1,2,1,2,3,2,3,6,7,12,14,14,6,10,8,1,6,8,6,3,10,8,9,5,9,7,5,8,3,9,10,9,8,6,8,12,9,7,7,9,9,10,20,9,7,8,4,7,4,8,17,11,9,11,13,1,15,7,AM/S C,1,1,20,17,1,1,1,1,1,1,1,1,1,1,1
84120939,Jonathan,1651,01/10/1991,24,0,0,0,0,185,77,2,1,3,4,3,1,3,3,3,3,2,2,1,10,11,10,2,11,1,1,1,2,5,1,7,7,4,2,5,3,3,5,6,9,4,9,3,2,3,11,11,3,10,20,11,11,10,5,5,7,7,2,6,7,7,10,12,13,10,9,19,4,S ,1,1,20,1,1,1,1,1,1,1,1,1,1,1,1
84122086,Fernando,1651,08/04/1994,22,0,0,0,0,183,85,7,4,7,5,13,8,7,9,8,8,10,2,2,2,2,1,5,1,3,1,1,2,3,1,2,8,7,14,5,8,5,13,5,2,12,1,8,6,5,11,11,6,7,9,8,9,20,3,8,8,6,4,8,8,14,11,11,14,11,1,14,5,GK ,20,1,1,1,1,1,1,1,1,1,1,1,1,1,1
84122774,Dhida,1651,02/01/1992,24,0,0,0,0,175,70,1,3,3,1,3,1,1,3,1,3,3,9,9,12,10,8,9,3,9,3,2,9,9,2,10,7,8,7,9,8,10,10,5,12,7,10,5,7,7,11,12,10,11,20,13,12,5,10,8,7,4,10,4,9,17,10,10,10,11,1,6,1,AM RL,1,1,10,13,20,17,1,1,1,1,1,13,1,1,1
84123522,Matheus Rodrigues,1651,01/10/1995,20,0,0,0,0,177,67,2,1,3,3,2,2,3,2,3,1,4,4,5,2,4,10,1,7,5,2,10,7,1,12,6,4,5,9,7,9,5,13,9,9,1,4,9,5,8,13,11,7,6,9,12,13,20,12,6,9,8,9,6,9,11,13,10,10,10,13,20,5,D R,1,1,1,1,1,1,1,1,20,1,1,1,1,1,10
84125056,Cléber,1651,15/12/1993,22,0,0,0,0,176,0,2,2,1,1,1,1,2,3,1,4,2,2,2,12,12,11,1,12,2,1,3,3,2,1,6,4,4,5,9,3,4,7,7,7,8,9,3,3,4,12,12,4,2,1,12,12,20,3,5,7,7,7,7,7,7,11,11,11,9,1,18,4,S ,1,1,20,1,1,1,1,1,1,1,1,1,1,1,1
84125460,Anderson Dim,1651,15/02/1996,20,0,0,0,0,177,72,2,2,2,3,3,3,4,2,2,1,1,9,13,13,10,13,6,2,7,4,5,7,6,5,13,8,8,8,7,5,5,8,1,13,3,8,3,7,8,13,13,7,5,10,10,13,20,4,5,9,9,8,9,8,14,11,12,12,11,3,7,8,AM RL,1,1,15,1,20,20,1,1,1,1,7,1,1,1,1
84125461,Vítor Carvalho,1651,17/02/1993,23,0,0,0,0,192,90,3,3,3,2,2,3,3,2,3,3,1,6,7,6,5,9,8,11,7,6,12,8,9,11,8,13,10,12,9,11,5,10,9,5,10,8,11,11,11,8,8,5,16,20,14,9,5,11,14,12,9,3,9,6,7,9,10,9,11,8,10,3,D C,1,1,1,1,1,1,20,1,1,1,1,1,1,1,1
84125465,Wellington,1651,01/03/1995,21,0,0,0,0,190,85,2,4,1,1,1,1,1,2,1,2,1,2,6,2,1,7,1,13,5,4,13,8,4,13,6,10,11,10,8,9,7,13,10,1,13,7,13,7,7,7,11,8,13,5,16,9,20,11,11,10,10,7,10,10,16,13,12,12,12,4,7,1,D C,1,1,1,1,1,1,20,1,1,1,1,1,1,1,1
84125466,Rodrigo Soares,1651,26/12/1992,23,0,0,0,0,176,71,2,1,1,2,3,3,2,4,1,2,3,6,10,10,6,10,8,7,7,11,11,11,7,13,13,8,11,9,9,14,8,10,15,8,7,13,9,11,11,15,13,11,8,5,12,15,20,13,9,14,4,9,10,6,8,11,8,10,14,12,13,5,D/WB RL,1,1,1,1,1,1,1,16,20,1,1,1,1,10,18
84125468,Kalindi,1651,29/08/1993,22,0,0,0,0,170,67,1,4,2,2,1,4,3,2,2,2,2,6,8,7,9,7,6,8,6,7,13,7,6,10,9,8,14,9,8,9,7,10,5,13,8,12,14,12,15,15,14,11,7,5,15,16,20,12,10,11,10,9,10,16,14,12,10,9,16,4,6,7,D/AM R,1,1,13,1,1,20,1,1,19,1,1,1,5,1,10
84125470,William Gustavo,1651,09/01/1992,24,0,0,0,0,193,79,1,2,3,1,1,3,2,1,2,1,3,6,6,8,6,10,5,13,5,10,10,10,5,12,11,16,10,14,9,8,8,8,5,5,6,7,11,12,12,9,10,14,13,20,13,10,5,12,14,10,14,8,8,6,3,9,19,5,5,7,14,15,D C,1,1,1,1,1,1,20,1,1,8,1,1,1,1,1
84125475,Jadson,1651,05/11/1991,24,0,0,0,0,186,80,2,2,3,3,1,1,2,1,2,3,2,7,6,9,7,11,9,16,9,9,14,12,6,15,13,13,14,12,12,12,8,13,5,5,10,8,13,12,13,13,14,14,12,5,13,12,20,11,11,12,3,11,4,5,13,12,13,11,14,3,19,7,D C,1,1,1,1,1,1,20,1,1,1,1,1,1,1,1
84125479,Lucas Silva,1651,28/04/1994,22,0,0,0,0,174,69,2,2,4,1,2,1,3,2,4,1,4,5,8,13,13,13,6,8,6,4,6,7,5,6,13,7,8,8,4,7,7,13,3,13,11,8,5,7,7,13,13,7,5,10,10,13,20,11,6,9,9,9,9,9,18,12,8,10,13,8,8,4,AM R,1,1,15,1,1,20,1,1,1,1,1,1,1,1,1
84125489,Enrick Santos,1651,20/03/1996,20,0,0,0,0,172,56,3,2,1,3,3,2,3,3,1,3,3,8,10,10,4,14,7,3,9,7,5,10,1,8,14,9,6,7,7,8,9,13,9,13,3,9,7,8,8,13,12,8,4,20,13,12,5,7,5,9,7,1,7,8,20,11,10,10,10,1,7,2,AM LC,1,1,1,20,20,1,1,1,1,1,1,1,1,1,1
84126680,Igor Cartaxo,1651,22/03/1991,25,0,0,0,0,187,72,3,4,2,3,3,2,1,2,1,3,1,3,5,2,2,7,5,13,6,5,10,7,2,13,6,8,12,8,7,8,4,7,8,8,2,5,13,5,8,8,9,7,12,9,6,11,20,12,11,8,8,8,6,8,15,12,12,12,12,3,11,3,D/DM C,1,1,1,1,1,1,20,1,1,17,1,1,1,1,1
8427775,Júnior Miranda,1651,21/05/1982,34,0,0,0,0,183,74,2,2,2,2,1,3,2,1,1,2,3,6,9,11,9,12,13,7,13,5,3,10,11,3,14,8,8,8,11,8,11,9,12,11,8,11,5,8,10,12,13,13,10,20,10,11,7,12,11,13,8,12,8,8,12,12,16,11,11,14,14,6,M/AM LC,5,1,12,20,16,10,1,1,1,1,18,16,10,1,1
8438645,Thiago Ribeiro,1651,24/02/1986,30,0,0,0,0,184,72,3,1,3,3,1,2,2,2,1,2,2,12,12,14,12,12,11,12,13,5,8,13,13,9,14,8,11,10,9,9,13,8,14,13,7,15,6,14,10,13,14,13,11,9,13,13,20,13,12,12,8,12,5,14,5,6,12,13,14,14,15,8,AM/S RL,1,1,20,1,18,15,1,1,1,1,1,1,1,1,1
8476307,Juninho Cearense,1651,17/12/1980,35,0,0,0,0,173,67,4,2,3,1,2,2,3,1,1,2,1,10,10,12,12,12,11,8,10,3,4,12,14,4,12,8,8,8,12,11,13,11,9,12,7,12,9,10,11,10,12,13,7,20,9,10,9,8,6,12,6,14,10,12,12,13,6,12,15,15,14,10,AM LC,1,1,5,20,17,14,1,1,1,1,15,10,7,1,1
8490776,Robson,1651,30/08/1988,27,0,0,0,0,172,68,3,2,1,2,1,3,1,1,1,3,3,6,5,8,8,12,6,6,8,1,7,13,5,6,12,9,10,7,7,7,13,13,9,12,1,8,8,7,8,13,13,8,6,8,8,13,20,7,5,9,9,8,9,9,13,10,12,12,10,3,2,1,M/AM C,1,1,11,20,7,9,1,1,1,1,16,1,1,1,1
85013938,Marcos Paulo,1651,13/07/1988,27,0,0,0,0,182,79,2,2,3,1,2,2,1,2,3,3,3,8,7,11,7,13,12,10,13,6,11,12,7,12,12,10,13,14,11,11,12,10,13,8,14,9,10,13,14,12,12,14,11,12,16,12,20,14,13,12,10,13,6,8,13,12,10,12,16,10,11,6,DM/M/AM C,1,1,1,17,1,1,1,1,1,16,20,1,1,1,1
85041743,Índio,1651,30/10/1983,32,0,0,0,0,183,81,1,3,2,1,3,2,1,3,2,3,2,2,1,1,3,6,3,13,6,5,13,7,1,10,4,9,6,9,5,10,6,13,8,7,5,3,12,6,7,8,8,7,11,8,14,8,20,12,6,9,1,9,9,9,20,9,11,12,10,10,14,3,D C,1,1,1,1,1,1,20,1,1,1,1,1,1,1,1
8506134,Rafinha,1651,29/06/1982,34,0,0,0,0,184,80,3,3,2,1,2,3,3,3,2,1,2,8,7,12,10,10,10,9,9,6,9,13,9,12,13,14,14,12,10,7,11,11,13,9,7,13,8,12,10,12,14,11,11,12,12,12,20,11,11,17,13,12,10,15,14,12,11,12,18,6,14,15,D/WB RLC,4,1,8,9,11,12,16,18,20,1,4,10,15,14,19
85072871,Márcio Piccolo,1651,08/06/1987,29,0,0,0,0,188,77,3,1,3,4,1,2,3,3,1,2,1,6,8,9,7,10,7,14,8,10,12,11,8,8,11,12,9,13,10,10,9,11,13,8,12,10,11,13,12,11,9,12,14,7,14,10,20,12,13,12,11,11,7,12,14,11,12,11,13,13,14,7,D/DM C,1,1,1,1,1,1,20,1,10,16,7,1,1,1,1
85075607,Gabriel,1651,28/07/1986,29,0,0,0,0,190,0,1,1,3,1,1,3,3,2,2,3,2,5,5,8,10,10,6,16,8,5,4,7,12,2,10,9,10,13,9,9,6,7,9,8,6,11,5,11,11,10,7,15,15,5,6,8,20,12,15,12,7,9,9,5,7,11,9,11,11,8,5,1,S ,1,1,20,1,1,1,1,1,1,1,1,1,1,1,1
851289,Marquinho,1651,20/02/1982,34,0,0,0,0,172,64,1,2,1,2,2,2,2,2,4,2,1,12,13,13,11,13,10,8,9,8,5,14,13,4,13,5,11,5,12,12,14,9,14,15,6,12,6,11,10,12,14,8,8,20,11,13,1,14,12,11,4,10,6,11,7,13,20,8,12,1,6,4,AM/S LC,1,1,16,20,15,1,1,1,1,1,12,12,1,1,1
8550683,Fábio,1651,30/09/1977,38,0,0,0,0,198,100,15,9,11,1,11,13,8,11,10,8,7,12,2,3,1,1,15,13,3,1,2,1,16,2,2,9,8,12,5,9,6,8,3,13,14,3,11,7,6,6,6,7,10,8,15,8,20,6,17,13,6,8,9,9,14,12,11,11,11,2,2,5,GK ,20,1,6,1,1,1,1,1,1,1,1,1,1,1,1
856161,Michel Bastos,1651,02/08/1983,32,10,1,0,0,179,73,4,1,1,1,1,3,3,2,1,1,3,13,15,14,13,14,15,8,15,11,7,14,14,10,14,8,12,9,13,10,14,8,8,14,7,14,8,8,9,14,13,12,9,20,13,14,6,13,12,11,10,12,8,15,10,7,7,13,10,9,9,9,DM/M/AM LC,1,1,1,18,20,14,1,15,1,16,19,16,14,15,1
86011478,Flávio de Oliveira,1651,09/06/1983,33,0,0,0,0,178,78,3,1,1,1,4,3,3,2,3,2,1,7,8,12,12,14,7,14,8,1,5,7,8,2,14,9,11,6,9,8,8,10,1,13,7,11,7,7,9,13,6,11,9,5,9,11,20,13,11,9,9,9,9,9,8,10,11,9,11,9,10,7,S ,1,1,20,1,1,1,1,1,1,1,1,1,1,1,1
86011908,Luis Carlos,1651,30/04/1984,32,0,0,0,0,186,0,3,1,2,3,2,1,1,2,4,2,2,6,7,4,8,9,7,15,1,3,15,10,1,15,8,10,10,10,10,12,7,15,10,2,8,8,15,9,10,11,7,10,12,1,13,10,20,7,12,10,4,10,5,10,14,13,11,13,11,6,1,8,D C,1,1,1,1,1,1,20,1,1,1,1,1,1,1,1
86016258,Wágner Coradin,1651,03/10/1989,26,0,0,0,0,196,0,13,11,11,6,13,12,11,13,10,9,12,3,3,1,2,5,7,1,2,1,1,1,3,1,4,10,10,10,8,7,7,11,2,2,7,1,11,8,7,11,9,8,13,9,10,12,20,4,11,10,8,8,9,10,15,11,10,9,10,9,12,5,GK ,20,1,1,1,1,1,1,1,1,1,1,1,1,1,1
86016827,Jeferson,1651,31/08/1988,27,0,0,0,0,190,0,2,2,3,3,2,3,2,1,3,1,4,1,3,1,3,5,1,11,7,1,12,5,1,13,2,10,12,10,8,9,5,13,5,1,8,7,13,7,8,13,11,8,14,12,17,13,20,13,11,10,10,2,9,10,8,12,9,11,9,7,14,1,D C,1,1,1,1,1,1,20,1,1,1,1,1,1,1,1
86032081,Fred Neves,1651,12/04/1988,28,0,0,0,0,184,76,2,2,1,1,2,2,2,3,2,2,1,5,2,11,13,8,4,13,5,1,6,4,6,4,12,7,11,5,9,6,2,12,9,12,8,9,7,6,7,13,10,7,11,10,9,12,20,7,7,9,5,8,5,9,13,12,11,9,10,7,11,2,S ,1,1,20,1,1,1,1,1,1,1,1,1,1,1,1
86036730,Leandro Ferreira,1651,15/07/1986,29,0,0,0,0,180,70,1,2,3,2,1,2,1,1,4,3,1,7,6,7,9,13,7,7,11,3,5,13,7,8,13,10,10,9,9,8,13,13,10,13,11,10,9,8,12,13,13,8,6,9,15,13,20,13,6,10,10,10,6,10,14,12,11,13,11,9,11,2,M/AM C,1,1,1,20,1,1,1,1,1,1,20,1,1,1,1
86042083,Rogério Leilão,1651,03/03/1980,36,0,0,0,0,176,0,3,3,4,1,2,2,1,4,2,3,4,7,3,9,13,13,7,13,6,1,7,7,9,3,13,8,8,9,12,8,4,12,1,13,13,13,7,7,8,13,7,8,8,10,11,10,20,13,8,10,6,9,6,10,13,11,11,12,10,3,8,5,S ,1,1,20,1,1,1,1,1,1,1,1,1,1,1,1
8668,Jean Macapá,1651,16/10/1977,38,0,0,0,0,180,76,1,3,2,2,4,2,1,4,1,2,3,3,5,4,11,5,4,11,3,4,4,3,1,2,10,9,11,14,7,5,5,9,14,12,12,13,3,3,6,13,15,14,13,10,15,13,20,13,14,9,8,9,8,9,16,10,11,14,10,11,1,6,S ,1,1,20,1,1,1,1,1,1,1,1,1,1,1,1
87000446,Fábio,1651,10/09/1980,35,0,0,0,0,183,79,1,2,1,2,1,1,4,1,1,1,3,7,7,10,11,12,11,13,5,2,12,12,9,13,12,11,12,12,13,12,10,11,9,9,13,11,9,12,12,11,11,13,12,20,13,13,14,12,12,15,6,11,6,11,12,6,8,12,13,8,14,5,D C,1,1,1,1,1,1,20,1,1,1,1,1,1,1,1
87000915,Israel Silva,1651,24/06/1981,35,0,0,0,0,172,71,1,3,4,2,3,3,3,2,1,3,4,9,11,12,13,12,9,11,10,6,9,12,13,8,12,12,12,6,11,11,12,11,12,12,9,13,10,11,8,12,12,11,7,20,13,12,8,10,11,12,3,8,6,7,14,11,11,8,12,12,13,6,S ,1,1,20,1,1,1,1,1,1,1,1,1,1,1,1
87001737,Franki Gonçalves,1651,29/10/1979,36,0,0,0,0,179,71,1,1,3,3,1,1,1,1,1,3,2,6,6,14,11,11,7,13,8,1,6,7,12,6,14,7,11,4,14,7,7,10,3,13,6,13,6,7,7,14,11,6,8,8,8,13,20,10,7,9,4,8,9,9,10,6,6,9,6,7,11,5,S ,1,1,20,1,1,1,1,1,1,1,1,1,1,1,1
87003883,Moacyr Filho,1651,24/10/1981,34,0,0,0,0,173,0,2,2,2,3,1,2,1,3,2,3,3,8,10,7,9,11,8,13,6,6,8,9,4,8,14,10,8,1,11,3,7,12,9,13,13,12,8,9,10,14,14,9,6,20,10,13,10,14,6,10,2,10,10,10,11,10,10,10,10,10,8,2,AM/S LC,1,1,20,15,18,1,1,1,1,1,1,1,1,1,1
87015351,Tomaz,1651,18/08/1985,30,0,0,0,0,176,72,3,2,1,3,3,3,2,2,2,3,3,8,9,12,9,12,7,11,6,10,11,11,6,10,12,13,9,10,9,9,10,9,12,12,9,12,9,11,12,12,12,10,8,20,15,13,15,12,9,13,6,11,5,10,12,8,10,10,13,4,13,6,M/AM RLC,1,1,15,18,18,17,1,1,1,1,20,17,16,1,1
87017052,Glauber,1651,01/10/1981,34,0,0,0,0,185,76,2,1,1,1,2,3,3,4,2,1,1,7,11,10,7,12,8,11,7,5,11,12,7,11,11,13,9,13,11,11,10,9,5,7,6,8,10,9,12,12,11,11,11,11,13,13,20,12,11,13,7,10,10,10,18,11,11,8,13,1,6,2,D RC,1,17,1,1,1,1,20,1,17,1,1,1,1,1,1
87030630,Marcelo Souza,1651,26/05/1990,26,0,0,0,0,175,69,2,3,2,1,1,3,3,3,2,1,3,6,9,11,8,9,6,9,5,9,10,11,6,10,11,12,10,11,10,11,10,9,11,11,8,11,10,10,14,13,13,8,3,20,14,13,12,13,8,12,6,11,4,10,15,9,11,11,10,12,4,5,WB/M L,1,1,15,1,15,1,1,13,1,1,1,17,1,20,1
87031626,Leo,1651,03/09/1988,27,0,0,0,0,173,0,3,4,1,1,3,3,2,1,3,2,2,9,5,11,11,12,9,12,10,6,9,8,6,3,13,4,10,7,10,10,8,8,10,11,8,11,10,9,11,13,12,9,8,10,13,13,20,11,9,10,10,10,4,10,13,13,12,11,11,7,11,3,S ,1,1,20,1,1,1,1,1,1,1,1,1,1,1,1
87035039,Ricardo Ferreira da Silva,1651,31/12/1986,29,0,0,0,0,176,69,3,2,3,2,2,1,3,4,2,3,3,8,8,11,10,12,6,10,7,9,4,10,12,8,12,11,10,9,10,10,7,9,1,11,11,10,5,5,10,12,11,10,7,13,13,11,20,12,10,12,6,10,5,10,12,10,6,13,12,12,16,2,AM/S RL,1,1,18,1,17,20,1,1,1,1,1,1,1,1,1
87035480,Josimar,1651,07/07/1988,27,0,0,0,0,195,82,2,2,3,2,1,2,2,1,1,1,3,5,7,13,11,14,5,12,9,1,8,9,7,6,12,10,10,13,11,9,9,14,3,11,4,11,9,8,9,12,8,13,16,10,12,8,20,8,14,10,10,10,9,10,7,9,11,10,12,1,5,5,S ,1,1,20,1,1,1,1,1,1,1,1,1,1,1,1
8708149,André Astorga,1651,07/01/1980,36,0,0,0,0,190,82,3,2,2,2,2,3,4,2,2,2,3,1,3,5,7,9,14,12,14,8,12,10,7,14,8,13,10,12,11,11,7,10,4,4,16,3,8,11,12,9,8,13,15,7,14,9,20,12,14,14,12,11,9,10,17,10,9,12,11,11,10,3,D C,1,1,1,1,1,1,20,1,1,1,1,1,1,1,1
8718008,Thiago Rockenbach,1651,01/02/1985,31,0,0,0,0,179,82,3,2,4,2,1,2,2,2,3,3,2,12,13,14,10,14,11,7,11,7,5,14,12,7,14,8,10,7,11,9,15,12,8,15,8,12,6,12,8,9,9,12,7,15,12,8,20,9,9,11,6,12,8,9,17,9,9,9,11,12,8,11,M/AM LC,1,1,1,20,17,14,1,1,1,1,13,17,14,1,1
8825036,Roncatto,1651,24/05/1986,30,0,0,1,0,190,80,2,3,2,1,1,2,1,1,2,3,3,6,9,11,7,11,9,8,12,4,10,11,13,11,11,12,8,10,7,12,12,11,12,13,7,13,12,13,10,13,12,8,12,10,11,12,20,13,10,10,11,10,14,10,12,13,6,7,6,12,11,7,AM/S RC,1,1,16,17,14,20,1,1,1,1,10,12,14,1,1
8825041,Júlio César,1651,15/06/1982,34,0,0,0,0,173,69,2,3,2,2,3,2,3,1,3,2,3,10,13,13,10,14,12,8,13,14,11,14,14,11,14,12,11,11,13,13,13,13,13,15,8,14,11,13,13,13,14,10,10,20,13,13,8,13,10,13,8,14,7,12,11,11,10,13,14,9,14,12,D/WB/M L,1,1,1,1,1,1,1,20,1,1,1,17,1,17,1
8825043,Renatinho Potiguar,1651,19/11/1982,33,0,0,0,0,164,63,1,3,2,1,3,2,2,2,1,2,3,10,10,11,9,11,11,5,10,10,8,11,11,8,11,11,11,12,11,10,10,11,3,12,5,12,8,10,12,11,13,16,3,20,13,11,7,11,5,9,9,9,9,14,17,12,9,11,11,1,10,2,D/WB L,1,1,9,9,11,10,1,18,1,1,10,12,9,20,1
8825061,Fernandinho,1651,04/05/1985,31,29,2,0,0,176,66,1,1,1,1,1,1,1,1,1,1,1,10,10,12,11,15,11,9,13,6,14,14,15,14,16,14,14,14,15,15,12,14,16,10,13,12,13,16,17,14,15,14,12,12,15,13,20,16,13,16,12,14,8,14,19,13,20,15,18,20,17,5,DM/M C,1,1,14,14,1,1,7,1,7,20,20,12,14,1,1
8825063,Daniel Marques,1651,11/07/1983,32,0,0,0,0,190,86,1,2,3,2,3,3,4,1,2,3,1,5,3,4,2,5,3,13,3,5,12,6,4,12,4,12,11,12,12,11,8,11,14,11,12,8,11,12,12,11,11,12,14,7,11,11,20,12,13,9,12,10,7,2,12,12,11,14,13,7,8,10,D C,1,1,1,1,1,1,20,1,1,1,1,1,1,1,1
8825082,Léo Fortunato,1651,14/03/1983,33,0,0,0,0,184,80,3,2,2,1,3,3,2,2,1,2,3,4,5,6,6,5,2,12,6,5,11,11,10,12,6,16,11,16,10,10,5,13,14,8,12,6,11,16,17,14,12,8,12,6,15,14,20,16,13,7,14,12,10,4,19,13,14,12,12,13,18,12,D C,1,1,1,1,1,1,20,1,1,14,1,1,1,1,1
8825125,Thiago Braga,1651,04/05/1984,32,0,0,0,0,184,79,15,15,14,7,13,14,13,9,9,6,15,6,1,1,3,3,9,1,3,1,3,1,3,2,5,10,12,16,8,10,9,8,13,2,7,3,15,10,9,9,12,10,14,9,15,12,20,8,10,11,9,10,7,10,10,11,18,10,12,12,13,10,GK ,20,1,1,1,1,1,1,1,1,1,1,1,1,1,1
8825128,Jardel,1651,27/01/1983,33,0,0,0,0,177,76,2,2,2,3,1,2,2,3,1,1,1,10,11,7,12,10,8,10,10,9,16,11,15,13,10,14,11,10,6,8,10,7,13,5,7,8,14,11,11,13,10,16,10,6,8,12,20,16,19,10,4,12,7,15,14,10,9,12,12,1,1,3,M C,1,1,1,12,1,1,1,1,1,14,20,1,1,1,1
8825160,Johnny,1651,06/08/1985,30,0,0,0,0,185,82,2,1,2,2,2,2,4,2,1,2,1,3,4,4,3,9,4,13,3,4,14,9,3,14,8,15,13,17,11,11,9,12,18,8,13,8,13,15,13,12,13,13,15,20,8,12,8,13,15,11,13,13,12,13,18,15,12,15,18,15,12,12,D C,1,4,1,1,1,1,20,4,1,7,1,1,1,1,1
8825198,Fernando Leal,1651,24/10/1981,34,0,0,0,0,191,85,11,11,13,5,13,15,13,14,12,10,13,2,3,4,4,8,7,7,4,4,5,10,6,8,10,11,11,12,10,10,5,11,13,5,15,7,13,8,11,9,13,11,15,3,13,8,20,11,13,11,10,13,5,4,11,13,15,13,13,11,10,11,GK ,20,1,1,1,1,1,1,1,1,1,1,1,1,1,1
8825413,Ricardo Conceição,1651,16/07/1984,31,0,0,0,0,175,71,2,1,1,2,2,1,2,3,2,3,1,5,7,8,9,10,5,9,9,7,15,10,9,15,10,16,13,16,10,12,7,11,16,7,10,8,15,16,17,12,11,14,8,8,16,12,20,14,14,15,8,16,9,5,6,12,10,13,16,8,16,4,DM/M C,1,1,1,1,1,1,1,1,14,20,18,1,12,1,13
8825499,Elias,1651,04/09/1981,34,0,0,0,0,178,72,2,4,1,3,3,2,2,2,3,3,3,8,11,13,14,13,11,13,14,12,13,14,15,13,15,14,12,14,14,14,11,13,15,6,14,11,13,14,14,10,10,13,11,5,14,8,20,10,10,14,12,15,7,13,14,13,12,10,14,7,8,5,DM/M C,1,1,1,15,1,1,1,1,1,18,20,1,1,1,1
8825505,Zé Carlos,1651,09/09/1985,30,0,0,0,0,185,79,12,12,11,10,12,12,12,12,12,12,12,1,1,3,1,9,10,4,1,2,3,8,4,2,9,10,12,12,12,11,8,11,15,2,11,2,13,11,12,12,10,8,13,9,12,10,20,12,11,10,11,2,10,10,11,15,6,8,5,8,9,17,GK ,20,1,1,1,1,1,1,1,1,1,1,1,1,1,1
8825507,Ilsinho,1651,12/10/1985,30,1,0,2,0,178,81,1,1,1,1,1,1,1,1,1,1,1,12,13,16,12,10,9,10,12,10,8,16,10,11,17,10,13,12,13,12,13,12,16,16,7,12,11,7,12,12,13,11,7,7,8,12,20,12,11,9,8,17,13,14,8,14,18,16,8,14,12,10,WB/M/AM RC,1,1,1,18,1,20,1,1,12,10,15,1,18,1,19
8825508,Rodrigo Paulista,1651,02/03/1985,31,0,0,0,0,171,65,3,1,4,2,3,3,1,3,1,2,1,9,12,13,12,13,9,7,10,3,11,14,14,9,14,11,13,14,8,10,13,12,15,15,5,13,10,12,13,12,14,6,5,8,16,12,20,14,7,10,12,15,3,12,13,11,17,14,8,10,17,11,M/AM C,1,1,10,17,7,11,1,1,1,1,20,1,3,1,1
8825510,Diego Tardelli,1651,10/05/1985,31,14,3,3,3,180,70,1,3,1,3,3,3,2,1,1,3,1,9,12,15,13,13,9,10,11,2,4,13,15,4,14,11,12,11,11,13,14,13,14,14,15,14,5,13,12,14,12,9,7,8,16,14,20,13,9,13,12,11,11,16,3,14,14,16,9,8,8,9,AM/S RLC,1,1,19,18,20,19,1,1,1,1,1,1,1,1,1
8825760,Rafael Morisco,1651,04/08/1986,29,0,0,0,0,182,80,3,3,2,1,3,1,2,2,3,2,1,4,7,8,6,10,9,11,8,4,12,8,8,12,11,12,10,11,11,11,7,11,10,11,10,6,11,12,12,12,9,9,11,20,13,12,10,13,10,12,11,12,5,6,9,13,7,10,12,13,12,7,D C,1,1,1,1,1,1,20,1,1,1,1,1,1,1,1
8825880,Fábio Santos,1651,16/09/1985,30,3,0,10,0,179,75,3,3,1,2,2,2,1,3,3,3,2,10,14,13,7,13,13,12,13,12,12,14,14,13,14,8,13,11,13,14,14,14,11,8,14,14,13,14,13,13,13,11,10,20,12,14,8,14,10,14,8,8,2,14,9,13,12,8,11,9,13,6,D/WB L,1,1,1,1,1,1,5,20,1,10,13,15,1,18,1
8826160,Fábio Braz,1651,02/12/1978,37,0,0,0,0,189,88,3,3,3,3,3,1,2,1,2,1,1,6,7,8,7,10,8,13,10,10,11,10,9,12,7,14,12,13,11,10,7,10,12,9,12,7,12,11,12,9,11,6,14,8,14,9,20,12,16,12,15,14,6,4,12,7,12,16,15,12,13,7,D C,1,1,1,1,1,1,20,1,1,1,1,1,1,1,1
8826161,Jô,1651,20/03/1987,29,20,5,4,0,189,80,2,1,2,1,1,1,1,3,3,3,3,9,9,11,13,13,9,15,14,9,8,13,16,8,12,12,12,14,11,12,11,13,13,12,13,14,8,13,14,12,13,10,15,20,16,12,13,14,15,10,6,16,7,12,14,4,10,14,5,13,15,5,S ,1,1,20,10,13,1,1,1,1,1,1,1,1,1,1
8826364,Vitinho,1651,05/10/1981,34,0,0,0,0,182,0,2,2,3,1,4,3,4,1,1,1,4,6,5,5,13,13,3,13,3,1,6,7,9,2,13,1,9,2,8,6,7,12,7,13,13,13,7,6,7,8,9,7,6,8,7,12,20,8,8,8,9,3,9,9,12,11,11,9,14,6,6,3,S ,1,1,20,1,1,1,1,1,1,1,1,1,1,1,1
8826926,Rodrigo Mancha,1651,16/05/1986,30,0,0,0,0,187,83,1,1,2,2,4,2,3,1,2,2,4,6,5,8,8,9,4,13,11,8,13,12,8,14,11,15,13,15,11,13,10,11,11,12,9,11,13,14,14,12,10,8,13,10,12,11,20,14,15,13,12,8,10,14,13,13,14,13,12,10,11,11,D/DM/M C,1,11,1,5,1,1,18,1,1,20,16,1,1,1,1
8826938,Jorge Luiz,1651,22/04/1982,34,0,0,0,0,192,81,3,1,2,2,1,3,3,1,4,1,1,5,6,8,7,8,8,13,9,6,11,11,10,12,10,16,13,15,12,10,8,9,13,6,13,9,11,14,16,12,8,15,15,8,15,14,20,15,15,11,12,13,7,8,11,10,12,12,12,13,15,13,D C,1,11,1,1,1,1,20,1,1,1,1,1,1,1,1
8827074,Jorge Fellipe,1651,27/10/1988,27,0,0,0,0,193,80,2,2,2,1,3,1,2,2,2,4,1,1,4,7,6,5,1,13,4,3,9,13,4,9,7,7,10,10,8,7,6,13,5,5,14,7,13,2,3,13,12,8,14,20,13,13,18,6,11,11,10,4,10,10,19,13,10,10,14,6,4,5,D LC,1,1,1,1,10,1,20,18,1,1,1,10,1,15,1
8827291,Marcus Vinícius,1651,22/03/1985,31,0,0,0,0,185,80,2,2,2,3,2,3,3,2,2,1,2,4,6,6,4,11,3,13,6,9,12,9,1,13,11,13,13,14,13,10,9,12,12,7,11,7,13,13,12,8,8,14,13,8,11,12,20,11,14,12,13,11,17,5,13,10,16,10,11,14,12,8,D C,1,1,1,1,1,1,20,1,1,1,1,1,1,1,1
8827363,Sidinei,1651,28/06/1984,32,0,0,0,0,170,69,1,2,2,1,2,2,1,3,3,1,3,5,6,12,10,12,10,8,10,4,3,12,5,3,13,8,10,10,8,10,9,11,5,13,6,9,9,7,8,11,12,11,8,16,8,11,20,10,10,11,10,10,7,12,11,12,11,10,11,1,1,4,AM/S C,1,1,20,18,1,1,1,1,1,1,1,1,1,1,1
8827470,Allan Barreto,1651,09/08/1984,31,0,0,0,0,172,68,4,1,1,3,1,2,4,3,1,2,3,7,3,12,13,13,7,9,8,3,6,11,4,1,13,5,10,7,10,3,8,13,15,11,14,11,8,7,14,14,12,12,5,20,7,15,17,11,6,10,10,10,10,10,12,13,11,12,10,3,15,7,S ,1,1,20,1,1,1,1,1,1,1,1,1,1,1,1
8827472,Godoy,1651,07/05/1985,31,0,0,0,0,180,73,1,1,4,4,3,1,2,3,1,1,2,6,8,12,12,14,9,15,10,2,5,9,6,4,10,6,11,8,8,8,8,12,14,8,9,7,7,7,15,11,8,8,14,7,14,10,20,16,13,12,10,10,10,9,9,11,13,12,11,6,3,7,S ,1,1,20,1,1,1,1,1,1,1,1,1,1,1,1
8827556,Leonardo,1651,22/09/1986,29,0,0,0,0,173,70,1,4,1,3,2,3,1,2,4,3,3,14,14,15,12,14,13,10,16,5,6,15,16,7,16,9,12,10,13,11,16,12,9,15,9,14,7,9,11,16,14,11,8,8,12,14,20,11,6,8,14,10,9,8,4,15,11,11,10,7,8,13,AM RL,1,1,1,12,20,20,1,1,1,1,1,12,12,1,1
8827561,Ronaldo Capixaba,1651,23/11/1983,32,0,0,0,0,179,76,2,2,2,2,2,2,3,3,2,2,3,2,8,10,11,11,11,12,11,2,3,9,14,3,11,10,11,11,12,8,9,9,12,12,11,11,6,9,9,13,9,12,9,11,14,12,20,10,12,10,7,11,7,15,12,12,6,13,14,14,12,6,S ,1,1,20,14,1,1,1,1,1,1,11,1,1,1,1
8827620,Ney Costa,1651,20/11/1980,35,0,0,0,0,187,0,2,2,2,1,1,3,2,3,1,1,1,7,10,11,11,12,8,13,8,7,9,12,13,9,13,9,12,11,13,11,11,9,8,11,14,10,7,8,9,9,10,15,14,12,17,13,20,9,14,13,9,10,6,10,12,11,10,13,11,1,9,8,AM/S C,1,1,20,16,1,1,1,1,1,1,1,1,1,1,1
8827745,Luisinho Paulista,1651,25/07/1985,30,0,0,0,0,175,75,2,2,1,1,1,2,2,2,2,1,2,7,9,12,13,8,10,10,7,7,6,13,14,5,13,12,12,10,12,9,11,11,16,11,9,11,5,9,14,14,12,9,11,11,12,13,20,12,9,11,10,14,11,9,17,16,17,17,18,15,8,1,S ,1,1,20,1,1,1,1,1,1,1,1,1,1,1,1
8827957,Rafael Miranda,1651,11/08/1984,31,0,0,0,0,179,78,4,3,1,1,2,4,3,2,3,3,2,8,9,10,9,13,8,13,8,10,11,14,10,13,13,12,13,13,13,13,13,12,12,8,16,11,14,16,13,11,12,14,11,12,11,11,20,13,13,13,8,14,14,12,12,13,13,6,14,14,5,3,DM/M C,1,1,1,1,1,1,1,1,13,20,17,1,10,1,12
8827958,Rafael Moura,1651,23/05/1983,33,0,0,0,0,189,85,1,1,2,1,1,1,3,2,1,3,1,4,8,11,13,12,10,17,12,6,6,12,15,7,11,14,13,15,12,11,10,10,17,12,13,12,7,13,16,11,10,7,16,10,16,11,20,13,15,10,16,15,5,5,7,16,12,11,15,7,8,15,S ,1,1,20,1,1,1,1,1,1,1,1,1,1,1,1
8829315,Hugo Almeida,1651,06/01/1986,30,0,0,3,0,182,77,3,1,3,3,3,1,1,1,1,1,1,7,7,9,11,7,7,13,11,5,9,11,15,9,13,13,13,13,11,10,11,12,14,14,11,10,8,8,11,12,11,9,12,13,12,13,20,14,11,11,9,12,11,9,9,14,5,12,12,12,13,13,S ,1,1,20,1,1,1,1,1,1,1,1,1,1,1,1
8829855,Leandro Kivel,1651,11/06/1983,33,0,0,0,0,186,81,1,3,3,1,3,1,1,1,2,1,1,7,6,13,12,12,7,13,5,1,6,6,6,4,13,10,11,4,11,8,5,12,10,13,13,11,7,7,8,13,12,7,13,11,15,13,20,8,14,10,7,10,9,10,14,13,9,13,11,1,17,4,S ,1,1,20,1,1,1,1,1,1,1,1,1,1,1,1
8829862,Naldo,1651,10/09/1982,33,4,0,0,0,198,89,2,3,1,3,3,3,3,1,2,1,1,4,9,10,8,11,13,18,15,8,14,12,9,14,11,10,16,13,15,12,9,15,15,13,14,10,14,10,12,9,8,13,20,10,14,11,20,12,16,17,8,16,10,10,14,12,15,13,16,14,11,8,D C,1,8,1,1,1,1,20,1,1,10,10,1,1,1,1
8829863,Cássio,1651,08/07/1986,29,0,0,0,0,183,83,3,1,4,3,3,3,3,3,4,3,2,6,6,8,7,8,9,12,9,7,13,6,10,13,9,13,12,12,11,13,6,12,11,8,11,7,13,11,11,13,12,13,12,8,14,14,20,15,14,11,14,10,10,4,11,15,13,10,12,10,10,9,D C,1,1,1,1,1,1,20,1,1,1,1,1,1,1,1
8829864,Alessandro,1651,30/03/1988,28,0,0,0,0,191,88,13,11,12,6,13,12,13,14,14,8,16,6,3,1,2,10,10,2,2,1,1,5,2,1,8,10,12,13,11,12,11,13,11,1,7,3,14,11,12,9,13,14,16,4,14,9,20,13,14,12,7,1,8,11,11,10,13,10,12,13,10,9,GK ,20,1,1,1,1,1,1,1,1,1,1,1,1,1,1
8829873,Marcos Rogério,1651,05/05/1985,31,0,0,0,0,173,72,3,3,2,1,2,3,3,3,3,3,1,6,5,3,6,13,3,7,6,1,10,10,5,13,9,17,11,15,9,9,9,13,15,9,3,8,8,9,16,15,6,17,7,10,15,15,20,11,18,10,15,6,10,10,11,7,15,15,15,14,13,8,DM ,1,1,1,1,1,1,10,1,1,20,14,1,1,1,1
8829875,Cleiton,1651,11/07/1981,34,0,0,0,0,187,76,3,3,1,3,2,3,2,2,1,2,2,3,5,8,6,10,8,13,8,8,12,10,8,11,11,13,12,15,9,14,10,10,12,12,13,7,11,14,12,9,12,12,13,6,8,9,20,12,11,11,10,15,15,11,13,12,4,9,10,8,10,7,D/DM RC,1,1,1,1,1,1,20,1,15,17,12,1,1,1,7
8829876,Mauro Silva,1651,20/05/1984,32,0,0,0,0,185,83,3,4,2,2,3,2,3,3,1,3,4,5,3,13,12,13,5,12,6,1,4,5,8,2,11,4,10,8,11,7,7,12,8,11,4,13,5,7,7,11,9,12,12,15,16,9,20,10,11,9,9,7,9,9,2,11,15,10,16,16,16,9,S ,1,1,20,1,1,1,1,1,1,1,1,1,1,1,1
8829879,Paulinho Oliveira,1651,10/08/1985,30,0,0,0,0,165,73,1,3,1,1,4,2,1,4,3,2,1,7,7,8,8,8,7,7,9,6,3,10,6,6,13,9,10,5,8,9,11,13,7,13,9,8,5,8,9,13,14,15,2,10,16,14,20,9,5,9,9,10,10,14,11,8,12,9,11,3,15,7,M/AM C,1,1,11,20,1,1,1,7,1,7,17,1,1,10,1
8829892,Anderson Silva,1651,28/08/1982,33,0,0,0,0,185,82,3,1,3,2,3,3,1,1,2,3,3,10,12,12,5,13,12,13,7,8,11,13,9,10,13,13,13,10,9,10,12,13,12,11,10,10,11,12,12,10,10,14,11,12,14,12,20,12,9,10,10,12,6,14,12,8,10,8,12,12,7,7,DM/M C,1,1,1,5,1,1,1,1,1,20,19,10,14,1,1
8830096,Vandinho,1651,24/08/1986,29,0,0,0,0,178,76,3,1,2,1,2,2,1,1,1,1,1,4,8,12,12,12,8,12,12,5,5,10,14,9,13,13,12,12,11,10,12,10,15,13,4,12,6,12,11,13,12,11,9,7,14,13,20,13,13,12,12,10,12,10,13,10,9,14,13,12,15,5,S ,1,1,20,10,5,10,1,1,1,1,1,1,1,1,1
8830246,Rodrigo,1651,23/11/1983,32,0,0,0,0,184,82,3,1,2,2,4,1,4,3,3,3,1,3,3,6,1,5,1,10,2,1,10,7,3,13,2,9,10,9,5,9,6,13,9,1,6,4,13,6,7,11,11,6,11,10,15,8,20,4,13,9,7,9,8,9,13,11,10,11,12,6,10,7,D C,1,1,1,1,1,1,20,1,1,1,1,1,1,1,1
8830249,Rafael Cruz,1651,18/01/1985,31,0,0,0,0,176,69,3,3,1,3,1,4,2,3,1,1,2,9,12,13,11,13,10,11,10,8,11,9,11,11,13,11,11,11,11,10,13,13,11,13,11,12,11,11,11,13,13,11,7,10,13,13,20,12,9,11,13,11,9,12,14,12,9,9,11,10,12,11,D/WB R,1,1,1,1,1,1,1,1,20,1,1,1,1,1,18
8830260,Léo,1651,11/09/1984,31,0,0,0,0,175,72,3,3,1,2,3,3,2,3,3,3,2,6,8,5,10,12,6,7,7,3,6,11,3,7,10,9,9,8,7,5,8,10,4,10,9,9,7,7,8,13,10,12,6,9,12,11,20,11,4,9,6,9,9,9,7,9,13,10,11,12,12,6,AM/S RC,1,1,17,20,1,16,1,1,1,1,15,1,15,1,1
8830322,Vinícius Barriviera,1651,19/07/1985,30,0,0,0,0,192,88,13,11,10,7,14,12,13,15,13,14,11,9,1,2,2,9,11,5,1,3,2,7,3,3,4,10,12,13,12,12,6,11,10,2,7,5,12,11,11,11,12,15,17,1,16,8,20,8,15,13,9,12,7,11,18,12,13,13,14,13,15,7,GK ,20,1,1,1,1,1,1,1,1,1,1,1,1,1,1
8830323,Stanley,1651,10/08/1985,30,0,0,0,0,170,66,1,2,4,1,3,3,2,2,1,1,2,5,8,7,1,9,1,8,4,7,9,9,1,10,7,9,12,9,6,8,7,14,1,9,6,7,10,8,9,13,13,11,10,20,10,15,8,13,10,9,6,9,9,9,19,9,12,12,11,7,16,6,D/WB L,1,1,1,1,1,1,1,20,1,1,1,1,1,16,1
8830328,Lucas,1651,21/02/1984,32,0,0,0,0,176,78,1,1,2,1,1,2,3,1,2,3,4,7,6,7,5,4,7,6,5,8,14,13,6,14,7,13,12,14,11,11,10,12,11,12,13,9,12,13,12,14,12,14,11,14,13,12,20,12,15,11,13,11,8,7,10,11,12,13,10,11,16,13,DM C,1,1,1,1,1,1,1,1,1,20,15,1,1,1,1
8830329,Marcus Vinicius,1651,22/05/1985,31,0,0,0,0,180,66,3,4,3,3,3,3,1,3,1,2,1,5,6,9,7,9,10,9,9,7,12,9,6,10,9,4,10,11,10,10,7,15,13,9,10,9,13,11,10,13,11,12,9,17,11,12,20,11,11,14,8,11,11,11,12,10,11,12,12,2,8,1,DM/M C,1,1,1,1,1,1,15,1,1,20,17,1,1,1,1
8830330,Murilo,1651,05/01/1984,32,0,0,0,0,176,74,1,3,1,2,3,2,1,3,4,2,1,5,8,5,9,12,9,5,7,5,12,8,1,12,14,5,10,9,6,13,8,12,3,8,6,5,10,5,8,15,12,10,11,9,12,15,20,10,10,14,7,10,10,10,9,14,8,10,13,3,6,6,D/WB R,1,1,1,1,1,1,1,1,18,1,1,1,1,1,20
8830332,Ticão,1651,07/02/1985,31,0,0,0,0,174,65,3,2,3,1,3,1,1,1,2,3,1,5,9,9,8,11,8,11,8,2,11,12,14,13,12,12,10,12,10,12,11,11,14,8,13,8,12,13,14,11,12,10,7,8,14,11,20,14,6,13,12,12,4,14,7,12,8,12,13,11,12,9,DM/M C,1,1,1,5,1,2,1,1,6,19,20,5,14,1,4
8830337,Vágner,1651,06/06/1986,30,0,0,0,0,185,79,12,11,12,15,11,12,12,15,8,14,10,7,2,2,3,10,10,3,2,3,3,11,3,3,11,4,14,13,11,11,10,11,15,3,11,1,12,12,12,11,14,13,15,5,15,12,20,11,11,12,9,11,11,11,12,14,14,12,15,14,14,5,GK ,20,1,1,1,1,1,1,1,1,1,1,1,1,1,1
8830345,Rhodolfo,1651,11/08/1986,29,0,0,0,0,193,84,3,2,3,2,1,1,2,1,1,2,1,2,7,8,8,8,11,16,10,10,15,10,10,15,8,13,13,13,10,13,7,13,15,7,15,8,15,12,10,7,7,15,17,10,15,9,20,12,16,14,11,14,9,10,7,12,13,13,15,13,12,9,D C,1,11,1,1,1,1,20,1,1,1,1,1,1,1,1
8830347,Vinícius Hess,1651,16/01/1988,28,0,0,0,0,179,80,2,1,1,1,1,1,2,3,2,1,1,4,10,8,7,10,9,9,10,9,11,11,9,12,10,12,10,13,11,11,11,10,15,8,11,10,11,14,14,12,15,5,8,20,12,15,11,11,9,11,4,10,5,12,13,12,14,9,12,5,13,7,DM ,1,1,1,1,1,1,1,1,1,20,13,10,1,1,1
8830353,Anderson Aquino,1651,18/12/1986,29,0,0,0,0,174,70,1,1,2,2,2,1,2,1,1,1,1,7,11,14,13,13,9,8,11,1,4,14,14,3,15,11,13,12,13,13,13,12,14,14,11,13,10,12,13,16,16,5,6,8,10,15,20,14,6,12,9,12,16,12,13,14,11,13,13,14,14,11,AM/S C,1,1,20,19,1,1,1,1,1,1,15,1,1,1,1
8830354,Schumacher,1651,31/08/1986,29,0,0,0,0,192,91,1,2,2,3,2,2,1,2,3,3,1,5,7,11,15,12,7,15,10,5,3,10,12,3,12,12,12,11,13,9,8,9,14,11,9,12,7,8,8,10,8,8,14,5,8,10,20,12,15,8,8,13,11,7,11,14,12,12,5,14,14,8,S ,1,1,20,1,1,1,1,1,1,1,1,1,1,1,1
8830367,Paulinho,1651,24/08/1983,32,0,0,0,0,175,72,1,3,2,1,2,2,2,4,1,1,3,8,14,13,9,8,8,6,9,13,12,13,10,11,13,11,9,7,8,10,11,9,9,11,5,7,13,14,8,13,16,9,8,5,12,14,20,11,7,9,12,10,11,12,13,11,14,7,11,11,11,13,D/DM R,1,1,1,8,1,10,1,1,20,17,12,1,14,1,15
8830369,Nicolas Ceolin,1651,10/04/1986,30,0,0,0,0,180,75,2,3,1,1,2,2,2,2,1,2,2,12,9,12,8,12,11,8,8,6,7,8,15,7,12,12,7,13,7,7,7,7,10,11,11,12,8,10,14,12,12,10,12,1,5,11,20,10,8,12,8,14,19,8,10,5,12,11,8,5,11,2,AM/S RL,1,1,18,12,15,20,1,1,1,1,1,1,1,1,1
8830373,Diego Souza,1651,17/06/1985,31,1,0,25,9,186,86,2,1,1,3,2,2,1,2,2,3,1,11,11,14,15,14,13,13,16,3,7,16,15,8,16,14,13,16,12,12,15,15,9,17,15,15,10,12,15,13,13,9,13,10,14,13,20,14,16,12,12,17,12,14,4,11,12,13,11,10,11,13,AM LC,1,1,15,20,15,13,1,1,1,5,10,1,1,1,1
8830374,Marcelinho,1651,09/01/1987,29,0,0,4,0,169,66,1,3,1,2,2,2,1,1,3,3,3,7,11,12,8,11,10,8,11,1,6,11,11,4,12,12,12,11,11,10,11,8,12,13,8,10,7,5,9,14,13,12,3,10,16,13,20,14,7,11,11,13,10,9,7,11,6,12,13,12,11,12,S L,1,1,20,7,15,8,1,1,1,1,1,15,1,1,1
8830376,Charles da Silva,1651,11/03/1984,32,0,0,0,0,175,77,1,3,1,3,2,3,3,1,2,4,1,9,11,13,8,15,9,9,10,5,9,14,4,10,12,10,12,9,11,13,12,12,15,15,11,11,10,9,10,14,15,11,6,20,14,13,10,8,6,13,4,4,10,10,17,10,11,10,11,1,8,8,AM LC,1,1,12,20,17,1,1,1,1,10,15,14,1,1,1
8830377,Alê,1651,21/01/1986,30,0,0,0,0,176,76,3,1,4,3,2,2,1,1,1,3,1,3,7,11,8,12,3,12,10,9,13,12,11,13,11,13,12,15,10,10,12,11,16,14,14,9,12,12,12,12,12,12,7,7,16,11,20,12,14,14,17,12,2,11,11,12,14,15,12,1,5,3,DM/M C,1,1,1,1,1,1,1,1,1,20,18,1,1,1,1
8830378,Ronny,1651,11/05/1986,30,0,0,0,0,175,74,2,3,3,2,2,2,3,3,1,3,1,16,17,12,13,14,18,10,18,16,8,17,16,9,14,7,13,6,15,12,16,13,7,14,5,8,10,10,7,8,11,14,8,20,9,10,8,10,11,8,6,12,8,10,11,10,12,9,8,14,14,4,M/AM C,1,1,1,20,12,1,1,14,1,13,18,12,1,14,1
8830525,Vicente,1651,30/04/1983,33,0,0,0,0,172,67,3,1,4,1,1,2,3,2,1,1,3,10,12,11,9,12,11,8,11,12,10,12,13,11,13,12,11,12,11,11,12,11,15,14,5,12,9,12,12,12,14,14,6,20,14,11,7,11,7,12,8,11,12,12,13,11,9,15,13,7,13,12,D/WB L,1,1,1,1,8,1,1,20,1,1,1,12,1,19,1
8830530,Diogo,1651,18/12/1984,31,0,0,0,0,173,64,3,3,1,1,3,2,2,1,2,2,1,11,11,12,6,6,12,5,13,14,11,12,4,11,12,13,11,14,7,10,9,9,12,13,5,13,11,12,12,12,11,7,7,7,13,12,20,13,8,11,10,12,11,12,11,11,3,12,8,11,9,15,D/WB/DM/M RC,1,1,1,12,1,12,1,1,20,20,17,1,13,1,18
8830549,Neném,1651,04/02/1982,34,0,0,0,0,173,70,2,3,1,3,3,2,2,2,3,3,1,10,9,11,10,12,11,6,9,5,8,11,10,8,12,13,13,12,12,12,11,12,11,11,14,12,8,12,12,11,13,15,6,20,11,11,8,10,7,14,13,13,10,8,11,6,14,11,14,12,11,9,M/AM C,1,1,1,20,1,1,1,1,1,1,18,1,1,1,1
8830559,Peçanha,1651,11/01/1980,36,0,0,0,0,182,78,11,12,11,8,13,12,13,15,11,10,11,7,1,1,3,10,11,8,1,2,2,12,3,3,11,10,8,12,6,13,7,10,17,5,10,5,13,8,14,10,13,10,11,20,12,12,6,11,10,8,11,11,6,10,12,12,14,15,16,15,16,6,GK ,20,1,1,1,1,1,1,1,1,1,1,1,1,1,1
8831089,Renato,1651,28/04/1985,31,0,0,17,5,186,86,2,2,1,3,2,3,3,3,2,3,3,11,10,11,11,11,12,13,11,5,10,11,11,11,11,12,12,14,10,9,10,10,12,13,8,12,10,13,11,12,11,12,12,8,15,12,20,13,12,11,13,12,7,16,11,10,13,12,13,6,10,10,M/AM C,1,1,15,20,11,13,1,1,1,12,19,10,14,1,6
8831166,Gleidson Souza,1651,17/04/1984,32,0,0,0,0,172,72,1,3,3,3,2,4,2,2,3,3,1,10,11,11,10,11,9,9,10,13,9,11,10,10,12,11,9,12,11,10,10,10,12,11,8,12,12,12,13,13,13,10,8,20,13,14,7,14,11,11,8,11,6,13,12,12,12,10,14,11,13,10,D L,1,1,1,1,1,1,1,20,1,1,1,15,1,15,1
8831776,Leandro Leite,1651,27/12/1982,33,0,0,0,0,180,83,2,3,3,3,2,2,2,2,2,3,3,10,5,8,10,10,11,8,10,2,14,11,8,12,10,13,12,16,12,10,8,11,14,9,16,9,14,14,14,12,12,13,13,11,13,14,20,16,12,12,10,11,11,11,8,8,11,13,10,7,11,6,DM/M C,1,1,1,1,1,1,1,1,1,20,18,1,1,1,1
8832566,Wagner,1651,29/01/1985,31,0,0,0,0,175,72,3,1,3,3,1,2,4,3,3,3,3,15,15,13,16,16,14,8,14,12,10,14,14,8,15,14,13,12,14,10,12,14,14,15,10,14,9,15,12,12,12,10,6,20,12,13,10,12,7,8,11,14,11,10,5,13,8,12,14,12,10,10,M/AM LC,1,1,1,20,19,10,1,8,1,1,19,15,1,1,1
8832567,Vinícius Pacheco,1651,27/09/1985,30,0,0,0,0,173,68,2,2,3,1,2,2,3,3,3,3,2,11,12,13,11,12,12,9,11,5,8,12,12,6,12,11,12,14,13,7,12,12,15,15,9,13,8,12,13,13,14,14,6,20,13,13,10,12,8,10,6,13,13,13,15,12,13,14,12,5,14,5,AM LC,1,1,12,20,19,12,1,1,1,1,1,15,11,1,1
8832568,Ernane,1651,02/05/1985,31,0,0,21,4,176,65,2,1,3,4,1,3,3,3,1,2,2,4,7,11,11,10,10,6,11,10,9,9,11,6,10,7,8,11,7,9,11,11,12,15,5,10,8,11,10,13,12,7,4,11,13,12,20,11,6,12,5,13,16,14,10,15,8,12,14,13,13,14,M/AM RC,1,1,10,20,13,19,1,1,1,8,17,13,16,1,1
8832569,Neto Potiguar,1651,29/10/1985,30,0,0,8,1,174,61,2,1,3,3,1,2,3,1,3,3,1,12,11,12,11,11,8,11,8,5,6,12,14,6,12,9,10,10,11,9,12,9,9,13,5,13,8,8,11,14,13,7,7,4,12,14,20,12,7,11,5,10,10,10,4,9,12,9,16,12,19,3,S ,1,1,20,14,14,14,1,1,1,1,5,6,6,1,1
8832791,Túlio de Melo,1651,31/01/1985,31,0,0,0,0,193,92,3,1,2,4,1,3,2,3,1,1,1,3,9,11,12,13,10,16,13,5,8,12,14,6,11,9,14,12,12,12,11,11,13,11,12,13,13,13,12,11,13,7,16,8,7,13,20,12,16,13,9,11,15,5,15,13,11,13,12,14,14,7,S ,1,1,20,8,1,1,1,1,1,1,1,1,1,1,1
8832792,Alex Silva,1651,10/03/1985,31,3,0,0,0,192,81,2,1,1,3,1,1,1,3,3,2,1,2,9,11,8,13,3,15,6,9,13,7,5,13,12,14,13,14,12,9,10,11,11,9,12,8,12,13,12,11,8,12,16,10,7,12,20,13,13,9,13,11,18,10,4,11,12,13,8,12,7,16,D C,1,5,1,1,1,1,20,1,10,14,1,1,1,1,6
8832793,Aranha,1651,17/11/1980,35,0,0,0,0,191,89,12,12,12,11,14,10,12,15,12,12,9,5,2,1,3,5,9,3,3,1,1,5,3,1,7,12,10,14,13,13,10,13,13,2,8,4,14,12,12,13,12,7,15,20,12,13,4,13,16,13,5,13,13,11,12,8,18,12,13,14,20,4,GK ,20,1,1,1,1,1,1,1,1,1,1,1,1,1,1
8832798,Evaldo,1651,04/01/1983,33,0,0,0,0,191,82,3,2,2,3,1,2,2,1,1,1,4,1,4,5,7,9,12,13,12,7,11,8,8,12,8,15,11,14,10,11,6,9,13,10,10,10,12,11,12,11,9,11,14,8,14,11,20,12,13,14,12,13,11,13,11,10,14,13,13,13,12,10,D C,1,11,1,1,1,1,20,1,7,14,5,1,1,1,1
8832801,Leandro Carvalho,1651,30/09/1983,32,0,0,0,0,180,73,1,1,3,1,3,3,3,1,3,1,1,3,12,9,7,9,6,12,11,7,13,12,6,11,10,15,13,10,13,11,8,11,13,8,11,8,13,13,14,13,13,14,12,9,12,12,20,14,14,12,15,11,11,7,8,14,12,13,12,13,14,13,DM/M C,1,1,1,1,1,1,13,1,1,20,18,1,1,1,1
8832802,Renatinho Carioca,1651,26/06/1980,36,0,0,0,0,165,65,2,3,3,2,2,3,1,1,1,2,2,10,10,11,9,10,10,6,9,11,9,11,10,10,11,12,9,11,10,10,10,10,2,12,7,11,9,10,12,11,13,16,3,20,13,11,7,11,8,12,8,12,9,12,8,10,11,10,12,5,7,5,D/WB L,1,1,1,1,8,1,1,18,1,1,1,13,1,20,1
8832804,Ramón,1651,24/05/1988,28,0,0,15,9,182,76,4,3,3,2,2,2,1,1,3,1,3,11,8,14,11,13,12,9,11,6,4,11,6,3,14,7,10,10,11,10,12,8,11,13,8,12,5,11,5,13,11,8,10,11,6,12,20,13,8,6,4,13,11,12,5,14,9,5,3,8,10,10,AM C,1,1,8,20,1,1,1,1,1,1,10,1,1,1,1
8832806,Edílson,1651,27/07/1986,29,0,0,0,0,176,76,2,1,3,3,3,3,2,1,3,3,1,13,13,12,10,13,14,12,15,13,12,13,12,12,12,14,12,15,11,13,13,13,9,14,14,13,12,13,13,13,13,13,8,10,13,13,20,12,13,12,15,12,14,11,12,12,12,11,13,8,6,7,D/WB/DM/M RC,1,1,1,1,1,1,1,1,20,19,18,1,1,1,19
8832807,João Carlos,1651,05/04/1989,27,0,0,0,0,188,75,13,12,12,7,13,12,13,15,13,9,11,6,2,1,1,8,11,7,1,3,2,11,1,1,12,11,11,15,11,12,10,12,12,3,4,2,12,13,12,12,13,9,14,8,14,12,20,12,11,11,9,1,14,11,7,11,17,12,15,14,14,9,GK ,20,1,1,1,1,1,1,1,1,1,1,1,1,1,1
8832808,Ricardinho,1651,08/08/1988,27,0,0,0,0,178,68,1,2,2,2,2,3,4,2,1,2,2,12,11,13,11,12,12,8,12,7,5,11,12,6,13,8,10,11,11,11,11,11,13,12,7,13,8,10,11,14,13,11,8,7,12,13,20,12,7,12,10,11,12,11,14,12,10,8,13,12,11,11,AM/S RLC,1,1,18,18,15,20,1,1,1,1,1,1,1,1,1
8832810,Bruno Batata,1651,26/09/1984,31,0,0,0,0,180,78,1,1,3,3,1,3,1,1,2,3,3,4,9,11,13,11,8,11,13,5,3,11,12,8,12,14,6,15,12,9,11,9,11,13,6,10,7,15,15,11,11,10,11,14,13,11,20,11,15,9,12,11,10,7,6,13,10,10,13,12,8,9,S ,1,1,20,1,1,1,1,1,1,1,1,1,1,1,1
8832812,Miranda,1651,07/09/1984,31,31,0,0,0,186,78,1,3,1,4,2,3,2,1,3,1,1,2,8,8,9,12,5,16,8,3,18,12,10,16,12,13,16,16,15,15,11,14,16,7,14,9,16,15,16,14,12,15,14,7,14,15,20,14,14,16,11,15,10,6,14,15,14,18,12,12,8,11,D C,1,1,1,1,1,1,20,1,1,1,1,1,1,1,1
8832817,Erick Flores,1651,30/04/1989,27,0,0,0,0,165,69,2,2,1,1,2,2,2,3,3,2,3,13,12,14,10,13,12,6,11,3,5,13,12,6,14,10,12,10,10,10,13,13,9,12,7,12,7,9,9,14,15,7,3,12,12,14,20,12,8,11,5,12,5,11,13,11,13,13,12,8,13,6,M/AM RC,1,1,12,20,14,17,1,1,1,1,19,11,15,1,1
8832824,André Lima,1651,03/05/1985,31,0,0,0,0,185,84,4,3,4,3,3,2,4,3,1,2,1,3,6,12,15,13,6,15,10,7,7,11,14,7,12,12,13,16,12,13,12,12,8,11,8,13,11,13,14,13,13,13,14,8,12,13,20,12,14,12,9,13,10,7,3,12,12,11,14,6,9,6,S ,1,1,20,1,1,1,1,1,1,1,1,1,1,1,1
8832825,Boiadeiro,1651,24/09/1984,31,0,0,0,0,172,63,4,3,3,1,3,1,3,2,1,2,2,11,11,10,9,12,10,7,10,12,11,13,11,11,12,11,10,11,12,11,11,11,12,12,9,12,11,11,11,13,13,8,5,8,13,13,20,12,5,13,10,13,6,14,13,11,10,14,14,12,15,10,D/WB R,1,1,1,10,1,12,1,1,19,5,14,1,15,1,20
8832827,Felipe Adão,1651,26/11/1985,30,0,0,0,0,188,80,3,1,1,3,2,3,2,3,2,4,2,4,8,11,10,11,7,12,9,4,4,11,10,6,12,9,12,13,10,11,14,10,14,13,10,12,5,10,11,13,12,12,13,5,15,12,20,12,14,5,2,7,5,10,6,14,12,14,11,13,12,7,S ,1,1,20,1,1,1,1,1,1,1,1,1,1,1,1
8832828,Muriqui,1651,16/06/1986,30,0,0,0,0,171,68,2,2,1,3,2,3,1,1,1,4,1,9,12,14,12,13,11,5,10,5,6,13,13,5,16,12,12,10,11,10,11,12,16,16,6,15,7,13,11,15,16,12,2,8,16,15,20,14,7,11,10,11,10,11,16,7,12,12,13,12,14,11,AM/S RLC,1,1,20,18,17,19,1,1,1,1,15,5,15,1,1
8832832,Gatti,1651,05/09/1984,31,0,0,0,0,187,79,10,14,11,4,12,12,14,14,14,13,12,8,3,3,2,2,12,1,3,3,1,2,2,1,6,10,9,15,6,7,7,13,13,3,10,1,7,8,7,9,13,9,15,10,13,6,20,5,10,12,5,15,8,10,18,15,13,11,14,6,13,6,GK ,20,1,1,1,1,1,1,1,1,1,1,1,1,1,1
8832837,Fabinho,1651,20/07/1984,31,0,0,0,0,176,73,2,4,2,2,3,3,3,3,3,3,1,9,9,8,7,10,11,10,12,10,11,10,12,10,9,14,10,16,11,10,12,11,12,10,8,8,9,14,13,9,10,11,7,8,12,10,20,11,12,12,16,10,8,12,9,12,14,10,9,4,8,12,DM/M C,1,1,1,1,1,1,1,1,1,20,19,1,1,1,1
8832840,Alex Sassá,1651,30/01/1986,30,0,0,0,0,181,82,1,3,3,2,2,1,3,4,2,2,3,5,8,8,6,11,8,12,3,1,11,11,1,11,10,11,11,12,9,10,8,10,2,9,10,8,11,11,11,11,11,12,12,10,13,11,20,11,12,12,6,9,6,9,11,12,11,12,11,6,13,2,D/DM C,1,15,1,1,1,1,19,1,1,20,1,1,1,1,1
8832841,Alexandre Acerola,1651,04/01/1986,30,0,0,0,0,170,68,3,2,3,4,3,3,4,1,3,1,2,8,8,11,9,10,8,15,7,7,3,10,7,3,13,10,8,13,9,10,3,13,3,11,3,12,11,11,11,12,11,5,3,10,12,11,20,11,10,10,14,10,5,9,11,10,12,13,13,11,7,8,S ,1,1,20,1,1,1,1,1,1,1,1,1,1,1,1
8832843,Daniel,1651,03/03/1986,30,0,0,0,0,192,75,13,13,8,5,11,9,8,13,11,10,13,3,1,1,3,4,7,1,2,3,1,1,3,2,6,6,9,15,8,6,7,13,10,3,12,3,12,8,7,13,7,8,12,6,12,11,20,4,11,10,8,10,10,10,17,10,11,9,11,10,14,2,GK ,20,1,1,1,1,1,1,1,1,1,1,1,1,1,1
8832845,Doda,1651,09/09/1986,29,0,0,0,0,175,72,1,2,2,2,1,1,4,3,2,3,2,9,11,12,11,15,9,7,11,5,5,12,5,4,13,6,8,9,9,6,12,7,10,10,8,11,7,10,14,13,13,9,5,20,16,13,10,15,9,10,4,5,5,10,13,12,11,11,10,10,1,1,M/AM RC,1,1,1,20,1,18,1,1,1,1,16,1,15,1,1
8832846,Esquerdinha,1651,09/01/1984,32,0,0,0,0,169,61,2,3,1,1,3,1,2,3,1,2,3,8,12,11,13,9,12,6,10,4,7,9,16,7,8,7,13,9,9,10,8,8,11,7,9,9,6,13,8,12,12,7,5,20,13,12,10,9,10,10,8,10,14,10,15,14,10,10,11,1,12,5,M/AM LC,1,1,15,18,20,1,1,1,1,1,17,18,1,1,1
8832850,Luís Cetin,1651,05/08/1987,28,0,0,0,0,191,75,9,10,10,4,13,12,12,13,8,16,11,5,2,2,1,5,10,4,3,3,1,5,2,1,10,10,6,10,10,9,11,9,12,3,13,3,11,11,11,17,13,11,14,8,10,17,20,11,8,8,9,10,10,10,7,12,14,13,12,14,13,9,GK ,20,1,1,1,1,1,1,1,1,1,1,1,1,1,1
8832851,Madissom,1651,19/08/1987,28,0,0,0,0,173,69,3,2,2,1,2,3,3,1,1,2,3,7,8,10,9,10,9,6,9,7,7,10,11,7,10,11,8,11,9,8,10,7,14,12,4,9,8,11,11,13,13,13,7,20,12,13,9,12,7,11,8,10,8,16,13,13,15,11,13,12,14,11,M/AM LC,1,1,1,15,17,1,1,13,1,1,10,20,1,15,1
8832852,Maicon,1651,14/09/1985,30,0,0,0,0,183,87,3,3,1,3,3,3,2,2,1,3,1,10,10,13,9,15,9,10,13,10,10,15,12,11,15,13,12,11,12,12,14,12,11,12,15,13,10,10,12,12,12,14,10,13,10,12,20,14,14,12,12,11,10,13,6,10,9,11,11,7,6,9,DM/M/AM C,1,1,1,16,14,10,1,1,1,19,20,13,13,1,1
8832853,Marcelo,1651,12/05/1988,28,42,4,4,0,174,75,1,1,2,3,1,2,3,2,3,1,3,13,17,18,12,18,11,10,14,13,12,15,12,13,18,16,13,13,16,14,16,13,14,18,13,16,11,15,13,15,15,18,6,20,10,13,16,15,11,15,14,14,12,11,14,14,17,14,9,11,15,11,D/WB L,1,1,1,1,8,1,1,20,1,1,1,15,1,19,1
8832856,Radamés,1651,17/04/1986,30,0,0,0,0,180,78,3,2,1,3,1,1,2,3,2,3,1,5,13,12,10,11,6,10,10,13,13,12,14,13,12,11,12,12,13,12,11,11,12,6,5,12,12,13,13,13,13,10,10,9,14,13,20,13,11,11,12,11,9,15,12,11,12,13,14,12,14,5,DM/M C,1,1,1,10,1,5,1,1,14,20,18,1,12,1,13
8832859,Thiago Benevides,1651,04/09/1987,28,0,0,0,0,171,61,3,2,2,2,1,1,1,2,2,3,1,10,10,11,10,11,10,10,8,10,4,14,9,5,12,8,10,7,12,11,13,11,11,10,9,12,8,12,12,13,11,6,11,20,13,15,9,9,5,11,9,9,13,10,18,11,10,9,11,6,9,8,M/AM LC,1,1,1,20,19,1,1,1,1,1,18,17,1,1,1
8832868,João Paulo,1651,17/11/1984,31,0,0,0,0,184,76,2,1,4,2,3,3,1,3,1,1,2,4,7,10,9,10,11,12,8,5,11,10,10,12,11,11,12,12,11,11,6,10,11,10,11,9,12,13,13,12,11,13,12,9,12,12,20,14,11,12,15,12,13,11,14,13,12,11,12,12,13,11,D C,1,12,1,1,1,1,20,1,1,13,10,1,1,1,1
8832878,Domingos,1651,12/12/1985,30,0,0,0,0,181,77,2,1,2,2,3,2,3,3,4,3,4,9,6,10,7,9,5,14,8,5,12,10,7,12,9,20,13,17,12,12,8,11,14,8,11,9,12,14,14,12,10,15,11,10,15,12,20,15,17,13,18,13,7,5,11,11,11,11,6,3,2,17,D C,1,11,1,1,1,1,20,1,5,1,1,1,1,1,1
8832881,Sandro,1651,01/10/1983,32,0,0,0,0,176,73,3,2,1,3,2,2,3,2,2,3,2,10,9,13,12,13,9,7,11,7,6,12,11,7,13,7,12,7,13,10,14,13,8,13,3,11,9,10,11,11,12,10,7,20,16,12,11,13,8,10,5,9,6,9,8,13,10,11,8,8,10,10,AM LC,1,1,15,20,18,1,1,1,1,1,1,1,1,1,1
8832883,Jackson,1651,03/06/1988,28,0,0,0,0,176,69,3,1,1,1,2,3,1,1,1,2,3,11,11,9,8,8,8,7,8,5,7,9,9,8,8,12,7,9,7,10,9,6,12,13,4,11,7,8,11,13,13,6,6,4,13,13,20,12,7,7,12,7,7,16,11,11,12,10,8,7,11,9,D/WB/M/AM RL,1,1,11,7,12,18,8,5,19,10,13,18,20,1,19
8832884,Leonardo,1651,08/02/1988,28,0,0,0,0,188,80,3,4,3,1,3,3,2,1,2,1,1,6,7,10,7,11,8,14,6,7,13,8,9,13,12,14,12,14,11,8,8,9,12,11,8,8,12,13,14,10,11,11,14,10,14,12,20,13,14,6,9,13,14,10,10,12,12,8,12,13,10,7,D C,1,10,1,1,1,1,20,1,1,1,1,1,1,1,1
8832886,Renan Teixeira,1651,29/03/1985,31,0,0,0,0,181,74,4,3,2,3,1,1,3,2,3,1,3,7,9,9,5,11,6,12,11,10,13,11,9,13,10,15,11,16,10,10,10,10,17,4,15,11,14,15,14,11,12,13,10,7,14,10,20,13,12,12,13,16,3,12,11,14,11,15,13,12,11,9,DM/M C,1,5,1,1,1,1,10,1,1,20,18,1,1,1,1
8832889,Willian,1651,09/08/1988,27,38,6,10,0,175,77,1,1,1,1,1,1,1,1,1,1,1,9,14,17,11,15,16,9,15,8,5,15,12,8,16,11,14,9,13,12,15,14,16,15,8,15,7,18,20,16,13,10,11,7,12,17,20,14,11,14,8,14,4,12,14,15,10,14,14,13,12,8,M/AM RLC,1,1,12,19,17,20,1,1,1,1,16,15,15,1,1
8832892,Kahê,1651,28/08/1982,33,0,0,0,0,187,81,2,4,3,3,3,3,4,2,3,1,3,8,9,8,12,12,11,14,10,4,9,12,15,7,13,13,15,12,12,9,8,12,10,11,12,13,11,12,8,8,7,13,13,20,15,9,12,7,13,12,7,14,5,6,9,11,12,9,13,15,15,5,S ,1,1,20,1,1,1,1,1,1,1,1,1,1,1,1
8832895,Rafael Marques,1651,27/05/1983,33,0,0,0,0,190,75,2,2,2,1,1,4,2,3,2,1,2,6,12,12,13,15,8,15,12,6,5,12,13,5,13,11,12,11,12,13,13,14,7,11,12,14,8,15,13,13,13,9,15,20,13,12,10,13,12,13,9,17,8,8,10,10,18,11,9,11,12,9,AM/S RL,1,1,17,14,20,18,1,1,1,1,1,1,1,1,1
8832896,William,1651,20/11/1986,29,0,0,0,0,175,70,3,1,1,2,2,2,1,3,1,2,3,12,11,13,11,13,12,9,11,9,8,12,15,9,14,15,12,14,12,12,12,12,15,13,7,13,9,13,14,14,14,11,8,20,12,14,10,13,8,13,9,12,12,16,10,13,15,16,15,11,12,12,AM LC,1,1,15,20,17,7,1,7,1,1,15,14,1,12,1
8832899,Celsinho,1651,20/10/1988,27,0,0,0,0,177,68,1,1,1,1,1,1,1,1,1,1,1,10,10,15,10,13,12,9,12,5,6,12,13,6,15,6,8,8,9,11,14,12,8,15,8,13,6,9,8,14,14,8,7,12,8,15,20,10,8,10,11,12,8,11,8,6,12,10,6,8,10,13,AM C,1,1,15,20,13,13,1,1,1,1,1,1,1,1,1
8832900,Michel Platini,1651,08/09/1983,32,0,0,0,0,189,82,1,3,1,1,3,1,1,1,1,4,2,6,10,13,12,11,8,13,13,2,5,11,12,5,13,10,10,13,11,9,11,9,10,14,7,11,9,9,9,9,8,14,14,10,13,11,20,11,14,7,12,9,10,11,10,11,8,7,6,3,1,20,AM/S C,1,1,20,18,1,12,1,1,1,8,9,1,1,1,1
8832901,Adílio,1651,09/01/1985,31,0,0,0,0,170,64,2,2,1,1,1,4,1,1,2,1,2,10,14,3,6,12,8,8,5,4,10,8,4,14,10,10,9,9,10,12,6,9,12,6,14,8,8,7,14,16,11,8,5,20,12,15,10,7,7,10,10,7,7,10,12,12,9,12,10,3,4,7,D L,1,1,1,1,1,1,1,20,1,1,10,15,1,15,1
8832905,Nil,1651,11/07/1982,33,0,0,0,0,178,68,2,2,3,2,4,3,2,2,1,2,2,8,12,10,9,14,9,7,13,12,8,11,6,9,12,10,9,6,9,9,10,10,11,11,15,9,9,10,10,11,10,9,7,20,13,12,7,13,9,14,2,10,6,10,5,10,16,12,14,13,15,6,D/WB/M/AM L,1,1,1,1,16,1,1,18,1,1,1,18,1,20,1
8832908,Paulo André,1651,20/08/1983,32,0,0,0,0,188,82,2,1,1,1,2,3,2,3,3,1,1,5,8,7,8,12,10,16,11,8,15,13,10,15,13,14,14,15,15,14,10,14,14,5,14,7,13,14,13,9,9,16,15,7,11,10,20,13,14,9,14,12,10,8,9,15,12,13,14,14,11,7,D C,1,1,1,1,1,1,20,1,1,10,1,1,1,1,1
8832909,Serginho,1651,20/05/1980,36,0,0,0,0,178,76,4,4,1,1,4,1,3,1,2,2,1,5,6,9,7,11,5,9,10,5,11,11,9,11,10,15,11,13,9,9,10,12,11,12,9,8,11,12,14,11,9,6,11,8,14,12,20,13,13,13,10,12,10,12,11,10,13,10,12,6,17,7,DM/M C,1,1,1,1,1,1,1,1,1,20,18,1,1,1,1
8832932,Bruno Luiz,1651,09/09/1984,31,0,0,0,0,182,78,3,3,1,1,3,2,2,1,1,4,2,6,8,12,12,11,3,12,10,2,2,10,13,2,12,9,8,14,11,6,12,6,15,13,3,13,7,7,12,13,13,12,13,11,16,13,20,10,13,13,6,13,10,10,11,15,14,12,15,13,13,7,AM/S C,1,1,20,16,1,1,1,1,1,1,1,1,1,1,1
8832936,Diego Marangon,1651,22/08/1986,29,0,0,0,0,174,62,3,1,2,1,1,3,2,3,3,4,1,5,10,11,7,9,12,8,5,6,13,10,8,11,11,15,10,15,6,12,7,10,17,10,12,13,12,13,14,13,14,10,10,20,12,13,8,11,12,13,16,11,15,10,10,10,11,12,11,9,10,7,DM/M C,1,1,1,13,13,1,1,1,1,17,20,13,1,1,1
8832949,Paulinho,1651,10/01/1986,30,0,0,12,4,176,72,1,3,1,3,2,3,2,3,1,1,1,8,9,13,15,13,13,14,12,7,4,13,15,5,15,12,13,14,14,11,13,12,16,12,15,12,10,12,14,13,14,13,10,13,15,14,20,13,12,17,11,13,5,10,9,9,13,12,17,12,14,5,S ,1,1,20,14,13,11,1,1,1,1,1,1,1,1,1
8832954,Ricardinho,1651,15/12/1985,30,0,0,0,0,175,64,2,1,3,2,3,2,3,1,3,3,2,13,13,14,13,14,14,10,13,10,7,14,12,6,14,8,13,8,13,13,13,12,12,13,13,14,7,10,12,14,14,10,10,20,12,14,8,13,10,12,7,13,12,11,11,12,11,12,11,11,12,9,M/AM LC,1,1,13,17,20,1,1,1,1,1,13,17,1,1,1
8832958,Éderson,1651,14/03/1986,30,0,0,0,0,186,82,3,3,3,4,3,1,2,3,2,3,3,8,8,10,11,12,12,15,11,14,12,8,8,14,10,8,12,16,9,14,10,11,16,7,6,10,12,15,15,8,9,12,13,8,9,9,20,9,12,15,6,8,16,15,10,14,11,14,14,14,12,7,DM/M C,1,1,1,1,1,1,14,1,1,20,19,1,1,1,1
8832961,Marcos,1651,17/06/1983,33,0,0,0,0,177,71,2,3,3,2,1,1,3,1,3,3,2,9,15,10,10,10,10,11,7,12,12,11,6,13,11,11,12,15,12,14,8,11,13,7,8,12,12,14,16,11,12,13,8,6,12,12,20,12,13,14,12,11,18,13,16,10,12,9,14,12,9,7,D/WB/DM R,1,12,1,1,1,1,11,1,20,19,1,1,1,1,17
8832963,Danny Morais,1651,29/06/1985,31,0,0,0,0,187,78,3,3,2,1,2,1,1,3,3,2,1,8,5,9,7,14,6,15,13,5,14,13,6,14,12,13,13,13,11,11,6,11,16,13,11,14,13,16,16,11,12,8,15,8,16,12,20,12,13,11,11,14,2,12,13,17,13,15,12,10,15,6,D C,1,7,1,1,1,1,20,8,1,14,8,1,1,1,1
8832964,Edinho,1651,15/01/1983,33,0,0,0,0,183,83,3,2,3,2,3,1,2,2,3,1,3,2,7,8,8,11,10,12,10,9,14,11,12,14,9,16,14,18,11,14,10,13,17,11,17,11,14,15,16,11,10,15,11,7,16,11,20,13,16,14,15,17,5,17,14,14,18,17,15,8,12,9,D/DM C,1,15,1,1,1,1,17,1,1,20,15,1,1,1,1
8832965,Rafael Sóbis,1651,17/06/1985,31,8,0,12,3,175,77,4,2,2,2,2,1,2,1,2,2,3,14,13,12,13,15,12,8,17,6,10,13,14,9,16,14,12,14,11,12,13,13,11,15,13,13,6,14,13,13,12,10,6,14,10,14,20,12,10,11,11,16,12,14,13,11,16,13,15,10,15,12,AM/S RL,1,1,20,13,18,18,1,1,1,1,1,1,1,1,1
8832966,Ricardo Jesus,1651,16/05/1985,31,0,0,0,0,185,81,2,1,1,3,1,2,3,1,2,2,2,5,7,10,12,11,10,13,10,4,5,11,12,4,12,10,12,11,13,12,11,11,6,13,9,12,8,11,11,12,10,13,12,12,14,11,20,14,13,12,8,12,9,6,5,3,14,9,10,12,16,4,S ,1,1,20,12,1,1,1,1,1,1,1,1,1,1,1
8832967,Sídnei,1651,23/08/1989,26,0,0,5,0,185,83,2,2,1,3,1,2,2,1,3,3,2,5,7,9,7,12,8,16,9,9,15,11,9,15,11,15,15,14,15,15,9,13,10,10,12,13,15,15,13,10,11,12,14,10,13,16,20,15,16,13,11,13,8,7,13,16,15,13,7,14,12,10,D C,1,10,1,1,1,1,20,5,5,8,1,1,1,1,1
8833070,Leonardo,1651,03/09/1984,31,0,0,0,0,188,87,3,2,1,1,2,2,3,3,2,3,2,3,7,9,7,10,9,11,9,7,11,11,9,11,10,12,11,12,9,11,7,10,12,8,12,9,12,12,11,10,9,13,13,8,13,10,20,12,14,11,10,12,8,13,12,11,10,12,13,14,11,10,D C,1,16,1,1,1,1,20,1,1,14,7,1,1,1,1
8833079,Marcos Vinícius,1651,05/12/1984,31,0,0,0,0,170,72,2,1,3,3,3,1,3,2,1,1,2,11,12,11,9,11,12,6,11,12,9,12,14,7,12,8,10,7,8,7,11,10,8,12,3,11,9,9,7,12,13,7,4,11,13,12,20,12,8,8,6,9,10,15,10,11,12,8,14,9,11,11,D/WB RL,1,1,1,7,5,11,1,16,19,8,12,9,14,15,20
8833082,Cícero,1651,26/08/1984,31,0,0,0,0,183,72,2,1,1,3,1,4,3,1,1,3,2,9,12,11,14,14,10,16,15,12,13,14,14,13,14,7,12,7,15,11,14,12,10,14,12,14,10,14,13,13,11,13,17,20,16,12,8,14,12,9,6,11,6,17,16,13,10,6,9,9,9,12,DM/M/AM LC,1,1,13,19,14,10,1,10,1,19,20,15,8,10,1
8833084,Elias,1651,02/09/1983,32,0,0,0,0,180,78,4,2,2,3,3,2,4,3,3,1,3,13,13,12,11,13,14,11,14,1,4,13,14,5,14,14,11,13,12,11,15,12,13,14,14,12,6,9,11,13,14,11,9,20,13,11,8,12,11,14,13,14,12,5,8,16,15,17,11,6,4,18,M/AM LC,1,1,3,20,17,10,1,1,1,3,18,17,5,1,1
8833086,Jajá,1651,29/11/1986,29,0,0,0,0,171,66,2,1,3,2,3,2,1,1,3,3,2,4,11,12,10,11,13,10,11,5,4,11,12,4,13,10,10,12,11,7,10,9,10,15,5,12,7,7,9,12,13,11,5,20,12,12,10,11,6,10,5,12,11,12,12,12,12,7,14,14,13,11,AM/S RLC,1,1,20,18,18,18,1,1,1,1,14,8,10,1,1
8833442,Cortez,1651,24/08/1981,34,0,0,0,0,177,0,2,2,1,2,1,2,1,2,3,3,2,7,8,7,14,14,3,12,4,2,7,9,9,4,13,5,11,7,12,9,9,10,2,12,3,14,9,7,9,14,14,4,4,10,10,14,20,14,6,8,9,9,9,9,9,10,14,11,8,3,1,4,AM/S C,1,1,20,17,1,1,1,1,1,1,1,1,1,1,1
8833474,Carlão,1651,12/02/1984,32,0,0,0,0,184,83,1,3,1,3,3,3,2,3,2,3,1,5,1,7,7,11,6,11,9,5,11,9,8,9,7,12,13,7,9,9,7,9,11,6,8,3,11,9,11,13,11,15,13,10,12,13,20,11,11,12,8,9,10,9,11,12,13,10,14,1,12,8,D C,1,1,1,1,1,1,20,1,1,1,1,1,1,1,1
8833476,Daniel Morais,1651,12/05/1986,30,0,0,0,0,180,80,1,2,2,1,3,3,2,3,3,1,2,7,6,9,10,11,9,11,9,2,2,9,6,4,11,5,8,9,12,9,8,8,10,9,7,9,2,9,9,16,12,8,12,11,12,15,20,10,12,7,18,9,10,10,9,9,15,9,12,5,12,10,S ,1,1,20,1,1,1,1,1,1,1,1,1,1,1,1
8833479,Fahel,1651,15/08/1981,34,0,0,0,0,182,77,1,1,2,2,1,3,3,3,1,3,2,9,11,10,11,12,12,15,11,11,12,12,11,12,12,12,12,13,12,10,9,12,13,8,15,12,13,14,12,10,11,11,12,7,13,10,20,11,11,13,13,12,7,12,12,15,15,10,12,8,11,8,DM/M C,1,1,1,1,1,1,13,1,1,20,18,1,1,1,1
8833480,Jajá Coelho,1651,28/02/1986,30,0,0,0,0,189,85,1,3,2,3,1,1,2,2,4,2,2,13,13,14,11,14,14,8,16,6,11,13,9,7,14,5,13,13,11,5,14,13,9,14,5,14,10,8,4,10,15,14,14,20,4,10,12,7,16,10,6,14,19,7,8,10,1,8,5,5,8,13,AM/S LC,1,1,20,18,18,1,1,1,1,1,1,14,1,1,1
8833481,Leandro Euzébio,1651,18/01/1981,35,0,0,0,0,187,83,1,1,3,1,1,2,3,2,2,2,2,5,6,8,7,9,10,13,11,4,12,10,11,13,11,14,13,13,13,12,7,11,15,6,15,10,13,13,12,9,8,8,14,12,12,8,20,11,14,12,16,13,10,12,13,13,14,11,11,11,6,13,D C,1,8,1,1,1,1,20,1,1,8,1,1,1,1,1
8833483,Osmar,1651,23/02/1982,34,0,0,0,0,175,65,2,3,3,2,4,3,2,3,1,2,2,11,11,12,11,12,11,7,14,14,9,11,12,9,14,10,12,12,13,13,13,12,12,13,5,14,11,14,15,13,13,11,9,8,12,12,20,13,10,12,11,13,8,13,8,15,12,15,12,13,12,9,D R,1,1,1,1,1,1,1,1,20,1,1,1,15,1,15
8833489,Éverton,1651,21/07/1983,32,0,0,0,0,190,89,1,3,1,3,2,2,3,1,3,3,2,2,6,4,6,9,16,11,15,2,11,9,13,12,8,16,10,12,12,11,8,12,12,6,13,8,12,15,12,10,10,13,13,8,13,9,20,12,14,12,14,13,13,10,15,10,12,10,7,6,7,7,D C,1,1,1,1,1,1,20,1,1,1,1,1,1,1,1
8833502,Ciro Sena,1651,08/06/1982,34,0,0,0,0,186,82,3,2,3,3,1,1,2,1,1,3,4,6,5,11,7,7,4,15,7,6,13,10,6,13,9,10,14,16,9,8,4,12,13,8,11,4,8,12,16,11,10,15,13,8,10,12,20,13,16,12,15,4,10,10,12,12,15,12,14,13,14,9,D C,1,1,1,1,1,1,20,1,1,1,1,1,1,1,1
8833510,Gilberto,1651,24/10/1978,37,0,0,0,0,190,83,10,9,10,3,11,9,12,11,11,16,9,5,2,1,3,1,9,1,3,2,2,1,1,3,4,7,6,14,6,13,5,9,9,1,12,2,10,6,4,9,15,6,13,8,10,6,20,1,7,17,9,9,5,9,8,14,9,11,11,3,3,1,GK ,20,1,1,1,1,1,1,1,1,1,1,1,1,1,1
8833511,Tony Heleno,1651,15/12/1983,32,0,0,0,0,180,78,1,1,2,1,2,3,1,1,3,3,3,9,6,11,10,12,7,11,8,9,8,11,13,10,13,11,13,14,13,13,10,11,9,14,10,9,13,14,11,11,11,9,10,20,12,10,9,11,9,10,4,9,5,7,10,9,12,11,13,5,17,4,M/AM C,1,1,1,20,1,1,1,1,1,1,18,1,1,1,1
8833515,França,1651,28/01/1978,38,0,0,0,0,190,88,14,11,12,5,13,11,12,13,11,10,12,5,2,1,3,10,8,2,2,1,3,2,4,3,9,11,10,11,9,12,7,10,12,3,9,5,12,9,12,7,10,12,15,7,12,8,20,10,15,13,8,12,9,10,7,15,5,12,13,12,12,11,GK ,20,1,1,1,1,1,1,1,1,1,1,1,1,1,1
8833526,Tinho,1651,24/11/1982,33,0,0,0,0,173,68,3,1,2,4,1,3,2,2,4,2,1,6,7,12,11,11,8,7,8,1,6,15,7,6,12,9,7,9,10,7,10,6,12,10,15,12,9,9,9,13,12,7,6,7,12,14,20,11,5,9,9,9,9,9,20,13,12,11,12,10,1,1,M/AM/S C,1,1,16,20,1,14,1,1,1,1,18,1,8,1,1
8833532,Moré,1651,04/02/1981,35,0,0,0,0,183,79,2,3,2,3,2,3,2,3,4,3,1,2,9,11,11,11,4,9,12,3,7,9,15,6,12,15,11,13,11,9,8,11,14,14,4,11,8,10,12,11,9,12,10,13,15,11,20,12,12,14,12,15,8,10,13,14,13,15,9,8,6,16,S ,1,1,20,11,11,11,1,1,1,1,1,1,1,1,1
8833533,Rafinha,1651,07/09/1985,30,2,0,15,3,172,68,3,3,3,2,1,3,3,2,2,2,1,10,15,13,10,14,8,7,11,10,12,13,17,16,14,16,13,10,14,11,12,14,15,13,7,13,12,10,16,15,16,8,6,14,14,14,20,16,7,13,16,13,3,10,14,10,12,12,11,6,8,17,D/WB R,1,1,1,1,1,12,1,14,20,10,10,1,12,14,20
8833535,Edson Veneno,1651,14/06/1981,35,0,0,0,0,184,83,1,2,1,1,2,1,1,2,3,1,3,4,5,3,2,2,6,13,5,3,12,5,3,12,2,14,11,13,11,11,11,12,11,14,12,9,12,13,13,12,11,13,13,20,12,12,10,12,13,10,13,10,7,3,11,10,13,14,9,7,16,12,D C,1,1,1,1,1,1,20,1,1,1,1,1,1,1,1
8833536,Leandrinho,1651,25/03/1983,33,0,0,0,0,171,64,2,3,1,2,3,4,3,2,2,2,2,4,12,12,10,12,6,8,9,6,5,13,6,7,12,10,10,8,9,10,12,10,13,13,6,14,9,10,11,15,14,8,8,8,13,15,20,11,9,12,8,12,5,10,8,13,10,11,10,3,5,3,S ,1,1,20,1,8,12,1,1,1,1,1,1,1,1,1
8833537,Neizinho,1651,10/08/1982,33,0,0,0,0,173,63,2,3,2,1,1,1,2,2,2,1,2,8,8,13,9,14,8,6,9,3,3,11,14,3,12,7,6,3,10,9,10,10,6,10,11,10,9,9,13,16,13,5,8,9,9,16,20,10,3,10,10,10,10,10,19,10,12,12,10,9,4,7,M/AM C,1,1,1,20,13,13,1,1,1,1,16,1,1,1,1
8833541,Santana,1651,03/01/1984,32,0,0,0,0,186,88,2,1,3,3,1,1,3,3,1,2,1,1,2,3,4,6,1,11,4,3,12,7,6,11,6,5,11,10,9,12,5,8,12,3,13,5,10,8,9,8,8,13,14,9,16,9,20,13,15,9,9,9,4,9,18,11,12,14,11,8,15,2,D C,1,11,1,1,1,1,20,1,1,1,1,1,1,1,1
8833545,Makanaki,1651,08/10/1983,32,0,0,0,0,174,64,1,1,3,4,4,2,3,3,3,3,2,8,11,13,9,12,6,7,9,5,6,11,8,7,10,12,9,10,9,8,7,8,14,12,7,16,6,7,15,14,13,12,7,7,12,13,20,8,7,7,12,9,11,8,9,11,9,14,8,7,13,9,AM/S RL,1,1,19,10,15,20,1,1,1,1,1,10,10,1,1
8833547,Daniel Bamberg,1651,23/04/1984,32,0,0,0,0,176,74,1,3,1,1,1,3,2,3,1,2,1,11,12,12,12,12,12,11,13,2,8,14,14,5,14,6,12,6,13,13,15,13,13,10,15,13,11,11,11,12,13,7,8,7,14,12,20,13,7,14,5,11,5,12,14,11,14,10,16,16,18,5,M/AM RC,1,1,14,19,1,20,1,1,1,1,14,1,19,1,1
8833549,Leyrielton,1651,22/06/1988,28,0,0,15,0,173,68,4,2,2,2,3,4,2,3,3,1,1,10,12,13,9,13,10,6,10,8,8,11,10,6,12,11,10,9,10,9,11,9,13,15,7,11,8,13,13,13,15,8,7,8,16,14,20,13,7,9,7,11,14,13,6,12,16,11,16,6,12,7,D/WB R,1,1,1,1,1,10,1,13,18,1,1,8,15,12,20
8833551,Aloísio,1651,19/06/1988,28,0,0,0,0,176,72,3,3,2,1,2,3,3,4,3,1,3,4,10,15,14,13,10,11,12,2,5,11,13,7,14,15,13,15,14,13,12,13,16,13,11,13,7,12,15,16,14,13,6,9,13,15,20,14,14,13,12,12,11,12,11,12,12,12,8,5,10,6,S ,1,1,20,5,10,8,1,1,1,1,1,5,1,1,1
8833552,Carlos Eduardo,1651,18/07/1987,28,6,0,0,0,171,68,1,1,1,3,3,1,2,1,3,3,3,14,14,13,11,13,14,6,12,6,7,13,13,7,14,12,11,9,11,10,14,13,4,13,5,15,8,11,12,13,13,11,6,20,7,13,9,11,7,9,15,14,15,15,9,15,8,14,5,9,4,18,AM RLC,1,1,1,20,15,15,1,1,1,1,15,10,10,1,1
8833553,Cássio,1651,06/06/1987,29,0,0,13,0,195,92,14,13,13,5,15,13,15,15,12,11,13,7,1,3,1,10,11,11,2,3,1,11,1,1,12,6,12,12,7,13,10,13,18,2,14,2,13,12,14,11,12,15,19,20,15,11,13,12,15,13,12,16,4,11,5,16,13,12,16,13,16,5,GK ,20,1,1,1,1,1,1,1,1,1,1,1,1,1,1
8833559,Felipe Mattioni,1651,15/10/1988,27,0,0,0,0,177,72,1,3,1,3,1,3,1,3,2,4,2,12,13,15,7,12,11,8,10,12,12,13,5,12,16,14,13,12,12,12,13,11,13,14,6,14,13,11,12,14,15,10,10,7,8,12,20,11,9,12,11,10,15,14,12,15,8,12,14,15,11,17,D/WB R,1,1,1,1,1,9,1,1,18,1,1,1,15,1,20
8833560,Fernando Miguel,1651,02/02/1985,31,0,0,0,0,190,87,12,13,14,6,15,10,14,15,13,13,11,6,2,2,1,10,8,5,2,1,1,10,4,3,10,14,13,13,13,10,3,13,15,7,16,3,13,15,15,10,14,9,15,20,13,10,6,14,14,12,5,13,8,11,8,6,19,16,18,15,12,10,GK ,20,1,1,1,1,1,1,1,1,1,1,1,1,1,1
8833562,Galatto,1651,10/04/1983,33,0,0,0,0,192,80,9,11,11,5,9,11,10,11,14,11,11,1,1,1,2,10,4,6,2,3,3,11,3,1,13,6,10,14,10,12,9,14,11,3,12,2,13,12,13,10,10,12,15,20,12,10,10,11,11,7,13,16,7,10,10,16,8,12,15,7,16,6,GK ,20,1,1,1,1,1,1,1,1,1,1,1,1,1,1
8833567,Itaqui,1651,28/02/1988,28,0,0,0,0,176,70,2,4,3,3,3,3,2,2,1,2,1,10,7,9,5,9,15,5,13,8,10,11,8,11,10,12,10,12,10,10,11,10,11,11,13,9,9,13,11,12,12,11,7,20,12,14,9,10,12,13,8,10,10,16,13,14,13,13,14,12,5,14,D/DM L,1,1,1,1,1,1,1,17,1,20,13,14,1,13,1
8833571,Escobar,1651,23/07/1988,27,0,0,0,0,176,68,2,2,3,2,3,1,2,2,2,1,2,5,7,8,6,12,7,6,7,2,13,10,4,12,9,14,10,15,7,11,11,13,5,2,7,7,11,15,11,11,9,12,6,9,13,11,20,12,12,11,8,10,8,10,12,9,15,10,8,9,5,7,DM ,1,1,1,1,1,1,1,1,1,20,10,1,1,1,1
8833573,Juninho Botelho,1651,19/01/1987,29,0,0,0,0,176,58,1,4,2,2,3,2,3,4,2,2,1,12,10,14,9,10,14,10,10,8,10,10,5,10,13,7,10,7,10,9,10,10,10,13,2,8,9,8,11,13,10,9,7,10,17,14,20,9,7,10,10,2,10,10,18,14,10,10,12,5,8,7,M C,1,1,7,15,1,1,1,1,1,1,20,1,1,1,1
8833576,Léo,1651,30/01/1988,28,0,0,0,0,184,85,2,1,1,1,1,2,1,4,1,2,3,1,7,7,8,12,5,15,10,8,14,12,8,14,11,14,15,15,13,14,10,13,13,8,13,7,14,13,14,13,11,11,13,7,14,11,20,14,14,12,12,12,8,11,12,12,13,15,11,12,13,8,D C,1,12,1,1,1,1,20,5,10,6,1,1,1,1,1
8833577,Lucas Leiva,1651,09/01/1987,29,24,0,9,4,179,74,2,3,1,1,2,1,3,2,3,4,3,7,8,11,5,15,8,12,4,5,15,16,9,15,14,15,18,14,16,16,9,15,16,10,11,14,17,16,16,11,14,14,12,10,14,10,20,15,13,15,11,14,8,11,18,14,18,16,17,12,15,6,DM C,1,1,1,10,1,1,15,1,1,20,14,1,1,1,1
8833580,Pará,1651,19/09/1987,28,0,0,0,0,172,73,1,1,4,1,1,3,2,1,2,3,3,11,11,12,10,12,12,6,11,8,10,11,6,10,13,10,11,14,14,10,12,13,14,12,8,13,10,12,12,15,14,8,12,20,13,15,9,12,12,11,11,8,11,12,19,13,8,10,10,12,10,6,D L,1,1,1,1,1,1,1,20,1,1,1,1,1,15,1
8833585,Révson,1651,20/12/1987,28,0,0,0,0,183,72,4,3,3,1,1,2,3,3,2,1,2,6,6,4,10,13,6,12,10,7,12,13,8,11,12,6,10,8,10,10,12,10,8,9,9,7,10,7,12,14,12,13,11,9,11,14,20,6,12,11,14,9,9,9,7,9,12,11,9,9,10,10,DM/M C,1,1,1,1,1,1,1,1,1,20,16,1,1,1,1
8833588,Tallys,1651,26/10/1987,28,0,0,0,0,172,74,2,2,2,1,2,2,2,2,3,3,1,6,8,10,8,13,7,7,8,2,7,14,4,9,10,10,10,6,12,9,13,9,4,10,12,12,9,9,12,14,14,7,7,9,17,14,20,10,8,10,7,3,5,9,11,12,10,12,10,10,8,8,AM C,1,1,1,20,1,1,1,1,1,1,15,1,1,1,1
8833593,Zulu,1651,05/09/1983,32,0,0,0,0,192,86,2,3,1,1,3,1,3,3,1,2,3,2,6,8,11,9,6,12,9,1,5,9,13,5,9,8,12,15,9,10,8,11,14,10,9,11,6,12,12,7,10,6,15,9,13,9,20,12,14,12,9,12,9,2,11,12,8,13,14,14,12,7,S ,1,1,20,1,1,1,1,1,1,1,1,1,1,1,1
8833597,Jaílson,1651,20/07/1981,34,0,0,0,0,187,81,12,12,12,9,14,11,14,15,13,12,12,5,1,2,1,6,8,2,2,8,3,5,3,1,7,12,13,13,13,14,8,14,10,2,11,2,14,13,13,11,13,14,14,5,14,12,20,14,14,18,12,10,4,11,8,10,12,14,2,7,10,10,GK ,20,1,1,1,1,1,1,1,1,1,1,1,1,1,1
8833612,Bruno Ribeiro,1651,01/04/1983,33,0,0,0,0,172,67,2,3,3,1,3,1,3,3,3,2,1,11,10,8,8,11,7,7,10,14,10,11,8,11,12,12,11,12,13,12,10,10,16,10,5,13,11,13,13,12,14,13,6,10,14,12,20,14,8,11,9,11,12,14,2,15,11,12,13,14,13,6,D/WB R,1,1,1,1,1,14,1,14,18,1,1,1,14,12,20
8833614,Dinei,1651,12/04/1985,31,0,0,0,0,182,79,3,1,2,1,3,3,1,4,1,2,2,9,10,11,10,10,8,10,9,6,7,9,11,7,10,10,9,10,9,9,9,9,9,11,7,12,7,10,11,13,12,8,12,9,13,12,20,12,12,8,7,9,7,12,7,12,12,11,9,6,8,6,S RLC,1,1,20,15,15,15,1,1,1,1,1,1,1,1,1
8833622,Willian Magrão,1651,16/02/1987,29,0,0,0,0,188,76,2,2,4,1,4,2,4,2,3,1,2,5,8,10,9,9,7,13,11,5,11,11,10,11,10,14,11,13,12,12,11,10,13,13,11,10,11,14,15,11,9,12,15,10,11,13,20,10,11,11,14,8,9,13,13,10,12,12,13,11,11,10,DM C,1,1,1,1,1,1,15,12,13,20,14,1,1,1,1
8833628,Thiago Silva,1651,22/09/1984,31,59,4,4,0,183,79,2,1,1,1,3,2,1,1,2,2,4,4,5,10,8,14,8,15,10,8,18,14,14,17,13,12,16,15,17,15,13,16,17,8,15,10,16,15,14,13,14,18,13,10,14,14,20,15,15,17,7,15,13,11,15,16,12,13,16,18,15,6,D C,1,10,1,1,1,1,20,1,1,10,10,1,1,1,1
8833630,Carlinhos,1651,12/02/1986,30,0,0,0,0,173,62,1,1,4,1,1,2,2,1,3,2,2,7,9,9,7,11,6,9,10,11,9,10,2,9,11,10,8,10,9,9,10,8,15,9,5,11,9,10,12,13,14,13,6,20,6,13,7,13,7,9,8,5,9,17,14,11,12,10,11,1,11,5,M/AM LC,1,1,11,19,20,1,1,12,1,1,10,16,1,13,1
8833633,Ediglê,1651,13/05/1978,38,0,0,0,0,185,79,1,2,3,2,1,1,3,2,2,2,3,3,2,8,10,10,7,13,9,13,11,10,10,11,7,16,11,13,9,12,8,6,18,5,12,11,12,13,11,11,10,10,13,10,17,9,20,11,10,12,15,11,8,13,12,14,12,15,16,8,12,7,D C,1,12,1,1,1,1,20,1,1,11,5,1,1,1,1
8833649,Alessandro Paraná,1651,23/01/1988,28,0,0,0,0,184,72,2,1,3,2,2,3,2,3,4,2,1,8,4,7,7,9,5,9,13,7,13,15,6,15,13,7,11,9,9,5,15,12,4,2,11,9,12,10,12,15,14,6,12,1,17,15,20,9,12,10,3,10,10,10,17,11,11,10,11,6,10,8,DM ,1,1,1,1,1,1,1,1,1,20,11,1,1,1,1
8833652,Andre Moritz,1651,06/08/1986,29,0,0,0,0,185,78,1,1,3,3,2,1,3,3,3,3,1,15,14,14,11,15,15,10,14,8,4,14,16,4,16,8,12,12,14,7,13,12,7,16,5,13,10,7,8,9,13,13,12,20,9,10,8,7,11,9,15,14,8,12,12,9,11,14,6,9,17,18,AM LC,1,1,10,20,15,12,1,1,1,1,1,7,6,1,1
8833657,Bruno Grassi,1651,05/03/1987,29,0,0,0,0,193,87,13,13,13,3,14,11,14,14,12,11,11,2,3,3,1,6,7,2,1,1,2,5,4,3,9,6,14,12,13,12,12,14,9,2,5,1,15,13,13,11,13,13,17,12,12,11,20,12,12,13,11,9,8,11,7,12,9,10,12,8,8,3,GK ,20,1,1,1,1,1,1,1,1,1,1,1,1,1,1
8833660,Cauê,1651,22/04/1987,29,0,0,0,0,180,84,3,3,2,3,1,1,3,1,1,3,3,2,6,7,5,8,10,13,7,7,12,8,9,12,8,13,10,11,8,10,6,10,14,6,11,6,11,12,12,9,11,12,9,20,15,10,10,14,13,12,13,11,10,8,3,14,12,11,12,13,13,13,D C,1,11,1,1,1,1,20,1,1,5,1,1,1,1,1
8833672,Diogo,1651,14/01/1988,28,0,0,0,0,179,69,1,2,2,2,2,2,3,1,3,1,2,12,12,11,10,13,11,8,13,6,8,12,9,11,11,16,9,12,11,10,12,10,8,12,7,15,11,10,11,12,12,6,7,4,10,12,20,10,6,11,13,11,9,12,14,11,11,9,12,1,8,1,WB/M RLC,1,1,1,14,14,14,1,1,15,9,17,15,20,1,17
8833674,Gottardi,1651,18/10/1985,30,0,0,0,0,193,83,14,13,12,12,13,12,14,16,15,14,9,9,1,3,2,11,11,10,2,2,2,11,2,2,12,11,13,12,11,12,8,13,11,2,13,3,13,14,13,7,12,12,16,9,14,5,20,11,13,12,7,11,10,11,15,11,16,14,15,12,14,10,GK ,20,1,1,1,1,1,1,1,1,1,1,1,1,1,1
8833682,Augusto Fraga,1651,04/05/1988,28,0,0,0,0,184,80,3,1,2,1,2,3,3,3,3,2,1,5,7,10,11,13,10,14,10,6,8,12,13,8,9,12,13,12,11,11,10,12,16,10,10,14,12,13,13,12,10,15,13,10,18,13,20,14,15,13,7,11,6,9,9,14,11,13,13,12,13,13,AM/S R,1,1,20,1,1,17,1,1,1,1,1,1,1,1,1
8833685,Liniker,1651,27/03/1987,29,0,0,0,0,178,79,2,2,2,1,1,1,2,2,2,3,2,2,2,6,2,8,4,8,6,4,10,12,2,9,9,9,9,8,6,8,6,13,16,2,8,6,11,5,9,13,13,13,12,6,15,13,20,8,11,9,4,7,9,9,8,11,14,13,7,7,9,8,D/DM/M C,1,1,1,1,1,1,18,1,1,20,16,1,1,1,1
8833686,Luciano,1651,13/06/1987,29,0,0,0,0,186,87,1,1,3,3,2,3,3,1,2,1,2,7,7,3,6,6,2,12,8,3,11,5,3,10,10,10,8,12,11,9,11,8,11,5,11,5,9,6,7,8,11,13,14,8,13,10,20,9,11,9,7,10,4,9,13,8,8,12,11,12,14,3,D/DM C,1,1,1,1,1,1,20,1,1,18,1,1,1,1,1
8833687,Luiz Adriano,1651,12/04/1987,29,4,0,11,2,183,71,2,2,2,1,1,3,1,1,1,1,1,3,11,13,14,14,4,16,8,6,4,12,15,6,12,12,14,15,13,13,11,12,12,11,14,14,7,18,16,15,15,11,13,10,12,16,20,15,12,12,14,14,8,4,15,13,11,13,14,13,10,12,S ,1,1,20,1,1,1,1,1,1,1,1,1,1,1,1
8833691,Maycon,1651,14/02/1985,31,0,0,0,0,180,78,2,1,3,3,1,3,2,3,2,2,1,5,1,3,8,12,7,7,10,6,13,13,2,14,9,13,12,15,8,8,13,11,15,6,10,7,11,8,10,10,11,12,9,9,13,9,20,14,13,11,15,5,10,10,15,13,14,7,10,12,6,7,DM ,1,1,1,1,1,1,1,1,1,20,10,1,1,1,1
8833693,Muriel,1651,14/02/1987,29,0,0,4,0,189,78,12,13,12,6,15,13,14,11,9,16,13,4,3,1,3,12,9,8,3,3,1,11,5,3,4,10,13,12,13,12,10,13,13,2,11,1,14,12,15,12,14,13,13,20,14,12,6,13,13,13,8,8,3,11,10,15,15,12,15,14,12,8,GK ,20,1,1,1,1,1,1,1,1,1,1,1,1,1,1
8833697,Nicolas,1651,06/06/1986,30,0,0,0,0,190,89,13,13,11,1,10,13,9,13,9,5,8,6,3,1,1,2,8,1,3,2,3,1,1,2,6,8,7,10,5,9,6,13,9,3,9,3,8,7,6,10,9,7,16,2,10,12,20,6,8,9,8,9,4,9,13,11,9,13,10,10,15,5,GK ,20,1,1,1,1,1,1,1,1,1,1,1,1,1,1
8833705,Rafael Porcellis,1651,19/01/1987,29,0,0,0,0,187,82,2,2,1,2,1,2,3,1,1,1,2,4,6,9,13,12,6,13,9,4,5,8,13,6,10,5,11,8,11,10,10,9,13,12,10,12,7,7,6,9,9,12,13,11,13,10,20,12,14,10,7,10,12,6,7,14,13,4,12,7,14,5,S ,1,1,20,1,1,1,1,1,1,1,1,1,1,1,1
8833714,Taianan,1651,13/03/1987,29,0,0,0,0,179,71,1,4,2,3,2,3,2,2,2,2,3,14,13,13,9,12,14,11,12,5,6,13,12,7,14,13,10,12,9,8,13,9,12,14,13,10,8,9,10,12,13,10,9,8,10,12,20,9,9,10,12,12,10,6,10,9,8,10,14,5,6,9,M/AM C,1,1,1,20,10,6,1,1,1,1,18,7,7,1,1
8833717,Tássio,1651,08/10/1984,31,0,0,0,0,196,90,2,3,2,2,1,1,3,3,2,1,3,5,6,7,11,10,12,13,11,3,5,10,10,6,11,12,10,11,12,11,11,11,10,11,7,11,11,13,14,10,10,15,15,8,13,11,20,11,16,14,10,10,10,10,11,9,11,13,8,2,14,16,S ,1,1,20,1,1,1,1,1,1,1,1,1,1,1,1
8833721,Álvaro,1651,11/03/1985,31,0,0,0,0,181,87,1,2,2,3,3,3,3,2,1,2,3,4,6,5,8,8,9,12,9,7,12,9,10,12,8,15,12,15,8,11,6,9,16,6,13,8,14,14,13,10,8,7,11,8,16,10,20,12,15,7,15,15,3,12,5,15,11,14,14,12,12,7,DM C,1,11,1,1,1,1,13,1,1,20,15,1,1,1,1
8833722,Anderson Oliveira,1651,07/11/1985,30,0,0,0,0,177,73,2,2,3,2,1,3,2,2,2,1,3,5,10,11,10,11,7,9,9,3,4,11,12,4,12,12,10,12,10,8,10,10,12,12,7,12,6,11,11,12,13,12,8,8,14,12,20,12,9,10,5,11,5,9,12,11,6,10,12,9,8,10,S ,1,1,20,12,12,12,1,1,1,1,1,1,1,1,1
8833733,André,1651,24/11/1986,29,0,0,0,0,186,67,2,3,1,2,3,1,1,2,3,3,3,10,7,10,8,9,13,12,8,7,11,9,9,10,9,12,10,14,8,11,8,11,10,9,13,10,12,12,12,10,8,14,14,12,14,9,20,14,14,10,12,10,6,10,19,8,10,9,10,8,13,8,D/DM C,1,1,1,1,1,1,20,1,1,18,10,1,1,1,1
8833734,Bruno,1651,30/08/1985,30,0,0,0,0,178,69,1,3,3,2,2,3,2,1,3,1,3,10,15,15,9,14,9,12,10,13,12,13,9,12,15,11,13,12,13,13,14,12,10,15,9,14,12,14,13,13,13,8,14,8,14,13,20,13,13,10,13,11,8,12,8,11,12,10,11,6,10,9,D/WB R,1,1,1,1,1,1,1,1,20,1,1,1,10,1,17
8833747,Héverton,1651,04/07/1987,28,0,0,0,0,182,79,1,1,4,1,1,4,2,2,1,2,1,4,1,3,3,7,1,13,4,1,13,5,4,9,3,9,11,9,6,10,2,13,5,2,3,6,13,6,7,13,13,7,10,8,10,13,20,10,9,8,9,9,9,9,17,8,9,10,11,8,7,4,D C,1,1,1,1,1,1,20,1,1,1,1,1,1,1,1
8833761,Plínio,1651,16/06/1986,30,0,0,0,0,181,0,2,2,2,2,2,2,3,3,3,2,1,7,9,8,7,13,2,4,3,7,12,9,4,11,9,10,11,14,8,8,8,11,7,9,11,7,11,16,15,14,14,8,10,20,4,14,10,8,7,9,6,3,4,9,11,11,12,11,9,1,19,7,D/WB L,1,1,1,1,1,1,1,20,1,1,1,1,1,17,1
8833765,Rômulo,1651,22/05/1987,29,0,0,0,0,178,72,2,2,1,3,1,2,2,1,1,3,2,7,13,13,11,13,7,12,13,6,11,13,11,14,12,15,11,13,12,14,11,13,12,14,8,14,9,13,14,13,14,11,9,9,9,14,20,14,11,15,12,13,16,15,14,15,11,10,13,8,9,11,D/WB/M RC,1,1,1,1,1,14,1,3,17,10,20,3,19,3,19
8833782,Luciano,1651,14/01/1985,31,0,0,0,0,182,73,1,1,2,2,2,1,1,2,3,3,1,8,8,10,11,9,9,9,11,2,4,9,7,5,11,9,8,8,8,9,11,9,11,9,11,10,9,11,10,12,13,8,12,20,7,13,10,10,9,11,9,1,12,9,7,10,10,12,5,5,12,1,M/AM C,1,1,1,20,1,1,1,1,1,1,17,1,1,1,1
8834810,Márcio Diogo,1651,22/09/1985,30,0,0,0,0,170,64,3,2,1,2,2,1,1,1,3,2,1,11,10,12,11,11,12,7,12,9,8,12,7,8,13,7,12,10,11,10,12,11,13,12,7,14,9,12,12,14,12,9,6,11,12,14,20,12,9,12,5,10,5,10,10,11,12,14,11,1,4,4,M/AM/S C,1,1,18,20,1,1,1,1,1,1,16,1,1,1,1
8834921,Rafael Gaúcho,1651,15/01/1984,32,0,0,0,0,178,72,3,2,3,1,3,1,1,3,3,2,2,9,7,4,9,12,7,10,6,9,11,9,7,15,10,4,9,11,8,13,9,13,10,8,5,9,12,10,10,15,12,8,6,7,13,12,20,9,7,10,5,10,10,10,18,11,10,11,12,3,9,7,D R,1,1,1,1,1,1,1,1,20,1,1,1,1,1,15
8834923,Ceará,1651,02/02/1985,31,0,0,0,0,175,71,3,2,1,1,1,2,1,2,2,3,3,6,8,10,7,13,4,3,8,3,6,11,4,6,12,9,8,8,6,5,10,11,5,13,7,8,6,7,11,11,11,7,5,8,11,13,20,13,4,9,8,7,9,9,10,12,11,9,12,8,6,2,M/AM RC,1,1,1,20,1,17,1,1,1,1,17,1,15,1,1
8834927,Rodrigo Defendi,1651,17/06/1986,30,0,0,0,0,190,80,1,3,3,3,3,2,1,3,2,3,3,8,7,8,8,9,11,13,12,10,12,8,9,13,10,14,12,13,10,9,8,8,11,13,11,11,14,13,11,12,10,12,14,20,12,13,12,12,13,10,10,13,8,13,10,5,10,9,16,13,15,4,D C,1,12,1,1,1,1,20,1,1,1,1,1,1,1,1
8835083,Jonas,1651,10/02/1987,29,0,0,0,0,181,76,2,2,4,3,3,1,3,1,3,2,1,11,12,12,9,11,10,11,12,15,11,12,5,12,12,13,12,13,12,12,12,12,13,10,7,13,11,13,13,13,12,11,11,13,16,13,20,16,11,13,12,8,6,16,11,13,12,10,13,8,11,12,D/WB R,1,1,1,1,1,1,12,10,20,10,9,3,7,10,18
8835092,Ronny,1651,25/02/1983,33,0,0,0,0,188,80,1,1,1,1,1,1,1,1,1,1,1,7,8,9,12,11,9,12,9,6,5,9,13,6,11,8,11,9,12,10,10,9,13,11,9,12,7,8,10,11,11,13,13,10,11,12,20,12,12,10,7,10,12,7,13,14,11,12,13,14,15,6,AM/S L,1,1,20,10,17,10,1,1,1,1,1,1,1,1,1
8835106,Michel Alves,1651,25/03/1981,35,0,0,0,0,188,87,13,12,12,4,14,13,12,12,14,12,12,1,3,4,5,8,10,11,10,6,6,10,13,9,12,10,12,11,11,8,5,12,12,9,17,5,13,9,10,10,13,14,14,4,16,9,20,16,15,12,9,11,3,9,13,15,15,13,13,11,14,11,GK ,20,1,1,1,1,1,1,1,1,1,1,1,1,1,1
8835111,Tiago Rodrigues,1651,13/11/1985,30,0,0,0,0,170,70,3,2,2,2,1,3,1,3,1,3,2,7,9,12,9,12,9,4,9,2,3,13,6,3,12,10,13,5,10,6,11,6,7,13,15,11,6,10,7,14,15,6,5,8,13,13,20,10,6,10,5,10,10,10,11,13,9,11,8,4,10,8,AM/S C,1,1,18,20,1,1,1,1,1,1,15,1,1,1,1
8835124,Anderson Ataíde,1651,12/12/1985,30,0,0,0,0,181,74,1,1,3,1,1,3,3,3,3,3,2,5,3,7,6,12,5,5,7,5,6,10,2,6,9,6,8,7,9,7,7,12,4,9,12,7,7,6,7,12,12,7,11,9,11,12,20,12,10,12,9,6,6,9,13,12,11,11,13,9,16,7,M/AM C,1,1,12,20,1,1,1,1,1,1,16,1,1,1,1
8835129,Bruno,1651,21/06/1986,30,0,0,0,0,185,80,2,3,1,1,2,1,1,3,1,3,3,11,10,12,11,13,12,10,13,7,8,12,11,9,13,11,11,11,11,11,12,11,11,14,10,11,9,11,9,10,12,13,10,20,14,9,8,9,10,14,12,14,7,13,10,13,12,11,13,13,13,6,M/AM RLC,1,1,4,20,19,17,1,1,1,9,19,17,14,1,1
8835139,Nunes,1651,20/03/1984,32,0,0,0,0,182,78,3,1,1,3,2,3,3,2,1,3,3,3,5,9,9,10,12,5,12,8,12,11,8,13,6,16,11,15,9,12,6,5,14,7,11,10,12,13,14,12,11,10,11,5,13,12,20,11,10,11,18,7,7,12,12,13,15,9,12,13,12,8,DM/M C,1,1,1,1,1,1,10,1,1,20,19,1,1,1,1
8835141,Fernando Pinto,1651,28/03/1985,31,0,0,0,0,186,82,2,1,3,1,2,4,1,2,1,3,3,6,4,3,7,9,4,14,1,4,10,9,5,9,8,10,14,10,8,9,6,14,8,1,12,8,12,7,9,9,12,7,13,10,10,10,20,9,13,10,6,10,3,10,14,11,11,10,11,1,11,3,D C,1,1,1,1,1,1,20,1,1,1,1,1,1,1,1
8835146,Gustavo Souza,1651,18/07/1984,31,0,0,0,0,180,71,1,2,1,1,1,2,2,2,3,1,2,9,8,8,11,10,5,10,13,5,3,11,7,5,9,7,10,10,12,9,7,9,10,12,11,12,9,10,11,10,11,10,7,17,8,10,20,10,9,7,9,12,14,15,12,11,10,13,12,1,8,3,AM RL,1,1,10,10,20,17,1,13,13,1,10,13,13,8,8
8835147,Guto,1651,09/07/1985,30,0,0,0,0,179,74,1,3,3,1,2,2,2,4,2,3,3,5,8,14,10,11,7,12,8,4,3,6,6,1,9,10,9,1,10,8,8,12,9,7,9,13,7,7,8,10,11,8,10,8,14,10,20,8,6,9,10,7,5,8,19,10,11,10,12,8,12,2,S ,1,1,20,1,1,1,1,1,1,1,1,1,1,1,1
8835150,Japa,1651,05/10/1986,29,0,0,0,0,181,75,2,2,2,1,3,2,1,1,3,1,2,10,8,12,10,11,10,7,9,1,6,8,10,6,11,13,10,11,11,10,8,12,6,10,10,12,9,11,13,11,11,8,9,17,12,11,20,13,9,9,10,10,4,10,13,11,13,12,10,8,15,2,S ,1,1,20,1,1,1,1,1,1,1,1,1,1,1,1
8835156,Marcelo Grohe,1651,13/01/1987,29,0,0,0,0,188,80,13,13,13,6,15,13,16,17,13,9,12,7,2,1,3,10,12,10,2,3,1,10,3,2,10,7,13,12,12,13,11,12,15,2,14,2,14,14,14,13,14,13,14,8,11,12,20,13,13,13,8,13,6,12,7,12,18,14,16,15,10,7,GK ,20,1,1,1,1,1,1,1,1,1,1,1,1,1,1
8835157,Marco Tiago,1651,23/03/1984,32,0,0,0,0,188,80,2,2,2,2,2,1,3,1,3,2,1,6,10,1,1,8,4,9,6,2,9,7,1,13,6,6,12,9,7,11,4,12,9,2,9,6,13,6,7,9,11,5,13,10,11,13,20,8,12,7,6,9,8,9,13,12,10,12,13,9,13,1,D C,1,1,1,1,1,1,20,1,13,1,1,1,1,1,10
8835158,Matheus Cavichioli,1651,27/07/1986,29,0,0,0,0,192,86,14,11,9,6,9,14,13,14,9,6,9,7,1,3,1,1,9,1,1,1,3,2,2,2,5,7,9,11,8,9,7,14,12,2,9,3,7,8,7,12,12,6,16,3,10,10,20,2,14,11,7,9,9,9,8,10,12,11,9,8,9,8,GK ,20,1,1,1,1,1,1,1,1,1,1,1,1,1,1
8835163,Renan Silva,1651,05/01/1984,32,0,0,0,0,181,78,1,3,3,3,2,1,3,1,2,3,1,8,8,4,9,14,5,8,14,1,11,14,5,10,11,5,11,9,9,8,14,13,4,6,14,9,13,9,11,10,12,11,11,9,11,14,20,8,13,10,10,10,7,10,14,11,14,11,9,7,11,2,DM/M C,1,1,1,1,1,1,1,1,1,20,16,1,1,1,1
8835165,Júnior Carvalho,1651,12/08/1986,29,0,0,0,0,183,76,1,2,2,2,2,1,3,3,1,2,1,6,4,4,6,6,2,13,7,2,10,8,1,9,7,10,13,10,8,11,7,13,7,1,13,6,12,7,8,13,10,13,14,9,6,12,20,8,13,10,10,6,10,10,17,9,12,12,12,1,10,2,D C,1,1,1,1,1,1,20,1,1,10,1,1,1,1,1
8835167,Rone Dias,1651,20/05/1984,32,0,0,0,0,174,70,1,1,3,3,3,2,2,2,2,4,1,10,10,11,10,12,11,9,10,5,5,12,13,6,12,10,11,9,11,11,11,12,11,12,7,12,7,10,11,12,12,13,7,10,12,12,20,11,8,11,8,11,6,10,12,14,13,10,13,10,14,9,AM C,1,1,10,20,12,12,1,1,1,1,15,7,7,1,1
8835170,Saldanha,1651,07/02/1989,27,0,0,0,0,174,63,3,2,1,2,1,1,2,2,4,3,3,11,12,11,11,11,11,6,11,9,9,11,10,6,10,9,12,12,12,11,10,10,7,11,9,11,10,10,11,13,12,7,6,10,12,13,20,11,7,12,8,12,6,10,16,9,10,11,10,9,11,1,AM C,1,1,15,20,13,13,1,1,1,1,12,1,1,1,1
8835173,Tuta,1651,12/12/1985,30,0,0,0,0,170,71,3,2,2,2,2,2,1,2,2,2,1,10,10,11,8,9,9,9,8,9,7,10,5,8,12,13,9,12,8,9,9,9,13,12,8,11,7,9,13,14,12,9,6,6,15,13,20,13,12,11,10,9,10,14,14,14,14,8,11,9,8,3,WB/M R,1,1,10,5,1,12,1,1,14,3,7,1,20,1,17
8835176,Waldison,1651,17/06/1984,32,0,0,0,0,177,73,1,2,2,1,2,4,2,3,4,1,2,7,8,12,10,12,5,8,10,1,4,10,12,6,14,13,12,12,9,10,12,12,10,13,5,13,6,8,10,13,15,7,10,12,14,11,20,9,8,11,10,11,9,9,8,11,10,11,13,2,7,5,AM/S RLC,1,1,16,19,20,15,1,1,1,1,1,1,1,1,1
8835181,João Leonardo,1651,25/06/1985,31,0,0,13,0,185,75,2,1,1,3,3,2,2,3,1,1,1,4,6,8,7,9,8,13,7,6,13,8,9,12,10,10,10,10,11,11,7,12,15,12,11,4,13,12,11,11,10,11,13,10,16,10,20,11,12,12,11,13,5,9,11,16,6,14,14,14,17,13,D C,1,10,1,1,1,1,20,1,1,1,1,1,1,1,1
8835187,Gilsinho,1651,04/04/1984,32,0,0,0,0,168,68,2,2,1,1,1,1,4,1,2,1,3,11,8,14,7,13,10,8,10,5,7,11,12,7,14,15,11,16,11,12,11,12,14,13,8,11,8,11,14,13,13,11,10,12,14,12,20,13,9,13,6,13,2,10,11,13,11,14,12,15,6,2,AM/S C,1,1,19,20,8,12,1,1,1,1,1,1,1,1,1
8835191,Wilson Matias,1651,14/09/1983,32,0,0,0,0,186,80,3,2,1,2,2,4,1,3,1,3,1,6,6,6,6,12,8,13,13,10,13,14,9,12,12,13,12,13,12,13,12,13,11,11,11,11,13,13,14,14,13,14,14,10,12,14,20,15,14,13,11,10,10,6,16,12,12,13,10,9,10,12,DM/M C,1,1,1,1,1,1,1,1,1,20,17,1,1,1,1
8835192,Soares,1651,16/05/1985,31,0,0,0,0,175,72,3,1,3,1,3,1,2,1,2,1,3,8,11,13,12,11,4,11,11,6,4,12,12,5,13,10,12,12,12,11,11,13,12,15,5,13,6,10,12,13,13,11,8,10,12,13,20,13,8,12,5,13,12,10,11,12,9,12,14,7,15,4,S ,1,1,20,14,14,14,1,1,1,1,1,1,1,1,1
8835199,Abraão,1651,14/06/1983,33,0,0,0,0,185,79,3,3,1,1,3,3,2,1,3,3,1,6,8,13,12,13,6,10,8,5,4,10,8,4,13,13,12,1,10,8,8,14,9,10,10,14,4,9,8,10,10,14,10,9,15,11,20,11,12,9,9,8,9,9,8,11,11,10,11,5,12,6,S ,1,1,20,1,1,1,1,1,1,1,1,1,1,1,1
8835200,Rodolfo,1651,04/04/1985,31,0,0,0,0,176,77,4,1,1,1,3,3,2,3,1,1,2,11,4,6,10,4,13,6,12,12,12,11,6,12,5,14,11,13,10,10,11,10,11,10,12,10,12,12,12,11,11,14,12,10,10,11,20,10,13,10,13,11,13,4,12,12,11,11,12,9,7,4,WB/DM/M RC,1,1,1,1,1,1,1,1,13,20,18,1,17,1,17
8835202,Sílvio,1651,30/04/1985,31,0,0,0,0,189,83,1,3,2,1,1,1,2,1,2,2,3,1,4,7,6,7,6,12,6,6,12,7,7,12,6,15,10,14,9,10,5,9,11,10,11,7,11,14,12,11,11,11,14,7,14,11,20,12,14,12,11,12,7,8,12,12,14,13,13,13,13,10,D C,1,11,1,1,1,1,20,1,1,1,1,1,1,1,1
8835206,Alex Barros,1651,28/10/1988,27,0,0,0,0,164,71,1,2,3,3,2,1,2,4,3,2,1,5,6,12,5,11,2,4,5,8,10,12,1,13,6,10,11,10,10,8,6,13,3,10,13,12,11,9,10,14,14,8,6,20,12,12,10,14,8,9,5,10,10,10,7,9,10,11,13,7,5,2,D/WB L,1,1,10,1,1,1,1,20,1,1,1,1,1,17,1
8835211,Fábio Rampi,1651,23/01/1989,27,0,0,0,0,182,80,14,13,13,1,8,14,7,13,10,10,9,5,3,1,3,5,8,1,2,1,1,3,3,2,7,7,10,14,9,11,8,9,6,2,7,3,13,9,8,13,13,10,12,9,11,13,20,5,12,10,9,9,10,10,14,12,10,10,11,5,15,2,GK ,20,1,1,1,1,1,1,1,1,1,1,1,1,1,1
8835218,Márcio Lima,1651,28/03/1988,28,0,0,0,0,172,66,3,2,3,3,2,1,2,3,2,1,1,8,12,11,8,12,6,7,7,11,10,10,7,9,11,13,10,12,13,11,9,11,3,9,4,11,10,12,13,12,12,10,8,8,14,13,20,12,9,10,10,10,4,10,9,10,11,12,12,8,15,6,D/WB R,1,1,1,1,1,1,1,1,20,1,1,1,1,1,17
8835219,Pedro Carmona,1651,15/04/1988,28,0,0,0,0,177,77,2,3,1,3,3,3,1,1,1,1,3,8,11,10,9,16,14,8,12,11,9,11,7,11,12,4,8,10,10,10,13,10,12,9,9,13,10,11,11,13,13,10,9,20,11,13,8,13,10,12,6,9,6,5,16,12,7,10,9,7,10,9,D/M/AM LC,1,1,1,20,19,1,1,18,1,1,12,17,1,15,1
8835230,Chumbinho,1651,21/09/1986,29,0,0,0,0,174,71,2,2,3,3,4,2,2,3,2,3,3,13,13,14,13,12,15,8,15,5,6,15,14,4,14,7,11,8,12,10,16,11,6,14,6,11,7,10,8,10,12,10,7,10,14,11,20,10,8,8,8,12,4,7,14,16,9,8,10,10,8,10,AM C,1,1,10,20,7,10,1,1,1,1,14,6,7,1,1
8835233,Ji-Paraná,1651,11/06/1987,29,0,0,4,0,172,72,2,1,3,1,2,3,1,3,1,2,3,11,10,13,9,13,12,7,11,10,7,14,11,9,16,11,11,11,12,10,13,12,12,14,13,12,9,10,9,14,12,10,6,20,9,10,12,8,12,11,11,9,13,16,13,6,8,11,13,8,9,12,DM/M LC,1,1,1,12,13,1,1,11,1,20,17,19,1,14,1
8835236,Élton,1651,07/04/1986,30,0,0,0,0,156,57,3,2,3,4,4,1,3,3,1,1,1,13,12,15,9,12,13,2,9,2,2,13,13,2,14,6,11,13,9,7,12,9,14,16,3,12,7,10,11,16,15,8,2,20,14,15,11,13,7,12,5,12,7,8,13,14,12,11,14,14,10,12,AM LC,1,1,12,20,20,12,1,1,1,1,15,15,1,1,1
8835240,Vítor Júnior,1651,15/09/1986,29,0,0,0,0,165,62,4,3,3,3,4,1,1,1,1,3,3,11,11,15,12,14,14,8,14,4,4,13,13,6,14,8,8,10,13,11,11,12,12,15,4,13,9,12,13,16,16,10,6,20,14,14,8,12,7,12,5,13,8,11,15,16,7,14,8,13,13,11,AM C,1,1,1,20,14,1,1,1,1,1,13,7,1,1,1
8835241,André Rocha,1651,19/08/1984,31,0,0,0,0,184,80,1,3,1,4,3,2,2,4,1,1,3,14,13,13,10,13,13,9,12,8,11,14,14,11,14,10,11,12,11,12,13,12,10,12,9,12,11,12,13,12,11,12,13,8,12,12,20,12,12,10,14,11,10,16,12,14,16,8,9,4,10,9,D R,1,1,1,12,1,1,1,1,20,12,14,1,12,1,15
8835244,Danilo,1651,21/02/1983,33,0,0,0,0,177,72,3,4,1,3,3,2,1,3,1,1,1,6,6,10,11,13,6,2,10,4,7,11,3,8,10,13,10,7,11,5,10,13,12,11,10,11,7,7,12,12,10,10,7,10,10,14,20,11,10,13,9,11,5,13,8,15,13,14,13,13,11,5,M/AM C,1,1,10,20,1,10,1,1,1,1,16,1,5,1,1
8835245,Leozinho,1651,12/12/1985,30,0,0,0,0,170,73,2,3,3,2,3,2,1,3,3,2,3,15,13,14,11,15,14,6,15,3,4,15,16,3,15,7,12,6,10,9,14,12,8,16,6,13,7,9,12,13,15,8,5,20,13,12,5,10,6,8,14,14,6,12,12,13,12,8,14,8,13,9,M/AM LC,1,1,10,20,16,14,1,1,1,1,16,10,7,1,1
885420,Marcelinho Paraíba,1651,17/05/1975,41,5,1,0,0,175,68,1,1,2,1,1,2,3,3,2,1,1,15,12,12,12,14,14,9,13,2,6,14,17,6,15,12,12,11,13,12,13,15,14,16,14,14,5,9,9,9,11,14,7,20,14,8,13,10,5,13,12,17,7,11,13,16,15,16,11,7,6,16,M/AM/S C,1,1,19,20,14,12,1,1,1,1,18,11,6,1,1
8871510,Léo,1651,18/11/1982,33,0,0,0,0,175,72,2,2,2,2,1,4,1,2,1,3,2,8,6,7,14,11,8,10,8,4,8,11,7,4,13,9,9,5,11,9,13,12,2,12,13,14,7,9,9,13,11,9,8,8,12,11,20,13,6,10,9,10,8,10,12,9,9,8,11,1,7,4,AM C,1,1,15,20,10,10,1,1,1,1,1,1,1,1,1
8875701,William Soares,1651,07/02/1985,31,0,0,0,0,186,80,1,2,1,3,4,3,3,2,3,3,1,2,4,12,5,7,4,14,7,11,12,12,6,12,12,14,14,15,13,13,11,12,16,9,13,7,14,17,16,10,7,16,14,7,17,11,20,14,13,12,7,12,5,13,12,14,8,12,15,13,13,3,D/DM/M C,1,17,1,1,1,1,20,1,1,17,17,1,1,1,1
8876055,Rodrigo Dantas,1651,26/12/1984,31,0,0,0,0,185,83,2,1,2,2,1,3,2,1,2,1,2,7,8,6,13,11,5,13,8,6,7,9,6,7,9,12,12,12,12,12,11,12,12,12,8,12,10,12,12,13,12,14,14,7,13,13,20,13,14,10,10,12,7,4,14,11,14,13,14,11,11,9,S ,1,1,20,1,4,1,1,1,1,1,1,1,1,1,1
8877007,Felipe,1651,20/04/1985,31,0,0,0,0,197,95,3,1,2,2,3,1,2,1,2,3,2,5,9,9,10,13,8,14,8,5,7,11,8,6,14,9,12,10,9,12,11,10,6,9,6,10,10,13,7,11,12,9,16,7,11,10,20,11,13,16,8,11,13,9,8,9,5,7,10,4,10,9,S ,1,1,20,7,1,1,1,1,1,1,1,1,1,1,1
8877986,Leandro Salino,1651,22/04/1985,31,0,0,0,0,168,62,1,2,3,2,3,3,2,1,2,1,2,8,11,8,7,11,7,8,10,12,14,11,10,13,12,16,13,16,12,13,10,13,16,8,11,10,13,16,16,15,14,13,7,7,11,14,20,14,10,14,10,16,8,14,12,13,14,16,14,11,12,8,D/WB R,1,1,1,1,1,1,1,14,20,10,14,1,7,10,16
8878263,Matheus,1651,15/01/1983,33,0,0,0,0,175,68,1,3,2,3,2,1,2,1,2,2,2,13,13,15,13,12,12,9,12,10,8,11,13,7,13,9,11,15,13,10,10,13,15,15,12,14,9,13,14,16,16,9,10,20,15,14,13,11,10,12,9,11,12,12,17,15,15,11,13,14,13,6,AM/S RLC,1,1,17,17,17,20,1,1,1,1,1,7,7,1,1
8878850,Geromel,1651,21/09/1985,30,0,0,0,0,190,84,2,3,2,2,2,1,1,1,4,2,2,4,4,8,7,14,4,15,5,4,16,11,5,16,12,5,15,12,14,14,8,14,13,6,6,10,15,16,15,14,14,8,15,10,11,15,20,14,14,16,8,15,5,8,16,12,14,15,16,17,13,12,D C,1,14,1,1,1,1,20,5,8,10,5,1,1,3,3
89024840,Raphael Branco,1651,25/07/1990,25,0,0,0,0,189,80,2,1,3,3,3,1,2,3,3,2,2,5,6,11,5,10,6,12,6,8,9,10,6,11,11,17,10,15,13,9,10,8,13,13,10,8,10,11,14,11,10,12,14,12,13,13,20,14,12,10,18,10,9,6,10,11,12,9,10,11,10,7,D RC,1,9,1,1,1,1,20,10,15,11,13,1,5,1,10
89054795,Iago Dias,1651,06/04/1993,23,0,0,0,0,175,74,2,1,1,1,3,1,1,2,1,1,2,11,14,14,12,14,9,11,8,9,7,11,7,9,12,8,12,6,12,8,7,14,3,12,10,11,9,10,10,15,13,10,5,11,17,14,20,9,9,6,10,9,4,11,20,10,11,13,12,10,4,6,M/AM/S R,1,1,16,1,1,20,1,1,1,1,1,1,19,1,1
89059005,Victor Henrique,1651,05/01/1998,18,0,0,0,0,186,0,2,1,1,2,3,1,2,1,3,3,3,6,4,5,3,4,5,13,2,2,13,7,3,13,6,9,5,9,7,10,5,13,10,1,11,5,12,6,7,9,11,7,11,2,9,13,20,11,7,9,9,6,3,9,15,11,10,11,12,8,7,3,D C,1,1,1,1,1,1,20,1,1,1,1,1,1,1,1
90066141,Franklin Joseph,1651,23/02/1999,17,0,0,0,0,192,0,3,2,2,3,1,2,1,1,2,2,1,4,2,4,5,8,2,14,5,6,10,8,3,10,3,9,9,9,3,12,7,14,8,1,5,6,10,7,8,14,13,8,15,20,11,12,6,8,10,9,5,9,9,8,8,11,13,11,11,3,13,2,D C,1,1,1,1,1,1,20,1,1,1,1,1,1,1,1
90066218,Hygor,1651,13/08/1992,23,0,0,0,0,187,78,1,3,1,2,2,2,1,2,2,1,1,3,8,9,11,9,4,9,7,5,2,9,8,6,9,18,16,11,10,9,9,9,12,4,7,12,10,14,18,13,14,8,11,6,12,10,20,11,6,7,1,12,2,9,11,7,10,6,19,18,12,10,AM/S L,1,1,16,1,20,5,1,1,1,1,1,1,1,1,1
90072860,Wendel,1651,28/08/1997,18,0,0,0,0,180,0,1,3,2,1,3,3,3,3,2,1,3,7,5,3,6,14,7,4,13,4,7,14,1,11,14,6,9,8,5,7,13,14,4,6,8,7,8,8,11,11,13,8,6,20,13,14,9,7,7,9,9,9,9,9,10,10,8,10,11,1,17,8,DM ,1,1,1,1,1,1,1,1,1,20,10,1,1,1,1
90072885,Aslen,1651,06/09/1998,17,0,0,0,0,186,0,3,2,3,2,1,3,3,3,1,1,4,5,7,13,11,13,7,5,10,4,7,11,7,8,14,9,6,8,7,5,14,14,9,13,10,5,6,8,13,13,11,8,11,1,14,11,20,10,10,8,9,9,3,9,10,12,10,12,10,10,8,4,AM C,1,1,1,20,1,1,1,1,1,1,1,1,1,1,1
91017336,Da Silva,1651,12/01/1986,30,0,0,0,0,189,0,1,1,3,2,2,3,2,2,2,3,1,4,5,9,9,12,4,12,4,1,3,4,2,1,8,8,8,2,7,3,4,12,1,9,12,12,4,4,6,12,12,5,9,10,5,12,20,11,11,8,8,2,8,8,11,10,9,7,9,4,8,8,S ,1,1,20,1,1,1,1,1,1,1,1,1,1,1,1
91119875,Cauly Oliveira Souza,1651,15/09/1995,20,0,0,0,0,175,72,4,3,1,1,2,4,2,1,2,2,2,12,10,13,9,10,10,4,7,5,5,11,8,6,12,11,9,9,9,9,14,10,10,17,7,12,7,10,9,14,16,9,8,20,9,11,14,10,8,12,7,11,9,11,6,10,12,9,11,13,12,6,M/AM LC,1,1,11,15,18,13,1,1,1,7,15,20,7,1,1
91145035,Alysson Andrei Vargas,1651,28/12/1994,21,0,0,0,0,175,80,3,1,2,2,1,2,1,1,2,2,3,1,6,13,13,11,5,10,2,2,5,7,8,2,8,8,7,5,9,6,7,10,3,8,5,11,6,5,7,13,10,6,7,20,8,12,9,7,6,8,7,4,8,8,12,11,10,11,13,4,3,2,S ,1,1,20,13,1,1,1,1,1,1,1,1,1,1,1
91148710,Marcony Pimentel,1651,06/06/1996,20,0,0,0,0,178,0,3,2,2,3,3,2,3,4,3,1,2,4,6,7,2,10,6,6,9,1,10,13,1,13,12,9,6,5,8,3,6,13,9,9,13,3,7,7,10,13,13,7,4,14,13,13,20,5,5,9,9,4,6,9,8,12,12,11,12,12,8,5,DM/M C,1,1,1,1,1,1,1,1,1,20,20,1,1,1,1
915016,Furtado,1651,07/04/1983,33,0,0,0,0,173,65,2,1,2,3,3,2,2,2,2,2,3,10,10,12,6,12,11,5,9,7,4,9,8,7,12,10,8,10,9,8,9,8,10,13,6,10,6,11,11,14,14,9,7,10,13,13,20,11,6,10,10,13,8,16,10,13,8,9,12,14,14,8,M/AM R,1,1,1,10,13,20,1,10,12,5,10,13,16,10,12
915423,Macio,1651,08/06/1982,34,0,0,0,0,178,65,1,1,3,2,3,3,3,2,3,3,4,5,8,12,8,10,3,9,6,1,4,10,5,4,14,8,9,4,10,7,7,5,8,11,5,11,5,7,11,11,13,8,9,1,11,15,20,11,5,13,8,5,15,8,13,12,10,9,11,3,4,7,AM/S RC,1,1,17,20,1,17,1,1,1,1,15,1,1,1,1
92035693,Lucas Rocha,1651,14/07/1991,24,0,0,0,0,194,82,3,1,1,4,2,2,2,3,2,1,3,3,5,8,9,11,4,12,8,8,11,9,6,11,9,7,11,10,10,12,8,10,12,9,7,11,12,13,14,12,10,14,15,5,14,10,20,13,14,10,7,10,6,5,12,11,11,11,13,14,7,7,D C,1,1,1,1,1,1,20,1,1,1,1,1,1,1,1
92056781,Ramón,1651,04/04/1991,25,0,0,0,0,180,76,3,4,3,1,3,3,2,4,3,1,4,7,8,13,12,10,10,7,12,12,6,12,12,7,14,11,13,13,14,13,9,12,4,12,8,15,8,13,13,15,13,11,12,10,12,14,20,14,9,11,7,10,10,12,8,11,10,12,10,1,13,5,AM/S R,1,1,20,14,12,16,1,1,1,1,1,1,1,1,1
92057437,Carlinhos,1651,22/06/1994,22,0,0,0,0,179,81,3,1,1,1,1,1,2,2,2,3,1,9,12,13,9,14,8,5,8,12,7,13,8,8,14,14,7,10,9,8,10,9,5,13,6,12,7,10,15,14,13,10,9,13,13,14,20,10,13,10,6,8,3,12,14,13,11,10,10,6,10,3,D/WB/M R,1,1,1,1,10,15,1,1,20,1,1,10,19,1,19
93021229,Clécio,1651,31/05/1988,28,0,0,0,0,187,82,3,4,2,1,1,2,1,2,2,3,2,9,8,10,10,12,10,10,11,10,2,6,4,3,10,14,7,7,9,9,7,6,7,9,3,5,2,9,9,14,12,8,15,12,14,13,20,9,14,9,14,9,9,9,6,8,13,7,9,4,8,1,S ,1,1,20,1,1,1,1,1,1,1,1,1,1,1,1
93031312,Gilmar,1651,11/01/1988,28,0,0,0,0,190,82,2,3,2,3,3,3,2,1,2,1,2,3,4,13,13,13,6,9,7,2,6,7,7,2,13,7,11,2,8,6,7,10,4,13,10,10,5,6,7,13,11,7,13,10,12,12,20,10,8,9,6,1,8,9,11,12,9,11,12,2,4,4,S ,1,1,20,1,1,1,1,1,1,1,1,1,1,1,1
93033425,Vinicius Gil,1651,18/01/1988,28,0,0,0,0,187,80,1,1,1,1,3,3,3,2,1,3,1,3,4,5,5,8,2,12,3,4,9,12,3,11,7,7,6,7,9,9,8,10,3,5,9,10,13,9,6,13,7,10,8,8,13,12,20,12,12,10,7,10,5,6,15,13,13,13,10,6,12,6,D C,1,1,1,1,1,1,20,5,12,1,1,1,1,1,1
93038196,Maranhão,1651,19/05/1992,24,0,0,0,0,175,70,2,3,3,3,2,1,3,3,2,3,1,7,10,14,10,13,11,7,12,4,5,11,12,4,14,13,9,8,14,7,7,11,8,17,4,12,9,10,10,14,11,9,11,15,14,12,20,11,6,7,10,15,10,11,17,9,10,11,12,5,9,2,AM RLC,1,1,15,20,17,16,1,1,1,1,10,1,1,1,1
93053376,Ismael,1651,01/12/1994,21,0,0,0,0,169,68,3,1,1,1,1,2,2,3,3,3,2,13,11,14,10,14,11,5,9,6,9,14,12,11,14,14,14,11,12,11,15,11,10,13,6,10,11,11,13,13,13,13,7,10,15,12,20,13,10,11,9,10,11,12,14,10,5,9,10,10,10,6,DM/M/AM C,1,1,1,17,1,1,1,1,1,16,20,1,1,1,1
93054716,Igor Santos Koppe,1651,31/03/1992,24,0,0,0,0,172,72,1,2,2,3,3,3,2,4,3,3,3,8,9,10,6,11,6,5,8,8,10,12,8,8,12,8,9,7,9,10,11,10,4,8,5,10,10,9,8,12,10,11,8,13,11,13,20,13,11,11,7,5,9,10,18,10,13,11,9,2,13,2,M C,1,1,1,10,1,1,1,1,1,1,20,1,1,1,1
93067237,Isaac Freitas,1651,01/02/1990,26,0,0,0,0,175,74,3,3,1,1,2,1,4,3,1,4,1,5,9,10,9,9,1,8,5,8,8,9,3,9,11,9,7,9,8,12,5,11,6,7,12,6,7,8,9,10,10,8,9,8,13,11,20,13,9,8,9,9,9,9,20,13,10,12,10,5,13,8,D R,1,1,1,1,1,1,1,1,20,1,1,1,1,1,15
93086462,Matheus Troche,1651,17/06/1996,20,0,0,0,0,190,84,1,1,3,2,2,3,3,2,2,2,3,5,1,5,1,7,5,10,1,2,6,7,1,12,4,7,10,8,4,6,4,13,8,1,13,3,8,5,7,7,12,3,14,20,11,11,9,9,11,8,8,7,8,8,19,10,13,14,12,5,12,5,D LC,1,1,1,1,1,1,20,16,1,12,10,1,1,10,1
945103,Thiago,1651,22/10/1988,27,0,0,0,0,171,64,3,1,3,2,3,2,3,1,1,2,3,12,13,15,10,14,12,5,8,6,4,14,10,4,15,13,14,7,10,5,14,5,3,16,6,11,4,4,8,15,15,13,5,16,5,12,20,6,5,3,10,7,13,4,5,10,6,6,4,6,15,15,M/AM C,1,1,10,20,13,10,1,1,1,1,17,13,10,1,1
945289,Diego Viana,1651,05/05/1983,33,0,0,0,0,183,76,3,2,2,1,3,1,4,3,3,2,1,1,4,11,13,10,2,11,7,6,2,10,7,4,10,7,11,13,10,11,11,11,12,2,14,10,5,13,13,11,11,14,12,16,14,10,20,10,12,12,8,10,12,10,11,16,8,10,13,11,3,5,S ,1,1,20,1,1,1,1,1,1,1,1,1,1,1,1
95035998,Gustavo Araújo,1651,09/04/1997,19,0,0,0,0,178,0,2,2,2,1,1,3,1,1,2,3,3,3,6,11,13,13,5,13,6,4,4,7,4,2,12,8,5,5,12,3,5,11,8,12,1,8,4,5,7,13,12,6,3,1,10,12,20,7,6,8,8,8,6,8,14,11,9,12,13,6,6,3,AM/S C,1,1,20,18,1,1,1,1,1,1,1,1,1,1,1
95036005,Werick,1651,25/04/1999,17,0,0,0,0,179,0,1,3,2,3,3,1,2,3,3,1,3,6,8,12,7,14,6,4,6,6,5,9,2,8,11,6,6,4,7,4,7,14,1,10,1,8,5,7,8,9,9,2,10,8,13,10,20,8,8,8,8,8,8,8,11,11,11,13,9,6,9,5,M/AM LC,1,1,12,20,15,1,1,1,1,1,17,13,1,1,1
95040312,Murilo Cerqueira,1651,27/03/1997,19,0,0,0,0,188,78,1,1,2,3,1,2,3,3,2,3,2,4,8,7,8,9,5,13,6,5,12,10,7,12,11,11,12,12,11,12,8,12,10,5,11,5,12,12,12,11,10,9,14,6,10,12,20,13,12,10,10,10,6,10,12,13,10,10,11,10,10,4,D C,1,1,1,1,1,1,20,1,1,1,1,1,1,1,1
95041150,Pedrão,1651,23/09/1992,23,0,0,0,0,182,0,2,3,3,2,2,1,2,2,1,3,1,3,1,2,2,8,5,13,4,3,13,8,1,14,6,9,14,8,7,10,4,14,9,6,9,5,8,7,8,14,11,8,7,9,9,13,20,10,8,9,6,9,9,9,16,14,10,8,12,4,9,3,D C,1,1,1,1,1,1,20,1,1,1,1,1,1,1,1
955285,Homero Sartori,1651,28/05/1983,33,0,0,0,0,182,73,2,1,2,2,2,1,3,1,1,1,4,7,10,7,4,5,4,10,10,12,11,4,11,11,12,13,12,10,9,10,10,10,9,11,7,4,12,11,9,11,10,8,10,5,11,12,20,12,12,12,9,12,7,9,16,10,9,12,13,2,10,7,D RC,1,1,1,1,1,1,15,1,20,5,1,1,1,1,10
956074,Edilio Cardoso,1651,16/05/1983,33,0,0,0,0,171,81,2,2,3,1,3,3,2,3,3,1,1,8,9,14,13,10,7,10,12,7,9,12,12,8,14,11,12,14,13,12,14,12,4,13,8,14,10,8,12,14,12,12,8,9,12,12,20,11,10,10,8,7,14,6,13,10,11,12,10,5,8,5,AM/S R,1,1,20,1,13,18,1,1,1,1,1,1,12,1,1
958135,Tiago,1651,16/08/1984,31,0,0,0,0,185,78,1,3,1,1,3,3,1,3,1,3,2,9,8,9,10,10,11,12,11,4,7,10,12,7,10,13,10,12,12,11,9,11,13,11,11,10,9,10,10,11,10,12,12,10,13,9,20,12,11,12,12,11,7,13,16,13,7,11,13,9,8,14,M/AM/S C,1,1,18,20,1,1,1,1,1,1,18,1,1,1,1
96027736,Lucas Guedes,1651,30/05/1996,20,0,0,0,0,181,77,4,1,2,2,1,1,2,2,1,1,2,9,7,10,11,11,7,6,14,5,11,10,5,9,12,9,7,9,7,6,10,6,9,16,7,10,9,11,15,11,11,7,11,10,13,11,20,10,6,9,7,7,8,8,14,6,14,10,15,3,6,5,M/AM C,1,1,1,17,1,1,1,1,1,1,20,1,1,1,1
96029492,Alexandre,1651,11/01/1992,24,0,0,0,0,182,71,1,3,2,3,4,4,1,1,1,3,3,4,4,12,10,12,4,8,7,5,3,9,12,3,13,6,10,11,10,12,9,7,12,13,2,11,4,8,10,12,12,10,10,10,13,12,20,10,7,10,3,12,4,2,7,9,13,12,11,16,15,6,S ,1,1,20,1,1,1,1,1,1,1,1,1,1,1,1
96029493,Dudu,1651,02/08/1992,23,0,0,0,0,178,72,3,3,2,1,1,1,1,2,3,2,1,5,6,6,5,9,6,11,7,8,9,6,10,9,11,6,7,6,8,10,9,10,5,9,3,6,9,12,11,9,10,10,10,6,11,10,20,12,12,9,5,8,6,6,20,8,12,11,10,1,6,7,D/WB/M RC,1,1,1,1,1,1,15,1,20,1,1,1,18,1,18
96029771,Serginho,1651,09/06/1990,26,0,0,0,0,195,0,3,1,2,1,1,1,1,1,3,1,1,8,8,7,9,11,7,8,10,3,8,11,6,13,12,10,12,9,6,9,10,14,3,7,12,6,9,9,11,14,14,9,15,7,12,14,20,8,11,10,7,6,10,10,11,9,10,14,10,7,8,4,DM ,1,1,1,1,1,1,1,1,1,20,10,1,1,1,1
96030414,Joao Carlos,1651,15/01/1985,31,0,0,0,0,196,89,3,1,2,1,4,2,2,2,4,1,1,3,3,9,4,7,1,12,3,6,10,10,3,10,6,8,8,8,8,8,11,9,9,1,12,9,9,11,8,6,4,15,17,6,10,7,20,13,16,12,8,9,9,9,11,11,9,12,12,3,5,1,D C,1,1,1,1,1,1,20,1,1,1,1,1,1,1,1
96041411,Leândro,1651,26/11/1988,27,0,0,0,0,175,74,2,2,1,4,4,2,1,3,1,3,1,7,10,13,11,10,11,7,13,2,5,10,13,8,12,13,10,12,12,12,12,11,15,14,11,11,6,10,12,12,12,8,8,9,12,12,20,11,8,14,12,11,6,10,15,11,20,15,13,9,9,5,AM/S C,1,1,20,17,1,1,1,1,1,1,1,1,1,1,1
96045180,Alex Bruno,1651,07/10/1993,22,0,0,0,0,169,61,3,2,3,2,2,1,1,1,3,2,2,7,11,12,8,12,9,7,9,7,6,12,8,7,13,13,8,13,12,9,12,10,3,12,5,13,7,8,13,14,12,7,7,6,11,13,20,10,7,9,13,10,5,11,14,12,4,4,3,8,14,6,AM RC,1,1,14,20,10,18,1,1,1,1,7,5,10,1,1
96048250,Diego,1651,15/11/1989,26,0,0,0,0,177,73,1,2,3,4,4,3,2,2,2,3,3,12,9,9,8,10,11,6,10,5,6,10,10,8,10,11,9,12,9,11,10,10,13,11,6,11,8,11,12,11,13,9,9,20,15,11,7,10,9,12,8,12,3,10,13,13,13,10,13,15,11,5,M LC,1,1,1,14,14,1,1,1,1,1,20,20,1,1,1
96078041,Jardel Muniz Cruz,1651,06/06/1989,27,0,0,0,0,184,78,2,1,2,3,3,2,1,2,1,1,3,7,3,11,14,11,7,8,6,4,3,11,8,2,12,8,9,8,10,8,8,7,4,9,5,11,6,7,9,10,10,10,10,20,10,10,7,13,10,9,8,5,6,8,16,10,12,9,12,1,2,1,S ,1,1,20,10,1,1,1,1,1,1,1,1,1,1,1
96080681,Diogo,1651,18/10/1992,23,0,0,0,0,187,76,1,1,3,2,2,3,1,1,2,1,3,6,7,12,7,10,7,9,7,3,11,13,4,11,12,8,9,10,11,8,12,12,12,14,5,12,9,13,12,8,14,11,16,9,13,8,20,12,10,11,4,10,5,8,14,13,10,10,12,14,15,4,DM/M C,1,1,1,7,1,1,7,1,1,18,20,1,1,1,1
96084294,Raphael Carioca,1651,28/07/1991,24,0,0,0,0,185,79,1,2,2,1,3,3,1,1,1,4,2,6,6,13,9,13,6,11,3,1,5,7,6,4,10,6,13,8,8,6,2,10,5,10,10,13,7,6,7,13,9,7,11,10,11,11,20,7,13,9,9,2,9,9,17,13,12,13,10,12,14,8,S ,1,1,20,1,1,1,1,1,1,1,1,1,1,1,1
96114518,Edil,1651,19/07/1990,25,0,0,0,0,190,82,4,2,2,1,3,3,1,2,3,2,1,2,5,6,6,7,5,13,1,2,6,7,1,11,3,9,10,9,7,9,4,13,4,8,11,6,12,6,6,12,12,7,14,9,11,13,20,10,8,9,7,2,9,9,18,10,12,12,11,1,11,6,D C,1,1,1,1,1,1,20,1,1,1,1,1,1,1,1
962097,Nei,1651,19/12/1980,35,0,0,0,0,187,90,13,7,7,8,9,13,5,13,8,8,12,2,1,3,3,3,7,1,2,2,3,1,1,2,2,8,6,13,6,5,5,11,4,1,11,2,9,6,5,10,12,5,13,9,15,11,20,5,15,8,8,8,8,8,12,10,11,11,10,8,5,1,GK ,20,1,1,1,1,1,1,1,1,1,1,1,1,1,1
98017009,Antero Gomes,1651,14/02/1993,23,0,0,0,0,173,0,2,3,2,3,3,3,1,3,1,2,3,7,10,12,13,8,6,7,4,6,6,10,2,4,10,9,8,2,5,7,9,9,9,10,11,11,7,7,8,13,9,7,2,20,14,13,3,13,4,9,9,9,9,9,15,13,11,11,13,1,13,7,AM RLC,1,1,15,18,20,15,1,1,1,1,14,1,1,1,1
98017611,Wellington,1651,27/02/1987,29,0,0,0,0,172,0,3,1,3,3,1,2,3,1,3,1,3,2,6,2,3,13,1,8,6,7,9,8,4,14,8,9,8,9,8,7,5,9,9,5,6,6,11,8,8,14,14,8,3,20,5,14,16,11,6,9,6,9,6,9,14,11,11,13,11,4,11,6,D L,1,1,1,1,1,1,1,20,1,1,1,1,1,1,1
98029347,Cássio,1651,20/08/1990,25,0,0,0,0,173,68,4,1,2,3,2,1,1,1,3,1,1,12,11,12,8,14,11,6,8,7,6,12,11,5,13,7,11,6,10,11,12,10,8,14,7,11,6,9,8,13,14,6,6,14,11,12,20,11,8,7,8,10,12,10,7,12,12,7,13,9,11,10,M/AM/S RLC,1,1,16,16,17,20,1,1,1,1,7,10,16,1,1
98029785,Guto,1651,08/11/1989,26,0,0,0,0,182,80,2,1,3,2,1,3,3,2,3,2,2,6,5,6,5,10,6,4,9,1,5,13,2,8,12,9,10,8,7,6,13,11,3,12,13,8,7,7,4,13,13,7,5,14,13,13,20,6,7,9,6,9,9,9,9,12,11,13,9,6,3,6,AM C,1,1,1,20,1,1,1,1,1,1,15,1,1,1,1
